Game started
Game ID: 787027613 0.50/1 (PRR) Karkadann (Hold'em)
Seat 7 is the button
Seat 1: StephCurry (105.78).
Seat 2: PANDAisEVIL (101).
Seat 3: AironVega (103.20).
Seat 4: IlxxxlI (43).
Seat 5: pineapplesand (40).
Seat 6: dankmann (206.52).
Seat 7: ElvenEyes (115).
Seat 8: gust (46).
Seat 9: VegetablesArentYummy (273.59).
Player gust has small blind (0.50)
Player VegetablesArentYummy has big blind (1)
Player IlxxxlI received card: [9d]
Player IlxxxlI received card: [7d]
Player StephCurry folds
Player PANDAisEVIL folds
Player AironVega folds
Player IlxxxlI folds
Player pineapplesand folds
Player dankmann raises (3)
Player ElvenEyes folds
Player gust folds
Player VegetablesArentYummy folds
Uncalled bet (2) returned to dankmann
Player dankmann mucks cards
------ Summary ------
Pot: 2.50. Rake 0
Player StephCurry does not show cards.Bets: 0. Collects: 0. Wins: 0.
Player PANDAisEVIL does not show cards.Bets: 0. Collects: 0. Wins: 0.
Player AironVega does not show cards.Bets: 0. Collects: 0. Wins: 0.
Player IlxxxlI does not show cards.Bets: 0. Collects: 0. Wins: 0.
Player pineapplesand does not show cards.Bets: 0. Collects: 0. Wins: 0.
Player dankmann mucks (does not show cards). Bets: 1. Collects: 2.50. Wins: 1.50.
Player ElvenEyes does not show cards.Bets: 0. Collects: 0. Wins: 0.
Player gust does not show cards.Bets: 0.50. Collects: 0. Loses: 0.50.
Player VegetablesArentYummy does not show cards.Bets: 1. Collects: 0. Loses: 1.
Game ended at: 2016/11/29 15:26:36

Game started
Game ID: 787027929 0.50/1 (PRR) Karkadann (Hold'em)
Seat 8 is the button
Seat 1: StephCurry (105.78).
Seat 2: PANDAisEVIL (101).
Seat 3: AironVega (103.20).
Seat 4: IlxxxlI (43).
Seat 5: pineapplesand (40).
Seat 6: dankmann (208.02).
Seat 7: ElvenEyes (115).
Seat 8: gust (45.50).
Seat 9: VegetablesArentYummy (272.59).
Player VegetablesArentYummy has small blind (0.50)
Player StephCurry has big blind (1)
Player IlxxxlI received card: [Js]
Player IlxxxlI received card: [3h]
Player PANDAisEVIL folds
Player AironVega folds
Player IlxxxlI folds
Player pineapplesand folds
Player dankmann folds
Player ElvenEyes folds
Player gust folds
Player VegetablesArentYummy raises (2.50)
Player StephCurry calls (2)
*** FLOP ***: [6d 5d 6s]
Player VegetablesArentYummy bets (2.35)
Player StephCurry calls (2.35)
*** TURN ***: [6d 5d 6s] [7s]
Player VegetablesArentYummy bets (7.78)
Player StephCurry calls (7.78)
*** RIVER ***: [6d 5d 6s 7s] [7c]
Player VegetablesArentYummy checks
Player StephCurry checks
------ Summary ------
Pot: 24.95. Rake 1.07. JP fee 0.24
Board: [6d 5d 6s 7s 7c]
*Player StephCurry shows: Two pairs. 7s and 6s [Ad 10d]. Bets: 13.13. Collects: 12.47. Loses: 0.66.
Player PANDAisEVIL does not show cards.Bets: 0. Collects: 0. Wins: 0.
Player AironVega does not show cards.Bets: 0. Collects: 0. Wins: 0.
Player IlxxxlI does not show cards.Bets: 0. Collects: 0. Wins: 0.
Player pineapplesand does not show cards.Bets: 0. Collects: 0. Wins: 0.
Player dankmann does not show cards.Bets: 0. Collects: 0. Wins: 0.
Player ElvenEyes does not show cards.Bets: 0. Collects: 0. Wins: 0.
Player gust does not show cards.Bets: 0. Collects: 0. Wins: 0.
*Player VegetablesArentYummy shows: Two pairs. 7s and 6s [9s Ah]. Bets: 13.13. Collects: 12.48. Loses: 0.65.
Game ended at: 2016/11/29 15:28:9

Game started
Game ID: 787027464 0.50/1 (PRR) Karkadann (Hold'em)
Seat 6 is the button
Seat 1: StephCurry (105.78).
Seat 2: PANDAisEVIL (101).
Seat 3: AironVega (101.70).
Seat 4: IlxxxlI (43).
Seat 5: pineapplesand (40).
Seat 6: dankmann (206.52).
Seat 7: ElvenEyes (115.50).
Seat 8: gust (47).
Seat 9: VegetablesArentYummy (273.59).
Player ElvenEyes has small blind (0.50)
Player gust has big blind (1)
Player IlxxxlI received card: [9s]
Player IlxxxlI received card: [Qc]
Player VegetablesArentYummy folds
Player StephCurry folds
Player PANDAisEVIL folds
Player AironVega raises (3)
Player IlxxxlI folds
Player pineapplesand folds
Player dankmann folds
Player ElvenEyes folds
Player gust folds
Uncalled bet (2) returned to AironVega
Player AironVega mucks cards
------ Summary ------
Pot: 2.50. Rake 0
Player StephCurry does not show cards.Bets: 0. Collects: 0. Wins: 0.
Player PANDAisEVIL does not show cards.Bets: 0. Collects: 0. Wins: 0.
*Player AironVega mucks (does not show cards). Bets: 1. Collects: 2.50. Wins: 1.50.
Player IlxxxlI does not show cards.Bets: 0. Collects: 0. Wins: 0.
Player pineapplesand does not show cards.Bets: 0. Collects: 0. Wins: 0.
Player dankmann does not show cards.Bets: 0. Collects: 0. Wins: 0.
Player ElvenEyes does not show cards.Bets: 0.50. Collects: 0. Loses: 0.50.
Player gust does not show cards.Bets: 1. Collects: 0. Loses: 1.
Player VegetablesArentYummy does not show cards.Bets: 0. Collects: 0. Wins: 0.
Game ended at: 2016/11/29 15:25:35

Game started
Game ID: 787027410 0.50/1 (PRR) Kraken - 10 (Hold'em)
Seat 6 is the button
Seat 1: AironVega (100).
Seat 2: aleks0v (100.23).
Seat 3: ElvenEyes (205.41).
Seat 4: IlxxxlI (40).
Seat 5: WeakAndWeary (101.54).
Seat 6: Sephiroth1 (103.50).
Player AironVega has small blind (0.50)
Player aleks0v has big blind (1)
Player IlxxxlI received card: [4s]
Player IlxxxlI received card: [5d]
Player ElvenEyes folds
Player IlxxxlI folds
Player WeakAndWeary folds
Player Sephiroth1 raises (3)
Player AironVega folds
Player aleks0v calls (2)
*** FLOP ***: [Jc 6c 8d]
Player aleks0v checks
Player Sephiroth1 checks
*** TURN ***: [Jc 6c 8d] [10c]
Player aleks0v bets (4.50)
Player Sephiroth1 folds
Uncalled bet (4.50) returned to aleks0v
Player aleks0v mucks cards
------ Summary ------
Pot: 6.18. Rake 0.22. JP fee 0.10
Board: [Jc 6c 8d 10c]
Player AironVega does not show cards.Bets: 0.50. Collects: 0. Loses: 0.50.
*Player aleks0v mucks (does not show cards). Bets: 3. Collects: 6.18. Wins: 3.18.
Player ElvenEyes does not show cards.Bets: 0. Collects: 0. Wins: 0.
Player IlxxxlI does not show cards.Bets: 0. Collects: 0. Wins: 0.
Player WeakAndWeary does not show cards.Bets: 0. Collects: 0. Wins: 0.
Player Sephiroth1 does not show cards.Bets: 3. Collects: 0. Loses: 3.
Game ended at: 2016/11/29 15:26:4

Game started
Game ID: 787027157 0.50/1 (PRR) Kraken - 10 (Hold'em)
Seat 5 is the button
Seat 1: AironVega (101).
Seat 2: aleks0v (100.23).
Seat 3: ElvenEyes (207.41).
Seat 4: IlxxxlI (40).
Seat 5: WeakAndWeary (101.54).
Seat 6: Sephiroth1 (100.50).
Player Sephiroth1 has small blind (0.50)
Player AironVega has big blind (1)
Player IlxxxlI received card: [Jd]
Player IlxxxlI received card: [10d]
Player aleks0v folds
Player ElvenEyes raises (2)
Player IlxxxlI folds
Player WeakAndWeary folds
Player Sephiroth1 raises (7.50)
Player AironVega folds
Player ElvenEyes folds
Uncalled bet (6) returned to Sephiroth1
Player Sephiroth1 mucks cards
------ Summary ------
Pot: 5. Rake 0
Player AironVega does not show cards.Bets: 1. Collects: 0. Loses: 1.
Player aleks0v does not show cards.Bets: 0. Collects: 0. Wins: 0.
Player ElvenEyes does not show cards.Bets: 2. Collects: 0. Loses: 2.
Player IlxxxlI does not show cards.Bets: 0. Collects: 0. Wins: 0.
Player WeakAndWeary does not show cards.Bets: 0. Collects: 0. Wins: 0.
*Player Sephiroth1 mucks (does not show cards). Bets: 2. Collects: 5. Wins: 3.
Game ended at: 2016/11/29 15:24:59

Game started
Game ID: 787027105 0.50/1 (PRR) Karkadann (Hold'em)
Seat 5 is the button
Seat 1: StephCurry (105.78).
Seat 2: PANDAisEVIL (101).
Seat 3: AironVega (101.70).
Seat 4: IlxxxlI (43).
Seat 5: pineapplesand (40).
Seat 6: dankmann (209.52).
Seat 7: ElvenEyes (112.80).
Seat 8: gust (47).
Seat 9: VegetablesArentYummy (273.59).
Player dankmann has small blind (0.50)
Player ElvenEyes has big blind (1)
Player IlxxxlI received card: [3s]
Player IlxxxlI received card: [6d]
Player gust folds
Player VegetablesArentYummy folds
Player StephCurry folds
Player PANDAisEVIL folds
Player AironVega folds
Player IlxxxlI folds
Player pineapplesand folds
Player dankmann raises (2.50)
Player ElvenEyes calls (2)
*** FLOP ***: [Ah Js 2s]
Player dankmann checks
Player ElvenEyes bets (2.85)
Player dankmann folds
Uncalled bet (2.85) returned to ElvenEyes
Player ElvenEyes mucks cards
------ Summary ------
Pot: 5.70. Rake 0.20. JP fee 0.10
Board: [Ah Js 2s]
Player StephCurry does not show cards.Bets: 0. Collects: 0. Wins: 0.
Player PANDAisEVIL does not show cards.Bets: 0. Collects: 0. Wins: 0.
Player AironVega does not show cards.Bets: 0. Collects: 0. Wins: 0.
Player IlxxxlI does not show cards.Bets: 0. Collects: 0. Wins: 0.
Player pineapplesand does not show cards.Bets: 0. Collects: 0. Wins: 0.
Player dankmann does not show cards.Bets: 3. Collects: 0. Loses: 3.
*Player ElvenEyes mucks (does not show cards). Bets: 3. Collects: 5.70. Wins: 2.70.
Player gust does not show cards.Bets: 0. Collects: 0. Wins: 0.
Player VegetablesArentYummy does not show cards.Bets: 0. Collects: 0. Wins: 0.
Game ended at: 2016/11/29 15:25:9

Game started
Game ID: 787026943 0.50/1 (PRR) Kraken - 10 (Hold'em)
Seat 4 is the button
Seat 1: AironVega (101).
Seat 2: aleks0v (100.23).
Seat 3: ElvenEyes (205.91).
Seat 4: IlxxxlI (40).
Seat 5: WeakAndWeary (102.04).
Seat 6: Sephiroth1 (101.50).
Player WeakAndWeary has small blind (0.50)
Player Sephiroth1 has big blind (1)
Player IlxxxlI received card: [9d]
Player IlxxxlI received card: [10c]
Player AironVega folds
Player aleks0v folds
Player ElvenEyes raises (2.58)
Player IlxxxlI folds
Player WeakAndWeary folds
Player Sephiroth1 folds
Uncalled bet (1.58) returned to ElvenEyes
Player ElvenEyes mucks cards
------ Summary ------
Pot: 2.50. Rake 0
Player AironVega does not show cards.Bets: 0. Collects: 0. Wins: 0.
Player aleks0v does not show cards.Bets: 0. Collects: 0. Wins: 0.
*Player ElvenEyes mucks (does not show cards). Bets: 1. Collects: 2.50. Wins: 1.50.
Player IlxxxlI does not show cards.Bets: 0. Collects: 0. Wins: 0.
Player WeakAndWeary does not show cards.Bets: 0.50. Collects: 0. Loses: 0.50.
Player Sephiroth1 does not show cards.Bets: 1. Collects: 0. Loses: 1.
Game ended at: 2016/11/29 15:24:13

Game started
Game ID: 787026888 0.25/0.50 (PRR) Gorgons - 18 (Hold'em)
Seat 4 is the button
Seat 1: hoocher (80.93).
Seat 2: IlxxxlI (20.25).
Seat 3: Beep_Beep (105.65).
Seat 4: IampokerKidd (50).
Seat 5: Jui Kuen (54.50).
Seat 6: foreseen (158.08).
Player Jui Kuen has small blind (0.25)
Player foreseen has big blind (0.50)
Player IlxxxlI received card: [7d]
Player IlxxxlI received card: [Kh]
Player hoocher folds
Player IlxxxlI folds
Player Beep_Beep raises (1.50)
Player IampokerKidd folds
Player Jui Kuen folds
Player foreseen folds
Uncalled bet (1) returned to Beep_Beep
Player Beep_Beep mucks cards
------ Summary ------
Pot: 1.25. Rake 0
Player hoocher does not show cards.Bets: 0. Collects: 0. Wins: 0.
Player IlxxxlI does not show cards.Bets: 0. Collects: 0. Wins: 0.
*Player Beep_Beep mucks (does not show cards). Bets: 0.50. Collects: 1.25. Wins: 0.75.
Player IampokerKidd does not show cards.Bets: 0. Collects: 0. Wins: 0.
Player Jui Kuen does not show cards.Bets: 0.25. Collects: 0. Loses: 0.25.
Player foreseen does not show cards.Bets: 0.50. Collects: 0. Loses: 0.50.
Game ended at: 2016/11/29 15:24:4

Game started
Game ID: 787026881 0.25/0.50 (PRR) Garuda - 3 (Hold'em)
Seat 8 is the button
Seat 1: choiCES (87.40).
Seat 2: hoocher (63.11).
Seat 3: Parcker (97.82).
Seat 4: IlxxxlI (31.57).
Seat 5: VamosRafaFTW (49.21).
Seat 6: dankmann (95.08).
Seat 7: BlueSmoke (46.89).
Seat 8: Maria_Pia (20).
Player choiCES has small blind (0.25)
Player hoocher has big blind (0.50)
Player BlueSmoke wait BB
Player IlxxxlI received card: [Ad]
Player IlxxxlI received card: [Kd]
Player Parcker folds
Player IlxxxlI raises (1.75)
Player VamosRafaFTW calls (1.75)
Player dankmann calls (1.75)
Player Maria_Pia folds
Player choiCES folds
Player hoocher folds
*** FLOP ***: [10d 2h 5s]
Player IlxxxlI checks
Player VamosRafaFTW checks
Player dankmann checks
*** TURN ***: [10d 2h 5s] [2c]
Player IlxxxlI checks
Player VamosRafaFTW checks
Player dankmann checks
*** RIVER ***: [10d 2h 5s 2c] [4d]
Player IlxxxlI checks
Player VamosRafaFTW bets (3.40)
Player dankmann calls (3.40)
Player IlxxxlI folds
Player dankmann mucks cards
------ Summary ------
Pot: 12.16. Rake 0.44. JP fee 0.20
Board: [10d 2h 5s 2c 4d]
Player choiCES does not show cards.Bets: 0.25. Collects: 0. Loses: 0.25.
Player hoocher does not show cards.Bets: 0.50. Collects: 0. Loses: 0.50.
Player Parcker does not show cards.Bets: 0. Collects: 0. Wins: 0.
Player IlxxxlI does not show cards.Bets: 1.75. Collects: 0. Loses: 1.75.
*Player VamosRafaFTW shows: Straight to 5 [3c Ac]. Bets: 5.15. Collects: 12.16. Wins: 7.01.
Player dankmann mucks (does not show cards). Bets: 5.15. Collects: 0. Loses: 5.15.
Player BlueSmoke does not show cards.Bets: 0. Collects: 0. Wins: 0.
Player Maria_Pia does not show cards.Bets: 0. Collects: 0. Wins: 0.
Game ended at: 2016/11/29 15:24:40

Game started
Game ID: 787026850 0.50/1 (PRR) Karkadann (Hold'em)
Seat 4 is the button
Seat 1: StephCurry (105.78).
Seat 2: PANDAisEVIL (101).
Seat 3: AironVega (101.70).
Seat 4: IlxxxlI (43).
Seat 5: pineapplesand (40).
Seat 6: dankmann (210.52).
Seat 7: ElvenEyes (111.30).
Seat 8: gust (47).
Seat 9: VegetablesArentYummy (273.59).
Player pineapplesand has small blind (0.50)
Player dankmann has big blind (1)
Player IlxxxlI received card: [2h]
Player IlxxxlI received card: [6d]
Player ElvenEyes raises (2)
Player gust folds
Player VegetablesArentYummy folds
Player StephCurry folds
Player PANDAisEVIL folds
Player AironVega folds
Player IlxxxlI folds
Player pineapplesand folds
Player dankmann folds
Uncalled bet (1) returned to ElvenEyes
Player ElvenEyes mucks cards
------ Summary ------
Pot: 2.50. Rake 0
Player StephCurry does not show cards.Bets: 0. Collects: 0. Wins: 0.
Player PANDAisEVIL does not show cards.Bets: 0. Collects: 0. Wins: 0.
Player AironVega does not show cards.Bets: 0. Collects: 0. Wins: 0.
Player IlxxxlI does not show cards.Bets: 0. Collects: 0. Wins: 0.
Player pineapplesand does not show cards.Bets: 0.50. Collects: 0. Loses: 0.50.
Player dankmann does not show cards.Bets: 1. Collects: 0. Loses: 1.
*Player ElvenEyes mucks (does not show cards). Bets: 1. Collects: 2.50. Wins: 1.50.
Player gust does not show cards.Bets: 0. Collects: 0. Wins: 0.
Player VegetablesArentYummy does not show cards.Bets: 0. Collects: 0. Wins: 0.
Game ended at: 2016/11/29 15:24:3

Game started
Game ID: 787026685 0.25/0.50 (PRR) Garuda - 3 (Hold'em)
Seat 6 is the button
Seat 1: choiCES (87.90).
Seat 2: hoocher (62.36).
Seat 3: Parcker (97.82).
Seat 4: IlxxxlI (31.57).
Seat 5: VamosRafaFTW (49.21).
Seat 6: dankmann (95.08).
Seat 8: Maria_Pia (20).
Seat 9: Spagetti1 (49.94).
Player Maria_Pia has small blind (0.25)
Player Spagetti1 sitting out
Player choiCES has big blind (0.50)
Player IlxxxlI received card: [3c]
Player IlxxxlI received card: [6c]
Player hoocher raises (1.50)
Player Parcker folds
Player IlxxxlI folds
Player VamosRafaFTW folds
Player dankmann folds
Player Maria_Pia folds
Player choiCES folds
Uncalled bet (1) returned to hoocher
Player hoocher mucks cards
------ Summary ------
Pot: 1.25. Rake 0
Player choiCES does not show cards.Bets: 0.50. Collects: 0. Loses: 0.50.
*Player hoocher mucks (does not show cards). Bets: 0.50. Collects: 1.25. Wins: 0.75.
Player Parcker does not show cards.Bets: 0. Collects: 0. Wins: 0.
Player IlxxxlI does not show cards.Bets: 0. Collects: 0. Wins: 0.
Player VamosRafaFTW does not show cards.Bets: 0. Collects: 0. Wins: 0.
Player dankmann does not show cards.Bets: 0. Collects: 0. Wins: 0.
Player Maria_Pia does not show cards.Bets: 0.25. Collects: 0. Loses: 0.25.
Player Spagetti1 does not show cards.Bets: 0. Collects: 0. Wins: 0.
Game ended at: 2016/11/29 15:23:22

Game started
Game ID: 787026640 0.50/1 (PRR) Karkadann (Hold'em)
Seat 3 is the button
Seat 1: StephCurry (105.78).
Seat 2: PANDAisEVIL (101).
Seat 3: AironVega (101.70).
Seat 4: IlxxxlI (43.50).
Seat 5: pineapplesand (40).
Seat 6: dankmann (210.52).
Seat 7: ElvenEyes (109.80).
Seat 8: gust (47).
Seat 9: VegetablesArentYummy (273.59).
Player IlxxxlI has small blind (0.50)
Player pineapplesand has big blind (1)
Player IlxxxlI received card: [5c]
Player IlxxxlI received card: [3d]
Player dankmann folds
Player ElvenEyes raises (2)
Player gust folds
Player VegetablesArentYummy folds
Player StephCurry folds
Player PANDAisEVIL folds
Player AironVega folds
Player IlxxxlI folds
Player pineapplesand folds
Uncalled bet (1) returned to ElvenEyes
Player ElvenEyes mucks cards
------ Summary ------
Pot: 2.50. Rake 0
Player StephCurry does not show cards.Bets: 0. Collects: 0. Wins: 0.
Player PANDAisEVIL does not show cards.Bets: 0. Collects: 0. Wins: 0.
Player AironVega does not show cards.Bets: 0. Collects: 0. Wins: 0.
Player IlxxxlI does not show cards.Bets: 0.50. Collects: 0. Loses: 0.50.
Player pineapplesand does not show cards.Bets: 1. Collects: 0. Loses: 1.
Player dankmann does not show cards.Bets: 0. Collects: 0. Wins: 0.
*Player ElvenEyes mucks (does not show cards). Bets: 1. Collects: 2.50. Wins: 1.50.
Player gust does not show cards.Bets: 0. Collects: 0. Wins: 0.
Player VegetablesArentYummy does not show cards.Bets: 0. Collects: 0. Wins: 0.
Game ended at: 2016/11/29 15:23:17

Game started
Game ID: 787026582 0.25/0.50 (PRR) Gorgons - 18 (Hold'em)
Seat 3 is the button
Seat 1: hoocher (80.93).
Seat 2: IlxxxlI (20.25).
Seat 3: Beep_Beep (105.65).
Seat 4: IampokerKidd (50.25).
Seat 5: Jui Kuen (53).
Seat 6: foreseen (158.08).
Player IampokerKidd has small blind (0.25)
Player Jui Kuen has big blind (0.50)
Player IlxxxlI received card: [9h]
Player IlxxxlI received card: [3s]
Player foreseen folds
Player hoocher folds
Player IlxxxlI folds
Player Beep_Beep folds
Player IampokerKidd raises (1.25)
Player Jui Kuen raises (5)
Player IampokerKidd folds
Uncalled bet (4) returned to Jui Kuen
Player Jui Kuen mucks cards
------ Summary ------
Pot: 3. Rake 0
Player hoocher does not show cards.Bets: 0. Collects: 0. Wins: 0.
Player IlxxxlI does not show cards.Bets: 0. Collects: 0. Wins: 0.
Player Beep_Beep does not show cards.Bets: 0. Collects: 0. Wins: 0.
Player IampokerKidd does not show cards.Bets: 1.50. Collects: 0. Loses: 1.50.
*Player Jui Kuen mucks (does not show cards). Bets: 1.50. Collects: 3. Wins: 1.50.
Player foreseen does not show cards.Bets: 0. Collects: 0. Wins: 0.
Game ended at: 2016/11/29 15:23:22

Game started
Game ID: 787026454 0.50/1 (PRR) Kraken - 10 (Hold'em)
Seat 3 is the button
Seat 1: AironVega (101).
Seat 2: aleks0v (100.23).
Seat 3: ElvenEyes (205.91).
Seat 4: IlxxxlI (40).
Seat 5: WeakAndWeary (100).
Seat 6: Sephiroth1 (101.50).
Player IlxxxlI has small blind (0.50)
Player WeakAndWeary has big blind (1)
Player IlxxxlI received card: [7s]
Player IlxxxlI received card: [Kh]
Player Sephiroth1 folds
Player AironVega folds
Player aleks0v folds
Player ElvenEyes folds
Player IlxxxlI calls (0.50)
Player WeakAndWeary checks
*** FLOP ***: [Qh 2s 4s]
Player IlxxxlI bets (1.26)
Player WeakAndWeary calls (1.26)
*** TURN ***: [Qh 2s 4s] [Qd]
Player IlxxxlI checks
Player WeakAndWeary checks
*** RIVER ***: [Qh 2s 4s Qd] [5c]
Player IlxxxlI checks
Player WeakAndWeary bets (2.15)
Player IlxxxlI folds
Uncalled bet (2.15) returned to WeakAndWeary
Player WeakAndWeary mucks cards
------ Summary ------
Pot: 4.30. Rake 0.16. JP fee 0.06
Board: [Qh 2s 4s Qd 5c]
Player AironVega does not show cards.Bets: 0. Collects: 0. Wins: 0.
Player aleks0v does not show cards.Bets: 0. Collects: 0. Wins: 0.
Player ElvenEyes does not show cards.Bets: 0. Collects: 0. Wins: 0.
Player IlxxxlI does not show cards.Bets: 2.26. Collects: 0. Loses: 2.26.
*Player WeakAndWeary mucks (does not show cards). Bets: 2.26. Collects: 4.30. Wins: 2.04.
Player Sephiroth1 does not show cards.Bets: 0. Collects: 0. Wins: 0.
Game ended at: 2016/11/29 15:23:33

Game started
Game ID: 787026366 0.25/0.50 (PRR) Gorgons - 18 (Hold'em)
Seat 2 is the button
Seat 1: hoocher (80.93).
Seat 2: IlxxxlI (20.25).
Seat 3: Beep_Beep (105.90).
Seat 4: IampokerKidd (50.75).
Seat 5: Jui Kuen (52.25).
Seat 6: foreseen (158.08).
Player Beep_Beep has small blind (0.25)
Player IampokerKidd has big blind (0.50)
Player IlxxxlI received card: [7c]
Player IlxxxlI received card: [4c]
Player Jui Kuen raises (1.50)
Player foreseen folds
Player hoocher folds
Player IlxxxlI folds
Player Beep_Beep folds
Player IampokerKidd folds
Uncalled bet (1) returned to Jui Kuen
Player Jui Kuen mucks cards
------ Summary ------
Pot: 1.25. Rake 0
Player hoocher does not show cards.Bets: 0. Collects: 0. Wins: 0.
Player IlxxxlI does not show cards.Bets: 0. Collects: 0. Wins: 0.
Player Beep_Beep does not show cards.Bets: 0.25. Collects: 0. Loses: 0.25.
Player IampokerKidd does not show cards.Bets: 0.50. Collects: 0. Loses: 0.50.
*Player Jui Kuen mucks (does not show cards). Bets: 0.50. Collects: 1.25. Wins: 0.75.
Player foreseen does not show cards.Bets: 0. Collects: 0. Wins: 0.
Game ended at: 2016/11/29 15:22:27

Game started
Game ID: 787026355 0.50/1 (PRR) Kraken - 20 (Hold'em)
Seat 5 is the button
Seat 1: AironVega (118.93).
Seat 4: WeakAndWeary (114.67).
Seat 5: IlxxxlI (40.28).
Seat 6: aleks0v (100).
Player aleks0v has small blind (0.50)
Player AironVega has big blind (1)
Player IlxxxlI received card: [5h]
Player IlxxxlI received card: [6s]
Player WeakAndWeary folds
Player IlxxxlI folds
Player aleks0v folds
Uncalled bet (0.50) returned to AironVega
Player AironVega mucks cards
------ Summary ------
Pot: 1. Rake 0
*Player AironVega mucks (does not show cards). Bets: 0.50. Collects: 1. Wins: 0.50.
Player WeakAndWeary does not show cards.Bets: 0. Collects: 0. Wins: 0.
Player IlxxxlI does not show cards.Bets: 0. Collects: 0. Wins: 0.
Player aleks0v does not show cards.Bets: 0.50. Collects: 0. Loses: 0.50.
Game ended at: 2016/11/29 15:22:17

Game started
Game ID: 787026305 0.50/1 (PRR) Karkadann (Hold'em)
Seat 2 is the button
Seat 1: StephCurry (105.78).
Seat 2: PANDAisEVIL (101).
Seat 3: AironVega (102.20).
Seat 4: IlxxxlI (44.50).
Seat 6: dankmann (210.52).
Seat 7: ElvenEyes (111.80).
Seat 8: gust (47).
Seat 9: VegetablesArentYummy (270.09).
Player AironVega has small blind (0.50)
Player IlxxxlI has big blind (1)
Player IlxxxlI received card: [6c]
Player IlxxxlI received card: [10c]
Player dankmann folds
Player ElvenEyes raises (2)
Player gust folds
Player VegetablesArentYummy raises (8)
Player StephCurry folds
Player PANDAisEVIL folds
Player AironVega folds
Player IlxxxlI folds
Player ElvenEyes folds
Uncalled bet (6) returned to VegetablesArentYummy
Player VegetablesArentYummy mucks cards
------ Summary ------
Pot: 5.50. Rake 0
Player StephCurry does not show cards.Bets: 0. Collects: 0. Wins: 0.
Player PANDAisEVIL does not show cards.Bets: 0. Collects: 0. Wins: 0.
Player AironVega does not show cards.Bets: 0.50. Collects: 0. Loses: 0.50.
Player IlxxxlI does not show cards.Bets: 1. Collects: 0. Loses: 1.
Player dankmann does not show cards.Bets: 0. Collects: 0. Wins: 0.
Player ElvenEyes does not show cards.Bets: 2. Collects: 0. Loses: 2.
Player gust does not show cards.Bets: 0. Collects: 0. Wins: 0.
*Player VegetablesArentYummy mucks (does not show cards). Bets: 2. Collects: 5.50. Wins: 3.50.
Game ended at: 2016/11/29 15:22:38

Game started
Game ID: 787026222 0.50/1 (PRR) Kraken - 10 (Hold'em)
Seat 2 is the button
Seat 1: AironVega (101).
Seat 2: aleks0v (100.23).
Seat 3: ElvenEyes (206.41).
Seat 4: IlxxxlI (40).
Seat 5: WeakAndWeary (100).
Seat 6: Sephiroth1 (100).
Player ElvenEyes has small blind (0.50)
Player IlxxxlI has big blind (1)
Player IlxxxlI received card: [7h]
Player IlxxxlI received card: [5c]
Player WeakAndWeary folds
Player Sephiroth1 raises (2)
Player AironVega folds
Player aleks0v folds
Player ElvenEyes folds
Player IlxxxlI folds
Uncalled bet (1) returned to Sephiroth1
Player Sephiroth1 mucks cards
------ Summary ------
Pot: 2.50. Rake 0
Player AironVega does not show cards.Bets: 0. Collects: 0. Wins: 0.
Player aleks0v does not show cards.Bets: 0. Collects: 0. Wins: 0.
Player ElvenEyes does not show cards.Bets: 0.50. Collects: 0. Loses: 0.50.
Player IlxxxlI does not show cards.Bets: 1. Collects: 0. Loses: 1.
Player WeakAndWeary does not show cards.Bets: 0. Collects: 0. Wins: 0.
*Player Sephiroth1 mucks (does not show cards). Bets: 1. Collects: 2.50. Wins: 1.50.
Game ended at: 2016/11/29 15:22:0

Game started
Game ID: 787026206 0.25/0.50 (PRR) Garuda - 3 (Hold'em)
Seat 5 is the button
Seat 1: choiCES (87.90).
Seat 2: hoocher (62.36).
Seat 3: Parcker (97.82).
Seat 4: IlxxxlI (30.25).
Seat 5: VamosRafaFTW (49.21).
Seat 6: dankmann (95.33).
Seat 8: Maria_Pia (20).
Seat 9: Spagetti1 (49.94).
Player dankmann has small blind (0.25)
Player Maria_Pia has big blind (0.50)
Player IlxxxlI received card: [4s]
Player IlxxxlI received card: [4h]
Player Spagetti1 folds
Player choiCES folds
Player hoocher folds
Player Parcker folds
Player IlxxxlI raises (1.20)
Player VamosRafaFTW folds
Player dankmann folds
Player Maria_Pia calls (0.70)
*** FLOP ***: [7d Ah 6d]
Player Maria_Pia checks
Player IlxxxlI checks
*** TURN ***: [7d Ah 6d] [3h]
Player Maria_Pia checks
Player IlxxxlI checks
*** RIVER ***: [7d Ah 6d 3h] [Ac]
Player Maria_Pia checks
Player IlxxxlI checks
Player Maria_Pia mucks cards
------ Summary ------
Pot: 2.52. Rake 0.09. JP fee 0.04
Board: [7d Ah 6d 3h Ac]
Player choiCES does not show cards.Bets: 0. Collects: 0. Wins: 0.
Player hoocher does not show cards.Bets: 0. Collects: 0. Wins: 0.
Player Parcker does not show cards.Bets: 0. Collects: 0. Wins: 0.
*Player IlxxxlI shows: Two pairs. As and 4s [4s 4h]. Bets: 1.20. Collects: 2.52. Wins: 1.32.
Player VamosRafaFTW does not show cards.Bets: 0. Collects: 0. Wins: 0.
Player dankmann does not show cards.Bets: 0.25. Collects: 0. Loses: 0.25.
Player Maria_Pia mucks (does not show cards). Bets: 1.20. Collects: 0. Loses: 1.20.
Player Spagetti1 does not show cards.Bets: 0. Collects: 0. Wins: 0.
Game ended at: 2016/11/29 15:22:43

Game started
Game ID: 787026197 0.25/0.50 (PRR) Gorgons - 18 (Hold'em)
Seat 1 is the button
Seat 1: hoocher (80.93).
Seat 2: IlxxxlI (20.50).
Seat 3: Beep_Beep (106.40).
Seat 4: IampokerKidd (50).
Seat 5: Jui Kuen (52.25).
Seat 6: foreseen (158.08).
Player IlxxxlI has small blind (0.25)
Player Beep_Beep has big blind (0.50)
Player IlxxxlI received card: [3h]
Player IlxxxlI received card: [5c]
Player IampokerKidd raises (1.50)
Player Jui Kuen folds
Player foreseen folds
Player hoocher folds
Player IlxxxlI folds
Player Beep_Beep folds
Uncalled bet (1) returned to IampokerKidd
Player IampokerKidd mucks cards
------ Summary ------
Pot: 1.25. Rake 0
Player hoocher does not show cards.Bets: 0. Collects: 0. Wins: 0.
Player IlxxxlI does not show cards.Bets: 0.25. Collects: 0. Loses: 0.25.
Player Beep_Beep does not show cards.Bets: 0.50. Collects: 0. Loses: 0.50.
*Player IampokerKidd mucks (does not show cards). Bets: 0.50. Collects: 1.25. Wins: 0.75.
Player Jui Kuen does not show cards.Bets: 0. Collects: 0. Wins: 0.
Player foreseen does not show cards.Bets: 0. Collects: 0. Wins: 0.
Game ended at: 2016/11/29 15:21:43

Game started
Game ID: 787026184 0.50/1 (PRR) Kraken - 20 (Hold'em)
Seat 4 is the button
Seat 1: AironVega (121.43).
Seat 4: WeakAndWeary (110.67).
Seat 5: IlxxxlI (40.78).
Seat 6: aleks0v (100).
Player IlxxxlI has small blind (0.50)
Player aleks0v has big blind (1)
Player IlxxxlI received card: [Ks]
Player IlxxxlI received card: [Qs]
Player AironVega raises (2.50)
Player WeakAndWeary raises (8)
Player IlxxxlI folds
Player aleks0v folds
Player AironVega folds
Uncalled bet (5.50) returned to WeakAndWeary
Player WeakAndWeary mucks cards
------ Summary ------
Pot: 6.50. Rake 0
Player AironVega does not show cards.Bets: 2.50. Collects: 0. Loses: 2.50.
*Player WeakAndWeary mucks (does not show cards). Bets: 2.50. Collects: 6.50. Wins: 4.
Player IlxxxlI does not show cards.Bets: 0.50. Collects: 0. Loses: 0.50.
Player aleks0v does not show cards.Bets: 1. Collects: 0. Loses: 1.
Game ended at: 2016/11/29 15:21:42

Game started
Game ID: 787026141 0.25/0.50 (PRR) Gorgons - 2 (Hold'em)
Seat 3 is the button
Seat 1: IlxxxlI (20).
Seat 3: foreseen (74.46).
Seat 4: aleks0v (57.99).
Seat 5: Beep_Beep (71.35).
Player aleks0v has small blind (0.25)
Player Beep_Beep has big blind (0.50)
Player IlxxxlI received card: [Ah]
Player IlxxxlI received card: [As]
Player IlxxxlI raises (1.20)
Player foreseen folds
Player aleks0v folds
Player Beep_Beep calls (0.70)
*** FLOP ***: [Ac Ad 5d]
Player Beep_Beep checks
Player IlxxxlI bets (0.50)
Player Beep_Beep calls (0.50)
*** TURN ***: [Ac Ad 5d] [4s]
Player Beep_Beep checks
Player IlxxxlI bets (2.31)
Player Beep_Beep folds
Uncalled bet (2.31) returned to IlxxxlI
Player IlxxxlI mucks cards
------ Summary ------
Pot: 3.47. Rake 0.12. JP fee 0.06
Board: [Ac Ad 5d 4s]
*Player IlxxxlI mucks (does not show cards). Bets: 1.70. Collects: 3.47. Wins: 1.77.
Player foreseen does not show cards.Bets: 0. Collects: 0. Wins: 0.
Player aleks0v does not show cards.Bets: 0.25. Collects: 0. Loses: 0.25.
Player Beep_Beep does not show cards.Bets: 1.70. Collects: 0. Loses: 1.70.
Game ended at: 2016/11/29 15:22:2

Game started
Game ID: 787026104 0.25/0.50 (PRR) Garuda - 4 (Hold'em)
Seat 2 is the button
Seat 1: GagaPoker (50).
Seat 2: dankmann (100.21).
Seat 3: kid4life (102.93).
Seat 5: wvlax1425 (48.75).
Seat 6: Spagetti1 (50.76).
Seat 7: IlxxxlI (26.19).
Seat 8: haroldbb (64.71).
Seat 9: Korobochka (100.70).
Player kid4life has small blind (0.25)
Player wvlax1425 has big blind (0.50)
Player IlxxxlI received card: [Kd]
Player IlxxxlI received card: [2c]
Player Spagetti1 folds
Player IlxxxlI folds
Player haroldbb folds
Player Korobochka folds
Player GagaPoker folds
Player dankmann folds
Player kid4life folds
Uncalled bet (0.25) returned to wvlax1425
Player wvlax1425 mucks cards
------ Summary ------
Pot: 0.50. Rake 0
Player GagaPoker does not show cards.Bets: 0. Collects: 0. Wins: 0.
Player dankmann does not show cards.Bets: 0. Collects: 0. Wins: 0.
Player kid4life does not show cards.Bets: 0.25. Collects: 0. Loses: 0.25.
*Player wvlax1425 mucks (does not show cards). Bets: 0.25. Collects: 0.50. Wins: 0.25.
Player Spagetti1 does not show cards.Bets: 0. Collects: 0. Wins: 0.
Player IlxxxlI does not show cards.Bets: 0. Collects: 0. Wins: 0.
Player haroldbb does not show cards.Bets: 0. Collects: 0. Wins: 0.
Player Korobochka does not show cards.Bets: 0. Collects: 0. Wins: 0.
Game ended at: 2016/11/29 15:21:16

Game started
Game ID: 787026050 0.50/1 (PRR) Karkadann (Hold'em)
Seat 1 is the button
Seat 1: StephCurry (105.78).
Seat 2: PANDAisEVIL (100).
Seat 3: AironVega (103.20).
Seat 4: IlxxxlI (44.50).
Seat 6: dankmann (210.52).
Seat 7: ElvenEyes (111.80).
Seat 8: gust (47).
Seat 9: VegetablesArentYummy (270.09).
Player PANDAisEVIL has small blind (0.50)
Player AironVega has big blind (1)
Player IlxxxlI received card: [9c]
Player IlxxxlI received card: [6s]
Player IlxxxlI folds
Player dankmann folds
Player ElvenEyes folds
Player gust folds
Player VegetablesArentYummy folds
Player StephCurry folds
Player PANDAisEVIL raises (2)
Player AironVega folds
Uncalled bet (1.50) returned to PANDAisEVIL
Player PANDAisEVIL mucks cards
------ Summary ------
Pot: 2. Rake 0
Player StephCurry does not show cards.Bets: 0. Collects: 0. Wins: 0.
*Player PANDAisEVIL mucks (does not show cards). Bets: 1. Collects: 2. Wins: 1.
Player AironVega does not show cards.Bets: 1. Collects: 0. Loses: 1.
Player IlxxxlI does not show cards.Bets: 0. Collects: 0. Wins: 0.
Player dankmann does not show cards.Bets: 0. Collects: 0. Wins: 0.
Player ElvenEyes does not show cards.Bets: 0. Collects: 0. Wins: 0.
Player gust does not show cards.Bets: 0. Collects: 0. Wins: 0.
Player VegetablesArentYummy does not show cards.Bets: 0. Collects: 0. Wins: 0.
Game ended at: 2016/11/29 15:21:33

Game started
Game ID: 787026033 0.50/1 (PRR) Kraken - 20 (Hold'em)
Seat 1 is the button
Seat 1: AironVega (121.43).
Seat 4: WeakAndWeary (111.17).
Seat 5: IlxxxlI (40.28).
Seat 6: aleks0v (100).
Player WeakAndWeary has small blind (0.50)
Player IlxxxlI has big blind (1)
Player IlxxxlI received card: [8h]
Player IlxxxlI received card: [7h]
Player aleks0v folds
Player AironVega folds
Player WeakAndWeary folds
Uncalled bet (0.50) returned to IlxxxlI
Player IlxxxlI mucks cards
------ Summary ------
Pot: 1. Rake 0
Player AironVega does not show cards.Bets: 0. Collects: 0. Wins: 0.
Player WeakAndWeary does not show cards.Bets: 0.50. Collects: 0. Loses: 0.50.
*Player IlxxxlI mucks (does not show cards). Bets: 0.50. Collects: 1. Wins: 0.50.
Player aleks0v does not show cards.Bets: 0. Collects: 0. Wins: 0.
Game ended at: 2016/11/29 15:21:7

Game started
Game ID: 787025872 0.25/0.50 (PRR) Garuda - 4 (Hold'em)
Seat 1 is the button
Seat 1: GagaPoker (50).
Seat 2: dankmann (100.46).
Seat 3: kid4life (103.43).
Seat 4: DRofBooya (46.69).
Seat 5: wvlax1425 (48.75).
Seat 6: Spagetti1 (50.01).
Seat 7: IlxxxlI (26.19).
Seat 8: haroldbb (64.71).
Seat 9: Korobochka (100.70).
Player dankmann has small blind (0.25)
Player kid4life has big blind (0.50)
Player IlxxxlI received card: [9c]
Player IlxxxlI received card: [7h]
Player DRofBooya folds
Player wvlax1425 folds
Player Spagetti1 raises (1.50)
Player IlxxxlI folds
Player haroldbb folds
Player Korobochka folds
Player GagaPoker folds
Player dankmann folds
Player kid4life folds
Uncalled bet (1) returned to Spagetti1
Player Spagetti1 mucks cards
------ Summary ------
Pot: 1.25. Rake 0
Player GagaPoker does not show cards.Bets: 0. Collects: 0. Wins: 0.
Player dankmann does not show cards.Bets: 0.25. Collects: 0. Loses: 0.25.
Player kid4life does not show cards.Bets: 0.50. Collects: 0. Loses: 0.50.
Player DRofBooya does not show cards.Bets: 0. Collects: 0. Wins: 0.
Player wvlax1425 does not show cards.Bets: 0. Collects: 0. Wins: 0.
*Player Spagetti1 mucks (does not show cards). Bets: 0.50. Collects: 1.25. Wins: 0.75.
Player IlxxxlI does not show cards.Bets: 0. Collects: 0. Wins: 0.
Player haroldbb does not show cards.Bets: 0. Collects: 0. Wins: 0.
Player Korobochka does not show cards.Bets: 0. Collects: 0. Wins: 0.
Game ended at: 2016/11/29 15:20:51

Game started
Game ID: 787025839 0.50/1 (PRR) Kraken - 20 (Hold'em)
Seat 6 is the button
Seat 1: AironVega (121.93).
Seat 4: WeakAndWeary (110.67).
Seat 5: IlxxxlI (40.28).
Seat 6: aleks0v (100).
Player AironVega has small blind (0.50)
Player WeakAndWeary has big blind (1)
Player IlxxxlI received card: [10c]
Player IlxxxlI received card: [4c]
Player IlxxxlI folds
Player aleks0v folds
Player AironVega folds
Uncalled bet (0.50) returned to WeakAndWeary
Player WeakAndWeary mucks cards
------ Summary ------
Pot: 1. Rake 0
Player AironVega does not show cards.Bets: 0.50. Collects: 0. Loses: 0.50.
*Player WeakAndWeary mucks (does not show cards). Bets: 0.50. Collects: 1. Wins: 0.50.
Player IlxxxlI does not show cards.Bets: 0. Collects: 0. Wins: 0.
Player aleks0v does not show cards.Bets: 0. Collects: 0. Wins: 0.
Game ended at: 2016/11/29 15:20:38

Game started
Game ID: 787025834 0.25/0.50 (PRR) Garuda - 3 (Hold'em)
Seat 4 is the button
Seat 1: choiCES (87.90).
Seat 2: hoocher (62.36).
Seat 3: Parcker (97.82).
Seat 4: IlxxxlI (30.25).
Seat 5: VamosRafaFTW (50.34).
Seat 6: dankmann (94.31).
Seat 7: BlueSmoke (46.89).
Seat 9: Spagetti1 (49.94).
Player VamosRafaFTW has small blind (0.25)
Player dankmann has big blind (0.50)
Player IlxxxlI received card: [8s]
Player IlxxxlI received card: [6h]
Player BlueSmoke folds
Player Spagetti1 folds
Player choiCES folds
Player hoocher folds
Player Parcker folds
Player IlxxxlI folds
Player VamosRafaFTW calls (0.25)
Player dankmann checks
*** FLOP ***: [Kd 10c 8c]
Player VamosRafaFTW checks
Player dankmann bets (0.63)
Player VamosRafaFTW calls (0.63)
*** TURN ***: [Kd 10c 8c] [7s]
Player VamosRafaFTW checks
Player dankmann bets (1.43)
Player VamosRafaFTW folds
Uncalled bet (1.43) returned to dankmann
Player dankmann mucks cards
------ Summary ------
Pot: 2.15. Rake 0.09. JP fee 0.02
Board: [Kd 10c 8c 7s]
Player choiCES does not show cards.Bets: 0. Collects: 0. Wins: 0.
Player hoocher does not show cards.Bets: 0. Collects: 0. Wins: 0.
Player Parcker does not show cards.Bets: 0. Collects: 0. Wins: 0.
Player IlxxxlI does not show cards.Bets: 0. Collects: 0. Wins: 0.
Player VamosRafaFTW does not show cards.Bets: 1.13. Collects: 0. Loses: 1.13.
*Player dankmann mucks (does not show cards). Bets: 1.13. Collects: 2.15. Wins: 1.02.
Player BlueSmoke does not show cards.Bets: 0. Collects: 0. Wins: 0.
Player Spagetti1 does not show cards.Bets: 0. Collects: 0. Wins: 0.
Game ended at: 2016/11/29 15:21:12

Game started
Game ID: 787025799 0.50/1 (PRR) Karkadann (Hold'em)
Seat 9 is the button
Seat 1: StephCurry (106.28).
Seat 2: PANDAisEVIL (100.94).
Seat 3: AironVega (103.20).
Seat 4: IlxxxlI (44.50).
Seat 6: dankmann (210.52).
Seat 7: ElvenEyes (111.80).
Seat 8: gust (45.50).
Seat 9: VegetablesArentYummy (270.09).
Player StephCurry has small blind (0.50)
Player PANDAisEVIL has big blind (1)
Player IlxxxlI received card: [Kh]
Player IlxxxlI received card: [3s]
Player AironVega folds
Player IlxxxlI folds
Player dankmann folds
Player ElvenEyes folds
Player gust raises (2)
Player VegetablesArentYummy folds
Player StephCurry folds
Player PANDAisEVIL folds
Uncalled bet (1) returned to gust
Player gust mucks cards
------ Summary ------
Pot: 2.50. Rake 0
Player StephCurry does not show cards.Bets: 0.50. Collects: 0. Loses: 0.50.
Player PANDAisEVIL does not show cards.Bets: 1. Collects: 0. Loses: 1.
Player AironVega does not show cards.Bets: 0. Collects: 0. Wins: 0.
Player IlxxxlI does not show cards.Bets: 0. Collects: 0. Wins: 0.
Player dankmann does not show cards.Bets: 0. Collects: 0. Wins: 0.
Player ElvenEyes does not show cards.Bets: 0. Collects: 0. Wins: 0.
*Player gust mucks (does not show cards). Bets: 1. Collects: 2.50. Wins: 1.50.
Player VegetablesArentYummy does not show cards.Bets: 0. Collects: 0. Wins: 0.
Game ended at: 2016/11/29 15:20:42

Game started
Game ID: 787025793 0.25/0.50 (PRR) Gorgons - 18 (Hold'em)
Seat 6 is the button
Seat 1: hoocher (81.18).
Seat 2: IlxxxlI (21).
Seat 3: Beep_Beep (106.40).
Seat 4: IampokerKidd (50.75).
Seat 5: Jui Kuen (50).
Seat 6: foreseen (158.08).
Player hoocher has small blind (0.25)
Player IlxxxlI has big blind (0.50)
Player IlxxxlI received card: [2s]
Player IlxxxlI received card: [10h]
Player Beep_Beep folds
Player IampokerKidd raises (1.50)
Player Jui Kuen raises (5)
Player foreseen folds
Player hoocher folds
Player IlxxxlI folds
Player IampokerKidd folds
Uncalled bet (3.50) returned to Jui Kuen
Player Jui Kuen mucks cards
------ Summary ------
Pot: 3.75. Rake 0
Player hoocher does not show cards.Bets: 0.25. Collects: 0. Loses: 0.25.
Player IlxxxlI does not show cards.Bets: 0.50. Collects: 0. Loses: 0.50.
Player Beep_Beep does not show cards.Bets: 0. Collects: 0. Wins: 0.
Player IampokerKidd does not show cards.Bets: 1.50. Collects: 0. Loses: 1.50.
*Player Jui Kuen mucks (does not show cards). Bets: 1.50. Collects: 3.75. Wins: 2.25.
Player foreseen does not show cards.Bets: 0. Collects: 0. Wins: 0.
Game ended at: 2016/11/29 15:21:9

Game started
Game ID: 787025628 0.25/0.50 (PRR) Gorgons - 18 (Hold'em)
Seat 5 is the button
Seat 1: hoocher (81.68).
Seat 2: IlxxxlI (21).
Seat 3: Beep_Beep (106.40).
Seat 4: IampokerKidd (50).
Seat 5: Jui Kuen (50).
Seat 6: foreseen (158.33).
Player foreseen has small blind (0.25)
Player hoocher has big blind (0.50)
Player IlxxxlI received card: [3d]
Player IlxxxlI received card: [Qd]
Player IlxxxlI folds
Player Beep_Beep folds
Player IampokerKidd raises (1.50)
Player Jui Kuen folds
Player foreseen folds
Player hoocher folds
Uncalled bet (1) returned to IampokerKidd
Player IampokerKidd mucks cards
------ Summary ------
Pot: 1.25. Rake 0
Player hoocher does not show cards.Bets: 0.50. Collects: 0. Loses: 0.50.
Player IlxxxlI does not show cards.Bets: 0. Collects: 0. Wins: 0.
Player Beep_Beep does not show cards.Bets: 0. Collects: 0. Wins: 0.
*Player IampokerKidd mucks (does not show cards). Bets: 0.50. Collects: 1.25. Wins: 0.75.
Player Jui Kuen does not show cards.Bets: 0. Collects: 0. Wins: 0.
Player foreseen does not show cards.Bets: 0.25. Collects: 0. Loses: 0.25.
Game ended at: 2016/11/29 15:19:55

Game started
Game ID: 787025559 0.25/0.50 (PRR) Gorgons - 2 (Hold'em)
Seat 1 is the button
Seat 1: IlxxxlI (20).
Seat 3: foreseen (74.71).
Seat 4: aleks0v (50).
Seat 5: Beep_Beep (71.35).
Player foreseen has small blind (0.25)
Player aleks0v has big blind (0.50)
Player IlxxxlI received card: [10h]
Player IlxxxlI received card: [9c]
Player Beep_Beep folds
Player IlxxxlI raises (1)
Player foreseen folds
Player aleks0v calls (0.50)
*** FLOP ***: [3c 2c Kh]
Player aleks0v checks
Player IlxxxlI bets (1.11)
Player aleks0v calls (1.11)
*** TURN ***: [3c 2c Kh] [8h]
Player aleks0v checks
Player IlxxxlI checks
*** RIVER ***: [3c 2c Kh 8h] [9s]
Player aleks0v bets (6.50)
Player IlxxxlI calls (6.50)
Player IlxxxlI mucks cards
------ Summary ------
Pot: 16.60. Rake 0.63. JP fee 0.24
Board: [3c 2c Kh 8h 9s]
Player IlxxxlI mucks (does not show: [10h 9c]). Bets: 8.61. Collects: 0. Loses: 8.61.
Player foreseen does not show cards.Bets: 0.25. Collects: 0. Loses: 0.25.
*Player aleks0v shows: Three Of Kind of 3s [3s 3d]. Bets: 8.61. Collects: 16.60. Wins: 7.99.
Player Beep_Beep does not show cards.Bets: 0. Collects: 0. Wins: 0.
Game ended at: 2016/11/29 15:20:56

Game started
Game ID: 787025529 0.25/0.50 (PRR) Garuda - 3 (Hold'em)
Seat 3 is the button
Seat 1: choiCES (78.89).
Seat 2: hoocher (62.36).
Seat 3: Parcker (107.03).
Seat 4: IlxxxlI (30.50).
Seat 5: VamosRafaFTW (50.84).
Seat 6: dankmann (94.31).
Seat 7: BlueSmoke (46.89).
Seat 9: Spagetti1 (49.94).
Player IlxxxlI has small blind (0.25)
Player VamosRafaFTW has big blind (0.50)
Player IlxxxlI received card: [7s]
Player IlxxxlI received card: [4s]
Player dankmann folds
Player BlueSmoke folds
Player Spagetti1 folds
Player choiCES raises (1.50)
Player hoocher folds
Player Parcker raises (4.54)
Player IlxxxlI folds
Player VamosRafaFTW folds
Player choiCES calls (3.04)
*** FLOP ***: [8h 4c 3s]
Player choiCES checks
Player Parcker bets (4.67)
Player choiCES raises (12.50)
Player Parcker folds
Uncalled bet (7.83) returned to choiCES
Player choiCES mucks cards
------ Summary ------
Pot: 18.22. Rake 0.71. JP fee 0.24
Board: [8h 4c 3s]
*Player choiCES mucks (does not show cards). Bets: 9.21. Collects: 18.22. Wins: 9.01.
Player hoocher does not show cards.Bets: 0. Collects: 0. Wins: 0.
Player Parcker does not show cards.Bets: 9.21. Collects: 0. Loses: 9.21.
Player IlxxxlI does not show cards.Bets: 0.25. Collects: 0. Loses: 0.25.
Player VamosRafaFTW does not show cards.Bets: 0.50. Collects: 0. Loses: 0.50.
Player dankmann does not show cards.Bets: 0. Collects: 0. Wins: 0.
Player BlueSmoke does not show cards.Bets: 0. Collects: 0. Wins: 0.
Player Spagetti1 does not show cards.Bets: 0. Collects: 0. Wins: 0.
Game ended at: 2016/11/29 15:20:5

Game started
Game ID: 787025463 0.25/0.50 (PRR) Gorgons - 2 (Hold'em)
Seat 5 is the button
Seat 1: IlxxxlI (20.25).
Seat 2: Maria_Pia (21.50).
Seat 3: foreseen (74.46).
Seat 4: aleks0v (50).
Seat 5: Beep_Beep (71.35).
Player IlxxxlI has small blind (0.25)
Player Maria_Pia sitting out
Player foreseen has big blind (0.50)
Player IlxxxlI received card: [4s]
Player IlxxxlI received card: [6c]
Player aleks0v folds
Player Beep_Beep folds
Player IlxxxlI folds
Uncalled bet (0.25) returned to foreseen
Player foreseen mucks cards
------ Summary ------
Pot: 0.50. Rake 0
Player IlxxxlI does not show cards.Bets: 0.25. Collects: 0. Loses: 0.25.
Player Maria_Pia does not show cards.Bets: 0. Collects: 0. Wins: 0.
*Player foreseen mucks (does not show cards). Bets: 0.25. Collects: 0.50. Wins: 0.25.
Player aleks0v does not show cards.Bets: 0. Collects: 0. Wins: 0.
Player Beep_Beep does not show cards.Bets: 0. Collects: 0. Wins: 0.
Game ended at: 2016/11/29 15:19:14

Game started
Game ID: 787025451 0.50/1 (PRR) Karkadann (Hold'em)
Seat 8 is the button
Seat 1: StephCurry (107.28).
Seat 2: PANDAisEVIL (100.94).
Seat 3: AironVega (103.20).
Seat 4: IlxxxlI (43).
Seat 6: dankmann (210.52).
Seat 7: ElvenEyes (111.80).
Seat 8: gust (45.50).
Seat 9: VegetablesArentYummy (270.59).
Player VegetablesArentYummy has small blind (0.50)
Player StephCurry has big blind (1)
Player IlxxxlI received card: [Jh]
Player IlxxxlI received card: [9h]
Player PANDAisEVIL folds
Player AironVega folds
Player IlxxxlI raises (3.50)
Player dankmann folds
Player ElvenEyes folds
Player gust folds
Player VegetablesArentYummy folds
Player StephCurry folds
Uncalled bet (2.50) returned to IlxxxlI
Player IlxxxlI mucks cards
------ Summary ------
Pot: 2.50. Rake 0
Player StephCurry does not show cards.Bets: 1. Collects: 0. Loses: 1.
Player PANDAisEVIL does not show cards.Bets: 0. Collects: 0. Wins: 0.
Player AironVega does not show cards.Bets: 0. Collects: 0. Wins: 0.
*Player IlxxxlI mucks (does not show cards). Bets: 1. Collects: 2.50. Wins: 1.50.
Player dankmann does not show cards.Bets: 0. Collects: 0. Wins: 0.
Player ElvenEyes does not show cards.Bets: 0. Collects: 0. Wins: 0.
Player gust does not show cards.Bets: 0. Collects: 0. Wins: 0.
Player VegetablesArentYummy does not show cards.Bets: 0.50. Collects: 0. Loses: 0.50.
Game ended at: 2016/11/29 15:19:57

Game started
Game ID: 787025353 0.25/0.50 (PRR) Gorgons - 2 (Hold'em)
Seat 4 is the button
Seat 1: IlxxxlI (20.75).
Seat 2: Maria_Pia (20.75).
Seat 3: foreseen (74.46).
Seat 4: aleks0v (50).
Seat 5: Beep_Beep (71.60).
Player Beep_Beep has small blind (0.25)
Player IlxxxlI has big blind (0.50)
Player IlxxxlI received card: [Kh]
Player IlxxxlI received card: [3c]
Player Maria_Pia raises (1.10)
Player foreseen folds
Player aleks0v folds
Player Beep_Beep folds
Player IlxxxlI folds
Uncalled bet (0.60) returned to Maria_Pia
Player Maria_Pia mucks cards
------ Summary ------
Pot: 1.25. Rake 0
Player IlxxxlI does not show cards.Bets: 0.50. Collects: 0. Loses: 0.50.
*Player Maria_Pia mucks (does not show cards). Bets: 0.50. Collects: 1.25. Wins: 0.75.
Player foreseen does not show cards.Bets: 0. Collects: 0. Wins: 0.
Player aleks0v does not show cards.Bets: 0. Collects: 0. Wins: 0.
Player Beep_Beep does not show cards.Bets: 0.25. Collects: 0. Loses: 0.25.
Game ended at: 2016/11/29 15:18:58

Game started
Game ID: 787025286 0.25/0.50 (PRR) Gorgons - 18 (Hold'em)
Seat 4 is the button
Seat 1: hoocher (81.68).
Seat 2: IlxxxlI (22).
Seat 3: Beep_Beep (104.78).
Seat 4: IampokerKidd (50).
Seat 5: Jui Kuen (50).
Seat 6: foreseen (158.83).
Player Jui Kuen has small blind (0.25)
Player foreseen has big blind (0.50)
Player IlxxxlI received card: [Jh]
Player IlxxxlI received card: [Ac]
Player hoocher folds
Player IlxxxlI raises (1)
Player Beep_Beep calls (1)
Player IampokerKidd folds
Player Jui Kuen folds
Player foreseen folds
*** FLOP ***: [7c 3h 4h]
Player IlxxxlI checks
Player Beep_Beep bets (2)
Player IlxxxlI folds
Uncalled bet (2) returned to Beep_Beep
Player Beep_Beep mucks cards
------ Summary ------
Pot: 2.62. Rake 0.09. JP fee 0.04
Board: [7c 3h 4h]
Player hoocher does not show cards.Bets: 0. Collects: 0. Wins: 0.
Player IlxxxlI does not show cards.Bets: 1. Collects: 0. Loses: 1.
*Player Beep_Beep mucks (does not show cards). Bets: 1. Collects: 2.62. Wins: 1.62.
Player IampokerKidd does not show cards.Bets: 0. Collects: 0. Wins: 0.
Player Jui Kuen does not show cards.Bets: 0.25. Collects: 0. Loses: 0.25.
Player foreseen does not show cards.Bets: 0.50. Collects: 0. Loses: 0.50.
Game ended at: 2016/11/29 15:19:25

Game started
Game ID: 787025242 0.25/0.50 (PRR) Garuda - 3 (Hold'em)
Seat 2 is the button
Seat 1: choiCES (78.89).
Seat 2: hoocher (62.36).
Seat 3: Parcker (107.28).
Seat 4: IlxxxlI (28.75).
Seat 5: VamosRafaFTW (50.84).
Seat 6: dankmann (94.31).
Seat 7: BlueSmoke (46.89).
Seat 9: Spagetti1 (51.44).
Player Parcker has small blind (0.25)
Player IlxxxlI has big blind (0.50)
Player IlxxxlI received card: [Ac]
Player IlxxxlI received card: [Kd]
Player VamosRafaFTW folds
Player dankmann folds
Player BlueSmoke folds
Player Spagetti1 raises (1.50)
Player choiCES folds
Player hoocher folds
Player Parcker folds
Player IlxxxlI raises (3.30)
Player Spagetti1 folds
Uncalled bet (2.30) returned to IlxxxlI
Player IlxxxlI mucks cards
------ Summary ------
Pot: 3.25. Rake 0
Player choiCES does not show cards.Bets: 0. Collects: 0. Wins: 0.
Player hoocher does not show cards.Bets: 0. Collects: 0. Wins: 0.
Player Parcker does not show cards.Bets: 0.25. Collects: 0. Loses: 0.25.
*Player IlxxxlI mucks (does not show cards). Bets: 1.50. Collects: 3.25. Wins: 1.75.
Player VamosRafaFTW does not show cards.Bets: 0. Collects: 0. Wins: 0.
Player dankmann does not show cards.Bets: 0. Collects: 0. Wins: 0.
Player BlueSmoke does not show cards.Bets: 0. Collects: 0. Wins: 0.
Player Spagetti1 does not show cards.Bets: 1.50. Collects: 0. Loses: 1.50.
Game ended at: 2016/11/29 15:19:11

Game started
Game ID: 787025192 0.50/1 (PRR) Karkadann (Hold'em)
Seat 7 is the button
Seat 1: StephCurry (107.28).
Seat 2: PANDAisEVIL (100.94).
Seat 3: AironVega (103.20).
Seat 4: IlxxxlI (41.50).
Seat 6: dankmann (210.52).
Seat 7: ElvenEyes (111.80).
Seat 8: gust (46).
Seat 9: VegetablesArentYummy (271.59).
Player gust has small blind (0.50)
Player VegetablesArentYummy has big blind (1)
Player IlxxxlI received card: [9c]
Player IlxxxlI received card: [9s]
Player StephCurry folds
Player PANDAisEVIL folds
Player AironVega folds
Player IlxxxlI raises (3.50)
Player dankmann folds
Player ElvenEyes folds
Player gust folds
Player VegetablesArentYummy folds
Uncalled bet (2.50) returned to IlxxxlI
Player IlxxxlI mucks cards
------ Summary ------
Pot: 2.50. Rake 0
Player StephCurry does not show cards.Bets: 0. Collects: 0. Wins: 0.
Player PANDAisEVIL does not show cards.Bets: 0. Collects: 0. Wins: 0.
Player AironVega does not show cards.Bets: 0. Collects: 0. Wins: 0.
*Player IlxxxlI mucks (does not show cards). Bets: 1. Collects: 2.50. Wins: 1.50.
Player dankmann does not show cards.Bets: 0. Collects: 0. Wins: 0.
Player ElvenEyes does not show cards.Bets: 0. Collects: 0. Wins: 0.
Player gust does not show cards.Bets: 0.50. Collects: 0. Loses: 0.50.
Player VegetablesArentYummy does not show cards.Bets: 1. Collects: 0. Loses: 1.
Game ended at: 2016/11/29 15:18:57

Game started
Game ID: 787025178 0.50/1 (PRR) Kraken - 20 (Hold'em)
Seat 5 is the button
Seat 1: AironVega (124.93).
Seat 4: WeakAndWeary (107.49).
Seat 5: IlxxxlI (40.28).
Seat 6: aleks0v (100).
Player aleks0v has small blind (0.50)
Player AironVega has big blind (1)
Player IlxxxlI received card: [9s]
Player IlxxxlI received card: [2h]
Player WeakAndWeary raises (3)
Player IlxxxlI folds
Player aleks0v folds
Player AironVega calls (2)
*** FLOP ***: [5s Kh 3h]
Player AironVega checks
Player WeakAndWeary checks
*** TURN ***: [5s Kh 3h] [Ah]
Player AironVega checks
Player WeakAndWeary checks
*** RIVER ***: [5s Kh 3h Ah] [6s]
Player AironVega checks
Player WeakAndWeary checks
Player AironVega mucks cards
------ Summary ------
Pot: 6.18. Rake 0.22. JP fee 0.10
Board: [5s Kh 3h Ah 6s]
Player AironVega mucks (does not show cards). Bets: 3. Collects: 0. Loses: 3.
*Player WeakAndWeary shows: One pair of As [As 10c]. Bets: 3. Collects: 6.18. Wins: 3.18.
Player IlxxxlI does not show cards.Bets: 0. Collects: 0. Wins: 0.
Player aleks0v does not show cards.Bets: 0.50. Collects: 0. Loses: 0.50.
Game ended at: 2016/11/29 15:20:3

Game started
Game ID: 787025140 0.25/0.50 (PRR) Garuda - 4 (Hold'em)
Seat 9 is the button
Seat 1: GagaPoker (50).
Seat 2: dankmann (100.96).
Seat 3: kid4life (114.92).
Seat 4: DRofBooya (46.69).
Seat 5: wvlax1425 (48.75).
Seat 6: Spagetti1 (50.01).
Seat 7: IlxxxlI (26.19).
Seat 8: haroldbb (53.65).
Seat 9: Korobochka (100.70).
Player GagaPoker has small blind (0.25)
Player dankmann has big blind (0.50)
Player IlxxxlI received card: [4h]
Player IlxxxlI received card: [9d]
Player kid4life raises (1)
Player DRofBooya folds
Player wvlax1425 folds
Player Spagetti1 folds
Player IlxxxlI folds
Player haroldbb calls (1)
Player Korobochka folds
Player GagaPoker folds
Player dankmann folds
*** FLOP ***: [3c Qd 5h]
Player kid4life checks
Player haroldbb bets (1.31)
Player kid4life calls (1.31)
*** TURN ***: [3c Qd 5h] [4c]
Player kid4life checks
Player haroldbb bets (3.40)
Player kid4life calls (3.40)
*** RIVER ***: [3c Qd 5h 4c] [7d]
Player kid4life bets (5.78)
Player haroldbb raises (23.12)
Player kid4life is timed out.
Player kid4life folds
Uncalled bet (17.34) returned to haroldbb
Player haroldbb mucks cards
------ Summary ------
Pot: 22.55. Rake 0.94. JP fee 0.24
Board: [3c Qd 5h 4c 7d]
Player GagaPoker does not show cards.Bets: 0.25. Collects: 0. Loses: 0.25.
Player dankmann does not show cards.Bets: 0.50. Collects: 0. Loses: 0.50.
Player kid4life does not show cards.Bets: 11.49. Collects: 0. Loses: 11.49.
Player DRofBooya does not show cards.Bets: 0. Collects: 0. Wins: 0.
Player wvlax1425 does not show cards.Bets: 0. Collects: 0. Wins: 0.
Player Spagetti1 does not show cards.Bets: 0. Collects: 0. Wins: 0.
Player IlxxxlI does not show cards.Bets: 0. Collects: 0. Wins: 0.
*Player haroldbb mucks (does not show cards). Bets: 11.49. Collects: 22.55. Wins: 11.06.
Player Korobochka does not show cards.Bets: 0. Collects: 0. Wins: 0.
Game ended at: 2016/11/29 15:20:11

Game started
Game ID: 787025102 0.25/0.50 (PRR) Gorgons - 18 (Hold'em)
Seat 3 is the button
Seat 1: hoocher (81.68).
Seat 2: IlxxxlI (22).
Seat 3: Beep_Beep (104.03).
Seat 4: IampokerKidd (50.25).
Seat 5: Jui Kuen (50).
Seat 6: foreseen (158.83).
Player IampokerKidd has small blind (0.25)
Player Jui Kuen has big blind (0.50)
Player IlxxxlI received card: [9d]
Player IlxxxlI received card: [6h]
Player foreseen folds
Player hoocher folds
Player IlxxxlI folds
Player Beep_Beep raises (1.50)
Player IampokerKidd folds
Player Jui Kuen folds
Uncalled bet (1) returned to Beep_Beep
Player Beep_Beep mucks cards
------ Summary ------
Pot: 1.25. Rake 0
Player hoocher does not show cards.Bets: 0. Collects: 0. Wins: 0.
Player IlxxxlI does not show cards.Bets: 0. Collects: 0. Wins: 0.
*Player Beep_Beep mucks (does not show cards). Bets: 0.50. Collects: 1.25. Wins: 0.75.
Player IampokerKidd does not show cards.Bets: 0.25. Collects: 0. Loses: 0.25.
Player Jui Kuen does not show cards.Bets: 0.50. Collects: 0. Loses: 0.50.
Player foreseen does not show cards.Bets: 0. Collects: 0. Wins: 0.
Game ended at: 2016/11/29 15:18:25

Game started
Game ID: 787025005 0.50/1 (PRR) Karkadann (Hold'em)
Seat 6 is the button
Seat 1: StephCurry (107.28).
Seat 2: PANDAisEVIL (100.94).
Seat 3: AironVega (103.20).
Seat 4: IlxxxlI (40).
Seat 6: dankmann (210.52).
Seat 7: ElvenEyes (112.30).
Seat 8: gust (47).
Seat 9: VegetablesArentYummy (271.59).
Player ElvenEyes has small blind (0.50)
Player gust has big blind (1)
Player IlxxxlI received card: [2h]
Player IlxxxlI received card: [2s]
Player VegetablesArentYummy folds
Player StephCurry folds
Player PANDAisEVIL folds
Player AironVega folds
Player IlxxxlI raises (2)
Player dankmann folds
Player ElvenEyes folds
Player gust folds
Uncalled bet (1) returned to IlxxxlI
Player IlxxxlI mucks cards
------ Summary ------
Pot: 2.50. Rake 0
Player StephCurry does not show cards.Bets: 0. Collects: 0. Wins: 0.
Player PANDAisEVIL does not show cards.Bets: 0. Collects: 0. Wins: 0.
Player AironVega does not show cards.Bets: 0. Collects: 0. Wins: 0.
*Player IlxxxlI mucks (does not show cards). Bets: 1. Collects: 2.50. Wins: 1.50.
Player dankmann does not show cards.Bets: 0. Collects: 0. Wins: 0.
Player ElvenEyes does not show cards.Bets: 0.50. Collects: 0. Loses: 0.50.
Player gust does not show cards.Bets: 1. Collects: 0. Loses: 1.
Player VegetablesArentYummy does not show cards.Bets: 0. Collects: 0. Wins: 0.
Game ended at: 2016/11/29 15:18:9

Game started
Game ID: 787024954 0.25/0.50 (PRR) Gorgons - 18 (Hold'em)
Seat 2 is the button
Seat 1: hoocher (81.68).
Seat 2: IlxxxlI (22).
Seat 3: Beep_Beep (104.28).
Seat 4: IampokerKidd (50).
Seat 5: Jui Kuen (50).
Seat 6: foreseen (158.83).
Player Beep_Beep has small blind (0.25)
Player IampokerKidd has big blind (0.50)
Player IlxxxlI received card: [10s]
Player IlxxxlI received card: [9c]
Player Jui Kuen folds
Player foreseen folds
Player hoocher folds
Player IlxxxlI folds
Player Beep_Beep folds
Uncalled bet (0.25) returned to IampokerKidd
Player IampokerKidd mucks cards
------ Summary ------
Pot: 0.50. Rake 0
Player hoocher does not show cards.Bets: 0. Collects: 0. Wins: 0.
Player IlxxxlI does not show cards.Bets: 0. Collects: 0. Wins: 0.
Player Beep_Beep does not show cards.Bets: 0.25. Collects: 0. Loses: 0.25.
*Player IampokerKidd mucks (does not show cards). Bets: 0.25. Collects: 0.50. Wins: 0.25.
Player Jui Kuen does not show cards.Bets: 0. Collects: 0. Wins: 0.
Player foreseen does not show cards.Bets: 0. Collects: 0. Wins: 0.
Game ended at: 2016/11/29 15:17:52

Game started
Game ID: 787024941 0.25/0.50 (PRR) Garuda - 3 (Hold'em)
Seat 1 is the button
Seat 1: choiCES (80.39).
Seat 2: hoocher (62.61).
Seat 3: Parcker (114.28).
Seat 4: IlxxxlI (20).
Seat 5: VamosRafaFTW (50.84).
Seat 6: dankmann (94.31).
Seat 7: BlueSmoke (46.89).
Seat 9: Spagetti1 (51.44).
Player hoocher has small blind (0.25)
Player Parcker has big blind (0.50)
Player IlxxxlI received card: [Ks]
Player IlxxxlI received card: [Kd]
Player IlxxxlI raises (1.50)
Player VamosRafaFTW folds
Player dankmann folds
Player BlueSmoke folds
Player Spagetti1 folds
Player choiCES calls (1.50)
Player hoocher folds
Player Parcker raises (6.50)
Player IlxxxlI allin (18.50)
Player choiCES folds
Player Parcker folds
Uncalled bet (13) returned to IlxxxlI
Player IlxxxlI mucks cards
------ Summary ------
Pot: 15.75. Rake 0
Player choiCES does not show cards.Bets: 1.50. Collects: 0. Loses: 1.50.
Player hoocher does not show cards.Bets: 0.25. Collects: 0. Loses: 0.25.
Player Parcker does not show cards.Bets: 7. Collects: 0. Loses: 7.
*Player IlxxxlI mucks (does not show cards). Bets: 7. Collects: 15.75. Wins: 8.75.
Player VamosRafaFTW does not show cards.Bets: 0. Collects: 0. Wins: 0.
Player dankmann does not show cards.Bets: 0. Collects: 0. Wins: 0.
Player BlueSmoke does not show cards.Bets: 0. Collects: 0. Wins: 0.
Player Spagetti1 does not show cards.Bets: 0. Collects: 0. Wins: 0.
Game ended at: 2016/11/29 15:18:16

Game started
Game ID: 787024939 0.50/1 (PRR) Kraken - 20 (Hold'em)
Seat 4 is the button
Seat 1: AironVega (124.93).
Seat 4: WeakAndWeary (105.99).
Seat 5: IlxxxlI (40.78).
Seat 6: aleks0v (100).
Player IlxxxlI has small blind (0.50)
Player aleks0v has big blind (1)
Player IlxxxlI received card: [7h]
Player IlxxxlI received card: [2d]
Player AironVega folds
Player WeakAndWeary raises (2)
Player IlxxxlI folds
Player aleks0v folds
Uncalled bet (1) returned to WeakAndWeary
Player WeakAndWeary mucks cards
------ Summary ------
Pot: 2.50. Rake 0
Player AironVega does not show cards.Bets: 0. Collects: 0. Wins: 0.
*Player WeakAndWeary mucks (does not show cards). Bets: 1. Collects: 2.50. Wins: 1.50.
Player IlxxxlI does not show cards.Bets: 0.50. Collects: 0. Loses: 0.50.
Player aleks0v does not show cards.Bets: 1. Collects: 0. Loses: 1.
Game ended at: 2016/11/29 15:18:4

Game started
Game ID: 787024782 0.50/1 (PRR) Karkadann (Hold'em)
Seat 4 is the button
Seat 1: StephCurry (107.28).
Seat 2: PANDAisEVIL (100.94).
Seat 3: AironVega (103.20).
Seat 4: IlxxxlI (40).
Seat 6: dankmann (211.02).
Seat 7: ElvenEyes (111.80).
Seat 8: gust (47).
Seat 9: VegetablesArentYummy (271.59).
Player dankmann has small blind (0.50)
Player ElvenEyes has big blind (1)
Player IlxxxlI received card: [As]
Player IlxxxlI received card: [6h]
Player gust folds
Player VegetablesArentYummy folds
Player StephCurry folds
Player PANDAisEVIL folds
Player AironVega folds
Player IlxxxlI folds
Player dankmann folds
Uncalled bet (0.50) returned to ElvenEyes
Player ElvenEyes mucks cards
------ Summary ------
Pot: 1. Rake 0
Player StephCurry does not show cards.Bets: 0. Collects: 0. Wins: 0.
Player PANDAisEVIL does not show cards.Bets: 0. Collects: 0. Wins: 0.
Player AironVega does not show cards.Bets: 0. Collects: 0. Wins: 0.
Player IlxxxlI does not show cards.Bets: 0. Collects: 0. Wins: 0.
Player dankmann does not show cards.Bets: 0.50. Collects: 0. Loses: 0.50.
*Player ElvenEyes mucks (does not show cards). Bets: 0.50. Collects: 1. Wins: 0.50.
Player gust does not show cards.Bets: 0. Collects: 0. Wins: 0.
Player VegetablesArentYummy does not show cards.Bets: 0. Collects: 0. Wins: 0.
Game ended at: 2016/11/29 15:17:34

Game started
Game ID: 787024697 0.25/0.50 (PRR) Gorgons - 2 (Hold'em)
Seat 3 is the button
Seat 1: IlxxxlI (20.75).
Seat 2: Maria_Pia (20.75).
Seat 3: foreseen (74.46).
Seat 4: aleks0v (50.25).
Seat 5: Beep_Beep (70.25).
Player aleks0v has small blind (0.25)
Player Beep_Beep has big blind (0.50)
Player IlxxxlI received card: [Qc]
Player IlxxxlI received card: [8h]
Player IlxxxlI folds
Player Maria_Pia folds
Player foreseen folds
Player aleks0v raises (1.25)
Player Beep_Beep calls (1)
*** FLOP ***: [Jh 3h Js]
Player aleks0v checks
Player Beep_Beep checks
*** TURN ***: [Jh 3h Js] [4d]
Player aleks0v checks
Player Beep_Beep bets (1.50)
Player aleks0v folds
Uncalled bet (1.50) returned to Beep_Beep
Player Beep_Beep mucks cards
------ Summary ------
Pot: 2.85. Rake 0.11. JP fee 0.04
Board: [Jh 3h Js 4d]
Player IlxxxlI does not show cards.Bets: 0. Collects: 0. Wins: 0.
Player Maria_Pia does not show cards.Bets: 0. Collects: 0. Wins: 0.
Player foreseen does not show cards.Bets: 0. Collects: 0. Wins: 0.
Player aleks0v does not show cards.Bets: 1.50. Collects: 0. Loses: 1.50.
*Player Beep_Beep mucks (does not show cards). Bets: 1.50. Collects: 2.85. Wins: 1.35.
Game ended at: 2016/11/29 15:18:38

Game started
Game ID: 787024693 0.50/1 (PRR) Kraken - 20 (Hold'em)
Seat 1 is the button
Seat 1: AironVega (124.93).
Seat 4: WeakAndWeary (102.49).
Seat 5: IlxxxlI (41.78).
Seat 6: aleks0v (100).
Player WeakAndWeary has small blind (0.50)
Player IlxxxlI has big blind (1)
Player IlxxxlI received card: [8c]
Player IlxxxlI received card: [Ad]
Player aleks0v raises (2.50)
Player AironVega folds
Player WeakAndWeary raises (9.50)
Player IlxxxlI folds
Player aleks0v folds
Uncalled bet (7.50) returned to WeakAndWeary
Player WeakAndWeary mucks cards
------ Summary ------
Pot: 6. Rake 0
Player AironVega does not show cards.Bets: 0. Collects: 0. Wins: 0.
*Player WeakAndWeary mucks (does not show cards). Bets: 2.50. Collects: 6. Wins: 3.50.
Player IlxxxlI does not show cards.Bets: 1. Collects: 0. Loses: 1.
Player aleks0v does not show cards.Bets: 2.50. Collects: 0. Loses: 2.50.
Game ended at: 2016/11/29 15:17:22

Game started
Game ID: 787024673 0.25/0.50 (PRR) Garuda - 3 (Hold'em)
Seat 9 is the button
Seat 1: choiCES (80.64).
Seat 2: hoocher (63.11).
Seat 3: Parcker (114.28).
Seat 4: IlxxxlI (20).
Seat 5: VamosRafaFTW (50.09).
Seat 6: dankmann (94.31).
Seat 7: BlueSmoke (46.89).
Seat 9: Spagetti1 (51.44).
Player choiCES has small blind (0.25)
Player hoocher has big blind (0.50)
Player IlxxxlI received card: [Qs]
Player IlxxxlI received card: [Jh]
Player Parcker folds
Player IlxxxlI folds
Player VamosRafaFTW raises (1.50)
Player dankmann folds
Player BlueSmoke folds
Player Spagetti1 folds
Player choiCES is timed out.
Player choiCES folds
Player hoocher folds
Uncalled bet (1) returned to VamosRafaFTW
Player VamosRafaFTW mucks cards
------ Summary ------
Pot: 1.25. Rake 0
Player choiCES does not show cards.Bets: 0.25. Collects: 0. Loses: 0.25.
Player hoocher does not show cards.Bets: 0.50. Collects: 0. Loses: 0.50.
Player Parcker does not show cards.Bets: 0. Collects: 0. Wins: 0.
Player IlxxxlI does not show cards.Bets: 0. Collects: 0. Wins: 0.
*Player VamosRafaFTW mucks (does not show cards). Bets: 0.50. Collects: 1.25. Wins: 0.75.
Player dankmann does not show cards.Bets: 0. Collects: 0. Wins: 0.
Player BlueSmoke does not show cards.Bets: 0. Collects: 0. Wins: 0.
Player Spagetti1 does not show cards.Bets: 0. Collects: 0. Wins: 0.
Game ended at: 2016/11/29 15:17:23

Game started
Game ID: 787024619 0.25/0.50 (PRR) Gorgons - 18 (Hold'em)
Seat 1 is the button
Seat 1: hoocher (83.18).
Seat 2: IlxxxlI (20).
Seat 3: Beep_Beep (104.78).
Seat 4: IampokerKidd (50).
Seat 5: Jui Kuen (50).
Seat 6: foreseen (158.83).
Player IlxxxlI has small blind (0.25)
Player Beep_Beep has big blind (0.50)
Player IlxxxlI received card: [9d]
Player IlxxxlI received card: [Ad]
Player IampokerKidd folds
Player Jui Kuen folds
Player foreseen folds
Player hoocher raises (1.50)
Player IlxxxlI raises (3.55)
Player Beep_Beep folds
Player hoocher folds
Uncalled bet (2.30) returned to IlxxxlI
Player IlxxxlI mucks cards
------ Summary ------
Pot: 3.50. Rake 0
Player hoocher does not show cards.Bets: 1.50. Collects: 0. Loses: 1.50.
*Player IlxxxlI mucks (does not show cards). Bets: 1.50. Collects: 3.50. Wins: 2.
Player Beep_Beep does not show cards.Bets: 0.50. Collects: 0. Loses: 0.50.
Player IampokerKidd does not show cards.Bets: 0. Collects: 0. Wins: 0.
Player Jui Kuen does not show cards.Bets: 0. Collects: 0. Wins: 0.
Player foreseen does not show cards.Bets: 0. Collects: 0. Wins: 0.
Game ended at: 2016/11/29 15:17:25

Game started
Game ID: 787024550 0.25/0.50 (PRR) Gorgons - 2 (Hold'em)
Seat 2 is the button
Seat 1: IlxxxlI (20.75).
Seat 2: Maria_Pia (20).
Seat 3: foreseen (74.71).
Seat 4: aleks0v (50.75).
Seat 5: Beep_Beep (70.25).
Player foreseen has small blind (0.25)
Player aleks0v has big blind (0.50)
Player IlxxxlI received card: [5h]
Player IlxxxlI received card: [9s]
Player Beep_Beep folds
Player IlxxxlI folds
Player Maria_Pia raises (1)
Player foreseen folds
Player aleks0v folds
Uncalled bet (0.50) returned to Maria_Pia
Player Maria_Pia mucks cards
------ Summary ------
Pot: 1.25. Rake 0
Player IlxxxlI does not show cards.Bets: 0. Collects: 0. Wins: 0.
*Player Maria_Pia mucks (does not show cards). Bets: 0.50. Collects: 1.25. Wins: 0.75.
Player foreseen does not show cards.Bets: 0.25. Collects: 0. Loses: 0.25.
Player aleks0v does not show cards.Bets: 0.50. Collects: 0. Loses: 0.50.
Player Beep_Beep does not show cards.Bets: 0. Collects: 0. Wins: 0.
Game ended at: 2016/11/29 15:16:41

Game started
Game ID: 787024515 0.50/1 (PRR) Kraken - 20 (Hold'em)
Seat 6 is the button
Seat 1: AironVega (123.93).
Seat 4: WeakAndWeary (103.49).
Seat 5: IlxxxlI (41.78).
Seat 6: aleks0v (100).
Player AironVega has small blind (0.50)
Player WeakAndWeary has big blind (1)
Player IlxxxlI received card: [7h]
Player IlxxxlI received card: [10h]
Player IlxxxlI folds
Player aleks0v folds
Player AironVega raises (2.50)
Player WeakAndWeary folds
Uncalled bet (2) returned to AironVega
Player AironVega mucks cards
------ Summary ------
Pot: 2. Rake 0
*Player AironVega mucks (does not show cards). Bets: 1. Collects: 2. Wins: 1.
Player WeakAndWeary does not show cards.Bets: 1. Collects: 0. Loses: 1.
Player IlxxxlI does not show cards.Bets: 0. Collects: 0. Wins: 0.
Player aleks0v does not show cards.Bets: 0. Collects: 0. Wins: 0.
Game ended at: 2016/11/29 15:16:41

Game started
Game ID: 787024445 0.50/1 (PRR) Karkadann (Hold'em)
Seat 3 is the button
Seat 1: StephCurry (107.28).
Seat 2: PANDAisEVIL (100.94).
Seat 3: AironVega (103.20).
Seat 4: IlxxxlI (40.50).
Seat 5: pineapplesand (40).
Seat 6: dankmann (210.52).
Seat 7: ElvenEyes (111.80).
Seat 8: gust (47).
Seat 9: VegetablesArentYummy (271.59).
Player IlxxxlI has small blind (0.50)
Player pineapplesand sitting out
Player dankmann has big blind (1)
Player IlxxxlI received card: [3d]
Player IlxxxlI received card: [8c]
Player ElvenEyes folds
Player gust folds
Player VegetablesArentYummy folds
Player StephCurry folds
Player PANDAisEVIL folds
Player AironVega folds
Player IlxxxlI folds
Uncalled bet (0.50) returned to dankmann
Player dankmann mucks cards
------ Summary ------
Pot: 1. Rake 0
Player StephCurry does not show cards.Bets: 0. Collects: 0. Wins: 0.
Player PANDAisEVIL does not show cards.Bets: 0. Collects: 0. Wins: 0.
Player AironVega does not show cards.Bets: 0. Collects: 0. Wins: 0.
Player IlxxxlI does not show cards.Bets: 0.50. Collects: 0. Loses: 0.50.
Player pineapplesand does not show cards.Bets: 0. Collects: 0. Wins: 0.
*Player dankmann mucks (does not show cards). Bets: 0.50. Collects: 1. Wins: 0.50.
Player ElvenEyes does not show cards.Bets: 0. Collects: 0. Wins: 0.
Player gust does not show cards.Bets: 0. Collects: 0. Wins: 0.
Player VegetablesArentYummy does not show cards.Bets: 0. Collects: 0. Wins: 0.
Game ended at: 2016/11/29 15:16:56

Game started
Game ID: 787024412 0.25/0.50 (PRR) Gorgons - 2 (Hold'em)
Seat 1 is the button
Seat 1: IlxxxlI (20).
Seat 2: Maria_Pia (20).
Seat 3: foreseen (75.21).
Seat 4: aleks0v (50.75).
Seat 5: Beep_Beep (70.25).
Player Maria_Pia has small blind (0.25)
Player foreseen has big blind (0.50)
Player IlxxxlI received card: [Js]
Player IlxxxlI received card: [Ac]
Player aleks0v folds
Player Beep_Beep folds
Player IlxxxlI raises (1.50)
Player Maria_Pia folds
Player foreseen folds
Uncalled bet (1) returned to IlxxxlI
Player IlxxxlI mucks cards
------ Summary ------
Pot: 1.25. Rake 0
*Player IlxxxlI mucks (does not show cards). Bets: 0.50. Collects: 1.25. Wins: 0.75.
Player Maria_Pia does not show cards.Bets: 0.25. Collects: 0. Loses: 0.25.
Player foreseen does not show cards.Bets: 0.50. Collects: 0. Loses: 0.50.
Player aleks0v does not show cards.Bets: 0. Collects: 0. Wins: 0.
Player Beep_Beep does not show cards.Bets: 0. Collects: 0. Wins: 0.
Game ended at: 2016/11/29 15:16:18

Game started
Game ID: 787024367 0.25/0.50 (PRR) Garuda - 4 (Hold'em)
Seat 8 is the button
Seat 1: GagaPoker (50).
Seat 2: dankmann (100.96).
Seat 3: kid4life (110.31).
Seat 4: DRofBooya (46.69).
Seat 5: wvlax1425 (48.75).
Seat 6: Spagetti1 (50.01).
Seat 7: IlxxxlI (26.19).
Seat 8: haroldbb (53.65).
Seat 9: Korobochka (100.95).
Player Korobochka has small blind (0.25)
Player GagaPoker has big blind (0.50)
Player IlxxxlI received card: [10d]
Player IlxxxlI received card: [2d]
Player dankmann folds
Player kid4life raises (1)
Player DRofBooya folds
Player wvlax1425 folds
Player Spagetti1 folds
Player IlxxxlI folds
Player haroldbb folds
Player Korobochka folds
Player GagaPoker calls (0.50)
*** FLOP ***: [4h 5h 6s]
Player GagaPoker checks
Player kid4life bets (1.07)
Player GagaPoker calls (1.07)
*** TURN ***: [4h 5h 6s] [3c]
Player GagaPoker checks
Player kid4life bets (2.78)
Player GagaPoker calls (2.78)
*** RIVER ***: [4h 5h 6s 3c] [6d]
Player GagaPoker checks
Player kid4life bets (6.30)
Player GagaPoker folds
Uncalled bet (6.30) returned to kid4life
Player kid4life mucks cards
------ Summary ------
Pot: 9.46. Rake 0.33. JP fee 0.16
Board: [4h 5h 6s 3c 6d]
Player GagaPoker does not show cards.Bets: 4.85. Collects: 0. Loses: 4.85.
Player dankmann does not show cards.Bets: 0. Collects: 0. Wins: 0.
*Player kid4life mucks (does not show cards). Bets: 4.85. Collects: 9.46. Wins: 4.61.
Player DRofBooya does not show cards.Bets: 0. Collects: 0. Wins: 0.
Player wvlax1425 does not show cards.Bets: 0. Collects: 0. Wins: 0.
Player Spagetti1 does not show cards.Bets: 0. Collects: 0. Wins: 0.
Player IlxxxlI does not show cards.Bets: 0. Collects: 0. Wins: 0.
Player haroldbb does not show cards.Bets: 0. Collects: 0. Wins: 0.
Player Korobochka does not show cards.Bets: 0.25. Collects: 0. Loses: 0.25.
Game ended at: 2016/11/29 15:18:0

Game started
Game ID: 787024340 0.25/0.50 (PRR) Garuda - 3 (Hold'em)
Seat 7 is the button
Seat 1: choiCES (82.14).
Seat 2: hoocher (63.11).
Seat 3: Parcker (114.28).
Seat 4: IlxxxlI (20).
Seat 5: VamosRafaFTW (48.50).
Seat 6: dankmann (94.31).
Seat 7: BlueSmoke (46.89).
Seat 9: Spagetti1 (51.69).
Player Spagetti1 has small blind (0.25)
Player choiCES has big blind (0.50)
Player IlxxxlI received card: [Jc]
Player IlxxxlI received card: [10d]
Player hoocher folds
Player Parcker folds
Player IlxxxlI folds
Player VamosRafaFTW raises (1.50)
Player dankmann folds
Player BlueSmoke folds
Player Spagetti1 folds
Player choiCES calls (1)
*** FLOP ***: [Jh 8d Kc]
Player choiCES checks
Player VamosRafaFTW bets (2.06)
Player choiCES folds
Uncalled bet (2.06) returned to VamosRafaFTW
Player VamosRafaFTW mucks cards
------ Summary ------
Pot: 3.09. Rake 0.12. JP fee 0.04
Board: [Jh 8d Kc]
Player choiCES does not show cards.Bets: 1.50. Collects: 0. Loses: 1.50.
Player hoocher does not show cards.Bets: 0. Collects: 0. Wins: 0.
Player Parcker does not show cards.Bets: 0. Collects: 0. Wins: 0.
Player IlxxxlI does not show cards.Bets: 0. Collects: 0. Wins: 0.
*Player VamosRafaFTW mucks (does not show cards). Bets: 1.50. Collects: 3.09. Wins: 1.59.
Player dankmann does not show cards.Bets: 0. Collects: 0. Wins: 0.
Player BlueSmoke does not show cards.Bets: 0. Collects: 0. Wins: 0.
Player Spagetti1 does not show cards.Bets: 0.25. Collects: 0. Loses: 0.25.
Game ended at: 2016/11/29 15:16:37

Game started
Game ID: 787024337 0.50/1 (PRR) Kraken - 20 (Hold'em)
Seat 5 is the button
Seat 1: AironVega (123.43).
Seat 4: WeakAndWeary (103.49).
Seat 5: IlxxxlI (41.78).
Seat 6: aleks0v (100.50).
Player aleks0v has small blind (0.50)
Player AironVega has big blind (1)
Player IlxxxlI received card: [4s]
Player IlxxxlI received card: [3c]
Player WeakAndWeary folds
Player IlxxxlI folds
Player aleks0v folds
Uncalled bet (0.50) returned to AironVega
Player AironVega mucks cards
------ Summary ------
Pot: 1. Rake 0
*Player AironVega mucks (does not show cards). Bets: 0.50. Collects: 1. Wins: 0.50.
Player WeakAndWeary does not show cards.Bets: 0. Collects: 0. Wins: 0.
Player IlxxxlI does not show cards.Bets: 0. Collects: 0. Wins: 0.
Player aleks0v does not show cards.Bets: 0.50. Collects: 0. Loses: 0.50.
Game ended at: 2016/11/29 15:16:12

Game started
Game ID: 787024299 0.25/0.50 (PRR) Gorgons - 18 (Hold'em)
Seat 6 is the button
Seat 1: hoocher (81.18).
Seat 2: IlxxxlI (20).
Seat 3: Beep_Beep (104.78).
Seat 4: IampokerKidd (50).
Seat 5: Jui Kuen (51.34).
Seat 6: foreseen (158.83).
Player hoocher has small blind (0.25)
Player IlxxxlI has big blind (0.50)
Player IlxxxlI received card: [Qh]
Player IlxxxlI received card: [9s]
Player Beep_Beep folds
Player IampokerKidd folds
Player Jui Kuen raises (1.50)
Player foreseen folds
Player hoocher raises (4.75)
Player IlxxxlI folds
Player Jui Kuen folds
Uncalled bet (3.50) returned to hoocher
Player hoocher mucks cards
------ Summary ------
Pot: 3.50. Rake 0
*Player hoocher mucks (does not show cards). Bets: 1.50. Collects: 3.50. Wins: 2.
Player IlxxxlI does not show cards.Bets: 0.50. Collects: 0. Loses: 0.50.
Player Beep_Beep does not show cards.Bets: 0. Collects: 0. Wins: 0.
Player IampokerKidd does not show cards.Bets: 0. Collects: 0. Wins: 0.
Player Jui Kuen does not show cards.Bets: 1.50. Collects: 0. Loses: 1.50.
Player foreseen does not show cards.Bets: 0. Collects: 0. Wins: 0.
Game ended at: 2016/11/29 15:16:28

Game started
Game ID: 787024210 0.25/0.50 (PRR) Garuda - 4 (Hold'em)
Seat 7 is the button
Seat 2: dankmann (100.96).
Seat 3: kid4life (110.31).
Seat 4: DRofBooya (46.69).
Seat 5: wvlax1425 (48.75).
Seat 6: Spagetti1 (50.01).
Seat 7: IlxxxlI (25.44).
Seat 8: haroldbb (53.90).
Seat 9: Korobochka (101.45).
Player haroldbb has small blind (0.25)
Player Korobochka has big blind (0.50)
Player IlxxxlI received card: [5h]
Player IlxxxlI received card: [Ac]
Player dankmann folds
Player kid4life folds
Player DRofBooya folds
Player wvlax1425 folds
Player Spagetti1 folds
Player IlxxxlI raises (1.50)
Player haroldbb folds
Player Korobochka folds
Uncalled bet (1) returned to IlxxxlI
Player IlxxxlI mucks cards
------ Summary ------
Pot: 1.25. Rake 0
Player dankmann does not show cards.Bets: 0. Collects: 0. Wins: 0.
Player kid4life does not show cards.Bets: 0. Collects: 0. Wins: 0.
Player DRofBooya does not show cards.Bets: 0. Collects: 0. Wins: 0.
Player wvlax1425 does not show cards.Bets: 0. Collects: 0. Wins: 0.
Player Spagetti1 does not show cards.Bets: 0. Collects: 0. Wins: 0.
*Player IlxxxlI mucks (does not show cards). Bets: 0.50. Collects: 1.25. Wins: 0.75.
Player haroldbb does not show cards.Bets: 0.25. Collects: 0. Loses: 0.25.
Player Korobochka does not show cards.Bets: 0.50. Collects: 0. Loses: 0.50.
Game ended at: 2016/11/29 15:15:48

Game started
Game ID: 787024159 0.50/1 (PRR) Kraken - 20 (Hold'em)
Seat 4 is the button
Seat 1: AironVega (123.43).
Seat 4: WeakAndWeary (103.49).
Seat 5: IlxxxlI (42.28).
Seat 6: aleks0v (100).
Player IlxxxlI has small blind (0.50)
Player aleks0v has big blind (1)
Player IlxxxlI received card: [Kd]
Player IlxxxlI received card: [2h]
Player AironVega folds
Player WeakAndWeary folds
Player IlxxxlI folds
Uncalled bet (0.50) returned to aleks0v
Player aleks0v mucks cards
------ Summary ------
Pot: 1. Rake 0
Player AironVega does not show cards.Bets: 0. Collects: 0. Wins: 0.
Player WeakAndWeary does not show cards.Bets: 0. Collects: 0. Wins: 0.
Player IlxxxlI does not show cards.Bets: 0.50. Collects: 0. Loses: 0.50.
*Player aleks0v mucks (does not show cards). Bets: 0.50. Collects: 1. Wins: 0.50.
Game ended at: 2016/11/29 15:15:43

Game started
Game ID: 787024146 0.25/0.50 (PRR) Gorgons - 2 (Hold'em)
Seat 5 is the button
Seat 1: IlxxxlI (20).
Seat 2: Maria_Pia (20).
Seat 3: foreseen (75.21).
Seat 4: aleks0v (50).
Seat 5: Beep_Beep (70.25).
Player IlxxxlI has small blind (0.25)
Player Maria_Pia has big blind (0.50)
Player IlxxxlI received card: [6s]
Player IlxxxlI received card: [8c]
Player foreseen folds
Player aleks0v raises (1.25)
Player Beep_Beep folds
Player IlxxxlI folds
Player Maria_Pia folds
Uncalled bet (0.75) returned to aleks0v
Player aleks0v mucks cards
------ Summary ------
Pot: 1.25. Rake 0
Player IlxxxlI does not show cards.Bets: 0.25. Collects: 0. Loses: 0.25.
Player Maria_Pia does not show cards.Bets: 0.50. Collects: 0. Loses: 0.50.
Player foreseen does not show cards.Bets: 0. Collects: 0. Wins: 0.
*Player aleks0v mucks (does not show cards). Bets: 0.50. Collects: 1.25. Wins: 0.75.
Player Beep_Beep does not show cards.Bets: 0. Collects: 0. Wins: 0.
Game ended at: 2016/11/29 15:15:57

Game started
Game ID: 787024125 0.50/1 (PRR) Karkadann (Hold'em)
Seat 2 is the button
Seat 1: StephCurry (107.28).
Seat 2: PANDAisEVIL (103.14).
Seat 3: AironVega (100).
Seat 4: IlxxxlI (41.50).
Seat 5: pineapplesand (40).
Seat 6: dankmann (210.52).
Seat 7: ElvenEyes (111.80).
Seat 8: gust (47).
Seat 9: VegetablesArentYummy (271.59).
Player AironVega has small blind (0.50)
Player IlxxxlI has big blind (1)
Player IlxxxlI received card: [Jd]
Player IlxxxlI received card: [Qc]
Player pineapplesand folds
Player dankmann folds
Player ElvenEyes folds
Player gust folds
Player VegetablesArentYummy folds
Player StephCurry folds
Player PANDAisEVIL raises (2.20)
Player AironVega raises (8.14)
Player IlxxxlI folds
Player PANDAisEVIL folds
Uncalled bet (6.44) returned to AironVega
Player AironVega mucks cards
------ Summary ------
Pot: 5.40. Rake 0
Player StephCurry does not show cards.Bets: 0. Collects: 0. Wins: 0.
Player PANDAisEVIL does not show cards.Bets: 2.20. Collects: 0. Loses: 2.20.
*Player AironVega mucks (does not show cards). Bets: 2.20. Collects: 5.40. Wins: 3.20.
Player IlxxxlI does not show cards.Bets: 1. Collects: 0. Loses: 1.
Player pineapplesand does not show cards.Bets: 0. Collects: 0. Wins: 0.
Player dankmann does not show cards.Bets: 0. Collects: 0. Wins: 0.
Player ElvenEyes does not show cards.Bets: 0. Collects: 0. Wins: 0.
Player gust does not show cards.Bets: 0. Collects: 0. Wins: 0.
Player VegetablesArentYummy does not show cards.Bets: 0. Collects: 0. Wins: 0.
Game ended at: 2016/11/29 15:16:2

Game started
Game ID: 787023986 0.25/0.50 (PRR) Garuda - 3 (Hold'em)
Seat 6 is the button
Seat 1: choiCES (82.14).
Seat 2: hoocher (59.62).
Seat 3: Parcker (114.28).
Seat 4: IlxxxlI (20).
Seat 5: VamosRafaFTW (50).
Seat 6: dankmann (95.81).
Seat 7: BlueSmoke (47.14).
Seat 9: Spagetti1 (52.19).
Player BlueSmoke has small blind (0.25)
Player Spagetti1 has big blind (0.50)
Player IlxxxlI received card: [Kc]
Player IlxxxlI received card: [9c]
Player choiCES folds
Player hoocher raises (1.50)
Player Parcker folds
Player IlxxxlI folds
Player VamosRafaFTW calls (1.50)
Player dankmann calls (1.50)
Player BlueSmoke folds
Player Spagetti1 folds
*** FLOP ***: [Js Kh Ks]
Player hoocher bets (3)
Player VamosRafaFTW folds
Player dankmann folds
Uncalled bet (3) returned to hoocher
Player hoocher mucks cards
------ Summary ------
Pot: 4.99. Rake 0.18. JP fee 0.08
Board: [Js Kh Ks]
Player choiCES does not show cards.Bets: 0. Collects: 0. Wins: 0.
*Player hoocher mucks (does not show cards). Bets: 1.50. Collects: 4.99. Wins: 3.49.
Player Parcker does not show cards.Bets: 0. Collects: 0. Wins: 0.
Player IlxxxlI does not show cards.Bets: 0. Collects: 0. Wins: 0.
Player VamosRafaFTW does not show cards.Bets: 1.50. Collects: 0. Loses: 1.50.
Player dankmann does not show cards.Bets: 1.50. Collects: 0. Loses: 1.50.
Player BlueSmoke does not show cards.Bets: 0.25. Collects: 0. Loses: 0.25.
Player Spagetti1 does not show cards.Bets: 0.50. Collects: 0. Loses: 0.50.
Game ended at: 2016/11/29 15:15:42

Game started
Game ID: 787023880 0.25/0.50 (PRR) Gorgons - 2 (Hold'em)
Seat 4 is the button
Seat 1: IlxxxlI (20).
Seat 2: Maria_Pia (20).
Seat 3: foreseen (75.21).
Seat 4: aleks0v (50).
Seat 5: Beep_Beep (69.75).
Seat 6: LawMaker20 (6.64).
Player Beep_Beep has small blind (0.25)
Player LawMaker20 sitting out
Player IlxxxlI has big blind (0.50)
Player IlxxxlI received card: [5h]
Player IlxxxlI received card: [10d]
Player Maria_Pia folds
Player foreseen folds
Player aleks0v folds
Player Beep_Beep raises (1.25)
Player IlxxxlI folds
Uncalled bet (1) returned to Beep_Beep
Player Beep_Beep mucks cards
------ Summary ------
Pot: 1. Rake 0
Player IlxxxlI does not show cards.Bets: 0.50. Collects: 0. Loses: 0.50.
Player Maria_Pia does not show cards.Bets: 0. Collects: 0. Wins: 0.
Player foreseen does not show cards.Bets: 0. Collects: 0. Wins: 0.
Player aleks0v does not show cards.Bets: 0. Collects: 0. Wins: 0.
*Player Beep_Beep mucks (does not show cards). Bets: 0.50. Collects: 1. Wins: 0.50.
Player LawMaker20 does not show cards.Bets: 0. Collects: 0. Wins: 0.
Game ended at: 2016/11/29 15:15:8

Game started
Game ID: 787023828 0.25/0.50 (PRR) Garuda - 4 (Hold'em)
Seat 6 is the button
Seat 2: dankmann (100.96).
Seat 3: kid4life (110.31).
Seat 4: DRofBooya (45.94).
Seat 5: wvlax1425 (48.75).
Seat 6: Spagetti1 (50.01).
Seat 7: IlxxxlI (25.69).
Seat 8: haroldbb (54.40).
Seat 9: Korobochka (101.45).
Player IlxxxlI has small blind (0.25)
Player haroldbb has big blind (0.50)
Player IlxxxlI received card: [Js]
Player IlxxxlI received card: [6s]
Player Korobochka folds
Player dankmann folds
Player kid4life folds
Player DRofBooya raises (1.50)
Player wvlax1425 folds
Player Spagetti1 folds
Player IlxxxlI folds
Player haroldbb folds
Uncalled bet (1) returned to DRofBooya
Player DRofBooya mucks cards
------ Summary ------
Pot: 1.25. Rake 0
Player dankmann does not show cards.Bets: 0. Collects: 0. Wins: 0.
Player kid4life does not show cards.Bets: 0. Collects: 0. Wins: 0.
*Player DRofBooya mucks (does not show cards). Bets: 0.50. Collects: 1.25. Wins: 0.75.
Player wvlax1425 does not show cards.Bets: 0. Collects: 0. Wins: 0.
Player Spagetti1 does not show cards.Bets: 0. Collects: 0. Wins: 0.
Player IlxxxlI does not show cards.Bets: 0.25. Collects: 0. Loses: 0.25.
Player haroldbb does not show cards.Bets: 0.50. Collects: 0. Loses: 0.50.
Player Korobochka does not show cards.Bets: 0. Collects: 0. Wins: 0.
Game ended at: 2016/11/29 15:15:21

Game started
Game ID: 787023803 0.25/0.50 (PRR) Garuda - 3 (Hold'em)
Seat 5 is the button
Seat 1: choiCES (82.14).
Seat 2: hoocher (59.62).
Seat 3: Parcker (114.28).
Seat 4: IlxxxlI (20).
Seat 5: VamosRafaFTW (50).
Seat 6: dankmann (96.06).
Seat 7: BlueSmoke (46.89).
Seat 9: Spagetti1 (52.19).
Player dankmann has small blind (0.25)
Player BlueSmoke has big blind (0.50)
Player IlxxxlI received card: [3d]
Player IlxxxlI received card: [2d]
Player Spagetti1 folds
Player choiCES folds
Player hoocher folds
Player Parcker folds
Player IlxxxlI folds
Player VamosRafaFTW folds
Player dankmann folds
Uncalled bet (0.25) returned to BlueSmoke
Player BlueSmoke mucks cards
------ Summary ------
Pot: 0.50. Rake 0
Player choiCES does not show cards.Bets: 0. Collects: 0. Wins: 0.
Player hoocher does not show cards.Bets: 0. Collects: 0. Wins: 0.
Player Parcker does not show cards.Bets: 0. Collects: 0. Wins: 0.
Player IlxxxlI does not show cards.Bets: 0. Collects: 0. Wins: 0.
Player VamosRafaFTW does not show cards.Bets: 0. Collects: 0. Wins: 0.
Player dankmann does not show cards.Bets: 0.25. Collects: 0. Loses: 0.25.
*Player BlueSmoke mucks (does not show cards). Bets: 0.25. Collects: 0.50. Wins: 0.25.
Player Spagetti1 does not show cards.Bets: 0. Collects: 0. Wins: 0.
Game ended at: 2016/11/29 15:14:46

Game started
Game ID: 787023731 0.50/1 (PRR) Karkadann (Hold'em)
Seat 1 is the button
Seat 1: StephCurry (107.28).
Seat 2: PANDAisEVIL (103.64).
Seat 3: AironVega (100).
Seat 4: IlxxxlI (41.50).
Seat 5: pineapplesand (40).
Seat 6: dankmann (210.52).
Seat 7: ElvenEyes (110.30).
Seat 8: gust (47).
Seat 9: VegetablesArentYummy (271.59).
Player PANDAisEVIL has small blind (0.50)
Player AironVega has big blind (1)
Player IlxxxlI received card: [7d]
Player IlxxxlI received card: [9c]
Player IlxxxlI folds
Player pineapplesand folds
Player dankmann folds
Player ElvenEyes raises (2)
Player gust folds
Player VegetablesArentYummy folds
Player StephCurry folds
Player PANDAisEVIL folds
Player AironVega folds
Uncalled bet (1) returned to ElvenEyes
Player ElvenEyes mucks cards
------ Summary ------
Pot: 2.50. Rake 0
Player StephCurry does not show cards.Bets: 0. Collects: 0. Wins: 0.
Player PANDAisEVIL does not show cards.Bets: 0.50. Collects: 0. Loses: 0.50.
Player AironVega does not show cards.Bets: 1. Collects: 0. Loses: 1.
Player IlxxxlI does not show cards.Bets: 0. Collects: 0. Wins: 0.
Player pineapplesand does not show cards.Bets: 0. Collects: 0. Wins: 0.
Player dankmann does not show cards.Bets: 0. Collects: 0. Wins: 0.
*Player ElvenEyes mucks (does not show cards). Bets: 1. Collects: 2.50. Wins: 1.50.
Player gust does not show cards.Bets: 0. Collects: 0. Wins: 0.
Player VegetablesArentYummy does not show cards.Bets: 0. Collects: 0. Wins: 0.
Game ended at: 2016/11/29 15:15:5

Game started
Game ID: 787023691 0.25/0.50 (PRR) Gorgons - 2 (Hold'em)
Seat 3 is the button
Seat 1: IlxxxlI (20).
Seat 2: Maria_Pia (20).
Seat 3: foreseen (75.21).
Seat 4: aleks0v (50).
Seat 5: Beep_Beep (69.50).
Seat 6: LawMaker20 (6.64).
Player aleks0v has small blind (0.25)
Player Beep_Beep has big blind (0.50)
Player IlxxxlI received card: [5s]
Player IlxxxlI received card: [Ac]
Player LawMaker20 folds
Player IlxxxlI folds
Player Maria_Pia folds
Player foreseen folds
Player aleks0v folds
Uncalled bet (0.25) returned to Beep_Beep
Player Beep_Beep mucks cards
------ Summary ------
Pot: 0.50. Rake 0
Player IlxxxlI does not show cards.Bets: 0. Collects: 0. Wins: 0.
Player Maria_Pia does not show cards.Bets: 0. Collects: 0. Wins: 0.
Player foreseen does not show cards.Bets: 0. Collects: 0. Wins: 0.
Player aleks0v does not show cards.Bets: 0.25. Collects: 0. Loses: 0.25.
*Player Beep_Beep mucks (does not show cards). Bets: 0.25. Collects: 0.50. Wins: 0.25.
Player LawMaker20 does not show cards.Bets: 0. Collects: 0. Wins: 0.
Game ended at: 2016/11/29 15:14:29

Game started
Game ID: 787023643 0.25/0.50 (PRR) Gorgons (Cap) - 2 (Hold'em)
Seat 5 is the button
Seat 1: Maria_Pia (20).
Seat 2: IlxxxlI (35.63).
Seat 3: jjeannin1 (36.83).
Seat 4: trader063 (32.72).
Seat 5: Parcker (89.15).
Seat 6: Jui Kuen (76.28).
Player Jui Kuen has small blind (0.25)
Player Maria_Pia has big blind (0.50)
Player IlxxxlI received card: [6c]
Player IlxxxlI received card: [7s]
Player IlxxxlI folds
Player jjeannin1 raises (1)
Player trader063 calls (1)
Player Parcker folds
Player Jui Kuen folds
Player Maria_Pia calls (0.50)
*** FLOP ***: [Ac Ah Kh]
Player Maria_Pia checks
Player jjeannin1 bets (1.50)
Player trader063 folds
Player Maria_Pia folds
Uncalled bet (1.50) returned to jjeannin1
Player jjeannin1 mucks cards
------ Summary ------
Pot: 3.09. Rake 0.12. JP fee 0.04
Board: [Ac Ah Kh]
Player Maria_Pia does not show cards.Bets: 1. Collects: 0. Loses: 1.
Player IlxxxlI does not show cards.Bets: 0. Collects: 0. Wins: 0.
*Player jjeannin1 mucks (does not show cards). Bets: 1. Collects: 3.09. Wins: 2.09.
Player trader063 does not show cards.Bets: 1. Collects: 0. Loses: 1.
Player Parcker does not show cards.Bets: 0. Collects: 0. Wins: 0.
Player Jui Kuen does not show cards.Bets: 0.25. Collects: 0. Loses: 0.25.
Game ended at: 2016/11/29 15:14:30

Game started
Game ID: 787023447 0.25/0.50 (PRR) Garuda - 3 (Hold'em)
Seat 4 is the button
Seat 1: choiCES (82.14).
Seat 2: hoocher (59.62).
Seat 3: Parcker (114.28).
Seat 4: IlxxxlI (20).
Seat 5: VamosRafaFTW (28.50).
Seat 6: dankmann (96.56).
Seat 7: BlueSmoke (46.20).
Seat 9: Spagetti1 (52.19).
Player VamosRafaFTW has small blind (0.25)
Player dankmann has big blind (0.50)
Player IlxxxlI received card: [2h]
Player IlxxxlI received card: [9s]
Player BlueSmoke calls (0.50)
Player Spagetti1 folds
Player choiCES folds
Player hoocher folds
Player Parcker folds
Player IlxxxlI folds
Player VamosRafaFTW folds
Player dankmann checks
*** FLOP ***: [Jc 10c Kc]
Player dankmann checks
Player BlueSmoke bets (1.19)
Player dankmann folds
Uncalled bet (1.19) returned to BlueSmoke
Player BlueSmoke mucks cards
------ Summary ------
Pot: 1.19. Rake 0.04. JP fee 0.02
Board: [Jc 10c Kc]
Player choiCES does not show cards.Bets: 0. Collects: 0. Wins: 0.
Player hoocher does not show cards.Bets: 0. Collects: 0. Wins: 0.
Player Parcker does not show cards.Bets: 0. Collects: 0. Wins: 0.
Player IlxxxlI does not show cards.Bets: 0. Collects: 0. Wins: 0.
Player VamosRafaFTW does not show cards.Bets: 0.25. Collects: 0. Loses: 0.25.
Player dankmann does not show cards.Bets: 0.50. Collects: 0. Loses: 0.50.
*Player BlueSmoke mucks (does not show cards). Bets: 0.50. Collects: 1.19. Wins: 0.69.
Player Spagetti1 does not show cards.Bets: 0. Collects: 0. Wins: 0.
Game ended at: 2016/11/29 15:14:16

Game started
Game ID: 787023450 0.25/0.50 (PRR) Gorgons - 2 (Hold'em)
Seat 2 is the button
Seat 1: IlxxxlI (20).
Seat 2: Maria_Pia (20).
Seat 3: foreseen (75.46).
Seat 4: aleks0v (50).
Seat 5: Beep_Beep (71).
Seat 6: LawMaker20 (4.39).
Player foreseen has small blind (0.25)
Player aleks0v has big blind (0.50)
Player IlxxxlI received card: [7c]
Player IlxxxlI received card: [9s]
Player Beep_Beep raises (1.50)
Player LawMaker20 allin (4.39)
Player IlxxxlI folds
Player Maria_Pia folds
Player foreseen folds
Player aleks0v folds
Player Beep_Beep folds
Uncalled bet (2.89) returned to LawMaker20
Player LawMaker20 mucks cards
------ Summary ------
Pot: 3.75. Rake 0
Player IlxxxlI does not show cards.Bets: 0. Collects: 0. Wins: 0.
Player Maria_Pia does not show cards.Bets: 0. Collects: 0. Wins: 0.
Player foreseen does not show cards.Bets: 0.25. Collects: 0. Loses: 0.25.
Player aleks0v does not show cards.Bets: 0.50. Collects: 0. Loses: 0.50.
Player Beep_Beep does not show cards.Bets: 1.50. Collects: 0. Loses: 1.50.
*Player LawMaker20 mucks (does not show cards). Bets: 1.50. Collects: 3.75. Wins: 2.25.
Game ended at: 2016/11/29 15:13:55

Game started
Game ID: 787023431 0.50/1 (PRR) Karkadann (Hold'em)
Seat 9 is the button
Seat 1: StephCurry (107.78).
Seat 2: PANDAisEVIL (104.64).
Seat 3: AironVega (100).
Seat 4: IlxxxlI (40).
Seat 5: pineapplesand (40).
Seat 6: dankmann (210.52).
Seat 7: ElvenEyes (110.30).
Seat 8: gust (47).
Seat 9: VegetablesArentYummy (271.59).
Player StephCurry has small blind (0.50)
Player PANDAisEVIL has big blind (1)
Player IlxxxlI received card: [10h]
Player IlxxxlI received card: [10d]
Player AironVega folds
Player IlxxxlI raises (3.50)
Player pineapplesand folds
Player dankmann folds
Player ElvenEyes folds
Player gust folds
Player VegetablesArentYummy folds
Player StephCurry folds
Player PANDAisEVIL folds
Uncalled bet (2.50) returned to IlxxxlI
Player IlxxxlI mucks cards
------ Summary ------
Pot: 2.50. Rake 0
Player StephCurry does not show cards.Bets: 0.50. Collects: 0. Loses: 0.50.
Player PANDAisEVIL does not show cards.Bets: 1. Collects: 0. Loses: 1.
Player AironVega does not show cards.Bets: 0. Collects: 0. Wins: 0.
*Player IlxxxlI mucks (does not show cards). Bets: 1. Collects: 2.50. Wins: 1.50.
Player pineapplesand does not show cards.Bets: 0. Collects: 0. Wins: 0.
Player dankmann does not show cards.Bets: 0. Collects: 0. Wins: 0.
Player ElvenEyes does not show cards.Bets: 0. Collects: 0. Wins: 0.
Player gust does not show cards.Bets: 0. Collects: 0. Wins: 0.
Player VegetablesArentYummy does not show cards.Bets: 0. Collects: 0. Wins: 0.
Game ended at: 2016/11/29 15:14:2

Game started
Game ID: 787023410 0.25/0.50 (PRR) Gorgons (Cap) - 2 (Hold'em)
Seat 4 is the button
Seat 2: IlxxxlI (35.63).
Seat 3: jjeannin1 (36.14).
Seat 4: trader063 (32.72).
Seat 5: Parcker (89.40).
Seat 6: Jui Kuen (76.78).
Player Parcker has small blind (0.25)
Player Jui Kuen has big blind (0.50)
Player IlxxxlI received card: [8s]
Player IlxxxlI received card: [4h]
Player IlxxxlI folds
Player jjeannin1 calls (0.50)
Player trader063 folds
Player Parcker folds
Player Jui Kuen checks
*** FLOP ***: [8h 3s 10d]
Player Jui Kuen checks
Player jjeannin1 bets (0.50)
Player Jui Kuen folds
Uncalled bet (0.50) returned to jjeannin1
Player jjeannin1 mucks cards
------ Summary ------
Pot: 1.19. Rake 0.04. JP fee 0.02
Board: [8h 3s 10d]
Player IlxxxlI does not show cards.Bets: 0. Collects: 0. Wins: 0.
*Player jjeannin1 mucks (does not show cards). Bets: 0.50. Collects: 1.19. Wins: 0.69.
Player trader063 does not show cards.Bets: 0. Collects: 0. Wins: 0.
Player Parcker does not show cards.Bets: 0.25. Collects: 0. Loses: 0.25.
Player Jui Kuen does not show cards.Bets: 0.50. Collects: 0. Loses: 0.50.
Game ended at: 2016/11/29 15:13:48

Game started
Game ID: 787023377 0.50/1 (PRR) Kraken - 20 (Hold'em)
Seat 1 is the button
Seat 1: AironVega (125.43).
Seat 4: WeakAndWeary (103.99).
Seat 5: IlxxxlI (40).
Seat 6: aleks0v (100).
Player WeakAndWeary has small blind (0.50)
Player IlxxxlI has big blind (1)
Player IlxxxlI received card: [5h]
Player IlxxxlI received card: [Ad]
Player aleks0v folds
Player AironVega raises (2)
Player WeakAndWeary folds
Player IlxxxlI calls (1)
*** FLOP ***: [Ac 2s 5d]
Player IlxxxlI checks
Player AironVega checks
*** TURN ***: [Ac 2s 5d] [Qd]
Player IlxxxlI checks
Player AironVega checks
*** RIVER ***: [Ac 2s 5d Qd] [2c]
Player IlxxxlI checks
Player AironVega checks
Player AironVega mucks cards
------ Summary ------
Pot: 4.28. Rake 0.16. JP fee 0.06
Board: [Ac 2s 5d Qd 2c]
Player AironVega mucks (does not show cards). Bets: 2. Collects: 0. Loses: 2.
Player WeakAndWeary does not show cards.Bets: 0.50. Collects: 0. Loses: 0.50.
*Player IlxxxlI shows: Two pairs. As and 5s [5h Ad]. Bets: 2. Collects: 4.28. Wins: 2.28.
Player aleks0v does not show cards.Bets: 0. Collects: 0. Wins: 0.
Game ended at: 2016/11/29 15:15:9

Game started
Game ID: 787023292 0.25/0.50 (PRR) Garuda - 3 (Hold'em)
Seat 3 is the button
Seat 1: choiCES (82.14).
Seat 2: hoocher (59.62).
Seat 3: Parcker (114.28).
Seat 4: IlxxxlI (20).
Seat 5: VamosRafaFTW (29).
Seat 6: dankmann (95.81).
Seat 7: BlueSmoke (46.20).
Seat 9: Spagetti1 (52.19).
Player IlxxxlI has small blind (0.25)
Player VamosRafaFTW has big blind (0.50)
Player IlxxxlI received card: [2c]
Player IlxxxlI received card: [2s]
Player dankmann raises (1.50)
Player BlueSmoke folds
Player Spagetti1 folds
Player choiCES folds
Player hoocher folds
Player Parcker folds
Player IlxxxlI folds
Player VamosRafaFTW folds
Uncalled bet (1) returned to dankmann
Player dankmann mucks cards
------ Summary ------
Pot: 1.25. Rake 0
Player choiCES does not show cards.Bets: 0. Collects: 0. Wins: 0.
Player hoocher does not show cards.Bets: 0. Collects: 0. Wins: 0.
Player Parcker does not show cards.Bets: 0. Collects: 0. Wins: 0.
Player IlxxxlI does not show cards.Bets: 0.25. Collects: 0. Loses: 0.25.
Player VamosRafaFTW does not show cards.Bets: 0.50. Collects: 0. Loses: 0.50.
*Player dankmann mucks (does not show cards). Bets: 0.50. Collects: 1.25. Wins: 0.75.
Player BlueSmoke does not show cards.Bets: 0. Collects: 0. Wins: 0.
Player Spagetti1 does not show cards.Bets: 0. Collects: 0. Wins: 0.
Game ended at: 2016/11/29 15:13:12

Game started
Game ID: 787023149 0.25/0.50 (PRR) Gorgons (Cap) - 2 (Hold'em)
Seat 3 is the button
Seat 2: IlxxxlI (35.63).
Seat 3: jjeannin1 (36.64).
Seat 4: trader063 (32.97).
Seat 5: Parcker (88.71).
Seat 6: Jui Kuen (76.78).
Player trader063 has small blind (0.25)
Player Parcker has big blind (0.50)
Player IlxxxlI received card: [Qc]
Player IlxxxlI received card: [2h]
Player Jui Kuen folds
Player IlxxxlI folds
Player jjeannin1 calls (0.50)
Player trader063 folds
Player Parcker checks
*** FLOP ***: [4s 3s 4h]
Player Parcker checks
Player jjeannin1 checks
*** TURN ***: [4s 3s 4h] [Qs]
Player Parcker checks
Player jjeannin1 checks
*** RIVER ***: [4s 3s 4h Qs] [6s]
Player Parcker checks
Player jjeannin1 checks
Player jjeannin1 mucks cards
------ Summary ------
Pot: 1.19. Rake 0.04. JP fee 0.02
Board: [4s 3s 4h Qs 6s]
Player IlxxxlI does not show cards.Bets: 0. Collects: 0. Wins: 0.
Player jjeannin1 mucks (does not show cards). Bets: 0.50. Collects: 0. Loses: 0.50.
Player trader063 does not show cards.Bets: 0.25. Collects: 0. Loses: 0.25.
*Player Parcker shows: Flush, Q high [Jc 7s]. Bets: 0.50. Collects: 1.19. Wins: 0.69.
Player Jui Kuen does not show cards.Bets: 0. Collects: 0. Wins: 0.
Game ended at: 2016/11/29 15:13:0

Game started
Game ID: 787022993 0.50/1 (PRR) Kraken - 20 (Hold'em)
Seat 6 is the button
Seat 1: AironVega (104.73).
Seat 2: ali23imsirovic (141.16).
Seat 4: WeakAndWeary (104.99).
Seat 5: IlxxxlI (40).
Seat 6: aleks0v (100).
Player AironVega has small blind (0.50)
Player ali23imsirovic sitting out
Player WeakAndWeary has big blind (1)
Player IlxxxlI received card: [7s]
Player IlxxxlI received card: [3c]
Player IlxxxlI folds
Player aleks0v raises (2)
Player AironVega raises (7.40)
Player WeakAndWeary folds
Player aleks0v raises (17.70)
Player AironVega allin (96.83)
Player aleks0v folds
Uncalled bet (85.03) returned to AironVega
Player AironVega mucks cards
------ Summary ------
Pot: 40.40. Rake 0
*Player AironVega mucks (does not show cards). Bets: 19.70. Collects: 40.40. Wins: 20.70.
Player ali23imsirovic does not show cards.Bets: 0. Collects: 0. Wins: 0.
Player WeakAndWeary does not show cards.Bets: 1. Collects: 0. Loses: 1.
Player IlxxxlI does not show cards.Bets: 0. Collects: 0. Wins: 0.
Player aleks0v does not show cards.Bets: 19.70. Collects: 0. Loses: 19.70.
Game ended at: 2016/11/29 15:12:58

Game started
Game ID: 787022952 0.25/0.50 (PRR) Garuda - 4 (Hold'em)
Seat 5 is the button
Seat 2: dankmann (100.96).
Seat 3: kid4life (112.85).
Seat 4: DRofBooya (45.94).
Seat 5: wvlax1425 (51.29).
Seat 6: Spagetti1 (50.26).
Seat 7: IlxxxlI (20.75).
Seat 8: haroldbb (54.40).
Seat 9: Korobochka (101.45).
Player Spagetti1 has small blind (0.25)
Player IlxxxlI has big blind (0.50)
Player IlxxxlI received card: [Ah]
Player IlxxxlI received card: [6d]
Player haroldbb folds
Player Korobochka folds
Player dankmann folds
Player kid4life raises (1)
Player DRofBooya folds
Player wvlax1425 calls (1)
Player Spagetti1 folds
Player IlxxxlI calls (0.50)
*** FLOP ***: [6s 5h 2d]
Player IlxxxlI checks
Player kid4life checks
Player wvlax1425 checks
*** TURN ***: [6s 5h 2d] [Ad]
Player IlxxxlI checks
Player kid4life bets (1.54)
Player wvlax1425 calls (1.54)
Player IlxxxlI raises (7)
Player kid4life folds
Player wvlax1425 folds
Uncalled bet (5.46) returned to IlxxxlI
Player IlxxxlI mucks cards
------ Summary ------
Pot: 7.48. Rake 0.27. JP fee 0.12
Board: [6s 5h 2d Ad]
Player dankmann does not show cards.Bets: 0. Collects: 0. Wins: 0.
Player kid4life does not show cards.Bets: 2.54. Collects: 0. Loses: 2.54.
Player DRofBooya does not show cards.Bets: 0. Collects: 0. Wins: 0.
Player wvlax1425 does not show cards.Bets: 2.54. Collects: 0. Loses: 2.54.
Player Spagetti1 does not show cards.Bets: 0.25. Collects: 0. Loses: 0.25.
*Player IlxxxlI mucks (does not show cards). Bets: 2.54. Collects: 7.48. Wins: 4.94.
Player haroldbb does not show cards.Bets: 0. Collects: 0. Wins: 0.
Player Korobochka does not show cards.Bets: 0. Collects: 0. Wins: 0.
Game ended at: 2016/11/29 15:14:21

Game started
Game ID: 787022911 0.50/1 (PRR) Karkadann (Hold'em)
Seat 8 is the button
Seat 1: StephCurry (104.78).
Seat 2: PANDAisEVIL (104.64).
Seat 3: AironVega (100).
Seat 4: IlxxxlI (40).
Seat 5: pineapplesand (40).
Seat 6: dankmann (210.52).
Seat 7: ElvenEyes (110.30).
Seat 8: gust (47).
Seat 9: VegetablesArentYummy (274.59).
Player VegetablesArentYummy has small blind (0.50)
Player StephCurry has big blind (1)
Player IlxxxlI received card: [3h]
Player IlxxxlI received card: [10c]
Player PANDAisEVIL folds
Player AironVega folds
Player IlxxxlI folds
Player pineapplesand folds
Player dankmann folds
Player ElvenEyes folds
Player gust folds
Player VegetablesArentYummy raises (2.50)
Player StephCurry raises (10)
Player VegetablesArentYummy folds
Uncalled bet (8) returned to StephCurry
Player StephCurry mucks cards
------ Summary ------
Pot: 6. Rake 0
*Player StephCurry mucks (does not show cards). Bets: 3. Collects: 6. Wins: 3.
Player PANDAisEVIL does not show cards.Bets: 0. Collects: 0. Wins: 0.
Player AironVega does not show cards.Bets: 0. Collects: 0. Wins: 0.
Player IlxxxlI does not show cards.Bets: 0. Collects: 0. Wins: 0.
Player pineapplesand does not show cards.Bets: 0. Collects: 0. Wins: 0.
Player dankmann does not show cards.Bets: 0. Collects: 0. Wins: 0.
Player ElvenEyes does not show cards.Bets: 0. Collects: 0. Wins: 0.
Player gust does not show cards.Bets: 0. Collects: 0. Wins: 0.
Player VegetablesArentYummy does not show cards.Bets: 3. Collects: 0. Loses: 3.
Game ended at: 2016/11/29 15:13:8

Game started
Game ID: 787022860 0.25/0.50 (PRR) Gorgons - 2 (Hold'em)
Seat 1 is the button
Seat 1: IlxxxlI (20).
Seat 2: Maria_Pia (20).
Seat 3: foreseen (56.98).
Seat 4: aleks0v (50).
Seat 5: Beep_Beep (71).
Seat 6: LawMaker20 (23.33).
Player Maria_Pia has small blind (0.25)
Player foreseen has big blind (0.50)
Player IlxxxlI received card: [7d]
Player IlxxxlI received card: [Qc]
Player aleks0v folds
Player Beep_Beep folds
Player LawMaker20 calls (0.50)
Player IlxxxlI folds
Player Maria_Pia calls (0.25)
Player foreseen checks
*** FLOP ***: [5c 4s 8c]
Player Maria_Pia checks
Player foreseen bets (1)
Player LawMaker20 calls (1)
Player Maria_Pia calls (1)
*** TURN ***: [5c 4s 8c] [Ad]
Player Maria_Pia checks
Player foreseen checks
Player LawMaker20 bets (2.14)
Player Maria_Pia folds
Player foreseen raises (7.85)
Player LawMaker20 calls (5.71)
*** RIVER ***: [5c 4s 8c Ad] [3c]
Player foreseen bets (9.59)
Player LawMaker20 calls (9.59)
Player LawMaker20 mucks cards
------ Summary ------
Pot: 37.42. Rake 1.72. JP fee 0.24
Board: [5c 4s 8c Ad 3c]
Player IlxxxlI does not show cards.Bets: 0. Collects: 0. Wins: 0.
Player Maria_Pia does not show cards.Bets: 1.50. Collects: 0. Loses: 1.50.
*Player foreseen shows: Straight to 5 [2h 3s]. Bets: 18.94. Collects: 37.42. Wins: 18.48.
Player aleks0v does not show cards.Bets: 0. Collects: 0. Wins: 0.
Player Beep_Beep does not show cards.Bets: 0. Collects: 0. Wins: 0.
Player LawMaker20 mucks (does not show cards). Bets: 18.94. Collects: 0. Loses: 18.94.
Game ended at: 2016/11/29 15:13:9

Game started
Game ID: 787022859 0.25/0.50 (PRR) Gorgons (Cap) - 2 (Hold'em)
Seat 2 is the button
Seat 1: cuervo_ (2).
Seat 2: IlxxxlI (35.63).
Seat 3: jjeannin1 (38.14).
Seat 4: trader063 (34.47).
Seat 5: Parcker (85.93).
Seat 6: Jui Kuen (76.78).
Player jjeannin1 has small blind (0.25)
Player trader063 has big blind (0.50)
Player IlxxxlI received card: [Qh]
Player IlxxxlI received card: [8c]
Player Parcker raises (1.50)
Player Jui Kuen folds
Player cuervo_ folds
Player IlxxxlI folds
Player jjeannin1 calls (1.25)
Player trader063 calls (1)
*** FLOP ***: [Qs 3h 6d]
Player jjeannin1 checks
Player trader063 checks
Player Parcker checks
*** TURN ***: [Qs 3h 6d] [9c]
Player jjeannin1 checks
Player trader063 checks
Player Parcker bets (3.21)
Player jjeannin1 folds
Player trader063 folds
Uncalled bet (3.21) returned to Parcker
Player Parcker mucks cards
------ Summary ------
Pot: 4.28. Rake 0.16. JP fee 0.06
Board: [Qs 3h 6d 9c]
Player cuervo_ does not show cards.Bets: 0. Collects: 0. Wins: 0.
Player IlxxxlI does not show cards.Bets: 0. Collects: 0. Wins: 0.
Player jjeannin1 does not show cards.Bets: 1.50. Collects: 0. Loses: 1.50.
Player trader063 does not show cards.Bets: 1.50. Collects: 0. Loses: 1.50.
*Player Parcker mucks (does not show cards). Bets: 1.50. Collects: 4.28. Wins: 2.78.
Player Jui Kuen does not show cards.Bets: 0. Collects: 0. Wins: 0.
Game ended at: 2016/11/29 15:12:15

Game started
Game ID: 787022738 0.25/0.50 (PRR) Garuda - 4 (Hold'em)
Seat 4 is the button
Seat 2: dankmann (100.96).
Seat 3: kid4life (112.85).
Seat 4: DRofBooya (45.94).
Seat 5: wvlax1425 (51.54).
Seat 6: Spagetti1 (50.76).
Seat 7: IlxxxlI (20.75).
Seat 8: haroldbb (54.40).
Seat 9: Korobochka (100.70).
Player wvlax1425 has small blind (0.25)
Player Spagetti1 has big blind (0.50)
Player IlxxxlI received card: [Qs]
Player IlxxxlI received card: [Jh]
Player IlxxxlI folds
Player haroldbb folds
Player Korobochka raises (1.50)
Player dankmann folds
Player kid4life folds
Player DRofBooya folds
Player wvlax1425 folds
Player Spagetti1 folds
Uncalled bet (1) returned to Korobochka
Player Korobochka mucks cards
------ Summary ------
Pot: 1.25. Rake 0
Player dankmann does not show cards.Bets: 0. Collects: 0. Wins: 0.
Player kid4life does not show cards.Bets: 0. Collects: 0. Wins: 0.
Player DRofBooya does not show cards.Bets: 0. Collects: 0. Wins: 0.
Player wvlax1425 does not show cards.Bets: 0.25. Collects: 0. Loses: 0.25.
Player Spagetti1 does not show cards.Bets: 0.50. Collects: 0. Loses: 0.50.
Player IlxxxlI does not show cards.Bets: 0. Collects: 0. Wins: 0.
Player haroldbb does not show cards.Bets: 0. Collects: 0. Wins: 0.
*Player Korobochka mucks (does not show cards). Bets: 0.50. Collects: 1.25. Wins: 0.75.
Game ended at: 2016/11/29 15:11:42

Game started
Game ID: 787022685 0.25/0.50 (PRR) Gorgons - 2 (Hold'em)
Seat 6 is the button
Seat 1: IlxxxlI (20).
Seat 2: Maria_Pia (20).
Seat 4: aleks0v (50).
Seat 5: Beep_Beep (70.25).
Seat 6: LawMaker20 (23.33).
Player IlxxxlI has small blind (0.25)
Player Maria_Pia has big blind (0.50)
Player IlxxxlI received card: [8c]
Player IlxxxlI received card: [Kd]
Player aleks0v folds
Player Beep_Beep raises (1.50)
Player LawMaker20 folds
Player IlxxxlI folds
Player Maria_Pia folds
Uncalled bet (1) returned to Beep_Beep
Player Beep_Beep mucks cards
------ Summary ------
Pot: 1.25. Rake 0
Player IlxxxlI does not show cards.Bets: 0.25. Collects: 0. Loses: 0.25.
Player Maria_Pia does not show cards.Bets: 0.50. Collects: 0. Loses: 0.50.
Player aleks0v does not show cards.Bets: 0. Collects: 0. Wins: 0.
*Player Beep_Beep mucks (does not show cards). Bets: 0.50. Collects: 1.25. Wins: 0.75.
Player LawMaker20 does not show cards.Bets: 0. Collects: 0. Wins: 0.
Game ended at: 2016/11/29 15:11:22

Game started
Game ID: 787022634 0.50/1 (PRR) Kraken - 20 (Hold'em)
Seat 5 is the button
Seat 1: AironVega (101.23).
Seat 2: ali23imsirovic (141.16).
Seat 4: WeakAndWeary (107.99).
Seat 5: IlxxxlI (40).
Seat 6: aleks0v (100).
Player aleks0v has small blind (0.50)
Player AironVega has big blind (1)
Player IlxxxlI received card: [7c]
Player IlxxxlI received card: [2c]
Player ali23imsirovic folds
Player WeakAndWeary raises (3)
Player IlxxxlI folds
Player aleks0v folds
Player AironVega raises (9)
Player WeakAndWeary folds
Uncalled bet (7) returned to AironVega
Player AironVega mucks cards
------ Summary ------
Pot: 6.50. Rake 0
*Player AironVega mucks (does not show cards). Bets: 3. Collects: 6.50. Wins: 3.50.
Player ali23imsirovic does not show cards.Bets: 0. Collects: 0. Wins: 0.
Player WeakAndWeary does not show cards.Bets: 3. Collects: 0. Loses: 3.
Player IlxxxlI does not show cards.Bets: 0. Collects: 0. Wins: 0.
Player aleks0v does not show cards.Bets: 0.50. Collects: 0. Loses: 0.50.
Game ended at: 2016/11/29 15:11:50

Game started
Game ID: 787022567 0.25/0.50 (PRR) Garuda - 3 (Hold'em)
Seat 2 is the button
Seat 1: choiCES (62.67).
Seat 2: hoocher (59.62).
Seat 3: Parcker (114.53).
Seat 4: IlxxxlI (20).
Seat 5: VamosRafaFTW (48.25).
Seat 6: dankmann (95.81).
Seat 7: BlueSmoke (47.70).
Seat 9: Spagetti1 (52.19).
Player Parcker has small blind (0.25)
Player IlxxxlI has big blind (0.50)
Player IlxxxlI received card: [Qh]
Player IlxxxlI received card: [7s]
Player VamosRafaFTW raises (1.50)
Player dankmann folds
Player BlueSmoke calls (1.50)
Player Spagetti1 folds
Player choiCES raises (3.50)
Player hoocher folds
Player Parcker folds
Player IlxxxlI folds
Player VamosRafaFTW raises (6.75)
Player BlueSmoke folds
Player choiCES calls (4.75)
*** FLOP ***: [2s Qc Qs]
Player VamosRafaFTW checks
Player choiCES checks
*** TURN ***: [2s Qc Qs] [2d]
Player VamosRafaFTW checks
Player choiCES checks
*** RIVER ***: [2s Qc Qs 2d] [4d]
Player VamosRafaFTW bets (11)
Player choiCES allin (54.42)
Player VamosRafaFTW folds
Uncalled bet (43.42) returned to choiCES
Player choiCES mucks cards
------ Summary ------
Pot: 38.72. Rake 1.79. JP fee 0.24
Board: [2s Qc Qs 2d 4d]
*Player choiCES mucks (does not show cards). Bets: 19.25. Collects: 38.72. Wins: 19.47.
Player hoocher does not show cards.Bets: 0. Collects: 0. Wins: 0.
Player Parcker does not show cards.Bets: 0.25. Collects: 0. Loses: 0.25.
Player IlxxxlI does not show cards.Bets: 0.50. Collects: 0. Loses: 0.50.
Player VamosRafaFTW does not show cards.Bets: 19.25. Collects: 0. Loses: 19.25.
Player dankmann does not show cards.Bets: 0. Collects: 0. Wins: 0.
Player BlueSmoke does not show cards.Bets: 1.50. Collects: 0. Loses: 1.50.
Player Spagetti1 does not show cards.Bets: 0. Collects: 0. Wins: 0.
Game ended at: 2016/11/29 15:12:41

Game started
Game ID: 787022539 0.25/0.50 (PRR) Garuda - 4 (Hold'em)
Seat 3 is the button
Seat 2: dankmann (100.96).
Seat 3: kid4life (112.85).
Seat 4: DRofBooya (46.19).
Seat 5: wvlax1425 (52.04).
Seat 6: Spagetti1 (50.76).
Seat 7: IlxxxlI (20).
Seat 8: haroldbb (54.40).
Seat 9: Korobochka (100.70).
Player DRofBooya has small blind (0.25)
Player wvlax1425 has big blind (0.50)
Player IlxxxlI received card: [Ac]
Player IlxxxlI received card: [Ks]
Player Spagetti1 folds
Player IlxxxlI raises (1.75)
Player haroldbb folds
Player Korobochka folds
Player dankmann folds
Player kid4life folds
Player DRofBooya folds
Player wvlax1425 folds
Uncalled bet (1.25) returned to IlxxxlI
Player IlxxxlI mucks cards
------ Summary ------
Pot: 1.25. Rake 0
Player dankmann does not show cards.Bets: 0. Collects: 0. Wins: 0.
Player kid4life does not show cards.Bets: 0. Collects: 0. Wins: 0.
Player DRofBooya does not show cards.Bets: 0.25. Collects: 0. Loses: 0.25.
Player wvlax1425 does not show cards.Bets: 0.50. Collects: 0. Loses: 0.50.
Player Spagetti1 does not show cards.Bets: 0. Collects: 0. Wins: 0.
*Player IlxxxlI mucks (does not show cards). Bets: 0.50. Collects: 1.25. Wins: 0.75.
Player haroldbb does not show cards.Bets: 0. Collects: 0. Wins: 0.
Player Korobochka does not show cards.Bets: 0. Collects: 0. Wins: 0.
Game ended at: 2016/11/29 15:11:3

Game started
Game ID: 787022487 0.50/1 (PRR) Karkadann (Hold'em)
Seat 7 is the button
Seat 1: StephCurry (103.28).
Seat 2: PANDAisEVIL (104.64).
Seat 3: AironVega (100).
Seat 4: IlxxxlI (40).
Seat 5: pineapplesand (40).
Seat 6: dankmann (210.52).
Seat 7: ElvenEyes (110.30).
Seat 8: gust (47.50).
Seat 9: VegetablesArentYummy (275.59).
Player gust has small blind (0.50)
Player VegetablesArentYummy has big blind (1)
Player IlxxxlI received card: [Qs]
Player IlxxxlI received card: [8s]
Player StephCurry raises (3)
Player PANDAisEVIL folds
Player AironVega folds
Player IlxxxlI folds
Player pineapplesand folds
Player dankmann folds
Player ElvenEyes folds
Player gust folds
Player VegetablesArentYummy folds
Uncalled bet (2) returned to StephCurry
Player StephCurry mucks cards
------ Summary ------
Pot: 2.50. Rake 0
*Player StephCurry mucks (does not show cards). Bets: 1. Collects: 2.50. Wins: 1.50.
Player PANDAisEVIL does not show cards.Bets: 0. Collects: 0. Wins: 0.
Player AironVega does not show cards.Bets: 0. Collects: 0. Wins: 0.
Player IlxxxlI does not show cards.Bets: 0. Collects: 0. Wins: 0.
Player pineapplesand does not show cards.Bets: 0. Collects: 0. Wins: 0.
Player dankmann does not show cards.Bets: 0. Collects: 0. Wins: 0.
Player ElvenEyes does not show cards.Bets: 0. Collects: 0. Wins: 0.
Player gust does not show cards.Bets: 0.50. Collects: 0. Loses: 0.50.
Player VegetablesArentYummy does not show cards.Bets: 1. Collects: 0. Loses: 1.
Game ended at: 2016/11/29 15:11:34

Game started
Game ID: 787022482 0.25/0.50 (PRR) Gorgons - 2 (Hold'em)
Seat 5 is the button
Seat 1: IlxxxlI (20).
Seat 4: aleks0v (50).
Seat 5: Beep_Beep (70.25).
Seat 6: LawMaker20 (21.33).
Player LawMaker20 has small blind (0.25)
Player IlxxxlI has big blind (0.50)
Player IlxxxlI received card: [4c]
Player IlxxxlI received card: [2c]
Player aleks0v raises (1.50)
Player Beep_Beep folds
Player LawMaker20 raises (4.75)
Player IlxxxlI folds
Player aleks0v folds
Uncalled bet (3.50) returned to LawMaker20
Player LawMaker20 mucks cards
------ Summary ------
Pot: 3.50. Rake 0
Player IlxxxlI does not show cards.Bets: 0.50. Collects: 0. Loses: 0.50.
Player aleks0v does not show cards.Bets: 1.50. Collects: 0. Loses: 1.50.
Player Beep_Beep does not show cards.Bets: 0. Collects: 0. Wins: 0.
*Player LawMaker20 mucks (does not show cards). Bets: 1.50. Collects: 3.50. Wins: 2.
Game ended at: 2016/11/29 15:10:53

Game started
Game ID: 787022389 0.25/0.50 (PRR) Garuda - 3 (Hold'em)
Seat 1 is the button
Seat 1: choiCES (62.67).
Seat 2: hoocher (59.87).
Seat 3: Parcker (115.03).
Seat 4: IlxxxlI (20).
Seat 5: VamosRafaFTW (48.25).
Seat 6: dankmann (95.06).
Seat 7: BlueSmoke (47.70).
Seat 9: Spagetti1 (52.19).
Player hoocher has small blind (0.25)
Player Parcker has big blind (0.50)
Player IlxxxlI received card: [8c]
Player IlxxxlI received card: [4c]
Player IlxxxlI folds
Player VamosRafaFTW folds
Player dankmann raises (1.50)
Player BlueSmoke folds
Player Spagetti1 folds
Player choiCES folds
Player hoocher folds
Player Parcker folds
Uncalled bet (1) returned to dankmann
Player dankmann mucks cards
------ Summary ------
Pot: 1.25. Rake 0
Player choiCES does not show cards.Bets: 0. Collects: 0. Wins: 0.
Player hoocher does not show cards.Bets: 0.25. Collects: 0. Loses: 0.25.
Player Parcker does not show cards.Bets: 0.50. Collects: 0. Loses: 0.50.
Player IlxxxlI does not show cards.Bets: 0. Collects: 0. Wins: 0.
Player VamosRafaFTW does not show cards.Bets: 0. Collects: 0. Wins: 0.
*Player dankmann mucks (does not show cards). Bets: 0.50. Collects: 1.25. Wins: 0.75.
Player BlueSmoke does not show cards.Bets: 0. Collects: 0. Wins: 0.
Player Spagetti1 does not show cards.Bets: 0. Collects: 0. Wins: 0.
Game ended at: 2016/11/29 15:10:33

Game started
Game ID: 787022313 0.25/0.50 (PRR) Gorgons (Cap) - 2 (Hold'em)
Seat 1 is the button
Seat 1: cuervo_ (17).
Seat 2: IlxxxlI (35.88).
Seat 3: jjeannin1 (23.92).
Seat 4: trader063 (34.97).
Seat 5: Parcker (85.93).
Seat 6: Jui Kuen (76.78).
Player IlxxxlI has small blind (0.25)
Player jjeannin1 has big blind (0.50)
Player IlxxxlI received card: [9h]
Player IlxxxlI received card: [4s]
Player trader063 calls (0.50)
Player Parcker folds
Player Jui Kuen folds
Player cuervo_ calls (0.50)
Player IlxxxlI folds
Player jjeannin1 checks
*** FLOP ***: [Ac Js Kc]
Player jjeannin1 checks
Player trader063 checks
Player cuervo_ checks
*** TURN ***: [Ac Js Kc] [3h]
Player jjeannin1 checks
Player trader063 checks
Player cuervo_ bets (4.50)
Player jjeannin1 calls (4.50)
Player trader063 folds
*** RIVER ***: [Ac Js Kc 3h] [Qs]
Player jjeannin1 checks
Player cuervo_ caps (10)
Player jjeannin1 calls (10)
------ Summary ------
Pot: 29.22. Rake 1.29. JP fee 0.24
Board: [Ac Js Kc 3h Qs]
Player cuervo_ shows: High card A [8c 9d]. Bets: 15. Collects: 0. Loses: 15.
Player IlxxxlI does not show cards.Bets: 0.25. Collects: 0. Loses: 0.25.
*Player jjeannin1 shows: One pair of Ks [2h Kh]. Bets: 15. Collects: 29.22. Wins: 14.22.
Player trader063 does not show cards.Bets: 0.50. Collects: 0. Loses: 0.50.
Player Parcker does not show cards.Bets: 0. Collects: 0. Wins: 0.
Player Jui Kuen does not show cards.Bets: 0. Collects: 0. Wins: 0.
Game ended at: 2016/11/29 15:11:21

Game started
Game ID: 787022282 0.25/0.50 (PRR) Garuda - 4 (Hold'em)
Seat 2 is the button
Seat 2: dankmann (100.96).
Seat 3: kid4life (113.10).
Seat 4: DRofBooya (45.94).
Seat 5: wvlax1425 (52.04).
Seat 6: Spagetti1 (50.76).
Seat 7: IlxxxlI (20).
Seat 8: haroldbb (54.40).
Seat 9: Korobochka (100.70).
Player kid4life has small blind (0.25)
Player DRofBooya has big blind (0.50)
Player IlxxxlI received card: [Jd]
Player IlxxxlI received card: [7s]
Player wvlax1425 folds
Player Spagetti1 folds
Player IlxxxlI folds
Player haroldbb folds
Player Korobochka folds
Player dankmann folds
Player kid4life folds
Uncalled bet (0.25) returned to DRofBooya
Player DRofBooya mucks cards
------ Summary ------
Pot: 0.50. Rake 0
Player dankmann does not show cards.Bets: 0. Collects: 0. Wins: 0.
Player kid4life does not show cards.Bets: 0.25. Collects: 0. Loses: 0.25.
*Player DRofBooya mucks (does not show cards). Bets: 0.25. Collects: 0.50. Wins: 0.25.
Player wvlax1425 does not show cards.Bets: 0. Collects: 0. Wins: 0.
Player Spagetti1 does not show cards.Bets: 0. Collects: 0. Wins: 0.
Player IlxxxlI does not show cards.Bets: 0. Collects: 0. Wins: 0.
Player haroldbb does not show cards.Bets: 0. Collects: 0. Wins: 0.
Player Korobochka does not show cards.Bets: 0. Collects: 0. Wins: 0.
Game ended at: 2016/11/29 15:10:29

Game started
Game ID: 787022259 0.50/1 (PRR) Kraken - 20 (Hold'em)
Seat 4 is the button
Seat 1: AironVega (101.23).
Seat 2: ali23imsirovic (141.16).
Seat 4: WeakAndWeary (106.49).
Seat 5: IlxxxlI (40).
Seat 6: aleks0v (100).
Player IlxxxlI has small blind (0.50)
Player aleks0v has big blind (1)
Player IlxxxlI received card: [2d]
Player IlxxxlI received card: [5h]
Player AironVega folds
Player ali23imsirovic folds
Player WeakAndWeary raises (2)
Player IlxxxlI folds
Player aleks0v folds
Uncalled bet (1) returned to WeakAndWeary
Player WeakAndWeary mucks cards
------ Summary ------
Pot: 2.50. Rake 0
Player AironVega does not show cards.Bets: 0. Collects: 0. Wins: 0.
Player ali23imsirovic does not show cards.Bets: 0. Collects: 0. Wins: 0.
*Player WeakAndWeary mucks (does not show cards). Bets: 1. Collects: 2.50. Wins: 1.50.
Player IlxxxlI does not show cards.Bets: 0.50. Collects: 0. Loses: 0.50.
Player aleks0v does not show cards.Bets: 1. Collects: 0. Loses: 1.
Game ended at: 2016/11/29 15:10:44

Game started
Game ID: 787022178 0.25/0.50 (PRR) Garuda - 3 (Hold'em)
Seat 9 is the button
Seat 1: choiCES (62.92).
Seat 2: hoocher (60.37).
Seat 3: Parcker (115.03).
Seat 4: IlxxxlI (20).
Seat 5: VamosRafaFTW (48.25).
Seat 6: dankmann (95.06).
Seat 7: BlueSmoke (49.14).
Seat 9: Spagetti1 (50).
Player choiCES has small blind (0.25)
Player hoocher has big blind (0.50)
Player IlxxxlI received card: [10c]
Player IlxxxlI received card: [4h]
Player Parcker folds
Player IlxxxlI folds
Player VamosRafaFTW folds
Player dankmann folds
Player BlueSmoke raises (1.44)
Player Spagetti1 raises (5)
Player choiCES folds
Player hoocher folds
Player BlueSmoke folds
Uncalled bet (3.56) returned to Spagetti1
Player Spagetti1 mucks cards
------ Summary ------
Pot: 3.63. Rake 0
Player choiCES does not show cards.Bets: 0.25. Collects: 0. Loses: 0.25.
Player hoocher does not show cards.Bets: 0.50. Collects: 0. Loses: 0.50.
Player Parcker does not show cards.Bets: 0. Collects: 0. Wins: 0.
Player IlxxxlI does not show cards.Bets: 0. Collects: 0. Wins: 0.
Player VamosRafaFTW does not show cards.Bets: 0. Collects: 0. Wins: 0.
Player dankmann does not show cards.Bets: 0. Collects: 0. Wins: 0.
Player BlueSmoke does not show cards.Bets: 1.44. Collects: 0. Loses: 1.44.
*Player Spagetti1 mucks (does not show cards). Bets: 1.44. Collects: 3.63. Wins: 2.19.
Game ended at: 2016/11/29 15:10:1

Game started
Game ID: 787022055 0.50/1 (PRR) Karkadann (Hold'em)
Seat 6 is the button
Seat 1: StephCurry (103.28).
Seat 2: PANDAisEVIL (104.64).
Seat 3: AironVega (100).
Seat 4: IlxxxlI (40).
Seat 5: pineapplesand (40).
Seat 6: dankmann (209.02).
Seat 7: ElvenEyes (110.80).
Seat 8: gust (48.50).
Seat 9: VegetablesArentYummy (275.59).
Player ElvenEyes has small blind (0.50)
Player gust has big blind (1)
Player IlxxxlI received card: [3h]
Player IlxxxlI received card: [Jc]
Player VegetablesArentYummy folds
Player StephCurry folds
Player PANDAisEVIL folds
Player AironVega folds
Player IlxxxlI folds
Player pineapplesand folds
Player dankmann raises (3)
Player ElvenEyes folds
Player gust folds
Uncalled bet (2) returned to dankmann
Player dankmann mucks cards
------ Summary ------
Pot: 2.50. Rake 0
Player StephCurry does not show cards.Bets: 0. Collects: 0. Wins: 0.
Player PANDAisEVIL does not show cards.Bets: 0. Collects: 0. Wins: 0.
Player AironVega does not show cards.Bets: 0. Collects: 0. Wins: 0.
Player IlxxxlI does not show cards.Bets: 0. Collects: 0. Wins: 0.
Player pineapplesand does not show cards.Bets: 0. Collects: 0. Wins: 0.
*Player dankmann mucks (does not show cards). Bets: 1. Collects: 2.50. Wins: 1.50.
Player ElvenEyes does not show cards.Bets: 0.50. Collects: 0. Loses: 0.50.
Player gust does not show cards.Bets: 1. Collects: 0. Loses: 1.
Player VegetablesArentYummy does not show cards.Bets: 0. Collects: 0. Wins: 0.
Game ended at: 2016/11/29 15:10:18

Game started
Game ID: 787021975 0.25/0.50 (PRR) Gorgons (Cap) - 2 (Hold'em)
Seat 6 is the button
Seat 1: cuervo_ (19.50).
Seat 2: IlxxxlI (20).
Seat 3: jjeannin1 (38.92).
Seat 4: trader063 (34.97).
Seat 5: Parcker (85.93).
Seat 6: Jui Kuen (76.78).
Player cuervo_ has small blind (0.25)
Player IlxxxlI has big blind (0.50)
Player IlxxxlI received card: [6d]
Player IlxxxlI received card: [9h]
Player jjeannin1 calls (0.50)
Player trader063 folds
Player Parcker folds
Player Jui Kuen folds
Player cuervo_ calls (0.25)
Player IlxxxlI checks
*** FLOP ***: [6h 7s 6c]
Player cuervo_ checks
Player IlxxxlI checks
Player jjeannin1 bets (2)
Player cuervo_ calls (2)
Player IlxxxlI calls (2)
*** TURN ***: [6h 7s 6c] [Kd]
Player cuervo_ checks
Player IlxxxlI checks
Player jjeannin1 caps (12.50)
Player cuervo_ folds
Player IlxxxlI calls (12.50)
*** RIVER ***: [6h 7s 6c Kd] [3h]
------ Summary ------
Pot: 30.88. Rake 1.38. JP fee 0.24
Board: [6h 7s 6c Kd 3h]
Player cuervo_ does not show cards.Bets: 2.50. Collects: 0. Loses: 2.50.
*Player IlxxxlI shows: Three Of Kind of 6s [6d 9h]. Bets: 15. Collects: 30.88. Wins: 15.88.
Player jjeannin1 shows: Two pairs. 6s and 4s [4d 4h]. Bets: 15. Collects: 0. Loses: 15.
Player trader063 does not show cards.Bets: 0. Collects: 0. Wins: 0.
Player Parcker does not show cards.Bets: 0. Collects: 0. Wins: 0.
Player Jui Kuen does not show cards.Bets: 0. Collects: 0. Wins: 0.
Game ended at: 2016/11/29 15:9:44

Game started
Game ID: 787021917 0.25/0.50 (PRR) Garuda - 3 (Hold'em)
Seat 7 is the button
Seat 1: choiCES (64.36).
Seat 2: hoocher (60.37).
Seat 3: Parcker (115.03).
Seat 4: IlxxxlI (20).
Seat 5: VamosRafaFTW (48.25).
Seat 6: dankmann (95.06).
Seat 7: BlueSmoke (47.60).
Seat 9: Spagetti1 (50.13).
Player Spagetti1 has small blind (0.25)
Player choiCES has big blind (0.50)
Player IlxxxlI received card: [Qd]
Player IlxxxlI received card: [4h]
Player hoocher folds
Player Parcker folds
Player IlxxxlI folds
Player VamosRafaFTW folds
Player dankmann folds
Player BlueSmoke raises (1.44)
Player Spagetti1 folds
Player choiCES calls (0.94)
*** FLOP ***: [Jh Ac 4c]
Player choiCES checks
Player BlueSmoke bets (2.24)
Player choiCES folds
Uncalled bet (2.24) returned to BlueSmoke
Player BlueSmoke mucks cards
------ Summary ------
Pot: 2.98. Rake 0.11. JP fee 0.04
Board: [Jh Ac 4c]
Player choiCES does not show cards.Bets: 1.44. Collects: 0. Loses: 1.44.
Player hoocher does not show cards.Bets: 0. Collects: 0. Wins: 0.
Player Parcker does not show cards.Bets: 0. Collects: 0. Wins: 0.
Player IlxxxlI does not show cards.Bets: 0. Collects: 0. Wins: 0.
Player VamosRafaFTW does not show cards.Bets: 0. Collects: 0. Wins: 0.
Player dankmann does not show cards.Bets: 0. Collects: 0. Wins: 0.
*Player BlueSmoke mucks (does not show cards). Bets: 1.44. Collects: 2.98. Wins: 1.54.
Player Spagetti1 does not show cards.Bets: 0.25. Collects: 0. Loses: 0.25.
Game ended at: 2016/11/29 15:9:21

Game started
Game ID: 787021889 0.50/1 (PRR) Kraken - 20 (Hold'em)
Seat 2 is the button
Seat 1: AironVega (101.23).
Seat 2: ali23imsirovic (137.98).
Seat 4: WeakAndWeary (106.99).
Seat 5: IlxxxlI (40).
Seat 6: aleks0v (100).
Player WeakAndWeary has small blind (0.50)
Player IlxxxlI has big blind (1)
Player IlxxxlI received card: [10d]
Player IlxxxlI received card: [Qc]
Player aleks0v folds
Player AironVega folds
Player ali23imsirovic raises (3)
Player WeakAndWeary folds
Player IlxxxlI calls (2)
*** FLOP ***: [4d Ac 6c]
Player IlxxxlI checks
Player ali23imsirovic bets (2.06)
Player IlxxxlI folds
Uncalled bet (2.06) returned to ali23imsirovic
Player ali23imsirovic mucks cards
------ Summary ------
Pot: 6.18. Rake 0.22. JP fee 0.10
Board: [4d Ac 6c]
Player AironVega does not show cards.Bets: 0. Collects: 0. Wins: 0.
*Player ali23imsirovic mucks (does not show cards). Bets: 3. Collects: 6.18. Wins: 3.18.
Player WeakAndWeary does not show cards.Bets: 0.50. Collects: 0. Loses: 0.50.
Player IlxxxlI does not show cards.Bets: 3. Collects: 0. Loses: 3.
Player aleks0v does not show cards.Bets: 0. Collects: 0. Wins: 0.
Game ended at: 2016/11/29 15:9:36

Game started
Game ID: 787021775 0.25/0.50 (PRR) Gorgons (Cap) - 2 (Hold'em)
Seat 5 is the button
Seat 1: cuervo_ (20).
Seat 2: IlxxxlI (20).
Seat 3: jjeannin1 (39.42).
Seat 4: trader063 (35.47).
Seat 5: Parcker (85.93).
Seat 6: Jui Kuen (75.28).
Player Jui Kuen has small blind (0.25)
Player cuervo_ has big blind (0.50)
Player IlxxxlI received card: [Jh]
Player IlxxxlI received card: [6s]
Player IlxxxlI folds
Player jjeannin1 calls (0.50)
Player trader063 calls (0.50)
Player Parcker folds
Player Jui Kuen caps (14.75)
Player cuervo_ folds
Player jjeannin1 folds
Player trader063 folds
Uncalled bet (14.50) returned to Jui Kuen
Player Jui Kuen mucks cards
------ Summary ------
Pot: 2. Rake 0
Player cuervo_ does not show cards.Bets: 0.50. Collects: 0. Loses: 0.50.
Player IlxxxlI does not show cards.Bets: 0. Collects: 0. Wins: 0.
Player jjeannin1 does not show cards.Bets: 0.50. Collects: 0. Loses: 0.50.
Player trader063 does not show cards.Bets: 0.50. Collects: 0. Loses: 0.50.
Player Parcker does not show cards.Bets: 0. Collects: 0. Wins: 0.
*Player Jui Kuen mucks (does not show cards). Bets: 0.50. Collects: 2. Wins: 1.50.
Game ended at: 2016/11/29 15:8:44

Game started
Game ID: 787021649 0.25/0.50 (PRR) Garuda - 3 (Hold'em)
Seat 6 is the button
Seat 1: choiCES (58.61).
Seat 2: hoocher (61.87).
Seat 3: Parcker (115.03).
Seat 4: IlxxxlI (20.75).
Seat 5: VamosRafaFTW (48.25).
Seat 6: dankmann (95.06).
Seat 7: BlueSmoke (47.85).
Seat 8: gorillaman68 (55.88).
Seat 9: Spagetti1 (50.63).
Player BlueSmoke has small blind (0.25)
Player gorillaman68 sitting out
Player Spagetti1 has big blind (0.50)
Player IlxxxlI received card: [Ad]
Player IlxxxlI received card: [Qd]
Player choiCES raises (1.50)
Player hoocher calls (1.50)
Player Parcker folds
Player IlxxxlI raises (3.50)
Player VamosRafaFTW folds
Player dankmann folds
Player BlueSmoke folds
Player Spagetti1 folds
Player choiCES raises (8)
Player hoocher folds
Player IlxxxlI folds
Uncalled bet (6) returned to choiCES
Player choiCES mucks cards
------ Summary ------
Pot: 9.25. Rake 0
*Player choiCES mucks (does not show cards). Bets: 3.50. Collects: 9.25. Wins: 5.75.
Player hoocher does not show cards.Bets: 1.50. Collects: 0. Loses: 1.50.
Player Parcker does not show cards.Bets: 0. Collects: 0. Wins: 0.
Player IlxxxlI does not show cards.Bets: 3.50. Collects: 0. Loses: 3.50.
Player VamosRafaFTW does not show cards.Bets: 0. Collects: 0. Wins: 0.
Player dankmann does not show cards.Bets: 0. Collects: 0. Wins: 0.
Player BlueSmoke does not show cards.Bets: 0.25. Collects: 0. Loses: 0.25.
Player gorillaman68 does not show cards.Bets: 0. Collects: 0. Wins: 0.
Player Spagetti1 does not show cards.Bets: 0.50. Collects: 0. Loses: 0.50.
Game ended at: 2016/11/29 15:8:33

Game started
Game ID: 787021435 0.25/0.50 (PRR) Garuda - 3 (Hold'em)
Seat 5 is the button
Seat 1: choiCES (58.61).
Seat 2: hoocher (61.87).
Seat 3: Parcker (115.03).
Seat 4: IlxxxlI (20.75).
Seat 5: VamosRafaFTW (48.25).
Seat 6: dankmann (95.31).
Seat 7: BlueSmoke (49.35).
Seat 8: gorillaman68 (54.29).
Seat 9: Spagetti1 (50.63).
Player dankmann has small blind (0.25)
Player BlueSmoke has big blind (0.50)
Player IlxxxlI received card: [9h]
Player IlxxxlI received card: [As]
Player gorillaman68 raises (1.50)
Player Spagetti1 folds
Player choiCES folds
Player hoocher folds
Player Parcker folds
Player IlxxxlI folds
Player VamosRafaFTW folds
Player dankmann folds
Player BlueSmoke calls (1)
*** FLOP ***: [4s 4h 3c]
Player BlueSmoke checks
Player gorillaman68 bets (1.50)
Player BlueSmoke folds
Uncalled bet (1.50) returned to gorillaman68
Player gorillaman68 mucks cards
------ Summary ------
Pot: 3.09. Rake 0.12. JP fee 0.04
Board: [4s 4h 3c]
Player choiCES does not show cards.Bets: 0. Collects: 0. Wins: 0.
Player hoocher does not show cards.Bets: 0. Collects: 0. Wins: 0.
Player Parcker does not show cards.Bets: 0. Collects: 0. Wins: 0.
Player IlxxxlI does not show cards.Bets: 0. Collects: 0. Wins: 0.
Player VamosRafaFTW does not show cards.Bets: 0. Collects: 0. Wins: 0.
Player dankmann does not show cards.Bets: 0.25. Collects: 0. Loses: 0.25.
Player BlueSmoke does not show cards.Bets: 1.50. Collects: 0. Loses: 1.50.
*Player gorillaman68 mucks (does not show cards). Bets: 1.50. Collects: 3.09. Wins: 1.59.
Player Spagetti1 does not show cards.Bets: 0. Collects: 0. Wins: 0.
Game ended at: 2016/11/29 15:7:47

Game started
Game ID: 787021407 0.25/0.50 (PRR) Garuda - 4 (Hold'em)
Seat 9 is the button
Seat 2: dankmann (101.21).
Seat 3: kid4life (113.59).
Seat 4: DRofBooya (45.94).
Seat 5: wvlax1425 (52.04).
Seat 6: Spagetti1 (50.76).
Seat 7: IlxxxlI (20).
Seat 8: haroldbb (54.88).
Seat 9: Korobochka (101.70).
Player dankmann has small blind (0.25)
Player kid4life has big blind (0.50)
Player IlxxxlI received card: [2s]
Player IlxxxlI received card: [3s]
Player DRofBooya folds
Player wvlax1425 folds
Player Spagetti1 folds
Player IlxxxlI folds
Player haroldbb raises (1)
Player Korobochka calls (1)
Player dankmann folds
Player kid4life raises (4.50)
Player haroldbb raises (12)
Player Korobochka folds
Player kid4life calls (8)
*** FLOP ***: [10c 6c 4h]
Player kid4life checks
Player haroldbb checks
*** TURN ***: [10c 6c 4h] [9s]
Player kid4life checks
Player haroldbb checks
*** RIVER ***: [10c 6c 4h 9s] [Ad]
Player kid4life checks
Player haroldbb bets (8.63)
Player kid4life calls (8.63)
------ Summary ------
Pot: 42.29. Rake 1.98. JP fee 0.24
Board: [10c 6c 4h 9s Ad]
Player dankmann does not show cards.Bets: 0.25. Collects: 0. Loses: 0.25.
*Player kid4life shows: One pair of As [Qh Ah]. Bets: 21.63. Collects: 21.14. Loses: 0.49.
Player DRofBooya does not show cards.Bets: 0. Collects: 0. Wins: 0.
Player wvlax1425 does not show cards.Bets: 0. Collects: 0. Wins: 0.
Player Spagetti1 does not show cards.Bets: 0. Collects: 0. Wins: 0.
Player IlxxxlI does not show cards.Bets: 0. Collects: 0. Wins: 0.
*Player haroldbb shows: One pair of As [As Qc]. Bets: 21.63. Collects: 21.15. Loses: 0.48.
Player Korobochka does not show cards.Bets: 1. Collects: 0. Loses: 1.
Game ended at: 2016/11/29 15:9:39

Game started
Game ID: 787021203 0.25/0.50 (PRR) Garuda - 4 (Hold'em)
Seat 8 is the button
Seat 1: gorillaman68 (53.77).
Seat 2: dankmann (101.71).
Seat 3: kid4life (113.59).
Seat 4: DRofBooya (45.94).
Seat 5: wvlax1425 (52.04).
Seat 6: Spagetti1 (50.01).
Seat 7: IlxxxlI (20).
Seat 8: haroldbb (54.88).
Seat 9: Korobochka (101.95).
Player Korobochka has small blind (0.25)
Player gorillaman68 sitting out
Player dankmann has big blind (0.50)
Player IlxxxlI received card: [10h]
Player IlxxxlI received card: [8d]
Player kid4life folds
Player DRofBooya folds
Player wvlax1425 folds
Player Spagetti1 raises (1.50)
Player IlxxxlI folds
Player haroldbb folds
Player Korobochka folds
Player dankmann folds
Uncalled bet (1) returned to Spagetti1
Player Spagetti1 mucks cards
------ Summary ------
Pot: 1.25. Rake 0
Player gorillaman68 does not show cards.Bets: 0. Collects: 0. Wins: 0.
Player dankmann does not show cards.Bets: 0.50. Collects: 0. Loses: 0.50.
Player kid4life does not show cards.Bets: 0. Collects: 0. Wins: 0.
Player DRofBooya does not show cards.Bets: 0. Collects: 0. Wins: 0.
Player wvlax1425 does not show cards.Bets: 0. Collects: 0. Wins: 0.
*Player Spagetti1 mucks (does not show cards). Bets: 0.50. Collects: 1.25. Wins: 0.75.
Player IlxxxlI does not show cards.Bets: 0. Collects: 0. Wins: 0.
Player haroldbb does not show cards.Bets: 0. Collects: 0. Wins: 0.
Player Korobochka does not show cards.Bets: 0.25. Collects: 0. Loses: 0.25.
Game ended at: 2016/11/29 15:7:4

Game started
Game ID: 787021174 0.50/1 (PRR) Karkadann (Hold'em)
Seat 5 is the button
Seat 1: StephCurry (103.28).
Seat 2: PANDAisEVIL (104.64).
Seat 3: AironVega (102.70).
Seat 4: IlxxxlI (40).
Seat 5: pineapplesand (40).
Seat 6: dankmann (209.52).
Seat 7: ElvenEyes (111.80).
Seat 8: gust (48.50).
Seat 9: VegetablesArentYummy (260.19).
Player dankmann has small blind (0.50)
Player ElvenEyes has big blind (1)
Player IlxxxlI received card: [8c]
Player IlxxxlI received card: [8h]
Player gust folds
Player VegetablesArentYummy raises (2.50)
Player StephCurry folds
Player PANDAisEVIL folds
Player AironVega raises (9.25)
Player IlxxxlI folds
Player pineapplesand folds
Player dankmann folds
Player ElvenEyes folds
Player VegetablesArentYummy calls (6.75)
*** FLOP ***: [5c 3h 6s]
Player VegetablesArentYummy checks
Player AironVega bets (6.27)
Player VegetablesArentYummy calls (6.27)
*** TURN ***: [5c 3h 6s] [2d]
Player VegetablesArentYummy checks
Player AironVega checks
*** RIVER ***: [5c 3h 6s 2d] [10h]
Player VegetablesArentYummy checks
Player AironVega checks
Player AironVega mucks cards
------ Summary ------
Pot: 30.92. Rake 1.38. JP fee 0.24
Board: [5c 3h 6s 2d 10h]
Player StephCurry does not show cards.Bets: 0. Collects: 0. Wins: 0.
Player PANDAisEVIL does not show cards.Bets: 0. Collects: 0. Wins: 0.
Player AironVega mucks (does not show cards). Bets: 15.52. Collects: 0. Loses: 15.52.
Player IlxxxlI does not show cards.Bets: 0. Collects: 0. Wins: 0.
Player pineapplesand does not show cards.Bets: 0. Collects: 0. Wins: 0.
Player dankmann does not show cards.Bets: 0.50. Collects: 0. Loses: 0.50.
Player ElvenEyes does not show cards.Bets: 1. Collects: 0. Loses: 1.
Player gust does not show cards.Bets: 0. Collects: 0. Wins: 0.
*Player VegetablesArentYummy shows: One pair of 9s [9c 9h]. Bets: 15.52. Collects: 30.92. Wins: 15.40.
Game ended at: 2016/11/29 15:8:58

Game started
Game ID: 787021151 0.25/0.50 (PRR) Garuda - 3 (Hold'em)
Seat 4 is the button
Seat 1: choiCES (58.61).
Seat 2: hoocher (61.87).
Seat 3: Parcker (115.03).
Seat 4: IlxxxlI (20.75).
Seat 5: VamosRafaFTW (48.50).
Seat 6: dankmann (95.81).
Seat 7: BlueSmoke (48.66).
Seat 8: gorillaman68 (54.29).
Seat 9: Spagetti1 (50.63).
Player VamosRafaFTW has small blind (0.25)
Player dankmann has big blind (0.50)
Player IlxxxlI received card: [Kd]
Player IlxxxlI received card: [4c]
Player BlueSmoke calls (0.50)
Player gorillaman68 folds
Player Spagetti1 folds
Player choiCES folds
Player hoocher folds
Player Parcker folds
Player IlxxxlI folds
Player VamosRafaFTW folds
Player dankmann checks
*** FLOP ***: [Kh 7s 2d]
Player dankmann checks
Player BlueSmoke bets (0.89)
Player dankmann folds
Uncalled bet (0.89) returned to BlueSmoke
Player BlueSmoke mucks cards
------ Summary ------
Pot: 1.19. Rake 0.04. JP fee 0.02
Board: [Kh 7s 2d]
Player choiCES does not show cards.Bets: 0. Collects: 0. Wins: 0.
Player hoocher does not show cards.Bets: 0. Collects: 0. Wins: 0.
Player Parcker does not show cards.Bets: 0. Collects: 0. Wins: 0.
Player IlxxxlI does not show cards.Bets: 0. Collects: 0. Wins: 0.
Player VamosRafaFTW does not show cards.Bets: 0.25. Collects: 0. Loses: 0.25.
Player dankmann does not show cards.Bets: 0.50. Collects: 0. Loses: 0.50.
*Player BlueSmoke mucks (does not show cards). Bets: 0.50. Collects: 1.19. Wins: 0.69.
Player gorillaman68 does not show cards.Bets: 0. Collects: 0. Wins: 0.
Player Spagetti1 does not show cards.Bets: 0. Collects: 0. Wins: 0.
Game ended at: 2016/11/29 15:7:9

Game started
Game ID: 787021150 0.25/0.50 (PRR) Gorgons (Cap) - 2 (Hold'em)
Seat 4 is the button
Seat 2: IlxxxlI (20).
Seat 3: jjeannin1 (41.92).
Seat 4: trader063 (35.47).
Seat 5: Parcker (83.20).
Seat 6: Jui Kuen (75.78).
Player Parcker has small blind (0.25)
Player Jui Kuen has big blind (0.50)
Player IlxxxlI received card: [8c]
Player IlxxxlI received card: [Js]
Player IlxxxlI folds
Player jjeannin1 calls (0.50)
Player trader063 folds
Player Parcker calls (0.25)
Player Jui Kuen checks
*** FLOP ***: [7c 6c 5s]
Player Parcker checks
Player Jui Kuen is timed out.
Player Jui Kuen checks
Player jjeannin1 checks
*** TURN ***: [7c 6c 5s] [9h]
Player Parcker checks
Player Jui Kuen checks
Player jjeannin1 checks
*** RIVER ***: [7c 6c 5s 9h] [4c]
Player Parcker checks
Player Jui Kuen checks
Player jjeannin1 bets (2)
Player Parcker calls (2)
Player Jui Kuen folds
------ Summary ------
Pot: 5.23. Rake 0.19. JP fee 0.08
Board: [7c 6c 5s 9h 4c]
Player IlxxxlI does not show cards.Bets: 0. Collects: 0. Wins: 0.
Player jjeannin1 shows: High card K [Qd Ks]. Bets: 2.50. Collects: 0. Loses: 2.50.
Player trader063 does not show cards.Bets: 0. Collects: 0. Wins: 0.
*Player Parcker shows: Straight to 7 [3c 3s]. Bets: 2.50. Collects: 5.23. Wins: 2.73.
Player Jui Kuen does not show cards.Bets: 0.50. Collects: 0. Loses: 0.50.
Game ended at: 2016/11/29 15:8:7

Game started
Game ID: 787021027 0.25/0.50 (PRR) Garuda - 4 (Hold'em)
Seat 7 is the button
Seat 1: gorillaman68 (53.77).
Seat 2: dankmann (101.71).
Seat 3: kid4life (113.59).
Seat 4: DRofBooya (45.19).
Seat 5: wvlax1425 (52.04).
Seat 6: Spagetti1 (50.01).
Seat 7: IlxxxlI (20).
Seat 8: haroldbb (55.13).
Seat 9: Korobochka (102.45).
Player haroldbb has small blind (0.25)
Player Korobochka has big blind (0.50)
Player IlxxxlI received card: [Qh]
Player IlxxxlI received card: [5s]
Player gorillaman68 folds
Player dankmann folds
Player kid4life folds
Player DRofBooya raises (1.50)
Player wvlax1425 folds
Player Spagetti1 folds
Player IlxxxlI folds
Player haroldbb folds
Player Korobochka folds
Uncalled bet (1) returned to DRofBooya
Player DRofBooya mucks cards
------ Summary ------
Pot: 1.25. Rake 0
Player gorillaman68 does not show cards.Bets: 0. Collects: 0. Wins: 0.
Player dankmann does not show cards.Bets: 0. Collects: 0. Wins: 0.
Player kid4life does not show cards.Bets: 0. Collects: 0. Wins: 0.
*Player DRofBooya mucks (does not show cards). Bets: 0.50. Collects: 1.25. Wins: 0.75.
Player wvlax1425 does not show cards.Bets: 0. Collects: 0. Wins: 0.
Player Spagetti1 does not show cards.Bets: 0. Collects: 0. Wins: 0.
Player IlxxxlI does not show cards.Bets: 0. Collects: 0. Wins: 0.
Player haroldbb does not show cards.Bets: 0.25. Collects: 0. Loses: 0.25.
Player Korobochka does not show cards.Bets: 0.50. Collects: 0. Loses: 0.50.
Game ended at: 2016/11/29 15:6:27

Game started
Game ID: 787020894 0.25/0.50 (PRR) Gorgons (Cap) - 2 (Hold'em)
Seat 3 is the button
Seat 2: IlxxxlI (20).
Seat 3: jjeannin1 (40.78).
Seat 4: trader063 (35.72).
Seat 5: Parcker (84.20).
Seat 6: Jui Kuen (75.78).
Player trader063 has small blind (0.25)
Player Parcker has big blind (0.50)
Player IlxxxlI received card: [4h]
Player IlxxxlI received card: [Ac]
Player Jui Kuen folds
Player IlxxxlI folds
Player jjeannin1 raises (1)
Player trader063 folds
Player Parcker calls (0.50)
*** FLOP ***: [8h Jc 6c]
Player Parcker checks
Player jjeannin1 bets (1)
Player Parcker folds
Uncalled bet (1) returned to jjeannin1
Player jjeannin1 mucks cards
------ Summary ------
Pot: 2.14. Rake 0.09. JP fee 0.02
Board: [8h Jc 6c]
Player IlxxxlI does not show cards.Bets: 0. Collects: 0. Wins: 0.
*Player jjeannin1 mucks (does not show cards). Bets: 1. Collects: 2.14. Wins: 1.14.
Player trader063 does not show cards.Bets: 0.25. Collects: 0. Loses: 0.25.
Player Parcker does not show cards.Bets: 1. Collects: 0. Loses: 1.
Player Jui Kuen does not show cards.Bets: 0. Collects: 0. Wins: 0.
Game ended at: 2016/11/29 15:6:19

Game started
Game ID: 787020853 0.25/0.50 (PRR) Garuda - 4 (Hold'em)
Seat 6 is the button
Seat 1: gorillaman68 (53.77).
Seat 2: dankmann (101.71).
Seat 3: kid4life (113.59).
Seat 4: DRofBooya (45.19).
Seat 5: wvlax1425 (52.04).
Seat 6: Spagetti1 (50.01).
Seat 7: IlxxxlI (20).
Seat 8: haroldbb (54.88).
Seat 9: Korobochka (102.45).
Player IlxxxlI has small blind (0.25)
Player haroldbb has big blind (0.50)
Player IlxxxlI received card: [Qd]
Player IlxxxlI received card: [7h]
Player Korobochka folds
Player gorillaman68 folds
Player dankmann folds
Player kid4life folds
Player DRofBooya folds
Player wvlax1425 folds
Player Spagetti1 folds
Player IlxxxlI folds
Uncalled bet (0.25) returned to haroldbb
Player haroldbb mucks cards
------ Summary ------
Pot: 0.50. Rake 0
Player gorillaman68 does not show cards.Bets: 0. Collects: 0. Wins: 0.
Player dankmann does not show cards.Bets: 0. Collects: 0. Wins: 0.
Player kid4life does not show cards.Bets: 0. Collects: 0. Wins: 0.
Player DRofBooya does not show cards.Bets: 0. Collects: 0. Wins: 0.
Player wvlax1425 does not show cards.Bets: 0. Collects: 0. Wins: 0.
Player Spagetti1 does not show cards.Bets: 0. Collects: 0. Wins: 0.
Player IlxxxlI does not show cards.Bets: 0.25. Collects: 0. Loses: 0.25.
*Player haroldbb mucks (does not show cards). Bets: 0.25. Collects: 0.50. Wins: 0.25.
Player Korobochka does not show cards.Bets: 0. Collects: 0. Wins: 0.
Game ended at: 2016/11/29 15:5:57

Game started
Game ID: 787020820 0.25/0.50 (PRR) Garuda - 3 (Hold'em)
Seat 3 is the button
Seat 1: choiCES (55.59).
Seat 2: hoocher (61.87).
Seat 3: Parcker (116.53).
Seat 4: IlxxxlI (21).
Seat 5: VamosRafaFTW (50).
Seat 6: dankmann (95.81).
Seat 7: BlueSmoke (48.66).
Seat 8: gorillaman68 (54.29).
Seat 9: Spagetti1 (50.63).
Player IlxxxlI has small blind (0.25)
Player VamosRafaFTW has big blind (0.50)
Player IlxxxlI received card: [5h]
Player IlxxxlI received card: [2s]
Player dankmann folds
Player BlueSmoke folds
Player gorillaman68 folds
Player Spagetti1 folds
Player choiCES raises (1.50)
Player hoocher folds
Player Parcker calls (1.50)
Player IlxxxlI folds
Player VamosRafaFTW calls (1)
*** FLOP ***: [7h 4h Js]
Player VamosRafaFTW checks
Player choiCES bets (2.26)
Player Parcker folds
Player VamosRafaFTW folds
Uncalled bet (2.26) returned to choiCES
Player choiCES mucks cards
------ Summary ------
Pot: 4.52. Rake 0.17. JP fee 0.06
Board: [7h 4h Js]
*Player choiCES mucks (does not show cards). Bets: 1.50. Collects: 4.52. Wins: 3.02.
Player hoocher does not show cards.Bets: 0. Collects: 0. Wins: 0.
Player Parcker does not show cards.Bets: 1.50. Collects: 0. Loses: 1.50.
Player IlxxxlI does not show cards.Bets: 0.25. Collects: 0. Loses: 0.25.
Player VamosRafaFTW does not show cards.Bets: 1.50. Collects: 0. Loses: 1.50.
Player dankmann does not show cards.Bets: 0. Collects: 0. Wins: 0.
Player BlueSmoke does not show cards.Bets: 0. Collects: 0. Wins: 0.
Player gorillaman68 does not show cards.Bets: 0. Collects: 0. Wins: 0.
Player Spagetti1 does not show cards.Bets: 0. Collects: 0. Wins: 0.
Game ended at: 2016/11/29 15:6:19

Game started
Game ID: 787020808 0.50/1 (PRR) Karkadann (Hold'em)
Seat 4 is the button
Seat 1: StephCurry (103.28).
Seat 2: PANDAisEVIL (104.64).
Seat 3: AironVega (102.70).
Seat 4: IlxxxlI (40).
Seat 5: pineapplesand (40).
Seat 6: dankmann (210.52).
Seat 7: ElvenEyes (111.80).
Seat 8: gust (48.50).
Seat 9: VegetablesArentYummy (258.69).
Player pineapplesand has small blind (0.50)
Player dankmann has big blind (1)
Player IlxxxlI received card: [3s]
Player IlxxxlI received card: [9h]
Player ElvenEyes folds
Player gust folds
Player VegetablesArentYummy raises (2.50)
Player StephCurry folds
Player PANDAisEVIL folds
Player AironVega folds
Player IlxxxlI folds
Player pineapplesand folds
Player dankmann folds
Uncalled bet (1.50) returned to VegetablesArentYummy
Player VegetablesArentYummy mucks cards
------ Summary ------
Pot: 2.50. Rake 0
Player StephCurry does not show cards.Bets: 0. Collects: 0. Wins: 0.
Player PANDAisEVIL does not show cards.Bets: 0. Collects: 0. Wins: 0.
Player AironVega does not show cards.Bets: 0. Collects: 0. Wins: 0.
Player IlxxxlI does not show cards.Bets: 0. Collects: 0. Wins: 0.
Player pineapplesand does not show cards.Bets: 0.50. Collects: 0. Loses: 0.50.
Player dankmann does not show cards.Bets: 1. Collects: 0. Loses: 1.
Player ElvenEyes does not show cards.Bets: 0. Collects: 0. Wins: 0.
Player gust does not show cards.Bets: 0. Collects: 0. Wins: 0.
*Player VegetablesArentYummy mucks (does not show cards). Bets: 1. Collects: 2.50. Wins: 1.50.
Game ended at: 2016/11/29 15:6:22

Game started
Game ID: 787020651 1/2 (PRR) Lakhey (Short) - 2 (Hold'em)
Seat 3 is the button
Seat 1: AironVega (140.05).
Seat 2: IlxxxlI (56.30).
Seat 3: VegetablesArentYummy (152.40).
Seat 5: aleks0v (134.72).
Seat 6: anarkopoker (100).
Player aleks0v has small blind (1)
Player anarkopoker has big blind (2)
Player IlxxxlI received card: [6h]
Player IlxxxlI received card: [Qs]
Player AironVega folds
Player IlxxxlI folds
Player VegetablesArentYummy raises (5)
Player aleks0v folds
Player anarkopoker folds
Uncalled bet (3) returned to VegetablesArentYummy
Player VegetablesArentYummy mucks cards
------ Summary ------
Pot: 5. Rake 0
Player AironVega does not show cards.Bets: 0. Collects: 0. Wins: 0.
Player IlxxxlI does not show cards.Bets: 0. Collects: 0. Wins: 0.
*Player VegetablesArentYummy mucks (does not show cards). Bets: 2. Collects: 5. Wins: 3.
Player aleks0v does not show cards.Bets: 1. Collects: 0. Loses: 1.
Player anarkopoker does not show cards.Bets: 2. Collects: 0. Loses: 2.
Game ended at: 2016/11/29 15:5:39

Game started
Game ID: 787020603 0.25/0.50 (PRR) Garuda - 3 (Hold'em)
Seat 2 is the button
Seat 1: choiCES (55.59).
Seat 2: hoocher (61.87).
Seat 3: Parcker (116.78).
Seat 4: IlxxxlI (20.75).
Seat 6: dankmann (95.81).
Seat 7: BlueSmoke (48.66).
Seat 8: gorillaman68 (54.29).
Seat 9: Spagetti1 (50.63).
Player Parcker has small blind (0.25)
Player IlxxxlI has big blind (0.50)
Player IlxxxlI received card: [9h]
Player IlxxxlI received card: [Js]
Player dankmann folds
Player BlueSmoke folds
Player gorillaman68 folds
Player Spagetti1 folds
Player choiCES folds
Player hoocher folds
Player Parcker folds
Uncalled bet (0.25) returned to IlxxxlI
Player IlxxxlI mucks cards
------ Summary ------
Pot: 0.50. Rake 0
Player choiCES does not show cards.Bets: 0. Collects: 0. Wins: 0.
Player hoocher does not show cards.Bets: 0. Collects: 0. Wins: 0.
Player Parcker does not show cards.Bets: 0.25. Collects: 0. Loses: 0.25.
*Player IlxxxlI mucks (does not show cards). Bets: 0.25. Collects: 0.50. Wins: 0.25.
Player dankmann does not show cards.Bets: 0. Collects: 0. Wins: 0.
Player BlueSmoke does not show cards.Bets: 0. Collects: 0. Wins: 0.
Player gorillaman68 does not show cards.Bets: 0. Collects: 0. Wins: 0.
Player Spagetti1 does not show cards.Bets: 0. Collects: 0. Wins: 0.
Game ended at: 2016/11/29 15:5:23

Game started
Game ID: 787020558 0.25/0.50 (PRR) Gorgons (Cap) - 2 (Hold'em)
Seat 2 is the button
Seat 2: IlxxxlI (20).
Seat 3: jjeannin1 (41.03).
Seat 4: trader063 (30.04).
Seat 5: Parcker (84.20).
Seat 6: Jui Kuen (81.82).
Player jjeannin1 has small blind (0.25)
Player trader063 has big blind (0.50)
Player IlxxxlI received card: [9d]
Player IlxxxlI received card: [2d]
Player Parcker folds
Player Jui Kuen raises (1.50)
Player IlxxxlI folds
Player jjeannin1 folds
Player trader063 calls (1)
*** FLOP ***: [4h 4c 2h]
Player trader063 checks
Player Jui Kuen bets (1.54)
Player trader063 calls (1.54)
*** TURN ***: [4h 4c 2h] [As]
Player trader063 checks
Player Jui Kuen bets (3)
Player trader063 calls (3)
*** RIVER ***: [4h 4c 2h As] [Jh]
Player trader063 checks
Player Jui Kuen checks
------ Summary ------
Pot: 11.72. Rake 0.41. JP fee 0.20
Board: [4h 4c 2h As Jh]
Player IlxxxlI does not show cards.Bets: 0. Collects: 0. Wins: 0.
Player jjeannin1 does not show cards.Bets: 0.25. Collects: 0. Loses: 0.25.
*Player trader063 shows: Two pairs. As and 4s [5s Ad]. Bets: 6.04. Collects: 11.72. Wins: 5.68.
Player Parcker does not show cards.Bets: 0. Collects: 0. Wins: 0.
Player Jui Kuen shows: Two pairs. Js and 4s [Jc 10d]. Bets: 6.04. Collects: 0. Loses: 6.04.
Game ended at: 2016/11/29 15:5:33

Game started
Game ID: 787020554 1/2 (PRR) Lakhey (Short) - 2 (Hold'em)
Seat 2 is the button
Seat 1: AironVega (140.05).
Seat 2: IlxxxlI (56.30).
Seat 3: VegetablesArentYummy (150.40).
Seat 5: aleks0v (136.72).
Seat 6: anarkopoker (100).
Player VegetablesArentYummy has small blind (1)
Player aleks0v has big blind (2)
Player IlxxxlI received card: [3s]
Player IlxxxlI received card: [Qc]
Player anarkopoker folds
Player AironVega folds
Player IlxxxlI folds
Player VegetablesArentYummy raises (5)
Player aleks0v folds
Uncalled bet (4) returned to VegetablesArentYummy
Player VegetablesArentYummy mucks cards
------ Summary ------
Pot: 4. Rake 0
Player AironVega does not show cards.Bets: 0. Collects: 0. Wins: 0.
Player IlxxxlI does not show cards.Bets: 0. Collects: 0. Wins: 0.
*Player VegetablesArentYummy mucks (does not show cards). Bets: 2. Collects: 4. Wins: 2.
Player aleks0v does not show cards.Bets: 2. Collects: 0. Loses: 2.
Player anarkopoker does not show cards.Bets: 0. Collects: 0. Wins: 0.
Game ended at: 2016/11/29 15:4:56

Game started
Game ID: 787020501 0.25/0.50 (PRR) Garuda - 4 (Hold'em)
Seat 5 is the button
Seat 1: gorillaman68 (57.05).
Seat 2: dankmann (101.71).
Seat 3: kid4life (113.59).
Seat 4: DRofBooya (41.52).
Seat 5: wvlax1425 (52.04).
Seat 6: Spagetti1 (50.26).
Seat 7: IlxxxlI (20).
Seat 8: haroldbb (54.88).
Seat 9: Korobochka (102.45).
Player Spagetti1 has small blind (0.25)
Player IlxxxlI has big blind (0.50)
Player IlxxxlI received card: [2c]
Player IlxxxlI received card: [5h]
Player haroldbb folds
Player Korobochka folds
Player gorillaman68 raises (1.50)
Player dankmann folds
Player kid4life folds
Player DRofBooya calls (1.50)
Player wvlax1425 folds
Player Spagetti1 folds
Player IlxxxlI folds
*** FLOP ***: [10s 7c Ks]
Player gorillaman68 bets (1.78)
Player DRofBooya calls (1.78)
*** TURN ***: [10s 7c Ks] [7d]
Player gorillaman68 checks
Player DRofBooya bets (3)
Player gorillaman68 folds
Uncalled bet (3) returned to DRofBooya
Player DRofBooya mucks cards
------ Summary ------
Pot: 6.95. Rake 0.24. JP fee 0.12
Board: [10s 7c Ks 7d]
Player gorillaman68 does not show cards.Bets: 3.28. Collects: 0. Loses: 3.28.
Player dankmann does not show cards.Bets: 0. Collects: 0. Wins: 0.
Player kid4life does not show cards.Bets: 0. Collects: 0. Wins: 0.
*Player DRofBooya mucks (does not show cards). Bets: 3.28. Collects: 6.95. Wins: 3.67.
Player wvlax1425 does not show cards.Bets: 0. Collects: 0. Wins: 0.
Player Spagetti1 does not show cards.Bets: 0.25. Collects: 0. Loses: 0.25.
Player IlxxxlI does not show cards.Bets: 0.50. Collects: 0. Loses: 0.50.
Player haroldbb does not show cards.Bets: 0. Collects: 0. Wins: 0.
Player Korobochka does not show cards.Bets: 0. Collects: 0. Wins: 0.
Game ended at: 2016/11/29 15:5:28

Game started
Game ID: 787020250 0.25/0.50 (PRR) Gorgons (Cap) - 2 (Hold'em)
Seat 6 is the button
Seat 2: IlxxxlI (20).
Seat 3: jjeannin1 (38.02).
Seat 4: trader063 (33.12).
Seat 5: Parcker (84.20).
Seat 6: Jui Kuen (81.82).
Player IlxxxlI has small blind (0.25)
Player jjeannin1 has big blind (0.50)
Player IlxxxlI received card: [3h]
Player IlxxxlI received card: [9c]
Player trader063 calls (0.50)
Player Parcker folds
Player Jui Kuen folds
Player IlxxxlI folds
Player jjeannin1 checks
*** FLOP ***: [6h Jd Kd]
Player jjeannin1 checks
Player trader063 checks
*** TURN ***: [6h Jd Kd] [8h]
Player jjeannin1 checks
Player trader063 bets (0.79)
Player jjeannin1 calls (0.79)
*** RIVER ***: [6h Jd Kd 8h] [4d]
Player jjeannin1 checks
Player trader063 bets (1.79)
Player jjeannin1 raises (3.58)
Player trader063 folds
Uncalled bet (1.79) returned to jjeannin1
Player jjeannin1 mucks cards
------ Summary ------
Pot: 6.09. Rake 0.22. JP fee 0.10
Board: [6h Jd Kd 8h 4d]
Player IlxxxlI does not show cards.Bets: 0.25. Collects: 0. Loses: 0.25.
*Player jjeannin1 mucks (does not show cards). Bets: 3.08. Collects: 6.09. Wins: 3.01.
Player trader063 does not show cards.Bets: 3.08. Collects: 0. Loses: 3.08.
Player Parcker does not show cards.Bets: 0. Collects: 0. Wins: 0.
Player Jui Kuen does not show cards.Bets: 0. Collects: 0. Wins: 0.
Game ended at: 2016/11/29 15:4:38

Game started
Game ID: 787020168 1/2 (PRR) Lakhey (Short) - 2 (Hold'em)
Seat 1 is the button
Seat 1: AironVega (140.05).
Seat 2: IlxxxlI (40).
Seat 3: VegetablesArentYummy (152.40).
Seat 5: aleks0v (152.72).
Seat 6: anarkopoker (100).
Player IlxxxlI has small blind (1)
Player VegetablesArentYummy has big blind (2)
Player IlxxxlI received card: [Jc]
Player IlxxxlI received card: [Kc]
Player aleks0v raises (4)
Player anarkopoker folds
Player AironVega folds
Player IlxxxlI calls (3)
Player VegetablesArentYummy folds
*** FLOP ***: [Js 4s 6d]
Player IlxxxlI checks
Player aleks0v checks
*** TURN ***: [Js 4s 6d] [9h]
Player IlxxxlI bets (12)
Player aleks0v calls (12)
*** RIVER ***: [Js 4s 6d 9h] [4h]
Player IlxxxlI allin (24)
Player aleks0v folds
Uncalled bet (24) returned to IlxxxlI
Player IlxxxlI mucks cards
------ Summary ------
Pot: 32.30. Rake 1.46. JP fee 0.24
Board: [Js 4s 6d 9h 4h]
Player AironVega does not show cards.Bets: 0. Collects: 0. Wins: 0.
*Player IlxxxlI mucks (does not show cards). Bets: 16. Collects: 32.30. Wins: 16.30.
Player VegetablesArentYummy does not show cards.Bets: 2. Collects: 0. Loses: 2.
Player aleks0v does not show cards.Bets: 16. Collects: 0. Loses: 16.
Player anarkopoker does not show cards.Bets: 0. Collects: 0. Wins: 0.
Game ended at: 2016/11/29 15:4:38

Game started
Game ID: 787020036 1/2 (PRR) Longana (Short) - 2 (Hold'em)
Seat 9 is the button
Seat 2: PANDAisEVIL (107.50).
Seat 3: VegetablesArentYummy (129.13).
Seat 4: gust (92.40).
Seat 6: IlxxxlI (52).
Seat 7: pineapplesand (46.12).
Seat 8: StephCurry (100.50).
Seat 9: AironVega (100).
Player PANDAisEVIL has small blind (1)
Player VegetablesArentYummy has big blind (2)
Player IlxxxlI received card: [Ad]
Player IlxxxlI received card: [Kd]
Player gust folds
Player IlxxxlI raises (7)
Player pineapplesand folds
Player StephCurry folds
Player AironVega folds
Player PANDAisEVIL raises (21.69)
Player VegetablesArentYummy folds
Player IlxxxlI allin (45)
Player PANDAisEVIL calls (29.31)
*** FLOP ***: [10h Ks 2h]
*** TURN ***: [10h Ks 2h] [6s]
*** RIVER ***: [10h Ks 2h 6s] [Jh]
------ Summary ------
Pot: 103. Rake 2.76. JP fee 0.24
Board: [10h Ks 2h 6s Jh]
Player PANDAisEVIL shows: One pair of 8s [8c 8d]. Bets: 52. Collects: 0. Loses: 52.
Player VegetablesArentYummy does not show cards.Bets: 2. Collects: 0. Loses: 2.
Player gust does not show cards.Bets: 0. Collects: 0. Wins: 0.
*Player IlxxxlI shows: One pair of Ks [Ad Kd]. Bets: 52. Collects: 103. Wins: 51.
Player pineapplesand does not show cards.Bets: 0. Collects: 0. Wins: 0.
Player StephCurry does not show cards.Bets: 0. Collects: 0. Wins: 0.
Player AironVega does not show cards.Bets: 0. Collects: 0. Wins: 0.
Game ended at: 2016/11/29 15:4:17

Game started
Game ID: 787020035 0.50/1 (PRR) Karkadann - 3 (Hold'em)
Seat 2 is the button
Seat 1: DRofBooya (43.48).
Seat 2: ElvenEyes (166.65).
Seat 3: StephCurry (110.10).
Seat 4: gust (51.95).
Seat 5: pineapplesand (40).
Seat 6: AironVega (100).
Seat 7: IlxxxlI (86.20).
Seat 8: dankmann (142.69).
Seat 9: VegetablesArentYummy (269.50).
Player StephCurry has small blind (0.50)
Player gust has big blind (1)
Player IlxxxlI received card: [6h]
Player IlxxxlI received card: [3d]
Player pineapplesand folds
Player AironVega folds
Player IlxxxlI folds
Player dankmann folds
Player VegetablesArentYummy folds
Player DRofBooya folds
Player ElvenEyes raises (3)
Player StephCurry folds
Player gust folds
Uncalled bet (2) returned to ElvenEyes
Player ElvenEyes mucks cards
------ Summary ------
Pot: 2.50. Rake 0
Player DRofBooya does not show cards.Bets: 0. Collects: 0. Wins: 0.
*Player ElvenEyes mucks (does not show cards). Bets: 1. Collects: 2.50. Wins: 1.50.
Player StephCurry does not show cards.Bets: 0.50. Collects: 0. Loses: 0.50.
Player gust does not show cards.Bets: 1. Collects: 0. Loses: 1.
Player pineapplesand does not show cards.Bets: 0. Collects: 0. Wins: 0.
Player AironVega does not show cards.Bets: 0. Collects: 0. Wins: 0.
Player IlxxxlI does not show cards.Bets: 0. Collects: 0. Wins: 0.
Player dankmann does not show cards.Bets: 0. Collects: 0. Wins: 0.
Player VegetablesArentYummy does not show cards.Bets: 0. Collects: 0. Wins: 0.
Game ended at: 2016/11/29 15:3:44

Game started
Game ID: 787019881 0.25/0.50 (PRR) Gorgons (Cap) - 2 (Hold'em)
Seat 5 is the button
Seat 2: IlxxxlI (20).
Seat 3: jjeannin1 (33.12).
Seat 4: trader063 (33.12).
Seat 5: Parcker (88.85).
Seat 6: Jui Kuen (82.07).
Player Jui Kuen has small blind (0.25)
Player IlxxxlI has big blind (0.50)
Player IlxxxlI received card: [7s]
Player IlxxxlI received card: [Ah]
Player jjeannin1 calls (0.50)
Player trader063 folds
Player Parcker raises (2.20)
Player Jui Kuen folds
Player IlxxxlI folds
Player jjeannin1 calls (1.70)
*** FLOP ***: [2h 6h Jd]
Player jjeannin1 checks
Player Parcker bets (2.45)
Player jjeannin1 caps (12.80)
Player Parcker folds
Uncalled bet (10.35) returned to jjeannin1
Player jjeannin1 mucks cards
------ Summary ------
Pot: 9.55. Rake 0.34. JP fee 0.16
Board: [2h 6h Jd]
Player IlxxxlI does not show cards.Bets: 0.50. Collects: 0. Loses: 0.50.
*Player jjeannin1 mucks (does not show cards). Bets: 4.65. Collects: 9.55. Wins: 4.90.
Player trader063 does not show cards.Bets: 0. Collects: 0. Wins: 0.
Player Parcker does not show cards.Bets: 4.65. Collects: 0. Loses: 4.65.
Player Jui Kuen does not show cards.Bets: 0.25. Collects: 0. Loses: 0.25.
Game ended at: 2016/11/29 15:3:50

Game started
Game ID: 787019874 0.50/1 (PRR) Karkadann (Hold'em)
Seat 3 is the button
Seat 1: StephCurry (103.28).
Seat 2: PANDAisEVIL (104.64).
Seat 3: AironVega (102.70).
Seat 4: IlxxxlI (40).
Seat 5: pineapplesand (40).
Seat 6: dankmann (210.52).
Seat 7: ElvenEyes (100).
Seat 8: gust (48.50).
Seat 9: VegetablesArentYummy (258.69).
Player IlxxxlI has small blind (0.50)
Player pineapplesand has big blind (1)
Player IlxxxlI received card: [10s]
Player IlxxxlI received card: [As]
Player dankmann folds
Player ElvenEyes raises (2)
Player gust folds
Player VegetablesArentYummy folds
Player StephCurry folds
Player PANDAisEVIL folds
Player AironVega folds
Player IlxxxlI calls (1.50)
Player pineapplesand calls (1)
*** FLOP ***: [9s 8c 3d]
Player IlxxxlI checks
Player pineapplesand checks
Player ElvenEyes checks
*** TURN ***: [9s 8c 3d] [2d]
Player IlxxxlI checks
Player pineapplesand bets (2.85)
Player ElvenEyes raises (9)
Player IlxxxlI folds
Player pineapplesand calls (6.15)
*** RIVER ***: [9s 8c 3d 2d] [Ad]
Player pineapplesand checks
Player ElvenEyes checks
Player pineapplesand mucks cards
------ Summary ------
Pot: 22.80. Rake 0.96. JP fee 0.24
Board: [9s 8c 3d 2d Ad]
Player StephCurry does not show cards.Bets: 0. Collects: 0. Wins: 0.
Player PANDAisEVIL does not show cards.Bets: 0. Collects: 0. Wins: 0.
Player AironVega does not show cards.Bets: 0. Collects: 0. Wins: 0.
Player IlxxxlI does not show cards.Bets: 2. Collects: 0. Loses: 2.
Player pineapplesand mucks (does not show cards). Bets: 11. Collects: 0. Loses: 11.
Player dankmann does not show cards.Bets: 0. Collects: 0. Wins: 0.
*Player ElvenEyes shows: Three Of Kind of 2s [2s 2c]. Bets: 11. Collects: 22.80. Wins: 11.80.
Player gust does not show cards.Bets: 0. Collects: 0. Wins: 0.
Player VegetablesArentYummy does not show cards.Bets: 0. Collects: 0. Wins: 0.
Game ended at: 2016/11/29 15:5:20

Game started
Game ID: 787019816 0.50/1 (PRR) Karkadann - 3 (Hold'em)
Seat 1 is the button
Seat 1: DRofBooya (43.48).
Seat 2: ElvenEyes (167.15).
Seat 3: StephCurry (111.10).
Seat 4: gust (51.95).
Seat 5: pineapplesand (40).
Seat 6: AironVega (100).
Seat 7: IlxxxlI (86.20).
Seat 8: dankmann (141.19).
Seat 9: VegetablesArentYummy (269.50).
Player ElvenEyes has small blind (0.50)
Player StephCurry has big blind (1)
Player IlxxxlI received card: [9c]
Player IlxxxlI received card: [8d]
Player gust folds
Player pineapplesand folds
Player AironVega folds
Player IlxxxlI folds
Player dankmann raises (3)
Player VegetablesArentYummy folds
Player DRofBooya folds
Player ElvenEyes folds
Player StephCurry folds
Uncalled bet (2) returned to dankmann
Player dankmann mucks cards
------ Summary ------
Pot: 2.50. Rake 0
Player DRofBooya does not show cards.Bets: 0. Collects: 0. Wins: 0.
Player ElvenEyes does not show cards.Bets: 0.50. Collects: 0. Loses: 0.50.
Player StephCurry does not show cards.Bets: 1. Collects: 0. Loses: 1.
Player gust does not show cards.Bets: 0. Collects: 0. Wins: 0.
Player pineapplesand does not show cards.Bets: 0. Collects: 0. Wins: 0.
Player AironVega does not show cards.Bets: 0. Collects: 0. Wins: 0.
Player IlxxxlI does not show cards.Bets: 0. Collects: 0. Wins: 0.
*Player dankmann mucks (does not show cards). Bets: 1. Collects: 2.50. Wins: 1.50.
Player VegetablesArentYummy does not show cards.Bets: 0. Collects: 0. Wins: 0.
Game ended at: 2016/11/29 15:3:16

Game started
Game ID: 787019718 1/2 (PRR) Lakhey (Short) - 2 (Hold'em)
Seat 6 is the button
Seat 1: AironVega (123.26).
Seat 2: IlxxxlI (40).
Seat 3: VegetablesArentYummy (152.40).
Seat 5: aleks0v (152.72).
Seat 6: anarkopoker (113.70).
Player AironVega has small blind (1)
Player IlxxxlI has big blind (2)
Player IlxxxlI received card: [Kh]
Player IlxxxlI received card: [2s]
Player VegetablesArentYummy folds
Player aleks0v folds
Player anarkopoker raises (4.20)
Player AironVega raises (15.54)
Player IlxxxlI folds
Player anarkopoker calls (12.34)
*** FLOP ***: [8c 7h Qd]
Player AironVega bets (11)
Player anarkopoker folds
Uncalled bet (11) returned to AironVega
Player AironVega mucks cards
------ Summary ------
Pot: 33.33. Rake 1.51. JP fee 0.24
Board: [8c 7h Qd]
*Player AironVega mucks (does not show cards). Bets: 16.54. Collects: 33.33. Wins: 16.79.
Player IlxxxlI does not show cards.Bets: 2. Collects: 0. Loses: 2.
Player VegetablesArentYummy does not show cards.Bets: 0. Collects: 0. Wins: 0.
Player aleks0v does not show cards.Bets: 0. Collects: 0. Wins: 0.
Player anarkopoker does not show cards.Bets: 16.54. Collects: 0. Loses: 16.54.
Game ended at: 2016/11/29 15:3:37

Game started
Game ID: 787019701 1/2 (PRR) Longana (Short) - 2 (Hold'em)
Seat 8 is the button
Seat 1: aleks0v (107.95).
Seat 2: PANDAisEVIL (102.50).
Seat 3: VegetablesArentYummy (129.13).
Seat 4: gust (92.40).
Seat 6: IlxxxlI (52).
Seat 7: pineapplesand (46.12).
Seat 8: StephCurry (104.50).
Seat 9: AironVega (100).
Player AironVega has small blind (1)
Player aleks0v sitting out
Player PANDAisEVIL has big blind (2)
Player IlxxxlI received card: [6h]
Player IlxxxlI received card: [10s]
Player VegetablesArentYummy folds
Player gust folds
Player IlxxxlI folds
Player pineapplesand folds
Player StephCurry raises (4)
Player AironVega folds
Player PANDAisEVIL raises (12.68)
Player StephCurry folds
Uncalled bet (10.68) returned to PANDAisEVIL
Player PANDAisEVIL mucks cards
------ Summary ------
Pot: 9. Rake 0
Player aleks0v does not show cards.Bets: 0. Collects: 0. Wins: 0.
*Player PANDAisEVIL mucks (does not show cards). Bets: 4. Collects: 9. Wins: 5.
Player VegetablesArentYummy does not show cards.Bets: 0. Collects: 0. Wins: 0.
Player gust does not show cards.Bets: 0. Collects: 0. Wins: 0.
Player IlxxxlI does not show cards.Bets: 0. Collects: 0. Wins: 0.
Player pineapplesand does not show cards.Bets: 0. Collects: 0. Wins: 0.
Player StephCurry does not show cards.Bets: 4. Collects: 0. Loses: 4.
Player AironVega does not show cards.Bets: 1. Collects: 0. Loses: 1.
Game ended at: 2016/11/29 15:3:16

Game started
Game ID: 787019697 0.25/0.50 (PRR) Garuda - 3 (Hold'em)
Seat 1 is the button
Seat 1: choiCES (41.88).
Seat 2: hoocher (63.31).
Seat 3: Parcker (118.22).
Seat 4: IlxxxlI (20.75).
Seat 6: dankmann (95.81).
Seat 7: BlueSmoke (60.85).
Seat 8: gorillaman68 (54.29).
Seat 9: Spagetti1 (50.63).
Player hoocher has small blind (0.25)
Player Parcker has big blind (0.50)
Player IlxxxlI received card: [Qc]
Player IlxxxlI received card: [6h]
Player IlxxxlI folds
Player dankmann folds
Player BlueSmoke raises (1.44)
Player gorillaman68 folds
Player Spagetti1 folds
Player choiCES calls (1.44)
Player hoocher calls (1.19)
Player Parcker calls (0.94)
*** FLOP ***: [4d 10s 6s]
Player hoocher checks
Player Parcker checks
Player BlueSmoke bets (4.11)
Player choiCES calls (4.11)
Player hoocher folds
Player Parcker folds
*** TURN ***: [4d 10s 6s] [9c]
Player BlueSmoke checks
Player choiCES bets (6.64)
Player BlueSmoke calls (6.64)
*** RIVER ***: [4d 10s 6s 9c] [3s]
Player BlueSmoke checks
Player choiCES allin (29.69)
Player BlueSmoke folds
Uncalled bet (29.69) returned to choiCES
Player choiCES mucks cards
------ Summary ------
Pot: 25.90. Rake 1.12. JP fee 0.24
Board: [4d 10s 6s 9c 3s]
*Player choiCES mucks (does not show cards). Bets: 12.19. Collects: 25.90. Wins: 13.71.
Player hoocher does not show cards.Bets: 1.44. Collects: 0. Loses: 1.44.
Player Parcker does not show cards.Bets: 1.44. Collects: 0. Loses: 1.44.
Player IlxxxlI does not show cards.Bets: 0. Collects: 0. Wins: 0.
Player dankmann does not show cards.Bets: 0. Collects: 0. Wins: 0.
Player BlueSmoke does not show cards.Bets: 12.19. Collects: 0. Loses: 12.19.
Player gorillaman68 does not show cards.Bets: 0. Collects: 0. Wins: 0.
Player Spagetti1 does not show cards.Bets: 0. Collects: 0. Wins: 0.
Game ended at: 2016/11/29 15:4:46

Game started
Game ID: 787019645 0.50/1 (PRR) Karkadann - 3 (Hold'em)
Seat 9 is the button
Seat 1: DRofBooya (43.98).
Seat 2: ElvenEyes (168.15).
Seat 3: StephCurry (109.60).
Seat 4: gust (51.95).
Seat 5: pineapplesand (40).
Seat 6: AironVega (100).
Seat 7: IlxxxlI (86.20).
Seat 8: dankmann (141.19).
Seat 9: VegetablesArentYummy (269.50).
Player DRofBooya has small blind (0.50)
Player ElvenEyes has big blind (1)
Player IlxxxlI received card: [2c]
Player IlxxxlI received card: [5h]
Player StephCurry raises (3)
Player gust folds
Player pineapplesand folds
Player AironVega folds
Player IlxxxlI folds
Player dankmann folds
Player VegetablesArentYummy folds
Player DRofBooya folds
Player ElvenEyes folds
Uncalled bet (2) returned to StephCurry
Player StephCurry mucks cards
------ Summary ------
Pot: 2.50. Rake 0
Player DRofBooya does not show cards.Bets: 0.50. Collects: 0. Loses: 0.50.
Player ElvenEyes does not show cards.Bets: 1. Collects: 0. Loses: 1.
*Player StephCurry mucks (does not show cards). Bets: 1. Collects: 2.50. Wins: 1.50.
Player gust does not show cards.Bets: 0. Collects: 0. Wins: 0.
Player pineapplesand does not show cards.Bets: 0. Collects: 0. Wins: 0.
Player AironVega does not show cards.Bets: 0. Collects: 0. Wins: 0.
Player IlxxxlI does not show cards.Bets: 0. Collects: 0. Wins: 0.
Player dankmann does not show cards.Bets: 0. Collects: 0. Wins: 0.
Player VegetablesArentYummy does not show cards.Bets: 0. Collects: 0. Wins: 0.
Game ended at: 2016/11/29 15:2:40

Game started
Game ID: 787019588 0.50/1 (PRR) Karkadann (Hold'em)
Seat 2 is the button
Seat 1: StephCurry (103.28).
Seat 2: PANDAisEVIL (104.64).
Seat 3: AironVega (100).
Seat 4: IlxxxlI (41.50).
Seat 5: pineapplesand (40).
Seat 6: dankmann (210.52).
Seat 7: ElvenEyes (100).
Seat 8: gust (48.50).
Seat 9: VegetablesArentYummy (258.69).
Player AironVega has small blind (0.50)
Player IlxxxlI has big blind (1)
Player IlxxxlI received card: [Jd]
Player IlxxxlI received card: [8d]
Player pineapplesand folds
Player dankmann folds
Player ElvenEyes folds
Player gust folds
Player VegetablesArentYummy folds
Player StephCurry folds
Player PANDAisEVIL folds
Player AironVega raises (2.50)
Player IlxxxlI calls (2)
*** FLOP ***: [Ac 5h As]
Player AironVega bets (3.76)
Player IlxxxlI folds
Uncalled bet (3.76) returned to AironVega
Player AironVega mucks cards
------ Summary ------
Pot: 5.70. Rake 0.20. JP fee 0.10
Board: [Ac 5h As]
Player StephCurry does not show cards.Bets: 0. Collects: 0. Wins: 0.
Player PANDAisEVIL does not show cards.Bets: 0. Collects: 0. Wins: 0.
*Player AironVega mucks (does not show cards). Bets: 3. Collects: 5.70. Wins: 2.70.
Player IlxxxlI does not show cards.Bets: 3. Collects: 0. Loses: 3.
Player pineapplesand does not show cards.Bets: 0. Collects: 0. Wins: 0.
Player dankmann does not show cards.Bets: 0. Collects: 0. Wins: 0.
Player ElvenEyes does not show cards.Bets: 0. Collects: 0. Wins: 0.
Player gust does not show cards.Bets: 0. Collects: 0. Wins: 0.
Player VegetablesArentYummy does not show cards.Bets: 0. Collects: 0. Wins: 0.
Game ended at: 2016/11/29 15:2:49

Game started
Game ID: 787019552 1/2 (PRR) Longana (Short) - 2 (Hold'em)
Seat 7 is the button
Seat 1: aleks0v (104.95).
Seat 2: PANDAisEVIL (102.50).
Seat 3: VegetablesArentYummy (129.13).
Seat 4: gust (92.40).
Seat 6: IlxxxlI (52).
Seat 7: pineapplesand (46.12).
Seat 8: StephCurry (105.50).
Seat 9: AironVega (100).
Player StephCurry has small blind (1)
Player AironVega has big blind (2)
Player IlxxxlI received card: [Kc]
Player IlxxxlI received card: [9c]
Player aleks0v raises (4)
Player PANDAisEVIL folds
Player VegetablesArentYummy folds
Player gust folds
Player IlxxxlI folds
Player pineapplesand folds
Player StephCurry folds
Player AironVega folds
Uncalled bet (2) returned to aleks0v
Player aleks0v mucks cards
------ Summary ------
Pot: 5. Rake 0
*Player aleks0v mucks (does not show cards). Bets: 2. Collects: 5. Wins: 3.
Player PANDAisEVIL does not show cards.Bets: 0. Collects: 0. Wins: 0.
Player VegetablesArentYummy does not show cards.Bets: 0. Collects: 0. Wins: 0.
Player gust does not show cards.Bets: 0. Collects: 0. Wins: 0.
Player IlxxxlI does not show cards.Bets: 0. Collects: 0. Wins: 0.
Player pineapplesand does not show cards.Bets: 0. Collects: 0. Wins: 0.
Player StephCurry does not show cards.Bets: 1. Collects: 0. Loses: 1.
Player AironVega does not show cards.Bets: 2. Collects: 0. Loses: 2.
Game ended at: 2016/11/29 15:2:22

Game started
Game ID: 787019456 1/2 (PRR) Lakhey (Short) - 2 (Hold'em)
Seat 5 is the button
Seat 1: AironVega (125.26).
Seat 2: IlxxxlI (40).
Seat 3: VegetablesArentYummy (149.40).
Seat 5: aleks0v (152.72).
Seat 6: anarkopoker (114.70).
Player anarkopoker has small blind (1)
Player AironVega has big blind (2)
Player IlxxxlI received card: [3s]
Player IlxxxlI received card: [Ah]
Player IlxxxlI folds
Player VegetablesArentYummy raises (5)
Player aleks0v folds
Player anarkopoker folds
Player AironVega folds
Uncalled bet (3) returned to VegetablesArentYummy
Player VegetablesArentYummy mucks cards
------ Summary ------
Pot: 5. Rake 0
Player AironVega does not show cards.Bets: 2. Collects: 0. Loses: 2.
Player IlxxxlI does not show cards.Bets: 0. Collects: 0. Wins: 0.
*Player VegetablesArentYummy mucks (does not show cards). Bets: 2. Collects: 5. Wins: 3.
Player aleks0v does not show cards.Bets: 0. Collects: 0. Wins: 0.
Player anarkopoker does not show cards.Bets: 1. Collects: 0. Loses: 1.
Game ended at: 2016/11/29 15:2:26

Game started
Game ID: 787019433 0.25/0.50 (PRR) Gorgons (Cap) - 2 (Hold'em)
Seat 4 is the button
Seat 2: IlxxxlI (20).
Seat 3: jjeannin1 (33.12).
Seat 4: trader063 (34.69).
Seat 5: Parcker (86.96).
Seat 6: Jui Kuen (82.57).
Player Parcker has small blind (0.25)
Player Jui Kuen has big blind (0.50)
Player IlxxxlI received card: [Kd]
Player IlxxxlI received card: [6h]
Player IlxxxlI folds
Player jjeannin1 folds
Player trader063 calls (0.50)
Player Parcker calls (0.25)
Player Jui Kuen checks
*** FLOP ***: [Ad 7s 10h]
Player Parcker checks
Player Jui Kuen checks
Player trader063 checks
*** TURN ***: [Ad 7s 10h] [Jh]
Player Parcker bets (1.07)
Player Jui Kuen folds
Player trader063 calls (1.07)
*** RIVER ***: [Ad 7s 10h Jh] [As]
Player Parcker checks
Player trader063 checks
Player trader063 mucks cards
------ Summary ------
Pot: 3.46. Rake 0.12. JP fee 0.06
Board: [Ad 7s 10h Jh As]
Player IlxxxlI does not show cards.Bets: 0. Collects: 0. Wins: 0.
Player jjeannin1 does not show cards.Bets: 0. Collects: 0. Wins: 0.
Player trader063 mucks (does not show cards). Bets: 1.57. Collects: 0. Loses: 1.57.
*Player Parcker shows: One pair of As [Ks 9d]. Bets: 1.57. Collects: 3.46. Wins: 1.89.
Player Jui Kuen does not show cards.Bets: 0.50. Collects: 0. Loses: 0.50.
Game ended at: 2016/11/29 15:2:48

Game started
Game ID: 787019145 1/2 (PRR) Lakhey (Short) - 2 (Hold'em)
Seat 3 is the button
Seat 1: AironVega (125.26).
Seat 2: IlxxxlI (40).
Seat 3: VegetablesArentYummy (149.40).
Seat 5: aleks0v (153.72).
Seat 6: anarkopoker (113.70).
Player aleks0v has small blind (1)
Player anarkopoker has big blind (2)
Player IlxxxlI received card: [4d]
Player IlxxxlI received card: [Kh]
Player AironVega folds
Player IlxxxlI folds
Player VegetablesArentYummy folds
Player aleks0v folds
Uncalled bet (1) returned to anarkopoker
Player anarkopoker mucks cards
------ Summary ------
Pot: 2. Rake 0
Player AironVega does not show cards.Bets: 0. Collects: 0. Wins: 0.
Player IlxxxlI does not show cards.Bets: 0. Collects: 0. Wins: 0.
Player VegetablesArentYummy does not show cards.Bets: 0. Collects: 0. Wins: 0.
Player aleks0v does not show cards.Bets: 1. Collects: 0. Loses: 1.
*Player anarkopoker mucks (does not show cards). Bets: 1. Collects: 2. Wins: 1.
Game ended at: 2016/11/29 15:1:44

Game started
Game ID: 787019120 0.50/1 (PRR) Karkadann (Hold'em)
Seat 1 is the button
Seat 1: StephCurry (101.78).
Seat 2: PANDAisEVIL (105.14).
Seat 3: AironVega (100).
Seat 4: IlxxxlI (41.50).
Seat 5: pineapplesand (40).
Seat 6: dankmann (210.52).
Seat 7: ElvenEyes (100).
Seat 8: gust (48.50).
Seat 9: VegetablesArentYummy (258.69).
Player PANDAisEVIL has small blind (0.50)
Player AironVega has big blind (1)
Player IlxxxlI received card: [5d]
Player IlxxxlI received card: [Qd]
Player IlxxxlI folds
Player pineapplesand folds
Player dankmann folds
Player ElvenEyes folds
Player gust folds
Player VegetablesArentYummy folds
Player StephCurry raises (2)
Player PANDAisEVIL folds
Player AironVega folds
Uncalled bet (1) returned to StephCurry
Player StephCurry mucks cards
------ Summary ------
Pot: 2.50. Rake 0
*Player StephCurry mucks (does not show cards). Bets: 1. Collects: 2.50. Wins: 1.50.
Player PANDAisEVIL does not show cards.Bets: 0.50. Collects: 0. Loses: 0.50.
Player AironVega does not show cards.Bets: 1. Collects: 0. Loses: 1.
Player IlxxxlI does not show cards.Bets: 0. Collects: 0. Wins: 0.
Player pineapplesand does not show cards.Bets: 0. Collects: 0. Wins: 0.
Player dankmann does not show cards.Bets: 0. Collects: 0. Wins: 0.
Player ElvenEyes does not show cards.Bets: 0. Collects: 0. Wins: 0.
Player gust does not show cards.Bets: 0. Collects: 0. Wins: 0.
Player VegetablesArentYummy does not show cards.Bets: 0. Collects: 0. Wins: 0.
Game ended at: 2016/11/29 15:2:3

Game started
Game ID: 787019109 0.50/1 (PRR) Karkadann - 3 (Hold'em)
Seat 8 is the button
Seat 1: DRofBooya (46.48).
Seat 2: ElvenEyes (168.15).
Seat 3: StephCurry (109.60).
Seat 4: gust (51.95).
Seat 5: pineapplesand (40).
Seat 6: AironVega (100).
Seat 7: IlxxxlI (86.20).
Seat 8: dankmann (141.19).
Seat 9: VegetablesArentYummy (267.25).
Player VegetablesArentYummy has small blind (0.50)
Player DRofBooya has big blind (1)
Player IlxxxlI received card: [9c]
Player IlxxxlI received card: [6h]
Player ElvenEyes folds
Player StephCurry folds
Player gust folds
Player pineapplesand folds
Player AironVega folds
Player IlxxxlI folds
Player dankmann folds
Player VegetablesArentYummy raises (2)
Player DRofBooya calls (1.50)
*** FLOP ***: [4h 10d 9s]
Player VegetablesArentYummy bets (2.37)
Player DRofBooya folds
Uncalled bet (2.37) returned to VegetablesArentYummy
Player VegetablesArentYummy mucks cards
------ Summary ------
Pot: 4.75. Rake 0.17. JP fee 0.08
Board: [4h 10d 9s]
Player DRofBooya does not show cards.Bets: 2.50. Collects: 0. Loses: 2.50.
Player ElvenEyes does not show cards.Bets: 0. Collects: 0. Wins: 0.
Player StephCurry does not show cards.Bets: 0. Collects: 0. Wins: 0.
Player gust does not show cards.Bets: 0. Collects: 0. Wins: 0.
Player pineapplesand does not show cards.Bets: 0. Collects: 0. Wins: 0.
Player AironVega does not show cards.Bets: 0. Collects: 0. Wins: 0.
Player IlxxxlI does not show cards.Bets: 0. Collects: 0. Wins: 0.
Player dankmann does not show cards.Bets: 0. Collects: 0. Wins: 0.
*Player VegetablesArentYummy mucks (does not show cards). Bets: 2.50. Collects: 4.75. Wins: 2.25.
Game ended at: 2016/11/29 15:2:14

Game started
Game ID: 787019077 1/2 (PRR) Longana (Short) - 2 (Hold'em)
Seat 6 is the button
Seat 1: aleks0v (109.95).
Seat 2: PANDAisEVIL (102.50).
Seat 3: VegetablesArentYummy (129.13).
Seat 4: gust (84.40).
Seat 6: IlxxxlI (52).
Seat 7: pineapplesand (47.12).
Seat 8: StephCurry (107.50).
Player pineapplesand has small blind (1)
Player StephCurry has big blind (2)
Player IlxxxlI received card: [4c]
Player IlxxxlI received card: [Jh]
Player aleks0v raises (5)
Player PANDAisEVIL folds
Player VegetablesArentYummy folds
Player gust raises (14)
Player IlxxxlI folds
Player pineapplesand folds
Player StephCurry folds
Player aleks0v folds
Uncalled bet (9) returned to gust
Player gust mucks cards
------ Summary ------
Pot: 13. Rake 0
Player aleks0v does not show cards.Bets: 5. Collects: 0. Loses: 5.
Player PANDAisEVIL does not show cards.Bets: 0. Collects: 0. Wins: 0.
Player VegetablesArentYummy does not show cards.Bets: 0. Collects: 0. Wins: 0.
*Player gust mucks (does not show cards). Bets: 5. Collects: 13. Wins: 8.
Player IlxxxlI does not show cards.Bets: 0. Collects: 0. Wins: 0.
Player pineapplesand does not show cards.Bets: 1. Collects: 0. Loses: 1.
Player StephCurry does not show cards.Bets: 2. Collects: 0. Loses: 2.
Game ended at: 2016/11/29 15:1:57

Game started
Game ID: 787018892 0.50/1 (PRR) Karkadann (Hold'em)
Seat 9 is the button
Seat 1: StephCurry (102.28).
Seat 2: PANDAisEVIL (106.14).
Seat 3: AironVega (100).
Seat 4: IlxxxlI (41.50).
Seat 5: pineapplesand (40).
Seat 6: dankmann (209.02).
Seat 7: ElvenEyes (100).
Seat 8: gust (48.50).
Seat 9: VegetablesArentYummy (258.69).
Player StephCurry has small blind (0.50)
Player PANDAisEVIL has big blind (1)
Player IlxxxlI received card: [8d]
Player IlxxxlI received card: [2c]
Player AironVega folds
Player IlxxxlI folds
Player pineapplesand folds
Player dankmann raises (3)
Player ElvenEyes folds
Player gust folds
Player VegetablesArentYummy folds
Player StephCurry folds
Player PANDAisEVIL folds
Uncalled bet (2) returned to dankmann
Player dankmann mucks cards
------ Summary ------
Pot: 2.50. Rake 0
Player StephCurry does not show cards.Bets: 0.50. Collects: 0. Loses: 0.50.
Player PANDAisEVIL does not show cards.Bets: 1. Collects: 0. Loses: 1.
Player AironVega does not show cards.Bets: 0. Collects: 0. Wins: 0.
Player IlxxxlI does not show cards.Bets: 0. Collects: 0. Wins: 0.
Player pineapplesand does not show cards.Bets: 0. Collects: 0. Wins: 0.
*Player dankmann mucks (does not show cards). Bets: 1. Collects: 2.50. Wins: 1.50.
Player ElvenEyes does not show cards.Bets: 0. Collects: 0. Wins: 0.
Player gust does not show cards.Bets: 0. Collects: 0. Wins: 0.
Player VegetablesArentYummy does not show cards.Bets: 0. Collects: 0. Wins: 0.
Game ended at: 2016/11/29 15:0:52

Game started
Game ID: 787018891 0.25/0.50 (PRR) Gorgons (Cap) - 2 (Hold'em)
Seat 3 is the button
Seat 2: IlxxxlI (20).
Seat 3: jjeannin1 (28.02).
Seat 4: trader063 (37.19).
Seat 5: Parcker (87.46).
Seat 6: Jui Kuen (82.57).
Player trader063 has small blind (0.25)
Player Parcker has big blind (0.50)
Player IlxxxlI received card: [Kd]
Player IlxxxlI received card: [Qd]
Player Jui Kuen folds
Player IlxxxlI raises (1.20)
Player jjeannin1 calls (1.20)
Player trader063 calls (0.95)
Player Parcker folds
*** FLOP ***: [8h 4h 10s]
Player trader063 checks
Player IlxxxlI bets (1.30)
Player jjeannin1 calls (1.30)
Player trader063 calls (1.30)
*** TURN ***: [8h 4h 10s] [10h]
Player trader063 checks
Player IlxxxlI checks
Player jjeannin1 bets (3.80)
Player trader063 folds
Player IlxxxlI folds
Uncalled bet (3.80) returned to jjeannin1
Player jjeannin1 mucks cards
------ Summary ------
Pot: 7.60. Rake 0.28. JP fee 0.12
Board: [8h 4h 10s 10h]
Player IlxxxlI does not show cards.Bets: 2.50. Collects: 0. Loses: 2.50.
*Player jjeannin1 mucks (does not show cards). Bets: 2.50. Collects: 7.60. Wins: 5.10.
Player trader063 does not show cards.Bets: 2.50. Collects: 0. Loses: 2.50.
Player Parcker does not show cards.Bets: 0.50. Collects: 0. Loses: 0.50.
Player Jui Kuen does not show cards.Bets: 0. Collects: 0. Wins: 0.
Game ended at: 2016/11/29 15:1:40

Game started
Game ID: 787018830 0.25/0.50 (PRR) Garuda - 3 (Hold'em)
Seat 9 is the button
Seat 1: choiCES (56.66).
Seat 2: hoocher (50).
Seat 3: Parcker (118.22).
Seat 4: IlxxxlI (20.75).
Seat 6: dankmann (95.81).
Seat 7: BlueSmoke (60.85).
Seat 8: gorillaman68 (54.29).
Seat 9: Spagetti1 (50.63).
Player choiCES has small blind (0.25)
Player hoocher has big blind (0.50)
Player IlxxxlI received card: [6d]
Player IlxxxlI received card: [10d]
Player Parcker folds
Player IlxxxlI folds
Player dankmann folds
Player BlueSmoke folds
Player gorillaman68 is timed out.
Player gorillaman68 folds
Player Spagetti1 folds
Player choiCES raises (1.25)
Player hoocher calls (1)
*** FLOP ***: [6h 8h Ad]
Player choiCES bets (0.95)
Player hoocher calls (0.95)
*** TURN ***: [6h 8h Ad] [Jc]
Player choiCES bets (2.33)
Player hoocher calls (2.33)
*** RIVER ***: [6h 8h Ad Jc] [4s]
Player choiCES bets (3.03)
Player hoocher raises (10)
Player choiCES calls (6.97)
Player choiCES mucks cards
------ Summary ------
Pot: 28.09. Rake 1.23. JP fee 0.24
Board: [6h 8h Ad Jc 4s]
Player choiCES mucks (does not show cards). Bets: 14.78. Collects: 0. Loses: 14.78.
*Player hoocher shows: Two pairs. 8s and 6s [6s 8d]. Bets: 14.78. Collects: 28.09. Wins: 13.31.
Player Parcker does not show cards.Bets: 0. Collects: 0. Wins: 0.
Player IlxxxlI does not show cards.Bets: 0. Collects: 0. Wins: 0.
Player dankmann does not show cards.Bets: 0. Collects: 0. Wins: 0.
Player BlueSmoke does not show cards.Bets: 0. Collects: 0. Wins: 0.
Player gorillaman68 does not show cards.Bets: 0. Collects: 0. Wins: 0.
Player Spagetti1 does not show cards.Bets: 0. Collects: 0. Wins: 0.
Game ended at: 2016/11/29 15:2:20

Game started
Game ID: 787018659 0.25/0.50 (PRR) Garuda - 3 (Hold'em)
Seat 8 is the button
Seat 1: choiCES (57.16).
Seat 3: Parcker (118.22).
Seat 4: IlxxxlI (20.75).
Seat 6: dankmann (95.81).
Seat 7: BlueSmoke (60.85).
Seat 8: gorillaman68 (53.54).
Seat 9: Spagetti1 (50.88).
Player Spagetti1 has small blind (0.25)
Player choiCES has big blind (0.50)
Player IlxxxlI received card: [Qh]
Player IlxxxlI received card: [4c]
Player Parcker folds
Player IlxxxlI folds
Player dankmann folds
Player BlueSmoke folds
Player gorillaman68 raises (1.50)
Player Spagetti1 folds
Player choiCES folds
Uncalled bet (1) returned to gorillaman68
Player gorillaman68 mucks cards
------ Summary ------
Pot: 1.25. Rake 0
Player choiCES does not show cards.Bets: 0.50. Collects: 0. Loses: 0.50.
Player Parcker does not show cards.Bets: 0. Collects: 0. Wins: 0.
Player IlxxxlI does not show cards.Bets: 0. Collects: 0. Wins: 0.
Player dankmann does not show cards.Bets: 0. Collects: 0. Wins: 0.
Player BlueSmoke does not show cards.Bets: 0. Collects: 0. Wins: 0.
*Player gorillaman68 mucks (does not show cards). Bets: 0.50. Collects: 1.25. Wins: 0.75.
Player Spagetti1 does not show cards.Bets: 0.25. Collects: 0. Loses: 0.25.
Game ended at: 2016/11/29 15:0:2

Game started
Game ID: 787018645 1/2 (PRR) Lakhey (Short) - 2 (Hold'em)
Seat 2 is the button
Seat 1: AironVega (125.26).
Seat 2: IlxxxlI (48.40).
Seat 3: VegetablesArentYummy (102).
Seat 4: pineapplesand (40).
Seat 5: aleks0v (155.72).
Seat 6: anarkopoker (113.70).
Player VegetablesArentYummy has small blind (1)
Player pineapplesand sitting out
Player aleks0v has big blind (2)
Player IlxxxlI received card: [Js]
Player IlxxxlI received card: [Ks]
Player anarkopoker folds
Player AironVega folds
Player IlxxxlI raises (6)
Player VegetablesArentYummy raises (15)
Player aleks0v folds
Player IlxxxlI calls (10)
*** FLOP ***: [8s Jh 8d]
Player VegetablesArentYummy allin (86)
Player IlxxxlI allin (32.40)
Uncalled bet (53.60) returned to VegetablesArentYummy
*** TURN ***: [8s Jh 8d] [3s]
*** RIVER ***: [8s Jh 8d 3s] [Qd]
------ Summary ------
Pot: 95.80. Rake 2.76. JP fee 0.24
Board: [8s Jh 8d 3s Qd]
Player AironVega does not show cards.Bets: 0. Collects: 0. Wins: 0.
Player IlxxxlI shows: Two pairs. Js and 8s [Js Ks]. Bets: 48.40. Collects: 0. Loses: 48.40.
*Player VegetablesArentYummy shows: Two pairs. As and 8s [Ah Ad]. Bets: 48.40. Collects: 95.80. Wins: 47.40.
Player pineapplesand does not show cards.Bets: 0. Collects: 0. Wins: 0.
Player aleks0v does not show cards.Bets: 2. Collects: 0. Loses: 2.
Player anarkopoker does not show cards.Bets: 0. Collects: 0. Wins: 0.
Game ended at: 2016/11/29 15:0:55

Game started
Game ID: 787018539 0.25/0.50 (PRR) Gorgons (Cap) - 2 (Hold'em)
Seat 2 is the button
Seat 2: IlxxxlI (22.24).
Seat 3: jjeannin1 (34.52).
Seat 4: trader063 (37.69).
Seat 5: Parcker (87.46).
Seat 6: Jui Kuen (73.87).
Player jjeannin1 has small blind (0.25)
Player trader063 has big blind (0.50)
Player IlxxxlI received card: [Ad]
Player IlxxxlI received card: [Qc]
Player Parcker folds
Player Jui Kuen raises (1.50)
Player IlxxxlI raises (2.50)
Player jjeannin1 calls (2.25)
Player trader063 folds
Player Jui Kuen raises (5)
Player IlxxxlI folds
Player jjeannin1 calls (4)
*** FLOP ***: [5s 8h 4h]
Player jjeannin1 checks
Player Jui Kuen caps (8.50)
Player jjeannin1 folds
Uncalled bet (8.50) returned to Jui Kuen
Player Jui Kuen mucks cards
------ Summary ------
Pot: 15.20. Rake 0.56. JP fee 0.24
Board: [5s 8h 4h]
Player IlxxxlI does not show cards.Bets: 2.50. Collects: 0. Loses: 2.50.
Player jjeannin1 does not show cards.Bets: 6.50. Collects: 0. Loses: 6.50.
Player trader063 does not show cards.Bets: 0.50. Collects: 0. Loses: 0.50.
Player Parcker does not show cards.Bets: 0. Collects: 0. Wins: 0.
*Player Jui Kuen mucks (does not show cards). Bets: 6.50. Collects: 15.20. Wins: 8.70.
Game ended at: 2016/11/29 15:0:12

Game started
Game ID: 787018483 0.25/0.50 (PRR) Garuda - 3 (Hold'em)
Seat 7 is the button
Seat 1: choiCES (57.16).
Seat 3: Parcker (118.22).
Seat 4: IlxxxlI (20.75).
Seat 6: dankmann (95.81).
Seat 7: BlueSmoke (62.29).
Seat 8: gorillaman68 (51.60).
Seat 9: Spagetti1 (51.38).
Player gorillaman68 has small blind (0.25)
Player Spagetti1 has big blind (0.50)
Player IlxxxlI received card: [8d]
Player IlxxxlI received card: [Ks]
Player choiCES folds
Player Parcker folds
Player IlxxxlI folds
Player dankmann folds
Player BlueSmoke raises (1.44)
Player gorillaman68 raises (4.75)
Player Spagetti1 folds
Player BlueSmoke folds
Uncalled bet (3.56) returned to gorillaman68
Player gorillaman68 mucks cards
------ Summary ------
Pot: 3.38. Rake 0
Player choiCES does not show cards.Bets: 0. Collects: 0. Wins: 0.
Player Parcker does not show cards.Bets: 0. Collects: 0. Wins: 0.
Player IlxxxlI does not show cards.Bets: 0. Collects: 0. Wins: 0.
Player dankmann does not show cards.Bets: 0. Collects: 0. Wins: 0.
Player BlueSmoke does not show cards.Bets: 1.44. Collects: 0. Loses: 1.44.
*Player gorillaman68 mucks (does not show cards). Bets: 1.44. Collects: 3.38. Wins: 1.94.
Player Spagetti1 does not show cards.Bets: 0.50. Collects: 0. Loses: 0.50.
Game ended at: 2016/11/29 14:59:27

Game started
Game ID: 787018439 1/2 (PRR) Longana (Short) - 2 (Hold'em)
Seat 4 is the button
Seat 1: aleks0v (116.80).
Seat 2: PANDAisEVIL (102.50).
Seat 3: VegetablesArentYummy (129.13).
Seat 4: gust (84.40).
Seat 6: IlxxxlI (53).
Seat 7: pineapplesand (40).
Seat 8: StephCurry (107.50).
Player IlxxxlI has small blind (1)
Player pineapplesand has big blind (2)
Player IlxxxlI received card: [5d]
Player IlxxxlI received card: [2d]
Player StephCurry folds
Player aleks0v raises (4)
Player PANDAisEVIL folds
Player VegetablesArentYummy folds
Player gust folds
Player IlxxxlI folds
Player pineapplesand calls (2)
*** FLOP ***: [4c 9c Ah]
Player pineapplesand checks
Player aleks0v bets (2.85)
Player pineapplesand calls (2.85)
*** TURN ***: [4c 9c Ah] [2s]
Player pineapplesand checks
Player aleks0v checks
*** RIVER ***: [4c 9c Ah 2s] [7d]
Player pineapplesand checks
Player aleks0v checks
Player aleks0v mucks cards
------ Summary ------
Pot: 13.97. Rake 0.49. JP fee 0.24
Board: [4c 9c Ah 2s 7d]
Player aleks0v mucks (does not show cards). Bets: 6.85. Collects: 0. Loses: 6.85.
Player PANDAisEVIL does not show cards.Bets: 0. Collects: 0. Wins: 0.
Player VegetablesArentYummy does not show cards.Bets: 0. Collects: 0. Wins: 0.
Player gust does not show cards.Bets: 0. Collects: 0. Wins: 0.
Player IlxxxlI does not show cards.Bets: 1. Collects: 0. Loses: 1.
*Player pineapplesand shows: One pair of As [6d As]. Bets: 6.85. Collects: 13.97. Wins: 7.12.
Player StephCurry does not show cards.Bets: 0. Collects: 0. Wins: 0.
Game ended at: 2016/11/29 15:0:43

Game started
Game ID: 787018394 0.50/1 (PRR) Karkadann - 3 (Hold'em)
Seat 7 is the button
Seat 2: ElvenEyes (168.15).
Seat 3: StephCurry (109.60).
Seat 4: gust (51.95).
Seat 5: pineapplesand (40).
Seat 6: AironVega (100).
Seat 7: IlxxxlI (86.20).
Seat 8: dankmann (141.69).
Seat 9: VegetablesArentYummy (257.91).
Player dankmann has small blind (0.50)
Player VegetablesArentYummy has big blind (1)
Player IlxxxlI received card: [4h]
Player IlxxxlI received card: [3c]
Player ElvenEyes folds
Player StephCurry folds
Player gust folds
Player pineapplesand folds
Player AironVega raises (2.50)
Player IlxxxlI folds
Player dankmann folds
Player VegetablesArentYummy calls (1.50)
*** FLOP ***: [Qs 9h 2h]
Player VegetablesArentYummy checks
Player AironVega bets (1.73)
Player VegetablesArentYummy calls (1.73)
*** TURN ***: [Qs 9h 2h] [7s]
Player VegetablesArentYummy checks
Player AironVega bets (5.62)
Player VegetablesArentYummy calls (5.62)
*** RIVER ***: [Qs 9h 2h 7s] [As]
Player VegetablesArentYummy checks
Player AironVega checks
------ Summary ------
Pot: 19.19. Rake 0.77. JP fee 0.24
Board: [Qs 9h 2h 7s As]
Player ElvenEyes does not show cards.Bets: 0. Collects: 0. Wins: 0.
Player StephCurry does not show cards.Bets: 0. Collects: 0. Wins: 0.
Player gust does not show cards.Bets: 0. Collects: 0. Wins: 0.
Player pineapplesand does not show cards.Bets: 0. Collects: 0. Wins: 0.
Player AironVega shows: One pair of 9s [9d Kd]. Bets: 9.85. Collects: 0. Loses: 9.85.
Player IlxxxlI does not show cards.Bets: 0. Collects: 0. Wins: 0.
Player dankmann does not show cards.Bets: 0.50. Collects: 0. Loses: 0.50.
*Player VegetablesArentYummy shows: One pair of Qs [Qd 10s]. Bets: 9.85. Collects: 19.19. Wins: 9.34.
Game ended at: 2016/11/29 15:0:47

Game started
Game ID: 787018388 0.50/1 (PRR) Karkadann (Hold'em)
Seat 8 is the button
Seat 1: StephCurry (100).
Seat 2: PANDAisEVIL (106.14).
Seat 3: AironVega (100).
Seat 4: IlxxxlI (41.50).
Seat 5: pineapplesand (40).
Seat 6: dankmann (209.02).
Seat 7: ElvenEyes (100).
Seat 8: gust (48.50).
Seat 9: VegetablesArentYummy (259.19).
Player VegetablesArentYummy has small blind (0.50)
Player StephCurry has big blind (1)
Player IlxxxlI received card: [2s]
Player IlxxxlI received card: [9d]
Player PANDAisEVIL folds
Player AironVega folds
Player IlxxxlI folds
Player pineapplesand raises (2)
Player dankmann folds
Player ElvenEyes folds
Player gust folds
Player VegetablesArentYummy folds
Player StephCurry calls (1)
*** FLOP ***: [5d 7s 6c]
Player StephCurry checks
Player pineapplesand checks
*** TURN ***: [5d 7s 6c] [Js]
Player StephCurry checks
Player pineapplesand checks
*** RIVER ***: [5d 7s 6c Js] [2c]
Player StephCurry checks
Player pineapplesand checks
Player pineapplesand mucks cards
------ Summary ------
Pot: 4.28. Rake 0.16. JP fee 0.06
Board: [5d 7s 6c Js 2c]
*Player StephCurry shows: One pair of 4s [4c 4s]. Bets: 2. Collects: 4.28. Wins: 2.28.
Player PANDAisEVIL does not show cards.Bets: 0. Collects: 0. Wins: 0.
Player AironVega does not show cards.Bets: 0. Collects: 0. Wins: 0.
Player IlxxxlI does not show cards.Bets: 0. Collects: 0. Wins: 0.
Player pineapplesand mucks (does not show cards). Bets: 2. Collects: 0. Loses: 2.
Player dankmann does not show cards.Bets: 0. Collects: 0. Wins: 0.
Player ElvenEyes does not show cards.Bets: 0. Collects: 0. Wins: 0.
Player gust does not show cards.Bets: 0. Collects: 0. Wins: 0.
Player VegetablesArentYummy does not show cards.Bets: 0.50. Collects: 0. Loses: 0.50.
Game ended at: 2016/11/29 15:0:11

Game started
Game ID: 787018376 0.25/0.50 (PRR) Garuda - 3 (Hold'em)
Seat 6 is the button
Seat 1: choiCES (57.16).
Seat 3: Parcker (118.22).
Seat 4: IlxxxlI (20).
Seat 6: dankmann (95.81).
Seat 7: BlueSmoke (62.54).
Seat 8: gorillaman68 (52.10).
Seat 9: Spagetti1 (51.38).
Player BlueSmoke has small blind (0.25)
Player gorillaman68 has big blind (0.50)
Player IlxxxlI received card: [Ad]
Player IlxxxlI received card: [Js]
Player Spagetti1 folds
Player choiCES folds
Player Parcker folds
Player IlxxxlI raises (1.20)
Player dankmann folds
Player BlueSmoke folds
Player gorillaman68 folds
Uncalled bet (0.70) returned to IlxxxlI
Player IlxxxlI mucks cards
------ Summary ------
Pot: 1.25. Rake 0
Player choiCES does not show cards.Bets: 0. Collects: 0. Wins: 0.
Player Parcker does not show cards.Bets: 0. Collects: 0. Wins: 0.
*Player IlxxxlI mucks (does not show cards). Bets: 0.50. Collects: 1.25. Wins: 0.75.
Player dankmann does not show cards.Bets: 0. Collects: 0. Wins: 0.
Player BlueSmoke does not show cards.Bets: 0.25. Collects: 0. Loses: 0.25.
Player gorillaman68 does not show cards.Bets: 0.50. Collects: 0. Loses: 0.50.
Player Spagetti1 does not show cards.Bets: 0. Collects: 0. Wins: 0.
Game ended at: 2016/11/29 14:58:55

Game started
Game ID: 787018351 1/2 (PRR) Lakhey (Short) - 2 (Hold'em)
Seat 1 is the button
Seat 1: AironVega (125.26).
Seat 2: IlxxxlI (50.40).
Seat 3: VegetablesArentYummy (100).
Seat 4: pineapplesand (40).
Seat 5: aleks0v (155.72).
Seat 6: anarkopoker (113.70).
Player IlxxxlI has small blind (1)
Player VegetablesArentYummy has big blind (2)
Player IlxxxlI received card: [7d]
Player IlxxxlI received card: [6h]
Player pineapplesand folds
Player aleks0v folds
Player anarkopoker folds
Player AironVega folds
Player IlxxxlI calls (1)
Player VegetablesArentYummy raises (4)
Player IlxxxlI folds
Uncalled bet (4) returned to VegetablesArentYummy
Player VegetablesArentYummy mucks cards
------ Summary ------
Pot: 4. Rake 0
Player AironVega does not show cards.Bets: 0. Collects: 0. Wins: 0.
Player IlxxxlI does not show cards.Bets: 2. Collects: 0. Loses: 2.
*Player VegetablesArentYummy mucks (does not show cards). Bets: 2. Collects: 4. Wins: 2.
Player pineapplesand does not show cards.Bets: 0. Collects: 0. Wins: 0.
Player aleks0v does not show cards.Bets: 0. Collects: 0. Wins: 0.
Player anarkopoker does not show cards.Bets: 0. Collects: 0. Wins: 0.
Game ended at: 2016/11/29 14:59:25

Game started
Game ID: 787018298 1/2 (PRR) Longana (Short) - 2 (Hold'em)
Seat 3 is the button
Seat 1: aleks0v (116.80).
Seat 2: PANDAisEVIL (102.50).
Seat 3: VegetablesArentYummy (129.13).
Seat 4: gust (85.40).
Seat 5: thimk (88.75).
Seat 6: IlxxxlI (52).
Seat 7: pineapplesand (40).
Seat 8: StephCurry (107.50).
Player gust has small blind (1)
Player thimk sitting out
Player IlxxxlI has big blind (2)
Player IlxxxlI received card: [7d]
Player IlxxxlI received card: [9h]
Player pineapplesand folds
Player StephCurry folds
Player aleks0v folds
Player PANDAisEVIL folds
Player VegetablesArentYummy folds
Player gust folds
Uncalled bet (1) returned to IlxxxlI
Player IlxxxlI mucks cards
------ Summary ------
Pot: 2. Rake 0
Player aleks0v does not show cards.Bets: 0. Collects: 0. Wins: 0.
Player PANDAisEVIL does not show cards.Bets: 0. Collects: 0. Wins: 0.
Player VegetablesArentYummy does not show cards.Bets: 0. Collects: 0. Wins: 0.
Player gust does not show cards.Bets: 1. Collects: 0. Loses: 1.
Player thimk does not show cards.Bets: 0. Collects: 0. Wins: 0.
*Player IlxxxlI mucks (does not show cards). Bets: 1. Collects: 2. Wins: 1.
Player pineapplesand does not show cards.Bets: 0. Collects: 0. Wins: 0.
Player StephCurry does not show cards.Bets: 0. Collects: 0. Wins: 0.
Game ended at: 2016/11/29 14:58:46

Game started
Game ID: 787018244 0.25/0.50 (PRR) Garuda - 3 (Hold'em)
Seat 4 is the button
Seat 1: choiCES (56.41).
Seat 3: Parcker (118.22).
Seat 4: IlxxxlI (20).
Seat 6: dankmann (96.06).
Seat 7: BlueSmoke (63.04).
Seat 8: gorillaman68 (52.10).
Seat 9: Spagetti1 (51.38).
Player dankmann has small blind (0.25)
Player BlueSmoke has big blind (0.50)
Player IlxxxlI received card: [3s]
Player IlxxxlI received card: [Qc]
Player gorillaman68 folds
Player Spagetti1 folds
Player choiCES raises (1.50)
Player Parcker folds
Player IlxxxlI folds
Player dankmann folds
Player BlueSmoke folds
Uncalled bet (1) returned to choiCES
Player choiCES mucks cards
------ Summary ------
Pot: 1.25. Rake 0
*Player choiCES mucks (does not show cards). Bets: 0.50. Collects: 1.25. Wins: 0.75.
Player Parcker does not show cards.Bets: 0. Collects: 0. Wins: 0.
Player IlxxxlI does not show cards.Bets: 0. Collects: 0. Wins: 0.
Player dankmann does not show cards.Bets: 0.25. Collects: 0. Loses: 0.25.
Player BlueSmoke does not show cards.Bets: 0.50. Collects: 0. Loses: 0.50.
Player gorillaman68 does not show cards.Bets: 0. Collects: 0. Wins: 0.
Player Spagetti1 does not show cards.Bets: 0. Collects: 0. Wins: 0.
Game ended at: 2016/11/29 14:58:32

Game started
Game ID: 787018202 0.25/0.50 (PRR) Gorgons (Cap) - 2 (Hold'em)
Seat 6 is the button
Seat 2: IlxxxlI (22.49).
Seat 3: jjeannin1 (32.41).
Seat 4: trader063 (37.69).
Seat 5: Parcker (87.46).
Seat 6: Jui Kuen (75.94).
Player IlxxxlI has small blind (0.25)
Player jjeannin1 has big blind (0.50)
Player IlxxxlI received card: [Jd]
Player IlxxxlI received card: [Qc]
Player trader063 folds
Player Parcker folds
Player Jui Kuen raises (1)
Player IlxxxlI folds
Player jjeannin1 calls (0.50)
*** FLOP ***: [5s Js 3h]
Player jjeannin1 checks
Player Jui Kuen bets (1.07)
Player jjeannin1 raises (2.14)
Player Jui Kuen is timed out.
Player Jui Kuen folds
Uncalled bet (1.07) returned to jjeannin1
Player jjeannin1 mucks cards
------ Summary ------
Pot: 4.18. Rake 0.15. JP fee 0.06
Board: [5s Js 3h]
Player IlxxxlI does not show cards.Bets: 0.25. Collects: 0. Loses: 0.25.
*Player jjeannin1 mucks (does not show cards). Bets: 2.07. Collects: 4.18. Wins: 2.11.
Player trader063 does not show cards.Bets: 0. Collects: 0. Wins: 0.
Player Parcker does not show cards.Bets: 0. Collects: 0. Wins: 0.
Player Jui Kuen does not show cards.Bets: 2.07. Collects: 0. Loses: 2.07.
Game ended at: 2016/11/29 14:59:7

Game started
Game ID: 787018189 0.50/1 (PRR) Karkadann (Hold'em)
Seat 7 is the button
Seat 1: StephCurry (100).
Seat 2: PANDAisEVIL (106.14).
Seat 3: AironVega (100).
Seat 4: IlxxxlI (41.50).
Seat 5: pineapplesand (40).
Seat 6: dankmann (207.52).
Seat 7: ElvenEyes (100).
Seat 8: gust (49).
Seat 9: VegetablesArentYummy (260.19).
Player gust has small blind (0.50)
Player VegetablesArentYummy has big blind (1)
Player IlxxxlI received card: [Ah]
Player IlxxxlI received card: [8s]
Player StephCurry folds
Player PANDAisEVIL folds
Player AironVega folds
Player IlxxxlI folds
Player pineapplesand folds
Player dankmann raises (3)
Player ElvenEyes folds
Player gust folds
Player VegetablesArentYummy folds
Uncalled bet (2) returned to dankmann
Player dankmann mucks cards
------ Summary ------
Pot: 2.50. Rake 0
Player StephCurry does not show cards.Bets: 0. Collects: 0. Wins: 0.
Player PANDAisEVIL does not show cards.Bets: 0. Collects: 0. Wins: 0.
Player AironVega does not show cards.Bets: 0. Collects: 0. Wins: 0.
Player IlxxxlI does not show cards.Bets: 0. Collects: 0. Wins: 0.
Player pineapplesand does not show cards.Bets: 0. Collects: 0. Wins: 0.
*Player dankmann mucks (does not show cards). Bets: 1. Collects: 2.50. Wins: 1.50.
Player ElvenEyes does not show cards.Bets: 0. Collects: 0. Wins: 0.
Player gust does not show cards.Bets: 0.50. Collects: 0. Loses: 0.50.
Player VegetablesArentYummy does not show cards.Bets: 1. Collects: 0. Loses: 1.
Game ended at: 2016/11/29 14:58:35

Game started
Game ID: 787018157 0.50/1 (PRR) Karkadann - 3 (Hold'em)
Seat 6 is the button
Seat 2: ElvenEyes (168.15).
Seat 3: StephCurry (109.60).
Seat 4: gust (51.95).
Seat 5: pineapplesand (40).
Seat 6: AironVega (100).
Seat 7: IlxxxlI (85.20).
Seat 8: dankmann (142.69).
Seat 9: VegetablesArentYummy (257.91).
Player IlxxxlI has small blind (0.50)
Player dankmann has big blind (1)
Player IlxxxlI received card: [6c]
Player IlxxxlI received card: [6s]
Player VegetablesArentYummy folds
Player ElvenEyes folds
Player StephCurry folds
Player gust folds
Player pineapplesand folds
Player AironVega folds
Player IlxxxlI raises (2)
Player dankmann folds
Uncalled bet (1.50) returned to IlxxxlI
Player IlxxxlI mucks cards
------ Summary ------
Pot: 2. Rake 0
Player ElvenEyes does not show cards.Bets: 0. Collects: 0. Wins: 0.
Player StephCurry does not show cards.Bets: 0. Collects: 0. Wins: 0.
Player gust does not show cards.Bets: 0. Collects: 0. Wins: 0.
Player pineapplesand does not show cards.Bets: 0. Collects: 0. Wins: 0.
Player AironVega does not show cards.Bets: 0. Collects: 0. Wins: 0.
*Player IlxxxlI mucks (does not show cards). Bets: 1. Collects: 2. Wins: 1.
Player dankmann does not show cards.Bets: 1. Collects: 0. Loses: 1.
Player VegetablesArentYummy does not show cards.Bets: 0. Collects: 0. Wins: 0.
Game ended at: 2016/11/29 14:58:36

Game started
Game ID: 787018133 1/2 (PRR) Longana (Short) - 2 (Hold'em)
Seat 2 is the button
Seat 1: aleks0v (116.80).
Seat 2: PANDAisEVIL (102.50).
Seat 3: VegetablesArentYummy (130.13).
Seat 4: gust (87.40).
Seat 5: thimk (88.75).
Seat 6: IlxxxlI (49).
Seat 7: pineapplesand (40).
Seat 8: StephCurry (107.50).
Player VegetablesArentYummy has small blind (1)
Player gust has big blind (2)
Player IlxxxlI received card: [Ah]
Player IlxxxlI received card: [Jc]
Player thimk folds
Player IlxxxlI raises (7)
Player pineapplesand folds
Player StephCurry folds
Player aleks0v folds
Player PANDAisEVIL folds
Player VegetablesArentYummy folds
Player gust folds
Uncalled bet (5) returned to IlxxxlI
Player IlxxxlI mucks cards
------ Summary ------
Pot: 5. Rake 0
Player aleks0v does not show cards.Bets: 0. Collects: 0. Wins: 0.
Player PANDAisEVIL does not show cards.Bets: 0. Collects: 0. Wins: 0.
Player VegetablesArentYummy does not show cards.Bets: 1. Collects: 0. Loses: 1.
Player gust does not show cards.Bets: 2. Collects: 0. Loses: 2.
Player thimk does not show cards.Bets: 0. Collects: 0. Wins: 0.
*Player IlxxxlI mucks (does not show cards). Bets: 2. Collects: 5. Wins: 3.
Player pineapplesand does not show cards.Bets: 0. Collects: 0. Wins: 0.
Player StephCurry does not show cards.Bets: 0. Collects: 0. Wins: 0.
Game ended at: 2016/11/29 14:58:16

Game started
Game ID: 787018043 0.25/0.50 (PRR) Garuda - 3 (Hold'em)
Seat 3 is the button
Seat 1: choiCES (56.41).
Seat 3: Parcker (117.47).
Seat 4: IlxxxlI (20).
Seat 6: dankmann (96.56).
Seat 7: BlueSmoke (63.04).
Seat 8: gorillaman68 (52.10).
Seat 9: Spagetti1 (51.38).
Player IlxxxlI has small blind (0.25)
Player dankmann has big blind (0.50)
Player IlxxxlI received card: [5d]
Player IlxxxlI received card: [8h]
Player BlueSmoke folds
Player gorillaman68 folds
Player Spagetti1 folds
Player choiCES folds
Player Parcker raises (1.20)
Player IlxxxlI folds
Player dankmann folds
Uncalled bet (0.70) returned to Parcker
Player Parcker mucks cards
------ Summary ------
Pot: 1.25. Rake 0
Player choiCES does not show cards.Bets: 0. Collects: 0. Wins: 0.
*Player Parcker mucks (does not show cards). Bets: 0.50. Collects: 1.25. Wins: 0.75.
Player IlxxxlI does not show cards.Bets: 0.25. Collects: 0. Loses: 0.25.
Player dankmann does not show cards.Bets: 0.50. Collects: 0. Loses: 0.50.
Player BlueSmoke does not show cards.Bets: 0. Collects: 0. Wins: 0.
Player gorillaman68 does not show cards.Bets: 0. Collects: 0. Wins: 0.
Player Spagetti1 does not show cards.Bets: 0. Collects: 0. Wins: 0.
Game ended at: 2016/11/29 14:58:5

Game started
Game ID: 787018025 1/2 (PRR) Lakhey (Short) - 2 (Hold'em)
Seat 6 is the button
Seat 1: AironVega (131.26).
Seat 2: IlxxxlI (45).
Seat 3: VegetablesArentYummy (100).
Seat 4: pineapplesand (40).
Seat 5: aleks0v (155.72).
Seat 6: anarkopoker (113.70).
Player AironVega has small blind (1)
Player IlxxxlI has big blind (2)
Player IlxxxlI received card: [7c]
Player IlxxxlI received card: [6c]
Player VegetablesArentYummy folds
Player pineapplesand folds
Player aleks0v folds
Player anarkopoker folds
Player AironVega raises (5)
Player IlxxxlI calls (4)
*** FLOP ***: [2d 8h Qs]
Player AironVega checks
Player IlxxxlI checks
*** TURN ***: [2d 8h Qs] [3h]
Player AironVega checks
Player IlxxxlI bets (10)
Player AironVega folds
Uncalled bet (10) returned to IlxxxlI
Player IlxxxlI mucks cards
------ Summary ------
Pot: 11.40. Rake 0.40. JP fee 0.20
Board: [2d 8h Qs 3h]
Player AironVega does not show cards.Bets: 6. Collects: 0. Loses: 6.
*Player IlxxxlI mucks (does not show cards). Bets: 6. Collects: 11.40. Wins: 5.40.
Player VegetablesArentYummy does not show cards.Bets: 0. Collects: 0. Wins: 0.
Player pineapplesand does not show cards.Bets: 0. Collects: 0. Wins: 0.
Player aleks0v does not show cards.Bets: 0. Collects: 0. Wins: 0.
Player anarkopoker does not show cards.Bets: 0. Collects: 0. Wins: 0.
Game ended at: 2016/11/29 14:58:29

Game started
Game ID: 787018005 1/2 (PRR) Lakhey (Hold'em)
Seat 5 is the button
Seat 1: VegetablesArentYummy (228.50).
Seat 2: IlxxxlI (162.90).
Seat 3: IbetUmuck (826.14).
Seat 4: iBiNkUsTiNk (197).
Seat 5: PANDAisEVIL (399).
Seat 6: AironVega (200).
Player AironVega has small blind (1)
Player VegetablesArentYummy has big blind (2)
Player IlxxxlI received card: [Js]
Player IlxxxlI received card: [Kc]
Player IlxxxlI raises (4)
Player IbetUmuck folds
Player iBiNkUsTiNk calls (4)
Player PANDAisEVIL folds
Player AironVega folds
Player VegetablesArentYummy calls (2)
*** FLOP ***: [5d Ac 4s]
Player VegetablesArentYummy checks
Player IlxxxlI checks
Player iBiNkUsTiNk bets (8)
Player VegetablesArentYummy folds
Player IlxxxlI folds
Uncalled bet (8) returned to iBiNkUsTiNk
Player iBiNkUsTiNk mucks cards
------ Summary ------
Pot: 12.35. Rake 0.45. JP fee 0.20
Board: [5d Ac 4s]
Player VegetablesArentYummy does not show cards.Bets: 4. Collects: 0. Loses: 4.
Player IlxxxlI does not show cards.Bets: 4. Collects: 0. Loses: 4.
Player IbetUmuck does not show cards.Bets: 0. Collects: 0. Wins: 0.
*Player iBiNkUsTiNk mucks (does not show cards). Bets: 4. Collects: 12.35. Wins: 8.35.
Player PANDAisEVIL does not show cards.Bets: 0. Collects: 0. Wins: 0.
Player AironVega does not show cards.Bets: 1. Collects: 0. Loses: 1.
Game ended at: 2016/11/29 14:58:28

Game started
Game ID: 787017934 0.25/0.50 (PRR) Gorgons (Cap) - 2 (Hold'em)
Seat 5 is the button
Seat 2: IlxxxlI (20).
Seat 3: jjeannin1 (32.41).
Seat 4: trader063 (40.19).
Seat 5: Parcker (87.46).
Seat 6: Jui Kuen (76.19).
Player Jui Kuen has small blind (0.25)
Player IlxxxlI has big blind (0.50)
Player IlxxxlI received card: [4s]
Player IlxxxlI received card: [Qc]
Player jjeannin1 folds
Player trader063 calls (0.50)
Player Parcker folds
Player Jui Kuen folds
Player IlxxxlI checks
*** FLOP ***: [Qs Kh 10h]
Player IlxxxlI checks
Player trader063 checks
*** TURN ***: [Qs Kh 10h] [4h]
Player IlxxxlI bets (2)
Player trader063 calls (2)
*** RIVER ***: [Qs Kh 10h 4h] [8c]
Player IlxxxlI bets (3.49)
Player trader063 folds
Uncalled bet (3.49) returned to IlxxxlI
Player IlxxxlI mucks cards
------ Summary ------
Pot: 4.99. Rake 0.18. JP fee 0.08
Board: [Qs Kh 10h 4h 8c]
*Player IlxxxlI mucks (does not show cards). Bets: 2.50. Collects: 4.99. Wins: 2.49.
Player jjeannin1 does not show cards.Bets: 0. Collects: 0. Wins: 0.
Player trader063 does not show cards.Bets: 2.50. Collects: 0. Loses: 2.50.
Player Parcker does not show cards.Bets: 0. Collects: 0. Wins: 0.
Player Jui Kuen does not show cards.Bets: 0.25. Collects: 0. Loses: 0.25.
Game ended at: 2016/11/29 14:57:56

Game started
Game ID: 787017938 1/2 (PRR) Longana (Short) - 2 (Hold'em)
Seat 1 is the button
Seat 1: aleks0v (116.80).
Seat 2: PANDAisEVIL (103.50).
Seat 3: VegetablesArentYummy (132.13).
Seat 4: gust (84.40).
Seat 5: thimk (88.75).
Seat 6: IlxxxlI (49).
Seat 7: pineapplesand (40).
Seat 8: StephCurry (107.50).
Player PANDAisEVIL has small blind (1)
Player VegetablesArentYummy has big blind (2)
Player IlxxxlI received card: [Kc]
Player IlxxxlI received card: [3s]
Player gust raises (4)
Player thimk folds
Player IlxxxlI folds
Player pineapplesand folds
Player StephCurry folds
Player aleks0v folds
Player PANDAisEVIL folds
Player VegetablesArentYummy folds
Uncalled bet (2) returned to gust
Player gust mucks cards
------ Summary ------
Pot: 5. Rake 0
Player aleks0v does not show cards.Bets: 0. Collects: 0. Wins: 0.
Player PANDAisEVIL does not show cards.Bets: 1. Collects: 0. Loses: 1.
Player VegetablesArentYummy does not show cards.Bets: 2. Collects: 0. Loses: 2.
*Player gust mucks (does not show cards). Bets: 2. Collects: 5. Wins: 3.
Player thimk does not show cards.Bets: 0. Collects: 0. Wins: 0.
Player IlxxxlI does not show cards.Bets: 0. Collects: 0. Wins: 0.
Player pineapplesand does not show cards.Bets: 0. Collects: 0. Wins: 0.
Player StephCurry does not show cards.Bets: 0. Collects: 0. Wins: 0.
Game ended at: 2016/11/29 14:57:43

Game started
Game ID: 787017885 1/2 (PRR) Lakhey (Short) - 2 (Hold'em)
Seat 5 is the button
Seat 1: AironVega (133.26).
Seat 2: IlxxxlI (45).
Seat 3: VegetablesArentYummy (100).
Seat 4: pineapplesand (40).
Seat 5: aleks0v (155.72).
Seat 6: anarkopoker (111.70).
Player anarkopoker has small blind (1)
Player AironVega has big blind (2)
Player IlxxxlI received card: [3h]
Player IlxxxlI received card: [7h]
Player IlxxxlI folds
Player VegetablesArentYummy folds
Player pineapplesand folds
Player aleks0v folds
Player anarkopoker raises (4)
Player AironVega folds
Uncalled bet (3) returned to anarkopoker
Player anarkopoker mucks cards
------ Summary ------
Pot: 4. Rake 0
Player AironVega does not show cards.Bets: 2. Collects: 0. Loses: 2.
Player IlxxxlI does not show cards.Bets: 0. Collects: 0. Wins: 0.
Player VegetablesArentYummy does not show cards.Bets: 0. Collects: 0. Wins: 0.
Player pineapplesand does not show cards.Bets: 0. Collects: 0. Wins: 0.
Player aleks0v does not show cards.Bets: 0. Collects: 0. Wins: 0.
*Player anarkopoker mucks (does not show cards). Bets: 2. Collects: 4. Wins: 2.
Game ended at: 2016/11/29 14:57:21

Game started
Game ID: 787017870 0.50/1 (PRR) Karkadann (Hold'em)
Seat 6 is the button
Seat 1: StephCurry (100).
Seat 2: PANDAisEVIL (106.14).
Seat 3: AironVega (100).
Seat 4: IlxxxlI (40).
Seat 5: pineapplesand (40).
Seat 6: dankmann (207.52).
Seat 7: ElvenEyes (100.50).
Seat 8: gust (50).
Seat 9: VegetablesArentYummy (260.19).
Player ElvenEyes has small blind (0.50)
Player gust has big blind (1)
Player IlxxxlI received card: [Ad]
Player IlxxxlI received card: [10s]
Player VegetablesArentYummy folds
Player StephCurry folds
Player PANDAisEVIL folds
Player AironVega folds
Player IlxxxlI raises (3.50)
Player pineapplesand folds
Player dankmann folds
Player ElvenEyes folds
Player gust folds
Uncalled bet (2.50) returned to IlxxxlI
Player IlxxxlI mucks cards
------ Summary ------
Pot: 2.50. Rake 0
Player StephCurry does not show cards.Bets: 0. Collects: 0. Wins: 0.
Player PANDAisEVIL does not show cards.Bets: 0. Collects: 0. Wins: 0.
Player AironVega does not show cards.Bets: 0. Collects: 0. Wins: 0.
*Player IlxxxlI mucks (does not show cards). Bets: 1. Collects: 2.50. Wins: 1.50.
Player pineapplesand does not show cards.Bets: 0. Collects: 0. Wins: 0.
Player dankmann does not show cards.Bets: 0. Collects: 0. Wins: 0.
Player ElvenEyes does not show cards.Bets: 0.50. Collects: 0. Loses: 0.50.
Player gust does not show cards.Bets: 1. Collects: 0. Loses: 1.
Player VegetablesArentYummy does not show cards.Bets: 0. Collects: 0. Wins: 0.
Game ended at: 2016/11/29 14:57:54

Game started
Game ID: 787017852 0.50/1 (PRR) Karkadann - 3 (Hold'em)
Seat 5 is the button
Seat 2: ElvenEyes (168.15).
Seat 3: StephCurry (109.60).
Seat 4: gust (51.95).
Seat 5: pineapplesand (40).
Seat 6: AironVega (102.78).
Seat 7: IlxxxlI (44.10).
Seat 8: dankmann (142.69).
Seat 9: VegetablesArentYummy (257.91).
Player AironVega has small blind (0.50)
Player IlxxxlI has big blind (1)
Player IlxxxlI received card: [Jh]
Player IlxxxlI received card: [Js]
Player dankmann folds
Player VegetablesArentYummy folds
Player ElvenEyes folds
Player StephCurry folds
Player gust folds
Player pineapplesand folds
Player AironVega raises (2.50)
Player IlxxxlI raises (6.29)
Player AironVega allin (99.78)
Player IlxxxlI allin (36.81)
Uncalled bet (58.68) returned to AironVega
*** FLOP ***: [7s Ks Ad]
*** TURN ***: [7s Ks Ad] [6h]
*** RIVER ***: [7s Ks Ad 6h] [6s]
------ Summary ------
Pot: 85.20. Rake 2.76. JP fee 0.24
Board: [7s Ks Ad 6h 6s]
Player ElvenEyes does not show cards.Bets: 0. Collects: 0. Wins: 0.
Player StephCurry does not show cards.Bets: 0. Collects: 0. Wins: 0.
Player gust does not show cards.Bets: 0. Collects: 0. Wins: 0.
Player pineapplesand does not show cards.Bets: 0. Collects: 0. Wins: 0.
Player AironVega shows: Two pairs. 9s and 6s [9c 9d]. Bets: 44.10. Collects: 0. Loses: 44.10.
*Player IlxxxlI shows: Two pairs. Js and 6s [Jh Js]. Bets: 44.10. Collects: 85.20. Wins: 41.10.
Player dankmann does not show cards.Bets: 0. Collects: 0. Wins: 0.
Player VegetablesArentYummy does not show cards.Bets: 0. Collects: 0. Wins: 0.
Game ended at: 2016/11/29 14:57:46

Game started
Game ID: 787017820 0.25/0.50 (PRR) Garuda - 3 (Hold'em)
Seat 1 is the button
Seat 1: choiCES (54.40).
Seat 3: Parcker (117.72).
Seat 4: IlxxxlI (20).
Seat 6: dankmann (96.56).
Seat 7: BlueSmoke (64.48).
Seat 8: gorillaman68 (52.10).
Seat 9: Spagetti1 (51.38).
Player Parcker has small blind (0.25)
Player IlxxxlI has big blind (0.50)
Player IlxxxlI received card: [5s]
Player IlxxxlI received card: [Kc]
Player dankmann folds
Player BlueSmoke raises (1.44)
Player gorillaman68 folds
Player Spagetti1 folds
Player choiCES calls (1.44)
Player Parcker folds
Player IlxxxlI folds
*** FLOP ***: [Qs 6d 2c]
Player BlueSmoke checks
Player choiCES bets (1.15)
Player BlueSmoke folds
Uncalled bet (1.15) returned to choiCES
Player choiCES mucks cards
------ Summary ------
Pot: 3.45. Rake 0.12. JP fee 0.06
Board: [Qs 6d 2c]
*Player choiCES mucks (does not show cards). Bets: 1.44. Collects: 3.45. Wins: 2.01.
Player Parcker does not show cards.Bets: 0.25. Collects: 0. Loses: 0.25.
Player IlxxxlI does not show cards.Bets: 0.50. Collects: 0. Loses: 0.50.
Player dankmann does not show cards.Bets: 0. Collects: 0. Wins: 0.
Player BlueSmoke does not show cards.Bets: 1.44. Collects: 0. Loses: 1.44.
Player gorillaman68 does not show cards.Bets: 0. Collects: 0. Wins: 0.
Player Spagetti1 does not show cards.Bets: 0. Collects: 0. Wins: 0.
Game ended at: 2016/11/29 14:57:25

Game started
Game ID: 787017805 0.50/1 (PRR) Kraken - 6 (Hold'em)
Seat 2 is the button
Seat 1: WeakAndWeary (100).
Seat 2: aleks0v (100).
Seat 3: AironVega (107.05).
Seat 4: ali23imsirovic (137.98).
Seat 5: Sephiroth1 (83.10).
Seat 6: IlxxxlI (78.50).
Player AironVega has small blind (0.50)
Player ali23imsirovic has big blind (1)
Player IlxxxlI received card: [Kh]
Player IlxxxlI received card: [9d]
Player Sephiroth1 folds
Player IlxxxlI folds
Player WeakAndWeary raises (3)
Player aleks0v folds
Player AironVega folds
Player ali23imsirovic folds
Uncalled bet (2) returned to WeakAndWeary
Player WeakAndWeary mucks cards
------ Summary ------
Pot: 2.50. Rake 0
*Player WeakAndWeary mucks (does not show cards). Bets: 1. Collects: 2.50. Wins: 1.50.
Player aleks0v does not show cards.Bets: 0. Collects: 0. Wins: 0.
Player AironVega does not show cards.Bets: 0.50. Collects: 0. Loses: 0.50.
Player ali23imsirovic does not show cards.Bets: 1. Collects: 0. Loses: 1.
Player Sephiroth1 does not show cards.Bets: 0. Collects: 0. Wins: 0.
Player IlxxxlI does not show cards.Bets: 0. Collects: 0. Wins: 0.
Game ended at: 2016/11/29 14:57:18

Game started
Game ID: 787017765 1/2 (PRR) Longana (Short) - 2 (Hold'em)
Seat 8 is the button
Seat 1: aleks0v (117.80).
Seat 2: PANDAisEVIL (105.50).
Seat 3: VegetablesArentYummy (132.13).
Seat 4: gust (84.40).
Seat 5: thimk (88.75).
Seat 6: IlxxxlI (46).
Seat 7: pineapplesand (40).
Seat 8: StephCurry (107.50).
Player aleks0v has small blind (1)
Player PANDAisEVIL has big blind (2)
Player IlxxxlI received card: [Ad]
Player IlxxxlI received card: [Qd]
Player VegetablesArentYummy folds
Player gust folds
Player thimk folds
Player IlxxxlI raises (4)
Player pineapplesand folds
Player StephCurry folds
Player aleks0v folds
Player PANDAisEVIL folds
Uncalled bet (2) returned to IlxxxlI
Player IlxxxlI mucks cards
------ Summary ------
Pot: 5. Rake 0
Player aleks0v does not show cards.Bets: 1. Collects: 0. Loses: 1.
Player PANDAisEVIL does not show cards.Bets: 2. Collects: 0. Loses: 2.
Player VegetablesArentYummy does not show cards.Bets: 0. Collects: 0. Wins: 0.
Player gust does not show cards.Bets: 0. Collects: 0. Wins: 0.
Player thimk does not show cards.Bets: 0. Collects: 0. Wins: 0.
*Player IlxxxlI mucks (does not show cards). Bets: 2. Collects: 5. Wins: 3.
Player pineapplesand does not show cards.Bets: 0. Collects: 0. Wins: 0.
Player StephCurry does not show cards.Bets: 0. Collects: 0. Wins: 0.
Game ended at: 2016/11/29 14:57:1

Game started
Game ID: 787017732 0.25/0.50 (PRR) Gorgons (Cap) - 2 (Hold'em)
Seat 4 is the button
Seat 2: IlxxxlI (20).
Seat 3: jjeannin1 (32.91).
Seat 4: trader063 (40.19).
Seat 5: Parcker (87.71).
Seat 6: Jui Kuen (75.50).
Player Parcker has small blind (0.25)
Player Jui Kuen has big blind (0.50)
Player IlxxxlI received card: [3s]
Player IlxxxlI received card: [8h]
Player IlxxxlI folds
Player jjeannin1 calls (0.50)
Player trader063 folds
Player Parcker folds
Player Jui Kuen checks
*** FLOP ***: [4d 4c Kc]
Player Jui Kuen bets (0.79)
Player jjeannin1 folds
Uncalled bet (0.79) returned to Jui Kuen
Player Jui Kuen mucks cards
------ Summary ------
Pot: 1.19. Rake 0.04. JP fee 0.02
Board: [4d 4c Kc]
Player IlxxxlI does not show cards.Bets: 0. Collects: 0. Wins: 0.
Player jjeannin1 does not show cards.Bets: 0.50. Collects: 0. Loses: 0.50.
Player trader063 does not show cards.Bets: 0. Collects: 0. Wins: 0.
Player Parcker does not show cards.Bets: 0.25. Collects: 0. Loses: 0.25.
*Player Jui Kuen mucks (does not show cards). Bets: 0.50. Collects: 1.19. Wins: 0.69.
Game ended at: 2016/11/29 14:57:0

Game started
Game ID: 787017644 0.50/1 (PRR) Karkadann - 3 (Hold'em)
Seat 4 is the button
Seat 2: ElvenEyes (168.15).
Seat 3: StephCurry (109.60).
Seat 4: gust (50.45).
Seat 5: pineapplesand (40).
Seat 6: AironVega (103.78).
Seat 7: IlxxxlI (44.10).
Seat 8: dankmann (142.69).
Seat 9: VegetablesArentYummy (257.91).
Player pineapplesand has small blind (0.50)
Player AironVega has big blind (1)
Player IlxxxlI received card: [Kh]
Player IlxxxlI received card: [10d]
Player IlxxxlI folds
Player dankmann folds
Player VegetablesArentYummy folds
Player ElvenEyes folds
Player StephCurry folds
Player gust raises (2)
Player pineapplesand folds
Player AironVega folds
Uncalled bet (1) returned to gust
Player gust mucks cards
------ Summary ------
Pot: 2.50. Rake 0
Player ElvenEyes does not show cards.Bets: 0. Collects: 0. Wins: 0.
Player StephCurry does not show cards.Bets: 0. Collects: 0. Wins: 0.
*Player gust mucks (does not show cards). Bets: 1. Collects: 2.50. Wins: 1.50.
Player pineapplesand does not show cards.Bets: 0.50. Collects: 0. Loses: 0.50.
Player AironVega does not show cards.Bets: 1. Collects: 0. Loses: 1.
Player IlxxxlI does not show cards.Bets: 0. Collects: 0. Wins: 0.
Player dankmann does not show cards.Bets: 0. Collects: 0. Wins: 0.
Player VegetablesArentYummy does not show cards.Bets: 0. Collects: 0. Wins: 0.
Game ended at: 2016/11/29 14:56:44

Game started
Game ID: 787017645 1/2 (PRR) Lakhey (Short) - 2 (Hold'em)
Seat 4 is the button
Seat 1: AironVega (133.26).
Seat 2: IlxxxlI (42).
Seat 3: VegetablesArentYummy (100).
Seat 4: pineapplesand (40).
Seat 5: aleks0v (156.72).
Seat 6: anarkopoker (113.70).
Player aleks0v has small blind (1)
Player anarkopoker has big blind (2)
Player IlxxxlI received card: [Jh]
Player IlxxxlI received card: [Jc]
Player AironVega folds
Player IlxxxlI raises (7)
Player VegetablesArentYummy folds
Player pineapplesand folds
Player aleks0v folds
Player anarkopoker folds
Uncalled bet (5) returned to IlxxxlI
Player IlxxxlI mucks cards
------ Summary ------
Pot: 5. Rake 0
Player AironVega does not show cards.Bets: 0. Collects: 0. Wins: 0.
*Player IlxxxlI mucks (does not show cards). Bets: 2. Collects: 5. Wins: 3.
Player VegetablesArentYummy does not show cards.Bets: 0. Collects: 0. Wins: 0.
Player pineapplesand does not show cards.Bets: 0. Collects: 0. Wins: 0.
Player aleks0v does not show cards.Bets: 1. Collects: 0. Loses: 1.
Player anarkopoker does not show cards.Bets: 2. Collects: 0. Loses: 2.
Game ended at: 2016/11/29 14:56:51

Game started
Game ID: 787017583 0.25/0.50 (PRR) Gorgons (Cap) - 2 (Hold'em)
Seat 3 is the button
Seat 2: IlxxxlI (20).
Seat 3: jjeannin1 (32.91).
Seat 4: trader063 (41.69).
Seat 5: Parcker (84.71).
Seat 6: Jui Kuen (77).
Player trader063 has small blind (0.25)
Player Parcker has big blind (0.50)
Player IlxxxlI received card: [4c]
Player IlxxxlI received card: [Qh]
Player Jui Kuen raises (1.50)
Player IlxxxlI folds
Player jjeannin1 folds
Player trader063 calls (1.25)
Player Parcker caps (14.50)
Player Jui Kuen folds
Player trader063 folds
Uncalled bet (13.50) returned to Parcker
Player Parcker mucks cards
------ Summary ------
Pot: 4.50. Rake 0
Player IlxxxlI does not show cards.Bets: 0. Collects: 0. Wins: 0.
Player jjeannin1 does not show cards.Bets: 0. Collects: 0. Wins: 0.
Player trader063 does not show cards.Bets: 1.50. Collects: 0. Loses: 1.50.
*Player Parcker mucks (does not show cards). Bets: 1.50. Collects: 4.50. Wins: 3.
Player Jui Kuen does not show cards.Bets: 1.50. Collects: 0. Loses: 1.50.
Game ended at: 2016/11/29 14:56:23

Game started
Game ID: 787017567 0.25/0.50 (PRR) Garuda - 3 (Hold'em)
Seat 9 is the button
Seat 1: choiCES (55.40).
Seat 3: Parcker (118.22).
Seat 4: IlxxxlI (20).
Seat 6: dankmann (96.56).
Seat 7: BlueSmoke (64.48).
Seat 8: gorillaman68 (52.10).
Seat 9: Spagetti1 (50).
Player choiCES has small blind (0.25)
Player Parcker has big blind (0.50)
Player IlxxxlI received card: [10s]
Player IlxxxlI received card: [9h]
Player IlxxxlI folds
Player dankmann folds
Player BlueSmoke folds
Player gorillaman68 folds
Player Spagetti1 raises (1)
Player choiCES calls (0.75)
Player Parcker folds
*** FLOP ***: [Qh Ks 5d]
Player choiCES checks
Player Spagetti1 bets (1.58)
Player choiCES is timed out.
Player choiCES folds
Uncalled bet (1.58) returned to Spagetti1
Player Spagetti1 mucks cards
------ Summary ------
Pot: 2.38. Rake 0.08. JP fee 0.04
Board: [Qh Ks 5d]
Player choiCES does not show cards.Bets: 1. Collects: 0. Loses: 1.
Player Parcker does not show cards.Bets: 0.50. Collects: 0. Loses: 0.50.
Player IlxxxlI does not show cards.Bets: 0. Collects: 0. Wins: 0.
Player dankmann does not show cards.Bets: 0. Collects: 0. Wins: 0.
Player BlueSmoke does not show cards.Bets: 0. Collects: 0. Wins: 0.
Player gorillaman68 does not show cards.Bets: 0. Collects: 0. Wins: 0.
*Player Spagetti1 mucks (does not show cards). Bets: 1. Collects: 2.38. Wins: 1.38.
Game ended at: 2016/11/29 14:56:39

Game started
Game ID: 787017444 0.25/0.50 (PRR) Gorgons (Cap) - 2 (Hold'em)
Seat 2 is the button
Seat 2: IlxxxlI (20).
Seat 3: jjeannin1 (32.46).
Seat 4: trader063 (42.19).
Seat 5: Parcker (84.71).
Seat 6: Jui Kuen (77).
Player jjeannin1 has small blind (0.25)
Player trader063 has big blind (0.50)
Player IlxxxlI received card: [4h]
Player IlxxxlI received card: [7d]
Player Parcker folds
Player Jui Kuen folds
Player IlxxxlI folds
Player jjeannin1 calls (0.25)
Player trader063 checks
*** FLOP ***: [10s Kd 7s]
Player jjeannin1 bets (0.50)
Player trader063 folds
Uncalled bet (0.50) returned to jjeannin1
Player jjeannin1 mucks cards
------ Summary ------
Pot: 0.95. Rake 0.05
Board: [10s Kd 7s]
Player IlxxxlI does not show cards.Bets: 0. Collects: 0. Wins: 0.
*Player jjeannin1 mucks (does not show cards). Bets: 0.50. Collects: 0.95. Wins: 0.45.
Player trader063 does not show cards.Bets: 0.50. Collects: 0. Loses: 0.50.
Player Parcker does not show cards.Bets: 0. Collects: 0. Wins: 0.
Player Jui Kuen does not show cards.Bets: 0. Collects: 0. Wins: 0.
Game ended at: 2016/11/29 14:55:50

Game started
Game ID: 787017436 1/2 (PRR) Lakhey (Short) - 2 (Hold'em)
Seat 3 is the button
Seat 1: AironVega (133.26).
Seat 2: IlxxxlI (42).
Seat 3: VegetablesArentYummy (100).
Seat 4: pineapplesand (41).
Seat 5: aleks0v (155.72).
Seat 6: anarkopoker (113.70).
Player pineapplesand has small blind (1)
Player aleks0v has big blind (2)
Player IlxxxlI received card: [9s]
Player IlxxxlI received card: [8c]
Player anarkopoker folds
Player AironVega folds
Player IlxxxlI folds
Player VegetablesArentYummy folds
Player pineapplesand folds
Uncalled bet (1) returned to aleks0v
Player aleks0v mucks cards
------ Summary ------
Pot: 2. Rake 0
Player AironVega does not show cards.Bets: 0. Collects: 0. Wins: 0.
Player IlxxxlI does not show cards.Bets: 0. Collects: 0. Wins: 0.
Player VegetablesArentYummy does not show cards.Bets: 0. Collects: 0. Wins: 0.
Player pineapplesand does not show cards.Bets: 1. Collects: 0. Loses: 1.
*Player aleks0v mucks (does not show cards). Bets: 1. Collects: 2. Wins: 1.
Player anarkopoker does not show cards.Bets: 0. Collects: 0. Wins: 0.
Game ended at: 2016/11/29 14:56:5

Game started
Game ID: 787017405 0.25/0.50 (PRR) Garuda - 3 (Hold'em)
Seat 8 is the button
Seat 1: choiCES (54.05).
Seat 3: Parcker (118.22).
Seat 4: IlxxxlI (20).
Seat 6: dankmann (96.56).
Seat 7: BlueSmoke (64.48).
Seat 8: gorillaman68 (52.10).
Seat 9: Spagetti1 (50.25).
Player Spagetti1 has small blind (0.25)
Player choiCES has big blind (0.50)
Player IlxxxlI received card: [4h]
Player IlxxxlI received card: [7d]
Player Parcker folds
Player IlxxxlI folds
Player dankmann folds
Player BlueSmoke folds
Player gorillaman68 folds
Player Spagetti1 raises (1.25)
Player choiCES calls (1)
*** FLOP ***: [3c Js 6s]
Player Spagetti1 checks
Player choiCES bets (0.95)
Player Spagetti1 folds
Uncalled bet (0.95) returned to choiCES
Player choiCES mucks cards
------ Summary ------
Pot: 2.85. Rake 0.11. JP fee 0.04
Board: [3c Js 6s]
*Player choiCES mucks (does not show cards). Bets: 1.50. Collects: 2.85. Wins: 1.35.
Player Parcker does not show cards.Bets: 0. Collects: 0. Wins: 0.
Player IlxxxlI does not show cards.Bets: 0. Collects: 0. Wins: 0.
Player dankmann does not show cards.Bets: 0. Collects: 0. Wins: 0.
Player BlueSmoke does not show cards.Bets: 0. Collects: 0. Wins: 0.
Player gorillaman68 does not show cards.Bets: 0. Collects: 0. Wins: 0.
Player Spagetti1 does not show cards.Bets: 1.50. Collects: 0. Loses: 1.50.
Game ended at: 2016/11/29 14:55:46

Game started
Game ID: 787017368 1/2 (PRR) Lakhey (Hold'em)
Seat 4 is the button
Seat 1: VegetablesArentYummy (228.50).
Seat 2: IlxxxlI (162.90).
Seat 3: IbetUmuck (826.14).
Seat 4: iBiNkUsTiNk (197).
Seat 5: PANDAisEVIL (201).
Seat 6: AironVega (229.66).
Player PANDAisEVIL has small blind (1)
Player AironVega has big blind (2)
Player IlxxxlI received card: [6d]
Player IlxxxlI received card: [Ac]
Player VegetablesArentYummy folds
Player IlxxxlI folds
Player IbetUmuck folds
Player iBiNkUsTiNk folds
Player PANDAisEVIL raises (4)
Player AironVega raises (18)
Player PANDAisEVIL calls (15)
*** FLOP ***: [4d 9d Qd]
Player PANDAisEVIL checks
Player AironVega bets (25.08)
Player PANDAisEVIL calls (25.08)
*** TURN ***: [4d 9d Qd] [2h]
Player PANDAisEVIL checks
Player AironVega bets (28.76)
Player PANDAisEVIL allin (155.92)
Player AironVega calls (127.16)
*** RIVER ***: [4d 9d Qd 2h] [8h]
------ Summary ------
Pot: 399. Rake 2.76. JP fee 0.24
Board: [4d 9d Qd 2h 8h]
Player VegetablesArentYummy does not show cards.Bets: 0. Collects: 0. Wins: 0.
Player IlxxxlI does not show cards.Bets: 0. Collects: 0. Wins: 0.
Player IbetUmuck does not show cards.Bets: 0. Collects: 0. Wins: 0.
Player iBiNkUsTiNk does not show cards.Bets: 0. Collects: 0. Wins: 0.
*Player PANDAisEVIL shows: One pair of Qs [10s Qs]. Bets: 201. Collects: 399. Wins: 198.
Player AironVega shows: High card A [Ad Ks]. Bets: 201. Collects: 0. Loses: 201.
Game ended at: 2016/11/29 14:57:14

Game started
Game ID: 787017330 0.25/0.50 (PRR) Garuda - 3 (Hold'em)
Seat 7 is the button
Seat 1: choiCES (53.30).
Seat 3: Parcker (118.22).
Seat 4: IlxxxlI (20).
Seat 6: dankmann (96.56).
Seat 7: BlueSmoke (64.48).
Seat 8: gorillaman68 (52.35).
Seat 9: Spagetti1 (50.75).
Player gorillaman68 has small blind (0.25)
Player Spagetti1 has big blind (0.50)
Player IlxxxlI received card: [Jd]
Player IlxxxlI received card: [7d]
Player choiCES raises (1.50)
Player Parcker folds
Player IlxxxlI folds
Player dankmann folds
Player BlueSmoke folds
Player gorillaman68 folds
Player Spagetti1 folds
Uncalled bet (1) returned to choiCES
Player choiCES mucks cards
------ Summary ------
Pot: 1.25. Rake 0
*Player choiCES mucks (does not show cards). Bets: 0.50. Collects: 1.25. Wins: 0.75.
Player Parcker does not show cards.Bets: 0. Collects: 0. Wins: 0.
Player IlxxxlI does not show cards.Bets: 0. Collects: 0. Wins: 0.
Player dankmann does not show cards.Bets: 0. Collects: 0. Wins: 0.
Player BlueSmoke does not show cards.Bets: 0. Collects: 0. Wins: 0.
Player gorillaman68 does not show cards.Bets: 0.25. Collects: 0. Loses: 0.25.
Player Spagetti1 does not show cards.Bets: 0.50. Collects: 0. Loses: 0.50.
Game ended at: 2016/11/29 14:55:17

Game started
Game ID: 787017329 1/2 (PRR) Lakhey (Short) - 2 (Hold'em)
Seat 2 is the button
Seat 1: AironVega (133.26).
Seat 2: IlxxxlI (42).
Seat 3: VegetablesArentYummy (100).
Seat 4: pineapplesand (40).
Seat 5: aleks0v (155.72).
Seat 6: anarkopoker (113.70).
Player VegetablesArentYummy has small blind (1)
Player pineapplesand has big blind (2)
Player IlxxxlI received card: [5c]
Player IlxxxlI received card: [Jc]
Player aleks0v folds
Player anarkopoker folds
Player AironVega folds
Player IlxxxlI folds
Player VegetablesArentYummy folds
Uncalled bet (1) returned to pineapplesand
Player pineapplesand mucks cards
------ Summary ------
Pot: 2. Rake 0
Player AironVega does not show cards.Bets: 0. Collects: 0. Wins: 0.
Player IlxxxlI does not show cards.Bets: 0. Collects: 0. Wins: 0.
Player VegetablesArentYummy does not show cards.Bets: 1. Collects: 0. Loses: 1.
*Player pineapplesand mucks (does not show cards). Bets: 1. Collects: 2. Wins: 1.
Player aleks0v does not show cards.Bets: 0. Collects: 0. Wins: 0.
Player anarkopoker does not show cards.Bets: 0. Collects: 0. Wins: 0.
Game ended at: 2016/11/29 14:55:22

Game started
Game ID: 787017304 0.50/1 (PRR) Kraken - 6 (Hold'em)
Seat 1 is the button
Seat 1: WeakAndWeary (101).
Seat 2: aleks0v (100).
Seat 3: AironVega (108.05).
Seat 4: ali23imsirovic (137.98).
Seat 5: Sephiroth1 (83.10).
Seat 6: IlxxxlI (40).
Player aleks0v has small blind (0.50)
Player AironVega has big blind (1)
Player IlxxxlI received card: [7c]
Player IlxxxlI received card: [7h]
Player ali23imsirovic folds
Player Sephiroth1 folds
Player IlxxxlI calls (1)
Player WeakAndWeary raises (3)
Player aleks0v folds
Player AironVega folds
Player IlxxxlI calls (2)
*** FLOP ***: [6c 5h 7s]
Player IlxxxlI checks
Player WeakAndWeary bets (4.76)
Player IlxxxlI calls (4.76)
*** TURN ***: [6c 5h 7s] [Kc]
Player IlxxxlI checks
Player WeakAndWeary bets (10.79)
Player IlxxxlI allin (32.24)
Player WeakAndWeary calls (21.45)
*** RIVER ***: [6c 5h 7s Kc] [9d]
------ Summary ------
Pot: 78.50. Rake 2.76. JP fee 0.24
Board: [6c 5h 7s Kc 9d]
Player WeakAndWeary shows: One pair of 10s [10h 10c]. Bets: 40. Collects: 0. Loses: 40.
Player aleks0v does not show cards.Bets: 0.50. Collects: 0. Loses: 0.50.
Player AironVega does not show cards.Bets: 1. Collects: 0. Loses: 1.
Player ali23imsirovic does not show cards.Bets: 0. Collects: 0. Wins: 0.
Player Sephiroth1 does not show cards.Bets: 0. Collects: 0. Wins: 0.
*Player IlxxxlI shows: Three Of Kind of 7s [7c 7h]. Bets: 40. Collects: 78.50. Wins: 38.50.
Game ended at: 2016/11/29 14:56:36

Game started
Game ID: 787017147 1/2 (PRR) Lakhey (Hold'em)
Seat 3 is the button
Seat 1: VegetablesArentYummy (228.50).
Seat 2: IlxxxlI (162.90).
Seat 3: IbetUmuck (826.14).
Seat 4: iBiNkUsTiNk (198).
Seat 5: PANDAisEVIL (200).
Seat 6: AironVega (229.66).
Player iBiNkUsTiNk has small blind (1)
Player PANDAisEVIL has big blind (2)
Player IlxxxlI received card: [9c]
Player IlxxxlI received card: [Jd]
Player AironVega folds
Player VegetablesArentYummy folds
Player IlxxxlI folds
Player IbetUmuck folds
Player iBiNkUsTiNk is timed out.
Player iBiNkUsTiNk folds
Uncalled bet (1) returned to PANDAisEVIL
Player PANDAisEVIL mucks cards
------ Summary ------
Pot: 2. Rake 0
Player VegetablesArentYummy does not show cards.Bets: 0. Collects: 0. Wins: 0.
Player IlxxxlI does not show cards.Bets: 0. Collects: 0. Wins: 0.
Player IbetUmuck does not show cards.Bets: 0. Collects: 0. Wins: 0.
Player iBiNkUsTiNk does not show cards.Bets: 1. Collects: 0. Loses: 1.
*Player PANDAisEVIL mucks (does not show cards). Bets: 1. Collects: 2. Wins: 1.
Player AironVega does not show cards.Bets: 0. Collects: 0. Wins: 0.
Game ended at: 2016/11/29 14:55:5

Game started
Game ID: 787017134 0.50/1 (PRR) Karkadann (Hold'em)
Seat 5 is the button
Seat 1: StephCurry (100).
Seat 2: PANDAisEVIL (106.14).
Seat 3: AironVega (100).
Seat 4: IlxxxlI (40).
Seat 5: pineapplesand (99.16).
Seat 6: dankmann (110.36).
Seat 7: ElvenEyes (101.50).
Seat 8: gust (50).
Seat 9: VegetablesArentYummy (260.19).
Player dankmann has small blind (0.50)
Player ElvenEyes has big blind (1)
Player IlxxxlI received card: [9s]
Player IlxxxlI received card: [5s]
Player gust folds
Player VegetablesArentYummy folds
Player StephCurry folds
Player PANDAisEVIL folds
Player AironVega folds
Player IlxxxlI folds
Player pineapplesand raises (2)
Player dankmann calls (1.50)
Player ElvenEyes folds
*** FLOP ***: [Qh Kh 3c]
Player dankmann checks
Player pineapplesand bets (2.37)
Player dankmann raises (9.48)
Player pineapplesand calls (7.11)
*** TURN ***: [Qh Kh 3c] [10c]
Player dankmann bets (16)
Player pineapplesand allin (87.68)
Player dankmann calls (71.68)
*** RIVER ***: [Qh Kh 3c 10c] [3d]
------ Summary ------
Pot: 196.32. Rake 2.76. JP fee 0.24
Board: [Qh Kh 3c 10c 3d]
Player StephCurry does not show cards.Bets: 0. Collects: 0. Wins: 0.
Player PANDAisEVIL does not show cards.Bets: 0. Collects: 0. Wins: 0.
Player AironVega does not show cards.Bets: 0. Collects: 0. Wins: 0.
Player IlxxxlI does not show cards.Bets: 0. Collects: 0. Wins: 0.
Player pineapplesand shows: Two pairs. 10s and 3s [10h 6h]. Bets: 99.16. Collects: 0. Loses: 99.16.
*Player dankmann shows: Two pairs. Ks and Qs [Qd Kd]. Bets: 99.16. Collects: 196.32. Wins: 97.16.
Player ElvenEyes does not show cards.Bets: 1. Collects: 0. Loses: 1.
Player gust does not show cards.Bets: 0. Collects: 0. Wins: 0.
Player VegetablesArentYummy does not show cards.Bets: 0. Collects: 0. Wins: 0.
Game ended at: 2016/11/29 14:56:46

Game started
Game ID: 787017071 0.25/0.50 (PRR) Gorgons (Cap) - 2 (Hold'em)
Seat 6 is the button
Seat 1: cuervo_ (7.81).
Seat 2: IlxxxlI (20).
Seat 3: jjeannin1 (32.46).
Seat 4: trader063 (42.69).
Seat 5: Parcker (63.31).
Seat 6: Jui Kuen (77).
Player cuervo_ has small blind (0.25)
Player IlxxxlI has big blind (0.50)
Player IlxxxlI received card: [10h]
Player IlxxxlI received card: [10d]
Player jjeannin1 folds
Player trader063 calls (0.50)
Player Parcker raises (2.25)
Player Jui Kuen folds
Player cuervo_ allin (7.56)
Player IlxxxlI caps (14.50)
Player trader063 folds
Player Parcker calls (12.75)
*** FLOP ***: [2c Qd Ks]
*** TURN ***: [2c Qd Ks] [9c]
*** RIVER ***: [2c Qd Ks 9c] [4d]
Player cuervo_ mucks cards
------ Summary ------
Pot: 36.40. Rake 1.67. JP fee 0.24
Board: [2c Qd Ks 9c 4d]
Player cuervo_ mucks (does not show cards). Bets: 7.81. Collects: 0. Loses: 7.81.
Player IlxxxlI shows: One pair of 10s [10h 10d]. Bets: 15. Collects: 0. Loses: 15.
Player jjeannin1 does not show cards.Bets: 0. Collects: 0. Wins: 0.
Player trader063 does not show cards.Bets: 0.50. Collects: 0. Loses: 0.50.
*Player Parcker shows: One pair of Ks [Ac Kd]. Bets: 15. Collects: 36.40. Wins: 21.40.
Player Jui Kuen does not show cards.Bets: 0. Collects: 0. Wins: 0.
Game ended at: 2016/11/29 14:55:22

Game started
Game ID: 787017059 1/2 (PRR) Lakhey (Short) - 2 (Hold'em)
Seat 1 is the button
Seat 1: AironVega (133.26).
Seat 2: IlxxxlI (40).
Seat 3: VegetablesArentYummy (100).
Seat 4: pineapplesand (40).
Seat 5: aleks0v (155.72).
Seat 6: anarkopoker (113.70).
Player IlxxxlI has small blind (1)
Player VegetablesArentYummy has big blind (2)
Player IlxxxlI received card: [Kc]
Player IlxxxlI received card: [4c]
Player pineapplesand folds
Player aleks0v folds
Player anarkopoker folds
Player AironVega folds
Player IlxxxlI raises (4)
Player VegetablesArentYummy folds
Uncalled bet (3) returned to IlxxxlI
Player IlxxxlI mucks cards
------ Summary ------
Pot: 4. Rake 0
Player AironVega does not show cards.Bets: 0. Collects: 0. Wins: 0.
*Player IlxxxlI mucks (does not show cards). Bets: 2. Collects: 4. Wins: 2.
Player VegetablesArentYummy does not show cards.Bets: 2. Collects: 0. Loses: 2.
Player pineapplesand does not show cards.Bets: 0. Collects: 0. Wins: 0.
Player aleks0v does not show cards.Bets: 0. Collects: 0. Wins: 0.
Player anarkopoker does not show cards.Bets: 0. Collects: 0. Wins: 0.
Game ended at: 2016/11/29 14:54:57

Game started
Game ID: 787017011 0.25/0.50 (PRR) Garuda - 3 (Hold'em)
Seat 6 is the button
Seat 1: choiCES (53.30).
Seat 3: Parcker (118.22).
Seat 4: IlxxxlI (20).
Seat 6: dankmann (96.56).
Seat 7: BlueSmoke (63.13).
Seat 8: gorillaman68 (53.85).
Seat 9: Spagetti1 (50.75).
Player BlueSmoke has small blind (0.25)
Player gorillaman68 has big blind (0.50)
Player IlxxxlI received card: [10c]
Player IlxxxlI received card: [5c]
Player Spagetti1 folds
Player choiCES folds
Player Parcker folds
Player IlxxxlI folds
Player dankmann folds
Player BlueSmoke raises (1.25)
Player gorillaman68 calls (1)
*** FLOP ***: [2s 6h 4s]
Player BlueSmoke bets (2.14)
Player gorillaman68 folds
Uncalled bet (2.14) returned to BlueSmoke
Player BlueSmoke mucks cards
------ Summary ------
Pot: 2.85. Rake 0.11. JP fee 0.04
Board: [2s 6h 4s]
Player choiCES does not show cards.Bets: 0. Collects: 0. Wins: 0.
Player Parcker does not show cards.Bets: 0. Collects: 0. Wins: 0.
Player IlxxxlI does not show cards.Bets: 0. Collects: 0. Wins: 0.
Player dankmann does not show cards.Bets: 0. Collects: 0. Wins: 0.
*Player BlueSmoke mucks (does not show cards). Bets: 1.50. Collects: 2.85. Wins: 1.35.
Player gorillaman68 does not show cards.Bets: 1.50. Collects: 0. Loses: 1.50.
Player Spagetti1 does not show cards.Bets: 0. Collects: 0. Wins: 0.
Game ended at: 2016/11/29 14:54:57

Game started
Game ID: 787017020 1/2 (PRR) Lakhey (Hold'em)
Seat 2 is the button
Seat 1: VegetablesArentYummy (228.50).
Seat 2: IlxxxlI (162.90).
Seat 3: IbetUmuck (824.14).
Seat 4: iBiNkUsTiNk (200).
Seat 5: PANDAisEVIL (200).
Seat 6: AironVega (229.66).
Player IbetUmuck has small blind (1)
Player iBiNkUsTiNk has big blind (2)
Player IlxxxlI received card: [8h]
Player IlxxxlI received card: [Jc]
Player PANDAisEVIL folds
Player AironVega folds
Player VegetablesArentYummy folds
Player IlxxxlI folds
Player IbetUmuck raises (4)
Player iBiNkUsTiNk folds
Uncalled bet (3) returned to IbetUmuck
Player IbetUmuck mucks cards
------ Summary ------
Pot: 4. Rake 0
Player VegetablesArentYummy does not show cards.Bets: 0. Collects: 0. Wins: 0.
Player IlxxxlI does not show cards.Bets: 0. Collects: 0. Wins: 0.
*Player IbetUmuck mucks (does not show cards). Bets: 2. Collects: 4. Wins: 2.
Player iBiNkUsTiNk does not show cards.Bets: 2. Collects: 0. Loses: 2.
Player PANDAisEVIL does not show cards.Bets: 0. Collects: 0. Wins: 0.
Player AironVega does not show cards.Bets: 0. Collects: 0. Wins: 0.
Game ended at: 2016/11/29 14:54:30

Game started
Game ID: 787016856 1/2 (PRR) Longana (Short) - 2 (Hold'em)
Seat 7 is the button
Seat 1: aleks0v (103).
Seat 2: PANDAisEVIL (105.50).
Seat 3: VegetablesArentYummy (132.13).
Seat 4: gust (84.40).
Seat 5: thimk (88.75).
Seat 6: IlxxxlI (46).
Seat 7: pineapplesand (42).
Seat 8: StephCurry (108.50).
Player StephCurry has small blind (1)
Player aleks0v has big blind (2)
Player IlxxxlI received card: [2d]
Player IlxxxlI received card: [Qs]
Player PANDAisEVIL folds
Player VegetablesArentYummy folds
Player gust folds
Player thimk folds
Player IlxxxlI folds
Player pineapplesand raises (4)
Player StephCurry folds
Player aleks0v calls (2)
*** FLOP ***: [Jd 5h Ad]
Player aleks0v checks
Player pineapplesand bets (4.27)
Player aleks0v calls (4.27)
*** TURN ***: [Jd 5h Ad] [Kc]
Player aleks0v checks
Player pineapplesand checks
*** RIVER ***: [Jd 5h Ad Kc] [4s]
Player aleks0v bets (7.11)
Player pineapplesand calls (7.11)
Player pineapplesand mucks cards
------ Summary ------
Pot: 30.18. Rake 1.34. JP fee 0.24
Board: [Jd 5h Ad Kc 4s]
*Player aleks0v shows: One pair of As [Ac 8s]. Bets: 15.38. Collects: 30.18. Wins: 14.80.
Player PANDAisEVIL does not show cards.Bets: 0. Collects: 0. Wins: 0.
Player VegetablesArentYummy does not show cards.Bets: 0. Collects: 0. Wins: 0.
Player gust does not show cards.Bets: 0. Collects: 0. Wins: 0.
Player thimk does not show cards.Bets: 0. Collects: 0. Wins: 0.
Player IlxxxlI does not show cards.Bets: 0. Collects: 0. Wins: 0.
Player pineapplesand mucks (does not show cards). Bets: 15.38. Collects: 0. Loses: 15.38.
Player StephCurry does not show cards.Bets: 1. Collects: 0. Loses: 1.
Game ended at: 2016/11/29 14:56:27

Game started
Game ID: 787016822 0.25/0.50 (PRR) Garuda - 3 (Hold'em)
Seat 4 is the button
Seat 1: choiCES (53.30).
Seat 3: Parcker (118.22).
Seat 4: IlxxxlI (20).
Seat 6: dankmann (96.81).
Seat 7: BlueSmoke (62.88).
Seat 8: gorillaman68 (53.85).
Seat 9: Spagetti1 (50.75).
Player dankmann has small blind (0.25)
Player BlueSmoke has big blind (0.50)
Player IlxxxlI received card: [2d]
Player IlxxxlI received card: [9s]
Player gorillaman68 folds
Player Spagetti1 folds
Player choiCES folds
Player Parcker folds
Player IlxxxlI folds
Player dankmann folds
Uncalled bet (0.25) returned to BlueSmoke
Player BlueSmoke mucks cards
------ Summary ------
Pot: 0.50. Rake 0
Player choiCES does not show cards.Bets: 0. Collects: 0. Wins: 0.
Player Parcker does not show cards.Bets: 0. Collects: 0. Wins: 0.
Player IlxxxlI does not show cards.Bets: 0. Collects: 0. Wins: 0.
Player dankmann does not show cards.Bets: 0.25. Collects: 0. Loses: 0.25.
*Player BlueSmoke mucks (does not show cards). Bets: 0.25. Collects: 0.50. Wins: 0.25.
Player gorillaman68 does not show cards.Bets: 0. Collects: 0. Wins: 0.
Player Spagetti1 does not show cards.Bets: 0. Collects: 0. Wins: 0.
Game ended at: 2016/11/29 14:54:9

Game started
Game ID: 787016821 0.50/1 (PRR) Karkadann - 3 (Hold'em)
Seat 3 is the button
Seat 2: ElvenEyes (168.15).
Seat 3: StephCurry (110.85).
Seat 4: gust (50.95).
Seat 5: pineapplesand (40).
Seat 6: AironVega (103.78).
Seat 7: IlxxxlI (44.10).
Seat 8: dankmann (142.69).
Seat 9: VegetablesArentYummy (257.91).
Player gust has small blind (0.50)
Player pineapplesand has big blind (1)
Player IlxxxlI received card: [Qh]
Player IlxxxlI received card: [7h]
Player AironVega folds
Player IlxxxlI folds
Player dankmann folds
Player VegetablesArentYummy folds
Player ElvenEyes folds
Player StephCurry raises (2)
Player gust folds
Player pineapplesand calls (1)
*** FLOP ***: [5h Jh 7c]
Player pineapplesand checks
Player StephCurry bets (2.85)
Player pineapplesand raises (7)
Player StephCurry allin (106)
Player pineapplesand allin (31)
Uncalled bet (70.85) returned to StephCurry
*** TURN ***: [5h Jh 7c] [3h]
*** RIVER ***: [5h Jh 7c 3h] [10s]
------ Summary ------
Pot: 77.50. Rake 2.76. JP fee 0.24
Board: [5h Jh 7c 3h 10s]
Player ElvenEyes does not show cards.Bets: 0. Collects: 0. Wins: 0.
*Player StephCurry shows: High card J [8s 6s]. Bets: 40. Collects: 38.75. Loses: 1.25.
Player gust does not show cards.Bets: 0.50. Collects: 0. Loses: 0.50.
*Player pineapplesand shows: High card J [8d 6c]. Bets: 40. Collects: 38.75. Loses: 1.25.
Player AironVega does not show cards.Bets: 0. Collects: 0. Wins: 0.
Player IlxxxlI does not show cards.Bets: 0. Collects: 0. Wins: 0.
Player dankmann does not show cards.Bets: 0. Collects: 0. Wins: 0.
Player VegetablesArentYummy does not show cards.Bets: 0. Collects: 0. Wins: 0.
Game ended at: 2016/11/29 14:56:3

Game started
Game ID: 787016813 0.50/1 (PRR) Kraken - 6 (Hold'em)
Seat 6 is the button
Seat 1: WeakAndWeary (101.50).
Seat 2: aleks0v (100).
Seat 3: AironVega (108.05).
Seat 4: ali23imsirovic (118.55).
Seat 5: Sephiroth1 (103.10).
Seat 6: IlxxxlI (40).
Player WeakAndWeary has small blind (0.50)
Player aleks0v has big blind (1)
Player IlxxxlI received card: [3d]
Player IlxxxlI received card: [Ah]
Player AironVega folds
Player ali23imsirovic raises (3)
Player Sephiroth1 calls (3)
Player IlxxxlI folds
Player WeakAndWeary folds
Player aleks0v folds
*** FLOP ***: [2d 7h 5h]
Player ali23imsirovic bets (5)
Player Sephiroth1 calls (5)
*** TURN ***: [2d 7h 5h] [Ac]
Player ali23imsirovic bets (12)
Player Sephiroth1 calls (12)
*** RIVER ***: [2d 7h 5h Ac] [Qh]
Player ali23imsirovic checks
Player Sephiroth1 checks
Player Sephiroth1 mucks cards
------ Summary ------
Pot: 39.43. Rake 1.83. JP fee 0.24
Board: [2d 7h 5h Ac Qh]
Player WeakAndWeary does not show cards.Bets: 0.50. Collects: 0. Loses: 0.50.
Player aleks0v does not show cards.Bets: 1. Collects: 0. Loses: 1.
Player AironVega does not show cards.Bets: 0. Collects: 0. Wins: 0.
*Player ali23imsirovic shows: One pair of Qs [Qd Kh]. Bets: 20. Collects: 39.43. Wins: 19.43.
Player Sephiroth1 mucks (does not show cards). Bets: 20. Collects: 0. Loses: 20.
Player IlxxxlI does not show cards.Bets: 0. Collects: 0. Wins: 0.
Game ended at: 2016/11/29 14:54:51

Game started
Game ID: 787016752 1/2 (PRR) Lakhey (Hold'em)
Seat 1 is the button
Seat 1: VegetablesArentYummy (228.50).
Seat 2: IlxxxlI (161.10).
Seat 3: IbetUmuck (826.14).
Seat 5: PANDAisEVIL (200).
Seat 6: AironVega (229.66).
Player IlxxxlI has small blind (1)
Player IbetUmuck has big blind (2)
Player IlxxxlI received card: [Qc]
Player IlxxxlI received card: [10h]
Player PANDAisEVIL folds
Player AironVega folds
Player VegetablesArentYummy folds
Player IlxxxlI calls (1)
Player IbetUmuck checks
*** FLOP ***: [Kc 10c 3d]
Player IlxxxlI checks
Player IbetUmuck checks
*** TURN ***: [Kc 10c 3d] [10d]
Player IlxxxlI bets (8)
Player IbetUmuck folds
Uncalled bet (8) returned to IlxxxlI
Player IlxxxlI mucks cards
------ Summary ------
Pot: 3.80. Rake 0.14. JP fee 0.06
Board: [Kc 10c 3d 10d]
Player VegetablesArentYummy does not show cards.Bets: 0. Collects: 0. Wins: 0.
*Player IlxxxlI mucks (does not show cards). Bets: 2. Collects: 3.80. Wins: 1.80.
Player IbetUmuck does not show cards.Bets: 2. Collects: 0. Loses: 2.
Player PANDAisEVIL does not show cards.Bets: 0. Collects: 0. Wins: 0.
Player AironVega does not show cards.Bets: 0. Collects: 0. Wins: 0.
Game ended at: 2016/11/29 14:54:10

Game started
Game ID: 787016623 0.25/0.50 (PRR) Garuda - 3 (Hold'em)
Seat 3 is the button
Seat 1: choiCES (52.55).
Seat 3: Parcker (118.22).
Seat 4: IlxxxlI (20).
Seat 6: dankmann (97.31).
Seat 7: BlueSmoke (62.88).
Seat 8: gorillaman68 (53.85).
Seat 9: Spagetti1 (50.75).
Player IlxxxlI has small blind (0.25)
Player dankmann has big blind (0.50)
Player IlxxxlI received card: [2d]
Player IlxxxlI received card: [3d]
Player BlueSmoke folds
Player gorillaman68 folds
Player Spagetti1 folds
Player choiCES raises (1.50)
Player Parcker folds
Player IlxxxlI folds
Player dankmann folds
Uncalled bet (1) returned to choiCES
Player choiCES mucks cards
------ Summary ------
Pot: 1.25. Rake 0
*Player choiCES mucks (does not show cards). Bets: 0.50. Collects: 1.25. Wins: 0.75.
Player Parcker does not show cards.Bets: 0. Collects: 0. Wins: 0.
Player IlxxxlI does not show cards.Bets: 0.25. Collects: 0. Loses: 0.25.
Player dankmann does not show cards.Bets: 0.50. Collects: 0. Loses: 0.50.
Player BlueSmoke does not show cards.Bets: 0. Collects: 0. Wins: 0.
Player gorillaman68 does not show cards.Bets: 0. Collects: 0. Wins: 0.
Player Spagetti1 does not show cards.Bets: 0. Collects: 0. Wins: 0.
Game ended at: 2016/11/29 14:53:42

Game started
Game ID: 787016615 0.50/1 (PRR) Kraken - 6 (Hold'em)
Seat 5 is the button
Seat 1: WeakAndWeary (101).
Seat 2: aleks0v (100).
Seat 3: AironVega (108.05).
Seat 4: ali23imsirovic (118.55).
Seat 5: Sephiroth1 (103.10).
Seat 6: IlxxxlI (40).
Player IlxxxlI has small blind (0.50)
Player WeakAndWeary has big blind (1)
Player IlxxxlI received card: [5c]
Player IlxxxlI received card: [9d]
Player aleks0v folds
Player AironVega folds
Player ali23imsirovic folds
Player Sephiroth1 folds
Player IlxxxlI folds
Uncalled bet (0.50) returned to WeakAndWeary
Player WeakAndWeary mucks cards
------ Summary ------
Pot: 1. Rake 0
*Player WeakAndWeary mucks (does not show cards). Bets: 0.50. Collects: 1. Wins: 0.50.
Player aleks0v does not show cards.Bets: 0. Collects: 0. Wins: 0.
Player AironVega does not show cards.Bets: 0. Collects: 0. Wins: 0.
Player ali23imsirovic does not show cards.Bets: 0. Collects: 0. Wins: 0.
Player Sephiroth1 does not show cards.Bets: 0. Collects: 0. Wins: 0.
Player IlxxxlI does not show cards.Bets: 0.50. Collects: 0. Loses: 0.50.
Game ended at: 2016/11/29 14:53:41

Game started
Game ID: 787016611 0.50/1 (PRR) Karkadann (Hold'em)
Seat 4 is the button
Seat 1: StephCurry (100).
Seat 2: PANDAisEVIL (106.14).
Seat 3: AironVega (100).
Seat 4: IlxxxlI (40).
Seat 5: pineapplesand (98.16).
Seat 6: dankmann (111.36).
Seat 7: ElvenEyes (101.50).
Seat 8: gust (50).
Seat 9: VegetablesArentYummy (260.19).
Player pineapplesand has small blind (0.50)
Player dankmann has big blind (1)
Player IlxxxlI received card: [Qd]
Player IlxxxlI received card: [4c]
Player ElvenEyes folds
Player gust folds
Player VegetablesArentYummy folds
Player StephCurry folds
Player PANDAisEVIL folds
Player AironVega folds
Player IlxxxlI folds
Player pineapplesand raises (2.50)
Player dankmann folds
Uncalled bet (2) returned to pineapplesand
Player pineapplesand mucks cards
------ Summary ------
Pot: 2. Rake 0
Player StephCurry does not show cards.Bets: 0. Collects: 0. Wins: 0.
Player PANDAisEVIL does not show cards.Bets: 0. Collects: 0. Wins: 0.
Player AironVega does not show cards.Bets: 0. Collects: 0. Wins: 0.
Player IlxxxlI does not show cards.Bets: 0. Collects: 0. Wins: 0.
*Player pineapplesand mucks (does not show cards). Bets: 1. Collects: 2. Wins: 1.
Player dankmann does not show cards.Bets: 1. Collects: 0. Loses: 1.
Player ElvenEyes does not show cards.Bets: 0. Collects: 0. Wins: 0.
Player gust does not show cards.Bets: 0. Collects: 0. Wins: 0.
Player VegetablesArentYummy does not show cards.Bets: 0. Collects: 0. Wins: 0.
Game ended at: 2016/11/29 14:54:29

Game started
Game ID: 787016571 0.50/1 (PRR) Karkadann - 3 (Hold'em)
Seat 2 is the button
Seat 2: ElvenEyes (168.15).
Seat 3: StephCurry (111.35).
Seat 4: gust (51.95).
Seat 5: pineapplesand (40).
Seat 6: AironVega (102.28).
Seat 7: IlxxxlI (44.10).
Seat 8: dankmann (142.69).
Seat 9: VegetablesArentYummy (257.91).
Player StephCurry has small blind (0.50)
Player gust has big blind (1)
Player IlxxxlI received card: [5s]
Player IlxxxlI received card: [6h]
Player pineapplesand folds
Player AironVega raises (3)
Player IlxxxlI folds
Player dankmann folds
Player VegetablesArentYummy folds
Player ElvenEyes folds
Player StephCurry folds
Player gust folds
Uncalled bet (2) returned to AironVega
Player AironVega mucks cards
------ Summary ------
Pot: 2.50. Rake 0
Player ElvenEyes does not show cards.Bets: 0. Collects: 0. Wins: 0.
Player StephCurry does not show cards.Bets: 0.50. Collects: 0. Loses: 0.50.
Player gust does not show cards.Bets: 1. Collects: 0. Loses: 1.
Player pineapplesand does not show cards.Bets: 0. Collects: 0. Wins: 0.
*Player AironVega mucks (does not show cards). Bets: 1. Collects: 2.50. Wins: 1.50.
Player IlxxxlI does not show cards.Bets: 0. Collects: 0. Wins: 0.
Player dankmann does not show cards.Bets: 0. Collects: 0. Wins: 0.
Player VegetablesArentYummy does not show cards.Bets: 0. Collects: 0. Wins: 0.
Game ended at: 2016/11/29 14:53:42

Game started
Game ID: 787016535 1/2 (PRR) Longana (Short) - 2 (Hold'em)
Seat 6 is the button
Seat 1: aleks0v (103).
Seat 2: PANDAisEVIL (105.50).
Seat 3: VegetablesArentYummy (132.13).
Seat 4: gust (84.40).
Seat 5: thimk (88.75).
Seat 6: IlxxxlI (46).
Seat 7: pineapplesand (40).
Seat 8: StephCurry (110.50).
Seat 9: hotshothotgg (98.04).
Player pineapplesand has small blind (1)
Player StephCurry has big blind (2)
Player IlxxxlI received card: [5c]
Player IlxxxlI received card: [3s]
Player hotshothotgg folds
Player aleks0v folds
Player PANDAisEVIL folds
Player VegetablesArentYummy folds
Player gust folds
Player thimk folds
Player IlxxxlI folds
Player pineapplesand raises (4)
Player StephCurry folds
Uncalled bet (3) returned to pineapplesand
Player pineapplesand mucks cards
------ Summary ------
Pot: 4. Rake 0
Player aleks0v does not show cards.Bets: 0. Collects: 0. Wins: 0.
Player PANDAisEVIL does not show cards.Bets: 0. Collects: 0. Wins: 0.
Player VegetablesArentYummy does not show cards.Bets: 0. Collects: 0. Wins: 0.
Player gust does not show cards.Bets: 0. Collects: 0. Wins: 0.
Player thimk does not show cards.Bets: 0. Collects: 0. Wins: 0.
Player IlxxxlI does not show cards.Bets: 0. Collects: 0. Wins: 0.
*Player pineapplesand mucks (does not show cards). Bets: 2. Collects: 4. Wins: 2.
Player StephCurry does not show cards.Bets: 2. Collects: 0. Loses: 2.
Player hotshothotgg does not show cards.Bets: 0. Collects: 0. Wins: 0.
Game ended at: 2016/11/29 14:53:47

Game started
Game ID: 787016528 0.25/0.50 (PRR) Gorgons (Cap) - 2 (Hold'em)
Seat 5 is the button
Seat 1: cuervo_ (8.31).
Seat 2: IlxxxlI (20.75).
Seat 3: jjeannin1 (42.21).
Seat 4: trader063 (31.54).
Seat 5: Parcker (63.31).
Seat 6: Jui Kuen (77.25).
Player Jui Kuen has small blind (0.25)
Player cuervo_ has big blind (0.50)
Player IlxxxlI received card: [Js]
Player IlxxxlI received card: [Ks]
Player IlxxxlI raises (1.75)
Player jjeannin1 calls (1.75)
Player trader063 calls (1.75)
Player Parcker folds
Player Jui Kuen folds
Player cuervo_ folds
*** FLOP ***: [5c Qc 6d]
Player IlxxxlI checks
Player jjeannin1 bets (3)
Player trader063 calls (3)
Player IlxxxlI folds
*** TURN ***: [5c Qc 6d] [4d]
Player jjeannin1 bets (5)
Player trader063 calls (5)
*** RIVER ***: [5c Qc 6d 4d] [6h]
Player jjeannin1 checks
Player trader063 checks
------ Summary ------
Pot: 20.90. Rake 0.86. JP fee 0.24
Board: [5c Qc 6d 4d 6h]
Player cuervo_ does not show cards.Bets: 0.50. Collects: 0. Loses: 0.50.
Player IlxxxlI does not show cards.Bets: 1.75. Collects: 0. Loses: 1.75.
Player jjeannin1 shows: One pair of 6s [10s Jd]. Bets: 9.75. Collects: 0. Loses: 9.75.
*Player trader063 shows: Two pairs. Qs and 6s [Qs Ad]. Bets: 9.75. Collects: 20.90. Wins: 11.15.
Player Parcker does not show cards.Bets: 0. Collects: 0. Wins: 0.
Player Jui Kuen does not show cards.Bets: 0.25. Collects: 0. Loses: 0.25.
Game ended at: 2016/11/29 14:54:16

Game started
Game ID: 787016531 1/2 (PRR) Lakhey (Short) - 2 (Hold'em)
Seat 6 is the button
Seat 1: AironVega (116.47).
Seat 2: IlxxxlI (40).
Seat 3: VegetablesArentYummy (100).
Seat 4: pineapplesand (40).
Seat 5: aleks0v (155.72).
Seat 6: anarkopoker (130.24).
Player AironVega has small blind (1)
Player IlxxxlI has big blind (2)
Player IlxxxlI received card: [3d]
Player IlxxxlI received card: [10s]
Player VegetablesArentYummy folds
Player pineapplesand folds
Player aleks0v folds
Player anarkopoker raises (4.20)
Player AironVega raises (15.54)
Player IlxxxlI folds
Player anarkopoker calls (12.34)
*** FLOP ***: [9h Kc Qc]
Player AironVega bets (11)
Player anarkopoker folds
Uncalled bet (11) returned to AironVega
Player AironVega mucks cards
------ Summary ------
Pot: 33.33. Rake 1.51. JP fee 0.24
Board: [9h Kc Qc]
*Player AironVega mucks (does not show cards). Bets: 16.54. Collects: 33.33. Wins: 16.79.
Player IlxxxlI does not show cards.Bets: 2. Collects: 0. Loses: 2.
Player VegetablesArentYummy does not show cards.Bets: 0. Collects: 0. Wins: 0.
Player pineapplesand does not show cards.Bets: 0. Collects: 0. Wins: 0.
Player aleks0v does not show cards.Bets: 0. Collects: 0. Wins: 0.
Player anarkopoker does not show cards.Bets: 16.54. Collects: 0. Loses: 16.54.
Game ended at: 2016/11/29 14:54:17

Game started
Game ID: 787016474 0.25/0.50 (PRR) Garuda - 3 (Hold'em)
Seat 1 is the button
Seat 1: choiCES (52.55).
Seat 3: Parcker (118.47).
Seat 4: IlxxxlI (20).
Seat 6: dankmann (97.31).
Seat 7: BlueSmoke (62.88).
Seat 8: gorillaman68 (53.85).
Seat 9: Spagetti1 (50).
Player Parcker has small blind (0.25)
Player IlxxxlI has big blind (0.50)
Player IlxxxlI received card: [8d]
Player IlxxxlI received card: [Ah]
Player dankmann folds
Player BlueSmoke folds
Player gorillaman68 folds
Player Spagetti1 raises (1.50)
Player choiCES folds
Player Parcker folds
Player IlxxxlI folds
Uncalled bet (1) returned to Spagetti1
Player Spagetti1 mucks cards
------ Summary ------
Pot: 1.25. Rake 0
Player choiCES does not show cards.Bets: 0. Collects: 0. Wins: 0.
Player Parcker does not show cards.Bets: 0.25. Collects: 0. Loses: 0.25.
Player IlxxxlI does not show cards.Bets: 0.50. Collects: 0. Loses: 0.50.
Player dankmann does not show cards.Bets: 0. Collects: 0. Wins: 0.
Player BlueSmoke does not show cards.Bets: 0. Collects: 0. Wins: 0.
Player gorillaman68 does not show cards.Bets: 0. Collects: 0. Wins: 0.
*Player Spagetti1 mucks (does not show cards). Bets: 0.50. Collects: 1.25. Wins: 0.75.
Game ended at: 2016/11/29 14:53:11

Game started
Game ID: 787016281 0.50/1 (PRR) Kraken - 6 (Hold'em)
Seat 4 is the button
Seat 1: WeakAndWeary (101).
Seat 2: aleks0v (100).
Seat 3: AironVega (108.05).
Seat 4: ali23imsirovic (117.05).
Seat 5: Sephiroth1 (103.60).
Seat 6: IlxxxlI (40).
Player Sephiroth1 has small blind (0.50)
Player IlxxxlI has big blind (1)
Player IlxxxlI received card: [8h]
Player IlxxxlI received card: [Ks]
Player WeakAndWeary folds
Player aleks0v folds
Player AironVega folds
Player ali23imsirovic raises (3)
Player Sephiroth1 folds
Player IlxxxlI folds
Uncalled bet (2) returned to ali23imsirovic
Player ali23imsirovic mucks cards
------ Summary ------
Pot: 2.50. Rake 0
Player WeakAndWeary does not show cards.Bets: 0. Collects: 0. Wins: 0.
Player aleks0v does not show cards.Bets: 0. Collects: 0. Wins: 0.
Player AironVega does not show cards.Bets: 0. Collects: 0. Wins: 0.
*Player ali23imsirovic mucks (does not show cards). Bets: 1. Collects: 2.50. Wins: 1.50.
Player Sephiroth1 does not show cards.Bets: 0.50. Collects: 0. Loses: 0.50.
Player IlxxxlI does not show cards.Bets: 1. Collects: 0. Loses: 1.
Game ended at: 2016/11/29 14:53:9

Game started
Game ID: 787016225 0.50/1 (PRR) Karkadann - 3 (Hold'em)
Seat 9 is the button
Seat 2: ElvenEyes (168.65).
Seat 3: StephCurry (112.35).
Seat 4: gust (51.95).
Seat 5: pineapplesand (40).
Seat 6: AironVega (102.28).
Seat 7: IlxxxlI (44.10).
Seat 8: dankmann (142.69).
Seat 9: VegetablesArentYummy (256.41).
Player ElvenEyes has small blind (0.50)
Player StephCurry has big blind (1)
Player IlxxxlI received card: [6c]
Player IlxxxlI received card: [4c]
Player gust folds
Player pineapplesand folds
Player AironVega folds
Player IlxxxlI folds
Player dankmann folds
Player VegetablesArentYummy raises (2.50)
Player ElvenEyes folds
Player StephCurry folds
Uncalled bet (1.50) returned to VegetablesArentYummy
Player VegetablesArentYummy mucks cards
------ Summary ------
Pot: 2.50. Rake 0
Player ElvenEyes does not show cards.Bets: 0.50. Collects: 0. Loses: 0.50.
Player StephCurry does not show cards.Bets: 1. Collects: 0. Loses: 1.
Player gust does not show cards.Bets: 0. Collects: 0. Wins: 0.
Player pineapplesand does not show cards.Bets: 0. Collects: 0. Wins: 0.
Player AironVega does not show cards.Bets: 0. Collects: 0. Wins: 0.
Player IlxxxlI does not show cards.Bets: 0. Collects: 0. Wins: 0.
Player dankmann does not show cards.Bets: 0. Collects: 0. Wins: 0.
*Player VegetablesArentYummy mucks (does not show cards). Bets: 1. Collects: 2.50. Wins: 1.50.
Game ended at: 2016/11/29 14:53:3

Game started
Game ID: 787016095 0.25/0.50 (PRR) Gorgons (Cap) - 2 (Hold'em)
Seat 4 is the button
Seat 1: cuervo_ (8.31).
Seat 2: IlxxxlI (20).
Seat 3: jjeannin1 (42.21).
Seat 4: trader063 (31.54).
Seat 5: Parcker (63.56).
Seat 6: Jui Kuen (77.75).
Player Parcker has small blind (0.25)
Player Jui Kuen has big blind (0.50)
Player IlxxxlI received card: [9d]
Player IlxxxlI received card: [9c]
Player cuervo_ folds
Player IlxxxlI raises (1.75)
Player jjeannin1 folds
Player trader063 folds
Player Parcker folds
Player Jui Kuen folds
Uncalled bet (1.25) returned to IlxxxlI
Player IlxxxlI mucks cards
------ Summary ------
Pot: 1.25. Rake 0
Player cuervo_ does not show cards.Bets: 0. Collects: 0. Wins: 0.
*Player IlxxxlI mucks (does not show cards). Bets: 0.50. Collects: 1.25. Wins: 0.75.
Player jjeannin1 does not show cards.Bets: 0. Collects: 0. Wins: 0.
Player trader063 does not show cards.Bets: 0. Collects: 0. Wins: 0.
Player Parcker does not show cards.Bets: 0.25. Collects: 0. Loses: 0.25.
Player Jui Kuen does not show cards.Bets: 0.50. Collects: 0. Loses: 0.50.
Game ended at: 2016/11/29 14:52:54

Game started
Game ID: 787015960 1/2 (PRR) Lakhey (Hold'em)
Seat 6 is the button
Seat 1: VegetablesArentYummy (229.50).
Seat 2: IlxxxlI (81.55).
Seat 3: IbetUmuck (826.14).
Seat 5: PANDAisEVIL (211.50).
Seat 6: AironVega (229.66).
Player VegetablesArentYummy has small blind (1)
Player IlxxxlI has big blind (2)
Player IlxxxlI received card: [9s]
Player IlxxxlI received card: [Qd]
Player IbetUmuck folds
Player PANDAisEVIL raises (5)
Player AironVega folds
Player VegetablesArentYummy folds
Player IlxxxlI calls (3)
*** FLOP ***: [Js Qs 7d]
Player IlxxxlI checks
Player PANDAisEVIL bets (6.48)
Player IlxxxlI calls (6.48)
*** TURN ***: [Js Qs 7d] [5c]
Player IlxxxlI checks
Player PANDAisEVIL bets (14.12)
Player IlxxxlI calls (14.12)
*** RIVER ***: [Js Qs 7d 5c] [5d]
Player IlxxxlI checks
Player PANDAisEVIL allin (185.90)
Player IlxxxlI allin (55.95)
Uncalled bet (129.95) returned to PANDAisEVIL
------ Summary ------
Pot: 161.10. Rake 2.76. JP fee 0.24
Board: [Js Qs 7d 5c 5d]
Player VegetablesArentYummy does not show cards.Bets: 1. Collects: 0. Loses: 1.
*Player IlxxxlI shows: Two pairs. Qs and 5s [9s Qd]. Bets: 81.55. Collects: 161.10. Wins: 79.55.
Player IbetUmuck does not show cards.Bets: 0. Collects: 0. Wins: 0.
Player PANDAisEVIL shows: One pair of 5s [Kc 10h]. Bets: 81.55. Collects: 0. Loses: 81.55.
Player AironVega does not show cards.Bets: 0. Collects: 0. Wins: 0.
Game ended at: 2016/11/29 14:53:31

Game started
Game ID: 787015947 0.50/1 (PRR) Karkadann (Hold'em)
Seat 3 is the button
Seat 1: StephCurry (100).
Seat 2: PANDAisEVIL (102.46).
Seat 3: AironVega (100).
Seat 4: IlxxxlI (40).
Seat 5: pineapplesand (99.16).
Seat 6: dankmann (111.36).
Seat 7: ElvenEyes (101.50).
Seat 8: gust (50).
Seat 9: VegetablesArentYummy (262.69).
Player IlxxxlI has small blind (0.50)
Player pineapplesand has big blind (1)
Player IlxxxlI received card: [5s]
Player IlxxxlI received card: [Qd]
Player dankmann folds
Player ElvenEyes folds
Player gust folds
Player VegetablesArentYummy raises (2.50)
Player StephCurry folds
Player PANDAisEVIL calls (2.50)
Player AironVega folds
Player IlxxxlI folds
Player pineapplesand folds
*** FLOP ***: [8c 9h 4d]
Player VegetablesArentYummy checks
Player PANDAisEVIL bets (3.83)
Player VegetablesArentYummy folds
Uncalled bet (3.83) returned to PANDAisEVIL
Player PANDAisEVIL mucks cards
------ Summary ------
Pot: 6.18. Rake 0.22. JP fee 0.10
Board: [8c 9h 4d]
Player StephCurry does not show cards.Bets: 0. Collects: 0. Wins: 0.
*Player PANDAisEVIL mucks (does not show cards). Bets: 2.50. Collects: 6.18. Wins: 3.68.
Player AironVega does not show cards.Bets: 0. Collects: 0. Wins: 0.
Player IlxxxlI does not show cards.Bets: 0.50. Collects: 0. Loses: 0.50.
Player pineapplesand does not show cards.Bets: 1. Collects: 0. Loses: 1.
Player dankmann does not show cards.Bets: 0. Collects: 0. Wins: 0.
Player ElvenEyes does not show cards.Bets: 0. Collects: 0. Wins: 0.
Player gust does not show cards.Bets: 0. Collects: 0. Wins: 0.
Player VegetablesArentYummy does not show cards.Bets: 2.50. Collects: 0. Loses: 2.50.
Game ended at: 2016/11/29 14:53:9

Game started
Game ID: 787015845 0.50/1 (PRR) Karkadann - 3 (Hold'em)
Seat 8 is the button
Seat 2: ElvenEyes (165.75).
Seat 3: StephCurry (112.35).
Seat 4: gust (51.95).
Seat 5: pineapplesand (40).
Seat 6: AironVega (102.28).
Seat 7: IlxxxlI (46.50).
Seat 8: dankmann (142.69).
Seat 9: VegetablesArentYummy (256.91).
Player VegetablesArentYummy has small blind (0.50)
Player ElvenEyes has big blind (1)
Player IlxxxlI received card: [Kh]
Player IlxxxlI received card: [Qd]
Player StephCurry folds
Player gust folds
Player pineapplesand folds
Player AironVega folds
Player IlxxxlI raises (2.40)
Player dankmann folds
Player VegetablesArentYummy folds
Player ElvenEyes raises (7)
Player IlxxxlI folds
Uncalled bet (5.60) returned to ElvenEyes
Player ElvenEyes mucks cards
------ Summary ------
Pot: 5.30. Rake 0
*Player ElvenEyes mucks (does not show cards). Bets: 2.40. Collects: 5.30. Wins: 2.90.
Player StephCurry does not show cards.Bets: 0. Collects: 0. Wins: 0.
Player gust does not show cards.Bets: 0. Collects: 0. Wins: 0.
Player pineapplesand does not show cards.Bets: 0. Collects: 0. Wins: 0.
Player AironVega does not show cards.Bets: 0. Collects: 0. Wins: 0.
Player IlxxxlI does not show cards.Bets: 2.40. Collects: 0. Loses: 2.40.
Player dankmann does not show cards.Bets: 0. Collects: 0. Wins: 0.
Player VegetablesArentYummy does not show cards.Bets: 0.50. Collects: 0. Loses: 0.50.
Game ended at: 2016/11/29 14:52:10

Game started
Game ID: 787015684 1/2 (PRR) Lakhey (Hold'em)
Seat 5 is the button
Seat 1: VegetablesArentYummy (231.50).
Seat 2: IlxxxlI (81.55).
Seat 3: IbetUmuck (826.14).
Seat 5: PANDAisEVIL (208.50).
Seat 6: AironVega (230.66).
Player AironVega has small blind (1)
Player VegetablesArentYummy has big blind (2)
Player IlxxxlI received card: [7d]
Player IlxxxlI received card: [9c]
Player IlxxxlI folds
Player IbetUmuck folds
Player PANDAisEVIL raises (4.40)
Player AironVega folds
Player VegetablesArentYummy folds
Uncalled bet (2.40) returned to PANDAisEVIL
Player PANDAisEVIL mucks cards
------ Summary ------
Pot: 5. Rake 0
Player VegetablesArentYummy does not show cards.Bets: 2. Collects: 0. Loses: 2.
Player IlxxxlI does not show cards.Bets: 0. Collects: 0. Wins: 0.
Player IbetUmuck does not show cards.Bets: 0. Collects: 0. Wins: 0.
*Player PANDAisEVIL mucks (does not show cards). Bets: 2. Collects: 5. Wins: 3.
Player AironVega does not show cards.Bets: 1. Collects: 0. Loses: 1.
Game ended at: 2016/11/29 14:51:29

Game started
Game ID: 787015511 1/2 (PRR) Lakhey (Hold'em)
Seat 3 is the button
Seat 1: VegetablesArentYummy (231.50).
Seat 2: IlxxxlI (81.55).
Seat 3: IbetUmuck (826.14).
Seat 5: PANDAisEVIL (204).
Seat 6: AironVega (235.66).
Player PANDAisEVIL has small blind (1)
Player AironVega has big blind (2)
Player IlxxxlI received card: [Qd]
Player IlxxxlI received card: [3c]
Player VegetablesArentYummy folds
Player IlxxxlI folds
Player IbetUmuck folds
Player PANDAisEVIL raises (4)
Player AironVega calls (3)
*** FLOP ***: [4c 6c 9c]
Player PANDAisEVIL bets (5.89)
Player AironVega folds
Uncalled bet (5.89) returned to PANDAisEVIL
Player PANDAisEVIL mucks cards
------ Summary ------
Pot: 9.50. Rake 0.34. JP fee 0.16
Board: [4c 6c 9c]
Player VegetablesArentYummy does not show cards.Bets: 0. Collects: 0. Wins: 0.
Player IlxxxlI does not show cards.Bets: 0. Collects: 0. Wins: 0.
Player IbetUmuck does not show cards.Bets: 0. Collects: 0. Wins: 0.
*Player PANDAisEVIL mucks (does not show cards). Bets: 5. Collects: 9.50. Wins: 4.50.
Player AironVega does not show cards.Bets: 5. Collects: 0. Loses: 5.
Game ended at: 2016/11/29 14:50:46

Game started
Game ID: 787015493 0.25/0.50 (PRR) Gorgons (Cap) - 2 (Hold'em)
Seat 3 is the button
Seat 1: cuervo_ (13.81).
Seat 2: IlxxxlI (20).
Seat 3: jjeannin1 (35.83).
Seat 4: trader063 (32.54).
Seat 5: Parcker (64.06).
Seat 6: Jui Kuen (77.75).
Player trader063 has small blind (0.25)
Player Parcker has big blind (0.50)
Player IlxxxlI received card: [7h]
Player IlxxxlI received card: [5d]
Player Jui Kuen folds
Player cuervo_ raises (1)
Player IlxxxlI folds
Player jjeannin1 calls (1)
Player trader063 calls (0.75)
Player Parcker folds
*** FLOP ***: [8s 8d 3s]
Player trader063 checks
Player cuervo_ bets (1)
Player jjeannin1 calls (1)
Player trader063 folds
*** TURN ***: [8s 8d 3s] [9h]
Player cuervo_ checks
Player jjeannin1 bets (2)
Player cuervo_ calls (2)
*** RIVER ***: [8s 8d 3s 9h] [Jc]
Player cuervo_ bets (1.50)
Player jjeannin1 raises (5)
Player cuervo_ folds
Uncalled bet (3.50) returned to jjeannin1
Player jjeannin1 mucks cards
------ Summary ------
Pot: 11.88. Rake 0.42. JP fee 0.20
Board: [8s 8d 3s 9h Jc]
Player cuervo_ does not show cards.Bets: 5.50. Collects: 0. Loses: 5.50.
Player IlxxxlI does not show cards.Bets: 0. Collects: 0. Wins: 0.
*Player jjeannin1 mucks (does not show cards). Bets: 5.50. Collects: 11.88. Wins: 6.38.
Player trader063 does not show cards.Bets: 1. Collects: 0. Loses: 1.
Player Parcker does not show cards.Bets: 0.50. Collects: 0. Loses: 0.50.
Player Jui Kuen does not show cards.Bets: 0. Collects: 0. Wins: 0.
Game ended at: 2016/11/29 14:51:48

Game started
Game ID: 787015496 1/2 (PRR) Longana (Short) - 2 (Hold'em)
Seat 5 is the button
Seat 1: aleks0v (103).
Seat 2: PANDAisEVIL (105.50).
Seat 3: VegetablesArentYummy (132.13).
Seat 4: gust (84.40).
Seat 5: thimk (65.87).
Seat 6: IlxxxlI (47).
Seat 7: pineapplesand (50.35).
Seat 8: StephCurry (116.50).
Seat 9: hotshothotgg (98.04).
Player IlxxxlI has small blind (1)
Player pineapplesand has big blind (2)
Player IlxxxlI received card: [4s]
Player IlxxxlI received card: [2d]
Player StephCurry raises (6)
Player hotshothotgg folds
Player aleks0v folds
Player PANDAisEVIL folds
Player VegetablesArentYummy folds
Player gust folds
Player thimk calls (6)
Player IlxxxlI folds
Player pineapplesand calls (4)
*** FLOP ***: [Ah 8d 5c]
Player pineapplesand checks
Player StephCurry checks
Player thimk checks
*** TURN ***: [Ah 8d 5c] [4c]
Player pineapplesand bets (12.03)
Player StephCurry folds
Player thimk calls (12.03)
*** RIVER ***: [Ah 8d 5c 4c] [9c]
Player pineapplesand checks
Player thimk bets (27.27)
Player pineapplesand folds
Uncalled bet (27.27) returned to thimk
Player thimk is timed out.
Player thimk mucks cards
------ Summary ------
Pot: 40.91. Rake 1.91. JP fee 0.24
Board: [Ah 8d 5c 4c 9c]
Player aleks0v does not show cards.Bets: 0. Collects: 0. Wins: 0.
Player PANDAisEVIL does not show cards.Bets: 0. Collects: 0. Wins: 0.
Player VegetablesArentYummy does not show cards.Bets: 0. Collects: 0. Wins: 0.
Player gust does not show cards.Bets: 0. Collects: 0. Wins: 0.
*Player thimk mucks (does not show cards). Bets: 18.03. Collects: 40.91. Wins: 22.88.
Player IlxxxlI does not show cards.Bets: 1. Collects: 0. Loses: 1.
Player pineapplesand does not show cards.Bets: 18.03. Collects: 0. Loses: 18.03.
Player StephCurry does not show cards.Bets: 6. Collects: 0. Loses: 6.
Player hotshothotgg does not show cards.Bets: 0. Collects: 0. Wins: 0.
Game ended at: 2016/11/29 14:52:56

Game started
Game ID: 787015397 0.50/1 (PRR) Karkadann - 3 (Hold'em)
Seat 7 is the button
Seat 2: ElvenEyes (165.75).
Seat 3: StephCurry (101.50).
Seat 4: gust (51.95).
Seat 5: pineapplesand (40).
Seat 6: AironVega (102.28).
Seat 7: IlxxxlI (46.50).
Seat 8: dankmann (153.69).
Seat 9: VegetablesArentYummy (257.91).
Player dankmann has small blind (0.50)
Player VegetablesArentYummy has big blind (1)
Player IlxxxlI received card: [9s]
Player IlxxxlI received card: [3d]
Player ElvenEyes folds
Player StephCurry raises (3)
Player gust folds
Player pineapplesand folds
Player AironVega folds
Player IlxxxlI folds
Player dankmann raises (10.50)
Player VegetablesArentYummy folds
Player StephCurry calls (8)
*** FLOP ***: [8c 5h 9h]
Player dankmann checks
Player StephCurry bets (14.56)
Player dankmann folds
Uncalled bet (14.56) returned to StephCurry
Player StephCurry mucks cards
------ Summary ------
Pot: 21.85. Rake 0.91. JP fee 0.24
Board: [8c 5h 9h]
Player ElvenEyes does not show cards.Bets: 0. Collects: 0. Wins: 0.
*Player StephCurry mucks (does not show cards). Bets: 11. Collects: 21.85. Wins: 10.85.
Player gust does not show cards.Bets: 0. Collects: 0. Wins: 0.
Player pineapplesand does not show cards.Bets: 0. Collects: 0. Wins: 0.
Player AironVega does not show cards.Bets: 0. Collects: 0. Wins: 0.
Player IlxxxlI does not show cards.Bets: 0. Collects: 0. Wins: 0.
Player dankmann does not show cards.Bets: 11. Collects: 0. Loses: 11.
Player VegetablesArentYummy does not show cards.Bets: 1. Collects: 0. Loses: 1.
Game ended at: 2016/11/29 14:51:11

Game started
Game ID: 787015365 1/2 (PRR) Lakhey - 2 (Hold'em)
Seat 4 is the button
Seat 2: IlxxxlI (94.21).
Seat 3: gust (105.30).
Seat 4: joonjoonjoon (200).
Seat 5: VegetablesArentYummy (415.96).
Seat 6: JoeRockwell (332.17).
Player VegetablesArentYummy has small blind (1)
Player JoeRockwell has big blind (2)
Player IlxxxlI received card: [Ah]
Player IlxxxlI received card: [Qs]
Player IlxxxlI raises (7)
Player gust folds
Player joonjoonjoon folds
Player VegetablesArentYummy folds
Player JoeRockwell calls (5)
*** FLOP ***: [Qd Kc 8h]
Player JoeRockwell bets (7.12)
Player IlxxxlI calls (7.12)
*** TURN ***: [Qd Kc 8h] [4h]
Player JoeRockwell bets (18.52)
Player IlxxxlI calls (18.52)
*** RIVER ***: [Qd Kc 8h 4h] [Qc]
Player JoeRockwell checks
Player IlxxxlI bets (44)
Player JoeRockwell calls (44)
Player JoeRockwell mucks cards
------ Summary ------
Pot: 151.28. Rake 2.76. JP fee 0.24
Board: [Qd Kc 8h 4h Qc]
*Player IlxxxlI shows: Three Of Kind of Qs [Ah Qs]. Bets: 76.64. Collects: 151.28. Wins: 74.64.
Player gust does not show cards.Bets: 0. Collects: 0. Wins: 0.
Player joonjoonjoon does not show cards.Bets: 0. Collects: 0. Wins: 0.
Player VegetablesArentYummy does not show cards.Bets: 1. Collects: 0. Loses: 1.
Player JoeRockwell mucks (does not show cards). Bets: 76.64. Collects: 0. Loses: 76.64.
Game ended at: 2016/11/29 14:51:15

Game started
Game ID: 787015266 0.50/1 (PRR) Karkadann (Hold'em)
Seat 2 is the button
Seat 1: StephCurry (100).
Seat 2: PANDAisEVIL (100).
Seat 3: AironVega (100).
Seat 4: IlxxxlI (40).
Seat 5: pineapplesand (99.16).
Seat 6: dankmann (111.36).
Seat 7: ElvenEyes (101.50).
Seat 8: gust (50).
Seat 9: VegetablesArentYummy (262.69).
Player AironVega has small blind (0.50)
Player IlxxxlI has big blind (1)
Player IlxxxlI received card: [Jc]
Player IlxxxlI received card: [3c]
Player pineapplesand folds
Player dankmann folds
Player ElvenEyes folds
Player gust folds
Player VegetablesArentYummy folds
Player StephCurry folds
Player PANDAisEVIL raises (2.20)
Player AironVega folds
Player IlxxxlI calls (1.20)
*** FLOP ***: [10s 8c 2s]
Player IlxxxlI checks
Player PANDAisEVIL bets (2.89)
Player IlxxxlI folds
Uncalled bet (2.89) returned to PANDAisEVIL
Player PANDAisEVIL mucks cards
------ Summary ------
Pot: 4.66. Rake 0.16. JP fee 0.08
Board: [10s 8c 2s]
Player StephCurry does not show cards.Bets: 0. Collects: 0. Wins: 0.
*Player PANDAisEVIL mucks (does not show cards). Bets: 2.20. Collects: 4.66. Wins: 2.46.
Player AironVega does not show cards.Bets: 0.50. Collects: 0. Loses: 0.50.
Player IlxxxlI does not show cards.Bets: 2.20. Collects: 0. Loses: 2.20.
Player pineapplesand does not show cards.Bets: 0. Collects: 0. Wins: 0.
Player dankmann does not show cards.Bets: 0. Collects: 0. Wins: 0.
Player ElvenEyes does not show cards.Bets: 0. Collects: 0. Wins: 0.
Player gust does not show cards.Bets: 0. Collects: 0. Wins: 0.
Player VegetablesArentYummy does not show cards.Bets: 0. Collects: 0. Wins: 0.
Game ended at: 2016/11/29 14:51:27

Game started
Game ID: 787015247 1/2 (PRR) Longana (Short) - 2 (Hold'em)
Seat 4 is the button
Seat 1: aleks0v (103).
Seat 2: PANDAisEVIL (105.50).
Seat 3: VegetablesArentYummy (132.13).
Seat 4: gust (84.40).
Seat 5: thimk (66.87).
Seat 6: IlxxxlI (49).
Seat 7: pineapplesand (50.35).
Seat 8: StephCurry (116.50).
Seat 9: hotshothotgg (95.04).
Player thimk has small blind (1)
Player IlxxxlI has big blind (2)
Player IlxxxlI received card: [6h]
Player IlxxxlI received card: [9c]
Player pineapplesand folds
Player StephCurry folds
Player hotshothotgg raises (4)
Player aleks0v folds
Player PANDAisEVIL folds
Player VegetablesArentYummy folds
Player gust folds
Player thimk folds
Player IlxxxlI folds
Uncalled bet (2) returned to hotshothotgg
Player hotshothotgg mucks cards
------ Summary ------
Pot: 5. Rake 0
Player aleks0v does not show cards.Bets: 0. Collects: 0. Wins: 0.
Player PANDAisEVIL does not show cards.Bets: 0. Collects: 0. Wins: 0.
Player VegetablesArentYummy does not show cards.Bets: 0. Collects: 0. Wins: 0.
Player gust does not show cards.Bets: 0. Collects: 0. Wins: 0.
Player thimk does not show cards.Bets: 1. Collects: 0. Loses: 1.
Player IlxxxlI does not show cards.Bets: 2. Collects: 0. Loses: 2.
Player pineapplesand does not show cards.Bets: 0. Collects: 0. Wins: 0.
Player StephCurry does not show cards.Bets: 0. Collects: 0. Wins: 0.
*Player hotshothotgg mucks (does not show cards). Bets: 2. Collects: 5. Wins: 3.
Game ended at: 2016/11/29 14:50:16

Game started
Game ID: 787015234 0.50/1 (PRR) Karkadann - 3 (Hold'em)
Seat 6 is the button
Seat 2: ElvenEyes (165.75).
Seat 3: StephCurry (101.50).
Seat 4: gust (51.95).
Seat 5: pineapplesand (40).
Seat 6: AironVega (100.78).
Seat 7: IlxxxlI (47).
Seat 8: dankmann (154.69).
Seat 9: VegetablesArentYummy (257.91).
Player IlxxxlI has small blind (0.50)
Player dankmann has big blind (1)
Player IlxxxlI received card: [9c]
Player IlxxxlI received card: [7d]
Player VegetablesArentYummy folds
Player ElvenEyes folds
Player StephCurry folds
Player gust folds
Player pineapplesand folds
Player AironVega raises (2)
Player IlxxxlI folds
Player dankmann folds
Uncalled bet (1) returned to AironVega
Player AironVega mucks cards
------ Summary ------
Pot: 2.50. Rake 0
Player ElvenEyes does not show cards.Bets: 0. Collects: 0. Wins: 0.
Player StephCurry does not show cards.Bets: 0. Collects: 0. Wins: 0.
Player gust does not show cards.Bets: 0. Collects: 0. Wins: 0.
Player pineapplesand does not show cards.Bets: 0. Collects: 0. Wins: 0.
*Player AironVega mucks (does not show cards). Bets: 1. Collects: 2.50. Wins: 1.50.
Player IlxxxlI does not show cards.Bets: 0.50. Collects: 0. Loses: 0.50.
Player dankmann does not show cards.Bets: 1. Collects: 0. Loses: 1.
Player VegetablesArentYummy does not show cards.Bets: 0. Collects: 0. Wins: 0.
Game ended at: 2016/11/29 14:50:0

Game started
Game ID: 787015077 0.25/0.50 (PRR) Gorgons (Cap) - 2 (Hold'em)
Seat 2 is the button
Seat 1: cuervo_ (13.81).
Seat 2: IlxxxlI (20).
Seat 3: jjeannin1 (36.08).
Seat 4: trader063 (34.04).
Seat 5: Parcker (62.47).
Seat 6: Jui Kuen (77.75).
Player jjeannin1 has small blind (0.25)
Player trader063 has big blind (0.50)
Player IlxxxlI received card: [5c]
Player IlxxxlI received card: [4s]
Player Parcker raises (1.50)
Player Jui Kuen folds
Player cuervo_ folds
Player IlxxxlI folds
Player jjeannin1 folds
Player trader063 calls (1)
*** FLOP ***: [As 4d 2d]
Player trader063 checks
Player Parcker checks
*** TURN ***: [As 4d 2d] [3c]
Player trader063 checks
Player Parcker bets (2.32)
Player trader063 folds
Uncalled bet (2.32) returned to Parcker
Player Parcker mucks cards
------ Summary ------
Pot: 3.09. Rake 0.12. JP fee 0.04
Board: [As 4d 2d 3c]
Player cuervo_ does not show cards.Bets: 0. Collects: 0. Wins: 0.
Player IlxxxlI does not show cards.Bets: 0. Collects: 0. Wins: 0.
Player jjeannin1 does not show cards.Bets: 0.25. Collects: 0. Loses: 0.25.
Player trader063 does not show cards.Bets: 1.50. Collects: 0. Loses: 1.50.
*Player Parcker mucks (does not show cards). Bets: 1.50. Collects: 3.09. Wins: 1.59.
Player Jui Kuen does not show cards.Bets: 0. Collects: 0. Wins: 0.
Game ended at: 2016/11/29 14:50:15

Game started
Game ID: 787015036 1/2 (PRR) Longana (Short) - 2 (Hold'em)
Seat 3 is the button
Seat 1: aleks0v (103).
Seat 2: PANDAisEVIL (105.50).
Seat 3: VegetablesArentYummy (132.13).
Seat 4: gust (85.40).
Seat 5: thimk (68.87).
Seat 6: IlxxxlI (46).
Seat 7: pineapplesand (50.35).
Seat 8: StephCurry (116.50).
Seat 9: hotshothotgg (95.04).
Player gust has small blind (1)
Player thimk has big blind (2)
Player IlxxxlI received card: [Kc]
Player IlxxxlI received card: [Ah]
Player IlxxxlI raises (7)
Player pineapplesand folds
Player StephCurry folds
Player hotshothotgg folds
Player aleks0v folds
Player PANDAisEVIL folds
Player VegetablesArentYummy folds
Player gust folds
Player thimk folds
Uncalled bet (5) returned to IlxxxlI
Player IlxxxlI mucks cards
------ Summary ------
Pot: 5. Rake 0
Player aleks0v does not show cards.Bets: 0. Collects: 0. Wins: 0.
Player PANDAisEVIL does not show cards.Bets: 0. Collects: 0. Wins: 0.
Player VegetablesArentYummy does not show cards.Bets: 0. Collects: 0. Wins: 0.
Player gust does not show cards.Bets: 1. Collects: 0. Loses: 1.
Player thimk does not show cards.Bets: 2. Collects: 0. Loses: 2.
*Player IlxxxlI mucks (does not show cards). Bets: 2. Collects: 5. Wins: 3.
Player pineapplesand does not show cards.Bets: 0. Collects: 0. Wins: 0.
Player StephCurry does not show cards.Bets: 0. Collects: 0. Wins: 0.
Player hotshothotgg does not show cards.Bets: 0. Collects: 0. Wins: 0.
Game ended at: 2016/11/29 14:49:34

Game started
Game ID: 787014855 1/2 (PRR) Lakhey (Hold'em)
Seat 2 is the button
Seat 1: VegetablesArentYummy (231.50).
Seat 2: IlxxxlI (81.55).
Seat 3: IbetUmuck (858.25).
Seat 5: PANDAisEVIL (206).
Seat 6: AironVega (204.55).
Player IbetUmuck has small blind (1)
Player PANDAisEVIL has big blind (2)
Player IlxxxlI received card: [3c]
Player IlxxxlI received card: [7h]
Player AironVega raises (6)
Player VegetablesArentYummy folds
Player IlxxxlI folds
Player IbetUmuck calls (5)
Player PANDAisEVIL folds
*** FLOP ***: [10h 5c Ks]
Player IbetUmuck checks
Player AironVega checks
*** TURN ***: [10h 5c Ks] [2s]
Player IbetUmuck bets (6.65)
Player AironVega calls (6.65)
*** RIVER ***: [10h 5c Ks 2s] [Kc]
Player IbetUmuck bets (19.46)
Player AironVega calls (19.46)
------ Summary ------
Pot: 63.22. Rake 2.76. JP fee 0.24
Board: [10h 5c Ks 2s Kc]
Player VegetablesArentYummy does not show cards.Bets: 0. Collects: 0. Wins: 0.
Player IlxxxlI does not show cards.Bets: 0. Collects: 0. Wins: 0.
Player IbetUmuck shows: One pair of Ks [3h 4h]. Bets: 32.11. Collects: 0. Loses: 32.11.
Player PANDAisEVIL does not show cards.Bets: 2. Collects: 0. Loses: 2.
*Player AironVega shows: Two pairs. Ks and 10s [10d 8d]. Bets: 32.11. Collects: 63.22. Wins: 31.11.
Game ended at: 2016/11/29 14:50:16

Game started
Game ID: 787014851 1/2 (PRR) Longana (Short) - 2 (Hold'em)
Seat 2 is the button
Seat 1: aleks0v (100).
Seat 2: PANDAisEVIL (105.50).
Seat 3: VegetablesArentYummy (133.13).
Seat 4: gust (87.40).
Seat 5: thimk (68.87).
Seat 6: IlxxxlI (46).
Seat 7: pineapplesand (50.35).
Seat 8: StephCurry (116.50).
Seat 9: hotshothotgg (95.04).
Player VegetablesArentYummy has small blind (1)
Player gust has big blind (2)
Player IlxxxlI received card: [6d]
Player IlxxxlI received card: [5s]
Player thimk folds
Player IlxxxlI folds
Player pineapplesand folds
Player StephCurry folds
Player hotshothotgg folds
Player aleks0v raises (4)
Player PANDAisEVIL folds
Player VegetablesArentYummy folds
Player gust folds
Uncalled bet (2) returned to aleks0v
Player aleks0v mucks cards
------ Summary ------
Pot: 5. Rake 0
*Player aleks0v mucks (does not show cards). Bets: 2. Collects: 5. Wins: 3.
Player PANDAisEVIL does not show cards.Bets: 0. Collects: 0. Wins: 0.
Player VegetablesArentYummy does not show cards.Bets: 1. Collects: 0. Loses: 1.
Player gust does not show cards.Bets: 2. Collects: 0. Loses: 2.
Player thimk does not show cards.Bets: 0. Collects: 0. Wins: 0.
Player IlxxxlI does not show cards.Bets: 0. Collects: 0. Wins: 0.
Player pineapplesand does not show cards.Bets: 0. Collects: 0. Wins: 0.
Player StephCurry does not show cards.Bets: 0. Collects: 0. Wins: 0.
Player hotshothotgg does not show cards.Bets: 0. Collects: 0. Wins: 0.
Game ended at: 2016/11/29 14:49:3

Game started
Game ID: 787014799 1/2 (PRR) Lakhey - 2 (Hold'em)
Seat 3 is the button
Seat 2: IlxxxlI (82).
Seat 3: gust (105.30).
Seat 4: joonjoonjoon (200).
Seat 5: VegetablesArentYummy (428.47).
Seat 6: JoeRockwell (332.17).
Player joonjoonjoon has small blind (1)
Player VegetablesArentYummy has big blind (2)
Player IlxxxlI received card: [7h]
Player IlxxxlI received card: [7d]
Player JoeRockwell folds
Player IlxxxlI raises (4.80)
Player gust folds
Player joonjoonjoon folds
Player VegetablesArentYummy calls (2.80)
*** FLOP ***: [6h 2s 9h]
Player VegetablesArentYummy checks
Player IlxxxlI checks
*** TURN ***: [6h 2s 9h] [3s]
Player VegetablesArentYummy bets (7.71)
Player IlxxxlI raises (16)
Player VegetablesArentYummy folds
Uncalled bet (8.29) returned to IlxxxlI
Player IlxxxlI mucks cards
------ Summary ------
Pot: 24.72. Rake 1.06. JP fee 0.24
Board: [6h 2s 9h 3s]
*Player IlxxxlI mucks (does not show cards). Bets: 12.51. Collects: 24.72. Wins: 12.21.
Player gust does not show cards.Bets: 0. Collects: 0. Wins: 0.
Player joonjoonjoon does not show cards.Bets: 1. Collects: 0. Loses: 1.
Player VegetablesArentYummy does not show cards.Bets: 12.51. Collects: 0. Loses: 12.51.
Player JoeRockwell does not show cards.Bets: 0. Collects: 0. Wins: 0.
Game ended at: 2016/11/29 14:49:56

Game started
Game ID: 787014700 0.50/1 (PRR) Karkadann - 3 (Hold'em)
Seat 5 is the button
Seat 2: ElvenEyes (165.75).
Seat 3: StephCurry (101.50).
Seat 4: gust (51.95).
Seat 5: pineapplesand (41.96).
Seat 6: AironVega (101.28).
Seat 7: IlxxxlI (44.50).
Seat 8: dankmann (154.69).
Seat 9: VegetablesArentYummy (257.91).
Player AironVega has small blind (0.50)
Player IlxxxlI has big blind (1)
Player IlxxxlI received card: [Js]
Player IlxxxlI received card: [Jd]
Player dankmann folds
Player VegetablesArentYummy folds
Player ElvenEyes folds
Player StephCurry folds
Player gust folds
Player pineapplesand raises (2)
Player AironVega folds
Player IlxxxlI raises (5)
Player pineapplesand folds
Uncalled bet (4) returned to IlxxxlI
Player IlxxxlI mucks cards
------ Summary ------
Pot: 4.50. Rake 0
Player ElvenEyes does not show cards.Bets: 0. Collects: 0. Wins: 0.
Player StephCurry does not show cards.Bets: 0. Collects: 0. Wins: 0.
Player gust does not show cards.Bets: 0. Collects: 0. Wins: 0.
Player pineapplesand does not show cards.Bets: 2. Collects: 0. Loses: 2.
Player AironVega does not show cards.Bets: 0.50. Collects: 0. Loses: 0.50.
*Player IlxxxlI mucks (does not show cards). Bets: 2. Collects: 4.50. Wins: 2.50.
Player dankmann does not show cards.Bets: 0. Collects: 0. Wins: 0.
Player VegetablesArentYummy does not show cards.Bets: 0. Collects: 0. Wins: 0.
Game ended at: 2016/11/29 14:49:32

Game started
Game ID: 787014561 0.25/0.50 (PRR) Gorgons (Cap) - 2 (Hold'em)
Seat 1 is the button
Seat 1: cuervo_ (6.39).
Seat 2: IlxxxlI (20).
Seat 3: jjeannin1 (42.47).
Seat 4: trader063 (34.04).
Seat 5: Parcker (63.97).
Seat 6: Jui Kuen (77.75).
Player IlxxxlI has small blind (0.25)
Player jjeannin1 has big blind (0.50)
Player IlxxxlI received card: [Ah]
Player IlxxxlI received card: [3c]
Player trader063 folds
Player Parcker raises (1.50)
Player Jui Kuen folds
Player cuervo_ calls (1.50)
Player IlxxxlI folds
Player jjeannin1 calls (1)
*** FLOP ***: [Kh Ac 5h]
Player jjeannin1 checks
Player Parcker checks
Player cuervo_ bets (2)
Player jjeannin1 raises (6)
Player Parcker folds
Player cuervo_ allin (2.89)
Uncalled bet (1.11) returned to jjeannin1
*** TURN ***: [Kh Ac 5h] [9c]
*** RIVER ***: [Kh Ac 5h 9c] [2c]
------ Summary ------
Pot: 13.81. Rake 0.48. JP fee 0.24
Board: [Kh Ac 5h 9c 2c]
*Player cuervo_ shows: One pair of As [Ad Qs]. Bets: 6.39. Collects: 13.81. Wins: 7.42.
Player IlxxxlI does not show cards.Bets: 0.25. Collects: 0. Loses: 0.25.
Player jjeannin1 shows: One pair of 4s [4s 4h]. Bets: 6.39. Collects: 0. Loses: 6.39.
Player trader063 does not show cards.Bets: 0. Collects: 0. Wins: 0.
Player Parcker does not show cards.Bets: 1.50. Collects: 0. Loses: 1.50.
Player Jui Kuen does not show cards.Bets: 0. Collects: 0. Wins: 0.
Game ended at: 2016/11/29 14:49:7

Game started
Game ID: 787014536 0.50/1 (PRR) Karkadann - 3 (Hold'em)
Seat 4 is the button
Seat 2: ElvenEyes (165.75).
Seat 3: StephCurry (101.50).
Seat 4: gust (51.95).
Seat 5: pineapplesand (42.46).
Seat 6: AironVega (102.28).
Seat 7: IlxxxlI (43).
Seat 8: dankmann (154.69).
Seat 9: VegetablesArentYummy (257.91).
Player pineapplesand has small blind (0.50)
Player AironVega has big blind (1)
Player IlxxxlI received card: [Ks]
Player IlxxxlI received card: [Qc]
Player IlxxxlI raises (3.50)
Player dankmann folds
Player VegetablesArentYummy folds
Player ElvenEyes folds
Player StephCurry folds
Player gust folds
Player pineapplesand folds
Player AironVega folds
Uncalled bet (2.50) returned to IlxxxlI
Player IlxxxlI mucks cards
------ Summary ------
Pot: 2.50. Rake 0
Player ElvenEyes does not show cards.Bets: 0. Collects: 0. Wins: 0.
Player StephCurry does not show cards.Bets: 0. Collects: 0. Wins: 0.
Player gust does not show cards.Bets: 0. Collects: 0. Wins: 0.
Player pineapplesand does not show cards.Bets: 0.50. Collects: 0. Loses: 0.50.
Player AironVega does not show cards.Bets: 1. Collects: 0. Loses: 1.
*Player IlxxxlI mucks (does not show cards). Bets: 1. Collects: 2.50. Wins: 1.50.
Player dankmann does not show cards.Bets: 0. Collects: 0. Wins: 0.
Player VegetablesArentYummy does not show cards.Bets: 0. Collects: 0. Wins: 0.
Game ended at: 2016/11/29 14:48:11

Game started
Game ID: 787014510 1/2 (PRR) Lakhey - 3 (Hold'em)
Seat 1 is the button
Seat 1: IlxxxlI (81).
Seat 6: AironVega (204.50).
Player IlxxxlI has small blind (1)
Player AironVega has big blind (2)
Player IlxxxlI received card: [8c]
Player IlxxxlI received card: [Qh]
Player IlxxxlI raises (4)
Player AironVega calls (3)
*** FLOP ***: [9d Js Kc]
Player AironVega checks
Player IlxxxlI bets (4.94)
Player AironVega folds
Uncalled bet (4.94) returned to IlxxxlI
Player IlxxxlI mucks cards
------ Summary ------
Pot: 9.50. Rake 0.46. JP fee 0.04
Board: [9d Js Kc]
*Player IlxxxlI mucks (does not show cards). Bets: 5. Collects: 9.50. Wins: 4.50.
Player AironVega does not show cards.Bets: 5. Collects: 0. Loses: 5.
Game ended at: 2016/11/29 14:48:1

Game started
Game ID: 787014455 1/2 (PRR) Lakhey - 3 (Hold'em)
Seat 6 is the button
Seat 1: IlxxxlI (80).
Seat 6: AironVega (205.50).
Player AironVega has small blind (1)
Player IlxxxlI has big blind (2)
Player IlxxxlI received card: [Ad]
Player IlxxxlI received card: [3d]
Player AironVega folds
Uncalled bet (1) returned to IlxxxlI
Player IlxxxlI mucks cards
------ Summary ------
Pot: 2. Rake 0
*Player IlxxxlI mucks (does not show cards). Bets: 1. Collects: 2. Wins: 1.
Player AironVega does not show cards.Bets: 1. Collects: 0. Loses: 1.
Game ended at: 2016/11/29 14:47:41

Game started
Game ID: 787014265 1/2 (PRR) Lakhey (Hold'em)
Seat 1 is the button
Seat 1: VegetablesArentYummy (226.05).
Seat 2: IlxxxlI (82.55).
Seat 3: IbetUmuck (863.25).
Seat 5: PANDAisEVIL (206).
Seat 6: AironVega (204.55).
Player IlxxxlI has small blind (1)
Player IbetUmuck has big blind (2)
Player IlxxxlI received card: [8s]
Player IlxxxlI received card: [3h]
Player PANDAisEVIL folds
Player AironVega folds
Player VegetablesArentYummy raises (5)
Player IlxxxlI folds
Player IbetUmuck calls (3)
*** FLOP ***: [6d Ah Kc]
Player IbetUmuck checks
Player VegetablesArentYummy checks
*** TURN ***: [6d Ah Kc] [Ks]
Player IbetUmuck checks
Player VegetablesArentYummy bets (6.96)
Player IbetUmuck folds
Uncalled bet (6.96) returned to VegetablesArentYummy
Player VegetablesArentYummy mucks cards
------ Summary ------
Pot: 10.45. Rake 0.37. JP fee 0.18
Board: [6d Ah Kc Ks]
*Player VegetablesArentYummy mucks (does not show cards). Bets: 5. Collects: 10.45. Wins: 5.45.
Player IlxxxlI does not show cards.Bets: 1. Collects: 0. Loses: 1.
Player IbetUmuck does not show cards.Bets: 5. Collects: 0. Loses: 5.
Player PANDAisEVIL does not show cards.Bets: 0. Collects: 0. Wins: 0.
Player AironVega does not show cards.Bets: 0. Collects: 0. Wins: 0.
Game ended at: 2016/11/29 14:48:33

Game started
Game ID: 787014255 0.50/1 (PRR) Karkadann - 3 (Hold'em)
Seat 3 is the button
Seat 2: ElvenEyes (165.75).
Seat 3: StephCurry (101.50).
Seat 4: gust (52.45).
Seat 5: pineapplesand (43.46).
Seat 6: AironVega (102.28).
Seat 7: IlxxxlI (41.50).
Seat 8: dankmann (154.69).
Seat 9: VegetablesArentYummy (257.91).
Player gust has small blind (0.50)
Player pineapplesand has big blind (1)
Player IlxxxlI received card: [Kd]
Player IlxxxlI received card: [Jd]
Player AironVega folds
Player IlxxxlI raises (3.50)
Player dankmann folds
Player VegetablesArentYummy folds
Player ElvenEyes folds
Player StephCurry folds
Player gust folds
Player pineapplesand folds
Uncalled bet (2.50) returned to IlxxxlI
Player IlxxxlI mucks cards
------ Summary ------
Pot: 2.50. Rake 0
Player ElvenEyes does not show cards.Bets: 0. Collects: 0. Wins: 0.
Player StephCurry does not show cards.Bets: 0. Collects: 0. Wins: 0.
Player gust does not show cards.Bets: 0.50. Collects: 0. Loses: 0.50.
Player pineapplesand does not show cards.Bets: 1. Collects: 0. Loses: 1.
Player AironVega does not show cards.Bets: 0. Collects: 0. Wins: 0.
*Player IlxxxlI mucks (does not show cards). Bets: 1. Collects: 2.50. Wins: 1.50.
Player dankmann does not show cards.Bets: 0. Collects: 0. Wins: 0.
Player VegetablesArentYummy does not show cards.Bets: 0. Collects: 0. Wins: 0.
Game ended at: 2016/11/29 14:47:45

Game started
Game ID: 787014130 0.25/0.50 (PRR) Gorgons (Cap) - 2 (Hold'em)
Seat 6 is the button
Seat 1: cuervo_ (7.39).
Seat 2: IlxxxlI (20).
Seat 3: jjeannin1 (41.09).
Seat 4: trader063 (34.04).
Seat 5: Parcker (63.97).
Seat 6: Jui Kuen (77.75).
Player cuervo_ has small blind (0.25)
Player IlxxxlI has big blind (0.50)
Player IlxxxlI received card: [8d]
Player IlxxxlI received card: [6s]
Player jjeannin1 raises (1)
Player trader063 folds
Player Parcker folds
Player Jui Kuen folds
Player cuervo_ calls (0.75)
Player IlxxxlI folds
*** FLOP ***: [10s Qh 6h]
Player cuervo_ checks
Player jjeannin1 bets (3)
Player cuervo_ folds
Uncalled bet (3) returned to jjeannin1
Player jjeannin1 mucks cards
------ Summary ------
Pot: 2.38. Rake 0.08. JP fee 0.04
Board: [10s Qh 6h]
Player cuervo_ does not show cards.Bets: 1. Collects: 0. Loses: 1.
Player IlxxxlI does not show cards.Bets: 0.50. Collects: 0. Loses: 0.50.
*Player jjeannin1 mucks (does not show cards). Bets: 1. Collects: 2.38. Wins: 1.38.
Player trader063 does not show cards.Bets: 0. Collects: 0. Wins: 0.
Player Parcker does not show cards.Bets: 0. Collects: 0. Wins: 0.
Player Jui Kuen does not show cards.Bets: 0. Collects: 0. Wins: 0.
Game ended at: 2016/11/29 14:47:50

Game started
Game ID: 787014069 1/2 (PRR) Lakhey - 2 (Hold'em)
Seat 2 is the button
Seat 2: IlxxxlI (82).
Seat 3: gust (106.30).
Seat 4: joonjoonjoon (212.25).
Seat 5: VegetablesArentYummy (406.34).
Seat 6: JoeRockwell (332.17).
Player gust has small blind (1)
Player joonjoonjoon has big blind (2)
Player IlxxxlI received card: [Jd]
Player IlxxxlI received card: [4h]
Player VegetablesArentYummy raises (5)
Player JoeRockwell folds
Player IlxxxlI folds
Player gust folds
Player joonjoonjoon calls (3)
*** FLOP ***: [3h 2s Qs]
Player joonjoonjoon checks
Player VegetablesArentYummy bets (4.22)
Player joonjoonjoon calls (4.22)
*** TURN ***: [3h 2s Qs] [Jh]
Player joonjoonjoon checks
Player VegetablesArentYummy bets (14.31)
Player joonjoonjoon calls (14.31)
*** RIVER ***: [3h 2s Qs Jh] [9d]
Player joonjoonjoon checks
Player VegetablesArentYummy bets (38.44)
Player joonjoonjoon folds
Uncalled bet (38.44) returned to VegetablesArentYummy
Player VegetablesArentYummy mucks cards
------ Summary ------
Pot: 45.66. Rake 2.16. JP fee 0.24
Board: [3h 2s Qs Jh 9d]
Player IlxxxlI does not show cards.Bets: 0. Collects: 0. Wins: 0.
Player gust does not show cards.Bets: 1. Collects: 0. Loses: 1.
Player joonjoonjoon does not show cards.Bets: 23.53. Collects: 0. Loses: 23.53.
*Player VegetablesArentYummy mucks (does not show cards). Bets: 23.53. Collects: 45.66. Wins: 22.13.
Player JoeRockwell does not show cards.Bets: 0. Collects: 0. Wins: 0.
Game ended at: 2016/11/29 14:48:26

Game started
Game ID: 787013999 0.50/1 (PRR) Karkadann - 3 (Hold'em)
Seat 2 is the button
Seat 2: ElvenEyes (165.75).
Seat 3: StephCurry (102).
Seat 4: gust (53.45).
Seat 5: pineapplesand (43.46).
Seat 6: AironVega (102.28).
Seat 7: IlxxxlI (41.50).
Seat 8: dankmann (154.69).
Seat 9: VegetablesArentYummy (256.41).
Player StephCurry has small blind (0.50)
Player gust has big blind (1)
Player IlxxxlI received card: [3h]
Player IlxxxlI received card: [6c]
Player pineapplesand folds
Player AironVega folds
Player IlxxxlI folds
Player dankmann folds
Player VegetablesArentYummy raises (2.50)
Player ElvenEyes folds
Player StephCurry folds
Player gust folds
Uncalled bet (1.50) returned to VegetablesArentYummy
Player VegetablesArentYummy mucks cards
------ Summary ------
Pot: 2.50. Rake 0
Player ElvenEyes does not show cards.Bets: 0. Collects: 0. Wins: 0.
Player StephCurry does not show cards.Bets: 0.50. Collects: 0. Loses: 0.50.
Player gust does not show cards.Bets: 1. Collects: 0. Loses: 1.
Player pineapplesand does not show cards.Bets: 0. Collects: 0. Wins: 0.
Player AironVega does not show cards.Bets: 0. Collects: 0. Wins: 0.
Player IlxxxlI does not show cards.Bets: 0. Collects: 0. Wins: 0.
Player dankmann does not show cards.Bets: 0. Collects: 0. Wins: 0.
*Player VegetablesArentYummy mucks (does not show cards). Bets: 1. Collects: 2.50. Wins: 1.50.
Game ended at: 2016/11/29 14:47:3

Game started
Game ID: 787013966 1/2 (PRR) Lakhey - 3 (Hold'em)
Seat 1 is the button
Seat 1: IlxxxlI (80).
Seat 6: AironVega (201).
Player IlxxxlI has small blind (1)
Player AironVega has big blind (2)
Player IlxxxlI received card: [Jd]
Player IlxxxlI received card: [As]
Player IlxxxlI raises (4)
Player AironVega calls (3)
*** FLOP ***: [Qd 8s Jh]
Player AironVega checks
Player IlxxxlI checks
*** TURN ***: [Qd 8s Jh] [Kh]
Player AironVega bets (14.25)
Player IlxxxlI folds
Uncalled bet (14.25) returned to AironVega
Player AironVega mucks cards
------ Summary ------
Pot: 9.50. Rake 0.46. JP fee 0.04
Board: [Qd 8s Jh Kh]
Player IlxxxlI does not show cards.Bets: 5. Collects: 0. Loses: 5.
*Player AironVega mucks (does not show cards). Bets: 5. Collects: 9.50. Wins: 4.50.
Game ended at: 2016/11/29 14:47:30

Game started
Game ID: 787013914 1/2 (PRR) Lakhey - 2 (Hold'em)
Seat 6 is the button
Seat 2: IlxxxlI (80).
Seat 3: gust (108.30).
Seat 4: joonjoonjoon (212.25).
Seat 5: VegetablesArentYummy (406.34).
Seat 6: JoeRockwell (332.17).
Player IlxxxlI has small blind (1)
Player gust has big blind (2)
Player IlxxxlI received card: [As]
Player IlxxxlI received card: [Ks]
Player joonjoonjoon folds
Player VegetablesArentYummy folds
Player JoeRockwell folds
Player IlxxxlI raises (4)
Player gust folds
Uncalled bet (3) returned to IlxxxlI
Player IlxxxlI mucks cards
------ Summary ------
Pot: 4. Rake 0
*Player IlxxxlI mucks (does not show cards). Bets: 2. Collects: 4. Wins: 2.
Player gust does not show cards.Bets: 2. Collects: 0. Loses: 2.
Player joonjoonjoon does not show cards.Bets: 0. Collects: 0. Wins: 0.
Player VegetablesArentYummy does not show cards.Bets: 0. Collects: 0. Wins: 0.
Player JoeRockwell does not show cards.Bets: 0. Collects: 0. Wins: 0.
Game ended at: 2016/11/29 14:46:34

Game started
Game ID: 787013902 1/2 (PRR) Lakhey - 3 (Hold'em)
Seat 6 is the button
Seat 1: IlxxxlI (80).
Seat 3: VegetablesArentYummy (438.04).
Seat 6: AironVega (200).
Player IlxxxlI has small blind (1)
Player VegetablesArentYummy sitting out
Player AironVega has big blind (2)
Player IlxxxlI received card: [9h]
Player IlxxxlI received card: [4d]
Player IlxxxlI folds
Uncalled bet (1) returned to AironVega
Player AironVega mucks cards
------ Summary ------
Pot: 2. Rake 0
Player IlxxxlI does not show cards.Bets: 1. Collects: 0. Loses: 1.
Player VegetablesArentYummy does not show cards.Bets: 0. Collects: 0. Wins: 0.
*Player AironVega mucks (does not show cards). Bets: 1. Collects: 2. Wins: 1.
Game ended at: 2016/11/29 14:46:21

Game started
Game ID: 787013875 1/2 (PRR) Lakhey (Hold'em)
Seat 6 is the button
Seat 1: VegetablesArentYummy (227.05).
Seat 2: IlxxxlI (86.55).
Seat 3: IbetUmuck (863.25).
Seat 5: PANDAisEVIL (206).
Seat 6: AironVega (200).
Player VegetablesArentYummy has small blind (1)
Player IlxxxlI has big blind (2)
Player IlxxxlI received card: [4s]
Player IlxxxlI received card: [4c]
Player IbetUmuck folds
Player PANDAisEVIL folds
Player AironVega raises (4)
Player VegetablesArentYummy folds
Player IlxxxlI calls (2)
*** FLOP ***: [8h 3d 7d]
Player IlxxxlI checks
Player AironVega bets (5.64)
Player IlxxxlI folds
Uncalled bet (5.64) returned to AironVega
Player AironVega mucks cards
------ Summary ------
Pot: 8.55. Rake 0.31. JP fee 0.14
Board: [8h 3d 7d]
Player VegetablesArentYummy does not show cards.Bets: 1. Collects: 0. Loses: 1.
Player IlxxxlI does not show cards.Bets: 4. Collects: 0. Loses: 4.
Player IbetUmuck does not show cards.Bets: 0. Collects: 0. Wins: 0.
Player PANDAisEVIL does not show cards.Bets: 0. Collects: 0. Wins: 0.
*Player AironVega mucks (does not show cards). Bets: 4. Collects: 8.55. Wins: 4.55.
Game ended at: 2016/11/29 14:47:6

Game started
Game ID: 787013749 0.50/1 (PRR) Karkadann - 3 (Hold'em)
Seat 9 is the button
Seat 2: ElvenEyes (166.25).
Seat 3: StephCurry (103).
Seat 4: gust (53.45).
Seat 5: pineapplesand (43.46).
Seat 6: AironVega (102.28).
Seat 7: IlxxxlI (40).
Seat 8: dankmann (154.69).
Seat 9: VegetablesArentYummy (256.41).
Player ElvenEyes has small blind (0.50)
Player StephCurry has big blind (1)
Player IlxxxlI received card: [Qs]
Player IlxxxlI received card: [10s]
Player gust folds
Player pineapplesand folds
Player AironVega folds
Player IlxxxlI raises (3.50)
Player dankmann folds
Player VegetablesArentYummy folds
Player ElvenEyes folds
Player StephCurry folds
Uncalled bet (2.50) returned to IlxxxlI
Player IlxxxlI mucks cards
------ Summary ------
Pot: 2.50. Rake 0
Player ElvenEyes does not show cards.Bets: 0.50. Collects: 0. Loses: 0.50.
Player StephCurry does not show cards.Bets: 1. Collects: 0. Loses: 1.
Player gust does not show cards.Bets: 0. Collects: 0. Wins: 0.
Player pineapplesand does not show cards.Bets: 0. Collects: 0. Wins: 0.
Player AironVega does not show cards.Bets: 0. Collects: 0. Wins: 0.
*Player IlxxxlI mucks (does not show cards). Bets: 1. Collects: 2.50. Wins: 1.50.
Player dankmann does not show cards.Bets: 0. Collects: 0. Wins: 0.
Player VegetablesArentYummy does not show cards.Bets: 0. Collects: 0. Wins: 0.
Game ended at: 2016/11/29 14:46:25

Game started
Game ID: 787013718 1/2 (PRR) Longana (Short) - 2 (Hold'em)
Seat 1 is the button
Seat 1: aleks0v (100).
Seat 2: PANDAisEVIL (101).
Seat 3: VegetablesArentYummy (138.13).
Seat 4: gust (87.40).
Seat 5: thimk (68.87).
Seat 6: IlxxxlI (46).
Seat 7: pineapplesand (50.35).
Seat 8: StephCurry (116.50).
Seat 9: hotshothotgg (95.04).
Player PANDAisEVIL has small blind (1)
Player VegetablesArentYummy has big blind (2)
Player IlxxxlI received card: [2h]
Player IlxxxlI received card: [6d]
Player gust folds
Player thimk folds
Player IlxxxlI folds
Player pineapplesand folds
Player StephCurry folds
Player hotshothotgg folds
Player aleks0v folds
Player PANDAisEVIL raises (4)
Player VegetablesArentYummy calls (3)
*** FLOP ***: [3c Jc Qd]
Player PANDAisEVIL checks
Player VegetablesArentYummy checks
*** TURN ***: [3c Jc Qd] [10d]
Player PANDAisEVIL checks
Player VegetablesArentYummy checks
*** RIVER ***: [3c Jc Qd 10d] [4h]
Player PANDAisEVIL checks
Player VegetablesArentYummy checks
Player VegetablesArentYummy mucks cards
------ Summary ------
Pot: 9.50. Rake 0.34. JP fee 0.16
Board: [3c Jc Qd 10d 4h]
Player aleks0v does not show cards.Bets: 0. Collects: 0. Wins: 0.
*Player PANDAisEVIL shows: One pair of 9s [9s 9d]. Bets: 5. Collects: 9.50. Wins: 4.50.
Player VegetablesArentYummy mucks (does not show cards). Bets: 5. Collects: 0. Loses: 5.
Player gust does not show cards.Bets: 0. Collects: 0. Wins: 0.
Player thimk does not show cards.Bets: 0. Collects: 0. Wins: 0.
Player IlxxxlI does not show cards.Bets: 0. Collects: 0. Wins: 0.
Player pineapplesand does not show cards.Bets: 0. Collects: 0. Wins: 0.
Player StephCurry does not show cards.Bets: 0. Collects: 0. Wins: 0.
Player hotshothotgg does not show cards.Bets: 0. Collects: 0. Wins: 0.
Game ended at: 2016/11/29 14:48:30

Game started
Game ID: 787013659 1/2 (PRR) Lakhey (Hold'em)
Seat 5 is the button
Seat 1: VegetablesArentYummy (226.05).
Seat 2: IlxxxlI (86.55).
Seat 3: IbetUmuck (863.25).
Seat 5: PANDAisEVIL (206).
Seat 6: AironVega (200).
Player AironVega has small blind (1)
Player VegetablesArentYummy has big blind (2)
Player IlxxxlI received card: [Qd]
Player IlxxxlI received card: [2d]
Player IlxxxlI folds
Player IbetUmuck folds
Player PANDAisEVIL folds
Player AironVega folds
Uncalled bet (1) returned to VegetablesArentYummy
Player VegetablesArentYummy mucks cards
------ Summary ------
Pot: 2. Rake 0
*Player VegetablesArentYummy mucks (does not show cards). Bets: 1. Collects: 2. Wins: 1.
Player IlxxxlI does not show cards.Bets: 0. Collects: 0. Wins: 0.
Player IbetUmuck does not show cards.Bets: 0. Collects: 0. Wins: 0.
Player PANDAisEVIL does not show cards.Bets: 0. Collects: 0. Wins: 0.
Player AironVega does not show cards.Bets: 1. Collects: 0. Loses: 1.
Game ended at: 2016/11/29 14:46:8

Game started
Game ID: 787013654 1/2 (PRR) Lakhey - 2 (Hold'em)
Seat 5 is the button
Seat 1: uncle_argyle (121.87).
Seat 2: IlxxxlI (80).
Seat 3: gust (108.30).
Seat 4: joonjoonjoon (209.25).
Seat 5: VegetablesArentYummy (406.34).
Seat 6: JoeRockwell (333.17).
Player JoeRockwell has small blind (1)
Player uncle_argyle sitting out
Player IlxxxlI has big blind (2)
Player IlxxxlI received card: [6s]
Player IlxxxlI received card: [10c]
Player gust folds
Player joonjoonjoon raises (6)
Player VegetablesArentYummy folds
Player JoeRockwell folds
Player IlxxxlI folds
Uncalled bet (4) returned to joonjoonjoon
Player joonjoonjoon mucks cards
------ Summary ------
Pot: 5. Rake 0
Player uncle_argyle does not show cards.Bets: 0. Collects: 0. Wins: 0.
Player IlxxxlI does not show cards.Bets: 2. Collects: 0. Loses: 2.
Player gust does not show cards.Bets: 0. Collects: 0. Wins: 0.
*Player joonjoonjoon mucks (does not show cards). Bets: 2. Collects: 5. Wins: 3.
Player VegetablesArentYummy does not show cards.Bets: 0. Collects: 0. Wins: 0.
Player JoeRockwell does not show cards.Bets: 1. Collects: 0. Loses: 1.
Game ended at: 2016/11/29 14:46:14

Game started
Game ID: 787013533 1/2 (PRR) Lakhey (Hold'em)
Seat 3 is the button
Seat 1: VegetablesArentYummy (226.05).
Seat 2: IlxxxlI (86.55).
Seat 3: IbetUmuck (863.25).
Seat 5: PANDAisEVIL (204).
Seat 6: AironVega (200).
Player PANDAisEVIL has small blind (1)
Player AironVega has big blind (2)
Player IlxxxlI received card: [5d]
Player IlxxxlI received card: [10d]
Player VegetablesArentYummy folds
Player IlxxxlI folds
Player IbetUmuck folds
Player PANDAisEVIL raises (4)
Player AironVega folds
Uncalled bet (3) returned to PANDAisEVIL
Player PANDAisEVIL mucks cards
------ Summary ------
Pot: 4. Rake 0
Player VegetablesArentYummy does not show cards.Bets: 0. Collects: 0. Wins: 0.
Player IlxxxlI does not show cards.Bets: 0. Collects: 0. Wins: 0.
Player IbetUmuck does not show cards.Bets: 0. Collects: 0. Wins: 0.
*Player PANDAisEVIL mucks (does not show cards). Bets: 2. Collects: 4. Wins: 2.
Player AironVega does not show cards.Bets: 2. Collects: 0. Loses: 2.
Game ended at: 2016/11/29 14:45:39

Game started
Game ID: 787013454 1/2 (PRR) Longana (Short) - 2 (Hold'em)
Seat 9 is the button
Seat 1: aleks0v (100).
Seat 2: PANDAisEVIL (103).
Seat 3: VegetablesArentYummy (138.13).
Seat 4: gust (87.40).
Seat 5: thimk (68.87).
Seat 6: IlxxxlI (43).
Seat 7: pineapplesand (50.35).
Seat 8: StephCurry (116.50).
Seat 9: hotshothotgg (95.04).
Player aleks0v has small blind (1)
Player PANDAisEVIL has big blind (2)
Player IlxxxlI received card: [Jd]
Player IlxxxlI received card: [Kc]
Player VegetablesArentYummy folds
Player gust folds
Player thimk folds
Player IlxxxlI raises (7)
Player pineapplesand folds
Player StephCurry folds
Player hotshothotgg folds
Player aleks0v folds
Player PANDAisEVIL folds
Uncalled bet (5) returned to IlxxxlI
Player IlxxxlI mucks cards
------ Summary ------
Pot: 5. Rake 0
Player aleks0v does not show cards.Bets: 1. Collects: 0. Loses: 1.
Player PANDAisEVIL does not show cards.Bets: 2. Collects: 0. Loses: 2.
Player VegetablesArentYummy does not show cards.Bets: 0. Collects: 0. Wins: 0.
Player gust does not show cards.Bets: 0. Collects: 0. Wins: 0.
Player thimk does not show cards.Bets: 0. Collects: 0. Wins: 0.
*Player IlxxxlI mucks (does not show cards). Bets: 2. Collects: 5. Wins: 3.
Player pineapplesand does not show cards.Bets: 0. Collects: 0. Wins: 0.
Player StephCurry does not show cards.Bets: 0. Collects: 0. Wins: 0.
Player hotshothotgg does not show cards.Bets: 0. Collects: 0. Wins: 0.
Game ended at: 2016/11/29 14:45:46

Game started
Game ID: 787013348 1/2 (PRR) Lakhey (Hold'em)
Seat 2 is the button
Seat 1: VegetablesArentYummy (226.05).
Seat 2: IlxxxlI (86.55).
Seat 3: IbetUmuck (864.25).
Seat 4: DonCesarGrinder (259.02).
Seat 5: PANDAisEVIL (203).
Player IbetUmuck has small blind (1)
Player DonCesarGrinder sitting out
Player PANDAisEVIL has big blind (2)
Player IlxxxlI received card: [Jh]
Player IlxxxlI received card: [2s]
Player VegetablesArentYummy folds
Player IlxxxlI folds
Player IbetUmuck folds
Uncalled bet (1) returned to PANDAisEVIL
Player PANDAisEVIL mucks cards
------ Summary ------
Pot: 2. Rake 0
Player VegetablesArentYummy does not show cards.Bets: 0. Collects: 0. Wins: 0.
Player IlxxxlI does not show cards.Bets: 0. Collects: 0. Wins: 0.
Player IbetUmuck does not show cards.Bets: 1. Collects: 0. Loses: 1.
Player DonCesarGrinder does not show cards.Bets: 0. Collects: 0. Wins: 0.
*Player PANDAisEVIL mucks (does not show cards). Bets: 1. Collects: 2. Wins: 1.
Game ended at: 2016/11/29 14:45:17

Game started
Game ID: 787013289 0.50/1 (PRR) Karkadann - 3 (Hold'em)
Seat 8 is the button
Seat 2: ElvenEyes (167.25).
Seat 3: StephCurry (103).
Seat 4: gust (53.45).
Seat 5: pineapplesand (43.46).
Seat 6: AironVega (102.28).
Seat 7: IlxxxlI (40).
Seat 8: dankmann (153.19).
Seat 9: VegetablesArentYummy (256.91).
Player VegetablesArentYummy has small blind (0.50)
Player ElvenEyes has big blind (1)
Player IlxxxlI received card: [3d]
Player IlxxxlI received card: [6c]
Player StephCurry folds
Player gust folds
Player pineapplesand folds
Player AironVega folds
Player IlxxxlI folds
Player dankmann raises (3)
Player VegetablesArentYummy folds
Player ElvenEyes folds
Uncalled bet (2) returned to dankmann
Player dankmann mucks cards
------ Summary ------
Pot: 2.50. Rake 0
Player ElvenEyes does not show cards.Bets: 1. Collects: 0. Loses: 1.
Player StephCurry does not show cards.Bets: 0. Collects: 0. Wins: 0.
Player gust does not show cards.Bets: 0. Collects: 0. Wins: 0.
Player pineapplesand does not show cards.Bets: 0. Collects: 0. Wins: 0.
Player AironVega does not show cards.Bets: 0. Collects: 0. Wins: 0.
Player IlxxxlI does not show cards.Bets: 0. Collects: 0. Wins: 0.
*Player dankmann mucks (does not show cards). Bets: 1. Collects: 2.50. Wins: 1.50.
Player VegetablesArentYummy does not show cards.Bets: 0.50. Collects: 0. Loses: 0.50.
Game ended at: 2016/11/29 14:45:52

Game started
Game ID: 787013261 1/2 (PRR) Lakhey - 3 (Hold'em)
Seat 3 is the button
Seat 1: IlxxxlI (80).
Seat 2: gust (89).
Seat 3: VegetablesArentYummy (427.41).
Seat 6: AironVega (200).
Player AironVega has small blind (1)
Player IlxxxlI has big blind (2)
Player IlxxxlI received card: [9h]
Player IlxxxlI received card: [Jd]
Player gust folds
Player VegetablesArentYummy raises (5)
Player AironVega folds
Player IlxxxlI calls (3)
*** FLOP ***: [8c 4d Kd]
Player IlxxxlI checks
Player VegetablesArentYummy checks
*** TURN ***: [8c 4d Kd] [Qs]
Player IlxxxlI bets (5.75)
Player VegetablesArentYummy raises (23)
Player IlxxxlI folds
Uncalled bet (17.25) returned to VegetablesArentYummy
Player VegetablesArentYummy mucks cards
------ Summary ------
Pot: 21.38. Rake 0.88. JP fee 0.24
Board: [8c 4d Kd Qs]
Player IlxxxlI does not show cards.Bets: 10.75. Collects: 0. Loses: 10.75.
Player gust does not show cards.Bets: 0. Collects: 0. Wins: 0.
*Player VegetablesArentYummy mucks (does not show cards). Bets: 10.75. Collects: 21.38. Wins: 10.63.
Player AironVega does not show cards.Bets: 1. Collects: 0. Loses: 1.
Game ended at: 2016/11/29 14:46:12

Game started
Game ID: 787013185 1/2 (PRR) Lakhey - 2 (Hold'em)
Seat 4 is the button
Seat 1: uncle_argyle (137.87).
Seat 2: IlxxxlI (80).
Seat 3: gust (87.91).
Seat 4: joonjoonjoon (209.25).
Seat 5: VegetablesArentYummy (407.34).
Seat 6: JoeRockwell (338.47).
Player VegetablesArentYummy has small blind (1)
Player JoeRockwell has big blind (2)
Player IlxxxlI received card: [10h]
Player IlxxxlI received card: [5h]
Player uncle_argyle raises (5.30)
Player IlxxxlI folds
Player gust calls (5.30)
Player joonjoonjoon folds
Player VegetablesArentYummy folds
Player JoeRockwell calls (3.30)
*** FLOP ***: [6c 9s 8d]
Player JoeRockwell checks
Player uncle_argyle checks
Player gust bets (10.70)
Player JoeRockwell folds
Player uncle_argyle calls (10.70)
*** TURN ***: [6c 9s 8d] [4h]
Player uncle_argyle checks
Player gust bets (24.26)
Player uncle_argyle folds
Uncalled bet (24.26) returned to gust
Player gust mucks cards
------ Summary ------
Pot: 36.39. Rake 1.67. JP fee 0.24
Board: [6c 9s 8d 4h]
Player uncle_argyle does not show cards.Bets: 16. Collects: 0. Loses: 16.
Player IlxxxlI does not show cards.Bets: 0. Collects: 0. Wins: 0.
*Player gust mucks (does not show cards). Bets: 16. Collects: 36.39. Wins: 20.39.
Player joonjoonjoon does not show cards.Bets: 0. Collects: 0. Wins: 0.
Player VegetablesArentYummy does not show cards.Bets: 1. Collects: 0. Loses: 1.
Player JoeRockwell does not show cards.Bets: 5.30. Collects: 0. Loses: 5.30.
Game ended at: 2016/11/29 14:45:38

Game started
Game ID: 787013146 1/2 (PRR) Lakhey (Hold'em)
Seat 1 is the button
Seat 1: VegetablesArentYummy (226.05).
Seat 2: IlxxxlI (87.55).
Seat 3: IbetUmuck (866.25).
Seat 4: DonCesarGrinder (259.02).
Seat 5: PANDAisEVIL (200).
Player IlxxxlI has small blind (1)
Player IbetUmuck has big blind (2)
Player IlxxxlI received card: [Qs]
Player IlxxxlI received card: [6s]
Player DonCesarGrinder folds
Player PANDAisEVIL raises (6)
Player VegetablesArentYummy folds
Player IlxxxlI folds
Player IbetUmuck folds
Uncalled bet (4) returned to PANDAisEVIL
Player PANDAisEVIL mucks cards
------ Summary ------
Pot: 5. Rake 0
Player VegetablesArentYummy does not show cards.Bets: 0. Collects: 0. Wins: 0.
Player IlxxxlI does not show cards.Bets: 1. Collects: 0. Loses: 1.
Player IbetUmuck does not show cards.Bets: 2. Collects: 0. Loses: 2.
Player DonCesarGrinder does not show cards.Bets: 0. Collects: 0. Wins: 0.
*Player PANDAisEVIL mucks (does not show cards). Bets: 2. Collects: 5. Wins: 3.
Game ended at: 2016/11/29 14:44:51

Game started
Game ID: 787013075 1/2 (PRR) Longana (Short) - 2 (Hold'em)
Seat 8 is the button
Seat 1: aleks0v (100).
Seat 2: PANDAisEVIL (103).
Seat 3: VegetablesArentYummy (138.13).
Seat 4: gust (87.40).
Seat 5: thimk (66.12).
Seat 6: IlxxxlI (43).
Seat 7: pineapplesand (50.35).
Seat 8: StephCurry (116.50).
Seat 9: hotshothotgg (96.04).
Player hotshothotgg has small blind (1)
Player aleks0v has big blind (2)
Player IlxxxlI received card: [2h]
Player IlxxxlI received card: [10d]
Player PANDAisEVIL folds
Player VegetablesArentYummy folds
Player gust folds
Player thimk calls (2)
Player IlxxxlI folds
Player pineapplesand folds
Player StephCurry folds
Player hotshothotgg folds
Player aleks0v checks
*** FLOP ***: [10s 9d Qs]
Player aleks0v checks
Player thimk bets (4)
Player aleks0v folds
Uncalled bet (4) returned to thimk
Player thimk is timed out.
Player thimk mucks cards
------ Summary ------
Pot: 4.75. Rake 0.17. JP fee 0.08
Board: [10s 9d Qs]
Player aleks0v does not show cards.Bets: 2. Collects: 0. Loses: 2.
Player PANDAisEVIL does not show cards.Bets: 0. Collects: 0. Wins: 0.
Player VegetablesArentYummy does not show cards.Bets: 0. Collects: 0. Wins: 0.
Player gust does not show cards.Bets: 0. Collects: 0. Wins: 0.
*Player thimk mucks (does not show cards). Bets: 2. Collects: 4.75. Wins: 2.75.
Player IlxxxlI does not show cards.Bets: 0. Collects: 0. Wins: 0.
Player pineapplesand does not show cards.Bets: 0. Collects: 0. Wins: 0.
Player StephCurry does not show cards.Bets: 0. Collects: 0. Wins: 0.
Player hotshothotgg does not show cards.Bets: 1. Collects: 0. Loses: 1.
Game ended at: 2016/11/29 14:45:7

Game started
Game ID: 787012998 1/2 (PRR) Lakhey (Hold'em)
Seat 5 is the button
Seat 1: VegetablesArentYummy (227.05).
Seat 2: IlxxxlI (86.55).
Seat 3: IbetUmuck (866.25).
Seat 4: DonCesarGrinder (259.02).
Seat 5: PANDAisEVIL (200).
Player VegetablesArentYummy has small blind (1)
Player IlxxxlI has big blind (2)
Player IlxxxlI received card: [10c]
Player IlxxxlI received card: [8s]
Player IbetUmuck folds
Player DonCesarGrinder folds
Player PANDAisEVIL folds
Player VegetablesArentYummy folds
Uncalled bet (1) returned to IlxxxlI
Player IlxxxlI mucks cards
------ Summary ------
Pot: 2. Rake 0
Player VegetablesArentYummy does not show cards.Bets: 1. Collects: 0. Loses: 1.
*Player IlxxxlI mucks (does not show cards). Bets: 1. Collects: 2. Wins: 1.
Player IbetUmuck does not show cards.Bets: 0. Collects: 0. Wins: 0.
Player DonCesarGrinder does not show cards.Bets: 0. Collects: 0. Wins: 0.
Player PANDAisEVIL does not show cards.Bets: 0. Collects: 0. Wins: 0.
Game ended at: 2016/11/29 14:44:19

Game started
Game ID: 787012874 0.50/1 (PRR) Kraken - 23 (Hold'em)
Seat 3 is the button
Seat 1: WeakAndWeary (100).
Seat 2: gust (49).
Seat 3: LloydXmas (136.33).
Seat 4: Sephiroth1 (105.26).
Seat 5: ElvenEyes (110.92).
Seat 6: IlxxxlI (60.05).
Player Sephiroth1 has small blind (0.50)
Player ElvenEyes has big blind (1)
Player IlxxxlI received card: [9d]
Player IlxxxlI received card: [Qd]
Player IlxxxlI raises (2)
Player WeakAndWeary folds
Player gust folds
Player LloydXmas folds
Player Sephiroth1 folds
Player ElvenEyes folds
Uncalled bet (1) returned to IlxxxlI
Player IlxxxlI mucks cards
------ Summary ------
Pot: 2.50. Rake 0
Player WeakAndWeary does not show cards.Bets: 0. Collects: 0. Wins: 0.
Player gust does not show cards.Bets: 0. Collects: 0. Wins: 0.
Player LloydXmas does not show cards.Bets: 0. Collects: 0. Wins: 0.
Player Sephiroth1 does not show cards.Bets: 0.50. Collects: 0. Loses: 0.50.
Player ElvenEyes does not show cards.Bets: 1. Collects: 0. Loses: 1.
*Player IlxxxlI mucks (does not show cards). Bets: 1. Collects: 2.50. Wins: 1.50.
Game ended at: 2016/11/29 14:44:17

Game started
Game ID: 787012867 0.50/1 (PRR) Karkadann - 3 (Hold'em)
Seat 7 is the button
Seat 1: zboiii (119.62).
Seat 2: ElvenEyes (167.25).
Seat 3: StephCurry (103).
Seat 4: gust (53.45).
Seat 5: pineapplesand (45.46).
Seat 6: AironVega (102.28).
Seat 7: IlxxxlI (40).
Seat 8: dankmann (150.19).
Seat 9: VegetablesArentYummy (257.91).
Player dankmann has small blind (0.50)
Player VegetablesArentYummy has big blind (1)
Player IlxxxlI received card: [Jh]
Player IlxxxlI received card: [2d]
Player zboiii folds
Player ElvenEyes folds
Player StephCurry folds
Player gust folds
Player pineapplesand raises (2)
Player AironVega folds
Player IlxxxlI folds
Player dankmann raises (6.50)
Player VegetablesArentYummy folds
Player pineapplesand folds
Uncalled bet (5) returned to dankmann
Player dankmann mucks cards
------ Summary ------
Pot: 5. Rake 0
Player zboiii does not show cards.Bets: 0. Collects: 0. Wins: 0.
Player ElvenEyes does not show cards.Bets: 0. Collects: 0. Wins: 0.
Player StephCurry does not show cards.Bets: 0. Collects: 0. Wins: 0.
Player gust does not show cards.Bets: 0. Collects: 0. Wins: 0.
Player pineapplesand does not show cards.Bets: 2. Collects: 0. Loses: 2.
Player AironVega does not show cards.Bets: 0. Collects: 0. Wins: 0.
Player IlxxxlI does not show cards.Bets: 0. Collects: 0. Wins: 0.
*Player dankmann mucks (does not show cards). Bets: 2. Collects: 5. Wins: 3.
Player VegetablesArentYummy does not show cards.Bets: 1. Collects: 0. Loses: 1.
Game ended at: 2016/11/29 14:44:43

Game started
Game ID: 787012776 1/2 (PRR) Longana (Short) - 2 (Hold'em)
Seat 7 is the button
Seat 1: aleks0v (100).
Seat 2: PANDAisEVIL (103).
Seat 3: VegetablesArentYummy (138.13).
Seat 4: gust (87.40).
Seat 5: thimk (66.12).
Seat 6: IlxxxlI (43).
Seat 7: pineapplesand (47.35).
Seat 8: StephCurry (117.50).
Seat 9: hotshothotgg (98.04).
Player StephCurry has small blind (1)
Player hotshothotgg has big blind (2)
Player IlxxxlI received card: [Jc]
Player IlxxxlI received card: [10h]
Player aleks0v folds
Player PANDAisEVIL folds
Player VegetablesArentYummy folds
Player gust folds
Player thimk folds
Player IlxxxlI folds
Player pineapplesand raises (4)
Player StephCurry folds
Player hotshothotgg folds
Uncalled bet (2) returned to pineapplesand
Player pineapplesand mucks cards
------ Summary ------
Pot: 5. Rake 0
Player aleks0v does not show cards.Bets: 0. Collects: 0. Wins: 0.
Player PANDAisEVIL does not show cards.Bets: 0. Collects: 0. Wins: 0.
Player VegetablesArentYummy does not show cards.Bets: 0. Collects: 0. Wins: 0.
Player gust does not show cards.Bets: 0. Collects: 0. Wins: 0.
Player thimk does not show cards.Bets: 0. Collects: 0. Wins: 0.
Player IlxxxlI does not show cards.Bets: 0. Collects: 0. Wins: 0.
*Player pineapplesand mucks (does not show cards). Bets: 2. Collects: 5. Wins: 3.
Player StephCurry does not show cards.Bets: 1. Collects: 0. Loses: 1.
Player hotshothotgg does not show cards.Bets: 2. Collects: 0. Loses: 2.
Game ended at: 2016/11/29 14:44:9

Game started
Game ID: 787012666 1/2 (PRR) Lakhey (Hold'em)
Seat 4 is the button
Seat 1: VegetablesArentYummy (229.05).
Seat 2: IlxxxlI (86.55).
Seat 3: IbetUmuck (863.25).
Seat 4: DonCesarGrinder (259.02).
Seat 5: PANDAisEVIL (200).
Seat 6: LloydXmas (237.73).
Player PANDAisEVIL has small blind (1)
Player LloydXmas sitting out
Player VegetablesArentYummy has big blind (2)
Player IlxxxlI received card: [Kd]
Player IlxxxlI received card: [2s]
Player IlxxxlI folds
Player IbetUmuck raises (5.75)
Player DonCesarGrinder folds
Player PANDAisEVIL folds
Player VegetablesArentYummy folds
Uncalled bet (3.75) returned to IbetUmuck
Player IbetUmuck mucks cards
------ Summary ------
Pot: 5. Rake 0
Player VegetablesArentYummy does not show cards.Bets: 2. Collects: 0. Loses: 2.
Player IlxxxlI does not show cards.Bets: 0. Collects: 0. Wins: 0.
*Player IbetUmuck mucks (does not show cards). Bets: 2. Collects: 5. Wins: 3.
Player DonCesarGrinder does not show cards.Bets: 0. Collects: 0. Wins: 0.
Player PANDAisEVIL does not show cards.Bets: 1. Collects: 0. Loses: 1.
Player LloydXmas does not show cards.Bets: 0. Collects: 0. Wins: 0.
Game ended at: 2016/11/29 14:43:58

Game started
Game ID: 787012622 1/2 (PRR) Lakhey - 2 (Hold'em)
Seat 3 is the button
Seat 1: uncle_argyle (137.87).
Seat 2: IlxxxlI (80).
Seat 3: gust (87.91).
Seat 4: joonjoonjoon (211.25).
Seat 5: VegetablesArentYummy (448.17).
Seat 6: JoeRockwell (298.64).
Player joonjoonjoon has small blind (1)
Player VegetablesArentYummy has big blind (2)
Player IlxxxlI received card: [9s]
Player IlxxxlI received card: [6d]
Player JoeRockwell calls (2)
Player uncle_argyle folds
Player IlxxxlI folds
Player gust folds
Player joonjoonjoon calls (1)
Player VegetablesArentYummy raises (8)
Player JoeRockwell calls (8)
Player joonjoonjoon folds
*** FLOP ***: [10c Js Ah]
Player VegetablesArentYummy checks
Player JoeRockwell bets (10.45)
Player VegetablesArentYummy calls (10.45)
*** TURN ***: [10c Js Ah] [7c]
Player VegetablesArentYummy checks
Player JoeRockwell bets (20.38)
Player VegetablesArentYummy calls (20.38)
*** RIVER ***: [10c Js Ah 7c] [3d]
Player VegetablesArentYummy checks
Player JoeRockwell checks
Player VegetablesArentYummy mucks cards
------ Summary ------
Pot: 80.66. Rake 2.76. JP fee 0.24
Board: [10c Js Ah 7c 3d]
Player uncle_argyle does not show cards.Bets: 0. Collects: 0. Wins: 0.
Player IlxxxlI does not show cards.Bets: 0. Collects: 0. Wins: 0.
Player gust does not show cards.Bets: 0. Collects: 0. Wins: 0.
Player joonjoonjoon does not show cards.Bets: 2. Collects: 0. Loses: 2.
Player VegetablesArentYummy mucks (does not show cards). Bets: 40.83. Collects: 0. Loses: 40.83.
*Player JoeRockwell shows: One pair of As [Qc As]. Bets: 40.83. Collects: 80.66. Wins: 39.83.
Game ended at: 2016/11/29 14:44:22

Game started
Game ID: 787012569 0.50/1 (PRR) Kraken - 16 (Hold'em)
Seat 1 is the button
Seat 1: aleks0v (100.78).
Seat 2: AironVega (100).
Seat 3: Sephiroth1 (151.29).
Seat 4: ali23imsirovic (101.50).
Seat 5: IlxxxlI (88.33).
Seat 6: gust (40.78).
Player AironVega has small blind (0.50)
Player Sephiroth1 has big blind (1)
Player IlxxxlI received card: [6s]
Player IlxxxlI received card: [5h]
Player ali23imsirovic folds
Player IlxxxlI folds
Player gust folds
Player aleks0v folds
Player AironVega raises (2.50)
Player Sephiroth1 calls (2)
*** FLOP ***: [Qs 7d 4c]
Player AironVega bets (1.88)
Player Sephiroth1 calls (1.88)
*** TURN ***: [Qs 7d 4c] [9c]
Player AironVega checks
Player Sephiroth1 bets (6.18)
Player AironVega folds
Uncalled bet (6.18) returned to Sephiroth1
Player Sephiroth1 mucks cards
------ Summary ------
Pot: 9.28. Rake 0.32. JP fee 0.16
Board: [Qs 7d 4c 9c]
Player aleks0v does not show cards.Bets: 0. Collects: 0. Wins: 0.
Player AironVega does not show cards.Bets: 4.88. Collects: 0. Loses: 4.88.
*Player Sephiroth1 mucks (does not show cards). Bets: 4.88. Collects: 9.28. Wins: 4.40.
Player ali23imsirovic does not show cards.Bets: 0. Collects: 0. Wins: 0.
Player IlxxxlI does not show cards.Bets: 0. Collects: 0. Wins: 0.
Player gust does not show cards.Bets: 0. Collects: 0. Wins: 0.
Game ended at: 2016/11/29 14:44:26

Game started
Game ID: 787012534 0.50/1 (PRR) Kraken - 23 (Hold'em)
Seat 2 is the button
Seat 1: WeakAndWeary (100).
Seat 2: gust (49).
Seat 3: LloydXmas (136.83).
Seat 4: Sephiroth1 (106.26).
Seat 5: ElvenEyes (110.92).
Seat 6: IlxxxlI (58.55).
Player LloydXmas has small blind (0.50)
Player Sephiroth1 has big blind (1)
Player IlxxxlI received card: [Jc]
Player IlxxxlI received card: [As]
Player ElvenEyes folds
Player IlxxxlI raises (3.50)
Player WeakAndWeary folds
Player gust folds
Player LloydXmas folds
Player Sephiroth1 folds
Uncalled bet (2.50) returned to IlxxxlI
Player IlxxxlI mucks cards
------ Summary ------
Pot: 2.50. Rake 0
Player WeakAndWeary does not show cards.Bets: 0. Collects: 0. Wins: 0.
Player gust does not show cards.Bets: 0. Collects: 0. Wins: 0.
Player LloydXmas does not show cards.Bets: 0.50. Collects: 0. Loses: 0.50.
Player Sephiroth1 does not show cards.Bets: 1. Collects: 0. Loses: 1.
Player ElvenEyes does not show cards.Bets: 0. Collects: 0. Wins: 0.
*Player IlxxxlI mucks (does not show cards). Bets: 1. Collects: 2.50. Wins: 1.50.
Game ended at: 2016/11/29 14:43:41

Game started
Game ID: 787012495 1/2 (PRR) Longana (Short) - 2 (Hold'em)
Seat 6 is the button
Seat 1: aleks0v (100).
Seat 2: PANDAisEVIL (103).
Seat 3: VegetablesArentYummy (138.13).
Seat 4: gust (87.40).
Seat 5: thimk (66.12).
Seat 6: IlxxxlI (40).
Seat 7: pineapplesand (48.35).
Seat 8: StephCurry (119.50).
Seat 9: hotshothotgg (98.04).
Player pineapplesand has small blind (1)
Player StephCurry has big blind (2)
Player IlxxxlI received card: [10c]
Player IlxxxlI received card: [Jd]
Player hotshothotgg folds
Player aleks0v folds
Player PANDAisEVIL folds
Player VegetablesArentYummy folds
Player gust folds
Player thimk folds
Player IlxxxlI raises (4)
Player pineapplesand folds
Player StephCurry folds
Uncalled bet (2) returned to IlxxxlI
Player IlxxxlI mucks cards
------ Summary ------
Pot: 5. Rake 0
Player aleks0v does not show cards.Bets: 0. Collects: 0. Wins: 0.
Player PANDAisEVIL does not show cards.Bets: 0. Collects: 0. Wins: 0.
Player VegetablesArentYummy does not show cards.Bets: 0. Collects: 0. Wins: 0.
Player gust does not show cards.Bets: 0. Collects: 0. Wins: 0.
Player thimk does not show cards.Bets: 0. Collects: 0. Wins: 0.
*Player IlxxxlI mucks (does not show cards). Bets: 2. Collects: 5. Wins: 3.
Player pineapplesand does not show cards.Bets: 1. Collects: 0. Loses: 1.
Player StephCurry does not show cards.Bets: 2. Collects: 0. Loses: 2.
Player hotshothotgg does not show cards.Bets: 0. Collects: 0. Wins: 0.
Game ended at: 2016/11/29 14:43:27

Game started
Game ID: 787012477 0.50/1 (PRR) Karkadann - 3 (Hold'em)
Seat 6 is the button
Seat 1: zboiii (119.62).
Seat 2: ElvenEyes (167.25).
Seat 3: StephCurry (103).
Seat 4: gust (53.45).
Seat 5: pineapplesand (45.46).
Seat 6: AironVega (100).
Seat 7: IlxxxlI (40.50).
Seat 8: dankmann (152.19).
Seat 9: VegetablesArentYummy (257.91).
Player IlxxxlI has small blind (0.50)
Player dankmann has big blind (1)
Player IlxxxlI received card: [Qd]
Player IlxxxlI received card: [3h]
Player VegetablesArentYummy folds
Player zboiii folds
Player ElvenEyes folds
Player StephCurry folds
Player gust folds
Player pineapplesand folds
Player AironVega raises (2)
Player IlxxxlI folds
Player dankmann calls (1)
*** FLOP ***: [9c 9d 7s]
Player dankmann checks
Player AironVega bets (1.41)
Player dankmann folds
Uncalled bet (1.41) returned to AironVega
Player AironVega mucks cards
------ Summary ------
Pot: 4.28. Rake 0.16. JP fee 0.06
Board: [9c 9d 7s]
Player zboiii does not show cards.Bets: 0. Collects: 0. Wins: 0.
Player ElvenEyes does not show cards.Bets: 0. Collects: 0. Wins: 0.
Player StephCurry does not show cards.Bets: 0. Collects: 0. Wins: 0.
Player gust does not show cards.Bets: 0. Collects: 0. Wins: 0.
Player pineapplesand does not show cards.Bets: 0. Collects: 0. Wins: 0.
*Player AironVega mucks (does not show cards). Bets: 2. Collects: 4.28. Wins: 2.28.
Player IlxxxlI does not show cards.Bets: 0.50. Collects: 0. Loses: 0.50.
Player dankmann does not show cards.Bets: 2. Collects: 0. Loses: 2.
Player VegetablesArentYummy does not show cards.Bets: 0. Collects: 0. Wins: 0.
Game ended at: 2016/11/29 14:43:40

Game started
Game ID: 787012409 1/2 (PRR) Lakhey - 2 (Hold'em)
Seat 2 is the button
Seat 1: uncle_argyle (137.87).
Seat 2: IlxxxlI (80).
Seat 3: gust (88.91).
Seat 4: joonjoonjoon (210.25).
Seat 5: VegetablesArentYummy (448.17).
Seat 6: JoeRockwell (298.64).
Player gust has small blind (1)
Player joonjoonjoon has big blind (2)
Player IlxxxlI received card: [10h]
Player IlxxxlI received card: [3d]
Player VegetablesArentYummy folds
Player JoeRockwell folds
Player uncle_argyle folds
Player IlxxxlI folds
Player gust folds
Uncalled bet (1) returned to joonjoonjoon
Player joonjoonjoon mucks cards
------ Summary ------
Pot: 2. Rake 0
Player uncle_argyle does not show cards.Bets: 0. Collects: 0. Wins: 0.
Player IlxxxlI does not show cards.Bets: 0. Collects: 0. Wins: 0.
Player gust does not show cards.Bets: 1. Collects: 0. Loses: 1.
*Player joonjoonjoon mucks (does not show cards). Bets: 1. Collects: 2. Wins: 1.
Player VegetablesArentYummy does not show cards.Bets: 0. Collects: 0. Wins: 0.
Player JoeRockwell does not show cards.Bets: 0. Collects: 0. Wins: 0.
Game ended at: 2016/11/29 14:43:4

Game started
Game ID: 787012385 1/2 (PRR) Lakhey - 3 (Hold'em)
Seat 3 is the button
Seat 1: IlxxxlI (80).
Seat 2: gust (80).
Seat 3: VegetablesArentYummy (430.41).
Seat 4: DonCesarGrinder (767.16).
Seat 6: AironVega (200).
Player DonCesarGrinder has small blind (1)
Player AironVega has big blind (2)
Player IlxxxlI received card: [Qc]
Player IlxxxlI received card: [2s]
Player IlxxxlI folds
Player gust raises (4)
Player VegetablesArentYummy folds
Player DonCesarGrinder raises (11.36)
Player AironVega folds
Player gust folds
Uncalled bet (8.36) returned to DonCesarGrinder
Player DonCesarGrinder mucks cards
------ Summary ------
Pot: 10. Rake 0
Player IlxxxlI does not show cards.Bets: 0. Collects: 0. Wins: 0.
Player gust does not show cards.Bets: 4. Collects: 0. Loses: 4.
Player VegetablesArentYummy does not show cards.Bets: 0. Collects: 0. Wins: 0.
*Player DonCesarGrinder mucks (does not show cards). Bets: 4. Collects: 10. Wins: 6.
Player AironVega does not show cards.Bets: 2. Collects: 0. Loses: 2.
Game ended at: 2016/11/29 14:43:5

Game started
Game ID: 787012243 0.50/1 (PRR) Kraken - 16 (Hold'em)
Seat 6 is the button
Seat 1: aleks0v (101.28).
Seat 2: AironVega (100).
Seat 3: Sephiroth1 (151.29).
Seat 4: ali23imsirovic (101.50).
Seat 5: IlxxxlI (86.83).
Seat 6: gust (40.78).
Player aleks0v has small blind (0.50)
Player AironVega has big blind (1)
Player IlxxxlI received card: [3c]
Player IlxxxlI received card: [Ac]
Player Sephiroth1 folds
Player ali23imsirovic folds
Player IlxxxlI raises (2.40)
Player gust folds
Player aleks0v folds
Player AironVega folds
Uncalled bet (1.40) returned to IlxxxlI
Player IlxxxlI mucks cards
------ Summary ------
Pot: 2.50. Rake 0
Player aleks0v does not show cards.Bets: 0.50. Collects: 0. Loses: 0.50.
Player AironVega does not show cards.Bets: 1. Collects: 0. Loses: 1.
Player Sephiroth1 does not show cards.Bets: 0. Collects: 0. Wins: 0.
Player ali23imsirovic does not show cards.Bets: 0. Collects: 0. Wins: 0.
*Player IlxxxlI mucks (does not show cards). Bets: 1. Collects: 2.50. Wins: 1.50.
Player gust does not show cards.Bets: 0. Collects: 0. Wins: 0.
Game ended at: 2016/11/29 14:42:58

Game started
Game ID: 787012206 0.50/1 (PRR) Karkadann - 3 (Hold'em)
Seat 5 is the button
Seat 1: zboiii (119.62).
Seat 2: ElvenEyes (167.25).
Seat 3: StephCurry (101.50).
Seat 4: gust (53.45).
Seat 5: pineapplesand (45.46).
Seat 6: AironVega (100).
Seat 7: IlxxxlI (41.50).
Seat 8: dankmann (152.19).
Seat 9: VegetablesArentYummy (257.91).
Player AironVega has small blind (0.50)
Player IlxxxlI has big blind (1)
Player IlxxxlI received card: [Qs]
Player IlxxxlI received card: [7h]
Player dankmann folds
Player VegetablesArentYummy folds
Player zboiii folds
Player ElvenEyes folds
Player StephCurry raises (3)
Player gust folds
Player pineapplesand folds
Player AironVega folds
Player IlxxxlI folds
Uncalled bet (2) returned to StephCurry
Player StephCurry mucks cards
------ Summary ------
Pot: 2.50. Rake 0
Player zboiii does not show cards.Bets: 0. Collects: 0. Wins: 0.
Player ElvenEyes does not show cards.Bets: 0. Collects: 0. Wins: 0.
*Player StephCurry mucks (does not show cards). Bets: 1. Collects: 2.50. Wins: 1.50.
Player gust does not show cards.Bets: 0. Collects: 0. Wins: 0.
Player pineapplesand does not show cards.Bets: 0. Collects: 0. Wins: 0.
Player AironVega does not show cards.Bets: 0.50. Collects: 0. Loses: 0.50.
Player IlxxxlI does not show cards.Bets: 1. Collects: 0. Loses: 1.
Player dankmann does not show cards.Bets: 0. Collects: 0. Wins: 0.
Player VegetablesArentYummy does not show cards.Bets: 0. Collects: 0. Wins: 0.
Game ended at: 2016/11/29 14:42:44

Game started
Game ID: 787012194 1/2 (PRR) Lakhey (Hold'em)
Seat 3 is the button
Seat 1: VegetablesArentYummy (229.05).
Seat 2: IlxxxlI (86.55).
Seat 3: IbetUmuck (854.50).
Seat 4: DonCesarGrinder (260.02).
Seat 5: PANDAisEVIL (200).
Seat 6: LloydXmas (243.48).
Player DonCesarGrinder has small blind (1)
Player PANDAisEVIL has big blind (2)
Player IlxxxlI received card: [9s]
Player IlxxxlI received card: [8h]
Player LloydXmas raises (5.75)
Player VegetablesArentYummy folds
Player IlxxxlI folds
Player IbetUmuck raises (16.63)
Player DonCesarGrinder folds
Player PANDAisEVIL folds
Player LloydXmas folds
Uncalled bet (10.88) returned to IbetUmuck
Player IbetUmuck mucks cards
------ Summary ------
Pot: 14.50. Rake 0
Player VegetablesArentYummy does not show cards.Bets: 0. Collects: 0. Wins: 0.
Player IlxxxlI does not show cards.Bets: 0. Collects: 0. Wins: 0.
*Player IbetUmuck mucks (does not show cards). Bets: 5.75. Collects: 14.50. Wins: 8.75.
Player DonCesarGrinder does not show cards.Bets: 1. Collects: 0. Loses: 1.
Player PANDAisEVIL does not show cards.Bets: 2. Collects: 0. Loses: 2.
Player LloydXmas does not show cards.Bets: 5.75. Collects: 0. Loses: 5.75.
Game ended at: 2016/11/29 14:43:10

Game started
Game ID: 787012156 1/2 (PRR) Lakhey - 3 (Hold'em)
Seat 2 is the button
Seat 1: IlxxxlI (80).
Seat 2: gust (80).
Seat 3: VegetablesArentYummy (431.41).
Seat 4: DonCesarGrinder (766.16).
Seat 5: mjj475 (477.99).
Player VegetablesArentYummy has small blind (1)
Player DonCesarGrinder has big blind (2)
Player IlxxxlI received card: [7s]
Player IlxxxlI received card: [Jh]
Player mjj475 folds
Player IlxxxlI folds
Player gust folds
Player VegetablesArentYummy folds
Uncalled bet (1) returned to DonCesarGrinder
Player DonCesarGrinder mucks cards
------ Summary ------
Pot: 2. Rake 0
Player IlxxxlI does not show cards.Bets: 0. Collects: 0. Wins: 0.
Player gust does not show cards.Bets: 0. Collects: 0. Wins: 0.
Player VegetablesArentYummy does not show cards.Bets: 1. Collects: 0. Loses: 1.
*Player DonCesarGrinder mucks (does not show cards). Bets: 1. Collects: 2. Wins: 1.
Player mjj475 does not show cards.Bets: 0. Collects: 0. Wins: 0.
Game ended at: 2016/11/29 14:42:29

Game started
Game ID: 787012071 1/2 (PRR) Lakhey (Hold'em)
Seat 2 is the button
Seat 1: VegetablesArentYummy (229.05).
Seat 2: IlxxxlI (83.55).
Seat 3: IbetUmuck (855.50).
Seat 4: DonCesarGrinder (262.02).
Seat 6: LloydXmas (243.48).
Player IbetUmuck has small blind (1)
Player DonCesarGrinder has big blind (2)
Player IlxxxlI received card: [5d]
Player IlxxxlI received card: [5s]
Player LloydXmas folds
Player VegetablesArentYummy folds
Player IlxxxlI raises (6)
Player IbetUmuck folds
Player DonCesarGrinder folds
Uncalled bet (4) returned to IlxxxlI
Player IlxxxlI mucks cards
------ Summary ------
Pot: 5. Rake 0
Player VegetablesArentYummy does not show cards.Bets: 0. Collects: 0. Wins: 0.
*Player IlxxxlI mucks (does not show cards). Bets: 2. Collects: 5. Wins: 3.
Player IbetUmuck does not show cards.Bets: 1. Collects: 0. Loses: 1.
Player DonCesarGrinder does not show cards.Bets: 2. Collects: 0. Loses: 2.
Player LloydXmas does not show cards.Bets: 0. Collects: 0. Wins: 0.
Game ended at: 2016/11/29 14:42:4

Game started
Game ID: 787012060 0.50/1 (PRR) Kraken - 16 (Hold'em)
Seat 5 is the button
Seat 1: aleks0v (102.28).
Seat 2: AironVega (100).
Seat 3: Sephiroth1 (149.79).
Seat 4: ali23imsirovic (101.50).
Seat 5: IlxxxlI (86.83).
Seat 6: gust (41.28).
Player gust has small blind (0.50)
Player aleks0v has big blind (1)
Player IlxxxlI received card: [2d]
Player IlxxxlI received card: [7d]
Player AironVega folds
Player Sephiroth1 raises (2)
Player ali23imsirovic folds
Player IlxxxlI folds
Player gust folds
Player aleks0v folds
Uncalled bet (1) returned to Sephiroth1
Player Sephiroth1 mucks cards
------ Summary ------
Pot: 2.50. Rake 0
Player aleks0v does not show cards.Bets: 1. Collects: 0. Loses: 1.
Player AironVega does not show cards.Bets: 0. Collects: 0. Wins: 0.
*Player Sephiroth1 mucks (does not show cards). Bets: 1. Collects: 2.50. Wins: 1.50.
Player ali23imsirovic does not show cards.Bets: 0. Collects: 0. Wins: 0.
Player IlxxxlI does not show cards.Bets: 0. Collects: 0. Wins: 0.
Player gust does not show cards.Bets: 0.50. Collects: 0. Loses: 0.50.
Game ended at: 2016/11/29 14:42:10

Game started
Game ID: 787012053 1/2 (PRR) Lakhey - 2 (Hold'em)
Seat 1 is the button
Seat 1: uncle_argyle (137.87).
Seat 2: IlxxxlI (80).
Seat 3: gust (90.91).
Seat 4: joonjoonjoon (210.25).
Seat 5: VegetablesArentYummy (448.17).
Seat 6: JoeRockwell (281.84).
Player IlxxxlI has small blind (1)
Player gust has big blind (2)
Player IlxxxlI received card: [Ad]
Player IlxxxlI received card: [Kh]
Player joonjoonjoon folds
Player VegetablesArentYummy folds
Player JoeRockwell calls (2)
Player uncle_argyle folds
Player IlxxxlI raises (7)
Player gust folds
Player JoeRockwell calls (6)
*** FLOP ***: [4s 6d 6s]
Player IlxxxlI checks
Player JoeRockwell bets (8.55)
Player IlxxxlI calls (8.55)
*** TURN ***: [4s 6d 6s] [10s]
Player IlxxxlI checks
Player JoeRockwell bets (16.67)
Player IlxxxlI folds
Uncalled bet (16.67) returned to JoeRockwell
Player JoeRockwell mucks cards
------ Summary ------
Pot: 33.35. Rake 1.51. JP fee 0.24
Board: [4s 6d 6s 10s]
Player uncle_argyle does not show cards.Bets: 0. Collects: 0. Wins: 0.
Player IlxxxlI does not show cards.Bets: 16.55. Collects: 0. Loses: 16.55.
Player gust does not show cards.Bets: 2. Collects: 0. Loses: 2.
Player joonjoonjoon does not show cards.Bets: 0. Collects: 0. Wins: 0.
Player VegetablesArentYummy does not show cards.Bets: 0. Collects: 0. Wins: 0.
*Player JoeRockwell mucks (does not show cards). Bets: 16.55. Collects: 33.35. Wins: 16.80.
Game ended at: 2016/11/29 14:42:33

Game started
Game ID: 787011951 1/2 (PRR) Lakhey (Hold'em)
Seat 1 is the button
Seat 1: VegetablesArentYummy (226.05).
Seat 2: IlxxxlI (84.55).
Seat 3: IbetUmuck (857.50).
Seat 4: DonCesarGrinder (262.02).
Seat 6: LloydXmas (243.48).
Player IlxxxlI has small blind (1)
Player IbetUmuck has big blind (2)
Player IlxxxlI received card: [8d]
Player IlxxxlI received card: [Js]
Player DonCesarGrinder folds
Player LloydXmas folds
Player VegetablesArentYummy raises (5)
Player IlxxxlI folds
Player IbetUmuck folds
Uncalled bet (3) returned to VegetablesArentYummy
Player VegetablesArentYummy mucks cards
------ Summary ------
Pot: 5. Rake 0
*Player VegetablesArentYummy mucks (does not show cards). Bets: 2. Collects: 5. Wins: 3.
Player IlxxxlI does not show cards.Bets: 1. Collects: 0. Loses: 1.
Player IbetUmuck does not show cards.Bets: 2. Collects: 0. Loses: 2.
Player DonCesarGrinder does not show cards.Bets: 0. Collects: 0. Wins: 0.
Player LloydXmas does not show cards.Bets: 0. Collects: 0. Wins: 0.
Game ended at: 2016/11/29 14:41:44

Game started
Game ID: 787011934 1/2 (PRR) Longana (Short) - 2 (Hold'em)
Seat 5 is the button
Seat 1: aleks0v (100).
Seat 2: PANDAisEVIL (103).
Seat 3: VegetablesArentYummy (138.13).
Seat 4: gust (87.40).
Seat 5: thimk (70.12).
Seat 6: IlxxxlI (40).
Seat 7: pineapplesand (40).
Seat 8: StephCurry (119.50).
Seat 9: hotshothotgg (102.04).
Player IlxxxlI has small blind (1)
Player pineapplesand has big blind (2)
Player IlxxxlI received card: [5h]
Player IlxxxlI received card: [Kh]
Player StephCurry folds
Player hotshothotgg raises (4)
Player aleks0v folds
Player PANDAisEVIL folds
Player VegetablesArentYummy folds
Player gust folds
Player thimk calls (4)
Player IlxxxlI folds
Player pineapplesand calls (2)
*** FLOP ***: [3s 6c 6s]
Player pineapplesand checks
Player hotshothotgg checks
Player thimk checks
*** TURN ***: [3s 6c 6s] [Jd]
Player pineapplesand bets (4.11)
Player hotshothotgg folds
Player thimk folds
Uncalled bet (4.11) returned to pineapplesand
Player pineapplesand mucks cards
------ Summary ------
Pot: 12.35. Rake 0.45. JP fee 0.20
Board: [3s 6c 6s Jd]
Player aleks0v does not show cards.Bets: 0. Collects: 0. Wins: 0.
Player PANDAisEVIL does not show cards.Bets: 0. Collects: 0. Wins: 0.
Player VegetablesArentYummy does not show cards.Bets: 0. Collects: 0. Wins: 0.
Player gust does not show cards.Bets: 0. Collects: 0. Wins: 0.
Player thimk does not show cards.Bets: 4. Collects: 0. Loses: 4.
Player IlxxxlI does not show cards.Bets: 1. Collects: 0. Loses: 1.
*Player pineapplesand mucks (does not show cards). Bets: 4. Collects: 12.35. Wins: 8.35.
Player StephCurry does not show cards.Bets: 0. Collects: 0. Wins: 0.
Player hotshothotgg does not show cards.Bets: 4. Collects: 0. Loses: 4.
Game ended at: 2016/11/29 14:42:47

Game started
Game ID: 787011905 0.50/1 (PRR) Karkadann - 3 (Hold'em)
Seat 4 is the button
Seat 1: zboiii (119.62).
Seat 2: ElvenEyes (167.25).
Seat 3: StephCurry (100).
Seat 4: gust (53.45).
Seat 5: pineapplesand (45.96).
Seat 6: AironVega (100).
Seat 7: IlxxxlI (41.50).
Seat 8: dankmann (152.19).
Seat 9: VegetablesArentYummy (257.91).
Player pineapplesand has small blind (0.50)
Player AironVega has big blind (1)
Player IlxxxlI received card: [3s]
Player IlxxxlI received card: [Ks]
Player IlxxxlI folds
Player dankmann folds
Player VegetablesArentYummy folds
Player zboiii folds
Player ElvenEyes folds
Player StephCurry raises (3)
Player gust folds
Player pineapplesand folds
Player AironVega folds
Uncalled bet (2) returned to StephCurry
Player StephCurry mucks cards
------ Summary ------
Pot: 2.50. Rake 0
Player zboiii does not show cards.Bets: 0. Collects: 0. Wins: 0.
Player ElvenEyes does not show cards.Bets: 0. Collects: 0. Wins: 0.
*Player StephCurry mucks (does not show cards). Bets: 1. Collects: 2.50. Wins: 1.50.
Player gust does not show cards.Bets: 0. Collects: 0. Wins: 0.
Player pineapplesand does not show cards.Bets: 0.50. Collects: 0. Loses: 0.50.
Player AironVega does not show cards.Bets: 1. Collects: 0. Loses: 1.
Player IlxxxlI does not show cards.Bets: 0. Collects: 0. Wins: 0.
Player dankmann does not show cards.Bets: 0. Collects: 0. Wins: 0.
Player VegetablesArentYummy does not show cards.Bets: 0. Collects: 0. Wins: 0.
Game ended at: 2016/11/29 14:42:6

Game started
Game ID: 787011876 0.50/1 (PRR) Kraken - 23 (Hold'em)
Seat 1 is the button
Seat 1: WeakAndWeary (100).
Seat 2: gust (49.50).
Seat 3: LloydXmas (124.29).
Seat 4: Sephiroth1 (106.26).
Seat 5: ElvenEyes (110.92).
Seat 6: IlxxxlI (58.55).
Player gust has small blind (0.50)
Player LloydXmas has big blind (1)
Player IlxxxlI received card: [5d]
Player IlxxxlI received card: [2s]
Player Sephiroth1 folds
Player ElvenEyes folds
Player IlxxxlI folds
Player WeakAndWeary raises (2)
Player gust folds
Player LloydXmas raises (8)
Player WeakAndWeary calls (7)
*** FLOP ***: [Ad 8d Ac]
Player LloydXmas bets (4.40)
Player WeakAndWeary calls (4.40)
*** TURN ***: [Ad 8d Ac] [Kh]
Player LloydXmas bets (19)
Player WeakAndWeary folds
Uncalled bet (19) returned to LloydXmas
Player LloydXmas mucks cards
------ Summary ------
Pot: 25.94. Rake 1.12. JP fee 0.24
Board: [Ad 8d Ac Kh]
Player WeakAndWeary does not show cards.Bets: 13.40. Collects: 0. Loses: 13.40.
Player gust does not show cards.Bets: 0.50. Collects: 0. Loses: 0.50.
*Player LloydXmas mucks (does not show cards). Bets: 13.40. Collects: 25.94. Wins: 12.54.
Player Sephiroth1 does not show cards.Bets: 0. Collects: 0. Wins: 0.
Player ElvenEyes does not show cards.Bets: 0. Collects: 0. Wins: 0.
Player IlxxxlI does not show cards.Bets: 0. Collects: 0. Wins: 0.
Game ended at: 2016/11/29 14:42:52

Game started
Game ID: 787011862 1/2 (PRR) Lakhey - 2 (Hold'em)
Seat 6 is the button
Seat 1: uncle_argyle (138.87).
Seat 2: IlxxxlI (80).
Seat 3: gust (90.91).
Seat 4: joonjoonjoon (210.25).
Seat 5: VegetablesArentYummy (445.17).
Seat 6: JoeRockwell (281.84).
Player uncle_argyle has small blind (1)
Player IlxxxlI has big blind (2)
Player IlxxxlI received card: [Jh]
Player IlxxxlI received card: [2s]
Player gust folds
Player joonjoonjoon folds
Player VegetablesArentYummy raises (5)
Player JoeRockwell folds
Player uncle_argyle folds
Player IlxxxlI folds
Uncalled bet (3) returned to VegetablesArentYummy
Player VegetablesArentYummy mucks cards
------ Summary ------
Pot: 5. Rake 0
Player uncle_argyle does not show cards.Bets: 1. Collects: 0. Loses: 1.
Player IlxxxlI does not show cards.Bets: 2. Collects: 0. Loses: 2.
Player gust does not show cards.Bets: 0. Collects: 0. Wins: 0.
Player joonjoonjoon does not show cards.Bets: 0. Collects: 0. Wins: 0.
*Player VegetablesArentYummy mucks (does not show cards). Bets: 2. Collects: 5. Wins: 3.
Player JoeRockwell does not show cards.Bets: 0. Collects: 0. Wins: 0.
Game ended at: 2016/11/29 14:41:42

Game started
Game ID: 787011766 0.50/1 (PRR) Karkadann - 3 (Hold'em)
Seat 3 is the button
Seat 1: zboiii (119.62).
Seat 2: ElvenEyes (167.25).
Seat 3: StephCurry (100).
Seat 4: gust (49.95).
Seat 5: pineapplesand (46.96).
Seat 7: IlxxxlI (41.50).
Seat 8: dankmann (152.19).
Seat 9: VegetablesArentYummy (260.41).
Player gust has small blind (0.50)
Player pineapplesand has big blind (1)
Player IlxxxlI received card: [4s]
Player IlxxxlI received card: [Kd]
Player IlxxxlI folds
Player dankmann folds
Player VegetablesArentYummy raises (2.50)
Player zboiii folds
Player ElvenEyes folds
Player StephCurry folds
Player gust raises (6.50)
Player pineapplesand folds
Player VegetablesArentYummy folds
Uncalled bet (4.50) returned to gust
Player gust mucks cards
------ Summary ------
Pot: 6. Rake 0
Player zboiii does not show cards.Bets: 0. Collects: 0. Wins: 0.
Player ElvenEyes does not show cards.Bets: 0. Collects: 0. Wins: 0.
Player StephCurry does not show cards.Bets: 0. Collects: 0. Wins: 0.
*Player gust mucks (does not show cards). Bets: 2.50. Collects: 6. Wins: 3.50.
Player pineapplesand does not show cards.Bets: 1. Collects: 0. Loses: 1.
Player IlxxxlI does not show cards.Bets: 0. Collects: 0. Wins: 0.
Player dankmann does not show cards.Bets: 0. Collects: 0. Wins: 0.
Player VegetablesArentYummy does not show cards.Bets: 2.50. Collects: 0. Loses: 2.50.
Game ended at: 2016/11/29 14:41:23

Game started
Game ID: 787011763 0.50/1 (PRR) Kraken - 16 (Hold'em)
Seat 4 is the button
Seat 1: aleks0v (102.28).
Seat 2: AironVega (100).
Seat 3: Sephiroth1 (149.79).
Seat 4: ali23imsirovic (100).
Seat 5: IlxxxlI (87.33).
Seat 6: gust (42.28).
Player IlxxxlI has small blind (0.50)
Player gust has big blind (1)
Player IlxxxlI received card: [3h]
Player IlxxxlI received card: [Kd]
Player aleks0v folds
Player AironVega folds
Player Sephiroth1 folds
Player ali23imsirovic raises (3)
Player IlxxxlI folds
Player gust folds
Uncalled bet (2) returned to ali23imsirovic
Player ali23imsirovic mucks cards
------ Summary ------
Pot: 2.50. Rake 0
Player aleks0v does not show cards.Bets: 0. Collects: 0. Wins: 0.
Player AironVega does not show cards.Bets: 0. Collects: 0. Wins: 0.
Player Sephiroth1 does not show cards.Bets: 0. Collects: 0. Wins: 0.
*Player ali23imsirovic mucks (does not show cards). Bets: 1. Collects: 2.50. Wins: 1.50.
Player IlxxxlI does not show cards.Bets: 0.50. Collects: 0. Loses: 0.50.
Player gust does not show cards.Bets: 1. Collects: 0. Loses: 1.
Game ended at: 2016/11/29 14:41:42

Game started
Game ID: 787011633 1/2 (PRR) Lakhey - 3 (Hold'em)
Seat 1 is the button
Seat 1: IlxxxlI (80).
Seat 2: gust (80).
Seat 3: VegetablesArentYummy (433.41).
Seat 4: DonCesarGrinder (766.16).
Seat 5: mjj475 (466.32).
Player gust has small blind (1)
Player VegetablesArentYummy has big blind (2)
Player IlxxxlI received card: [2h]
Player IlxxxlI received card: [Kc]
Player DonCesarGrinder folds
Player mjj475 calls (2)
Player IlxxxlI folds
Player gust calls (1)
Player VegetablesArentYummy checks
*** FLOP ***: [2d Qc 6s]
Player gust bets (2.85)
Player VegetablesArentYummy folds
Player mjj475 calls (2.85)
*** TURN ***: [2d Qc 6s] [9c]
Player gust bets (6)
Player mjj475 calls (6)
*** RIVER ***: [2d Qc 6s 9c] [2c]
Player gust checks
Player mjj475 bets (15.01)
Player gust folds
Uncalled bet (15.01) returned to mjj475
Player mjj475 mucks cards
------ Summary ------
Pot: 22.52. Rake 0.94. JP fee 0.24
Board: [2d Qc 6s 9c 2c]
Player IlxxxlI does not show cards.Bets: 0. Collects: 0. Wins: 0.
Player gust does not show cards.Bets: 10.85. Collects: 0. Loses: 10.85.
Player VegetablesArentYummy does not show cards.Bets: 2. Collects: 0. Loses: 2.
Player DonCesarGrinder does not show cards.Bets: 0. Collects: 0. Wins: 0.
*Player mjj475 mucks (does not show cards). Bets: 10.85. Collects: 22.52. Wins: 11.67.
Game ended at: 2016/11/29 14:41:58

Game started
Game ID: 787011589 1/2 (PRR) Lakhey (Hold'em)
Seat 6 is the button
Seat 1: VegetablesArentYummy (227.05).
Seat 2: IlxxxlI (80).
Seat 3: IbetUmuck (857.50).
Seat 4: DonCesarGrinder (262.02).
Seat 6: LloydXmas (247.48).
Player VegetablesArentYummy has small blind (1)
Player IlxxxlI has big blind (2)
Player IlxxxlI received card: [Kc]
Player IlxxxlI received card: [3c]
Player IbetUmuck folds
Player DonCesarGrinder folds
Player LloydXmas raises (4)
Player VegetablesArentYummy folds
Player IlxxxlI calls (2)
*** FLOP ***: [Kd Jh 7s]
Player IlxxxlI checks
Player LloydXmas checks
*** TURN ***: [Kd Jh 7s] [Qd]
Player IlxxxlI bets (4.70)
Player LloydXmas folds
Uncalled bet (4.70) returned to IlxxxlI
Player IlxxxlI mucks cards
------ Summary ------
Pot: 8.55. Rake 0.31. JP fee 0.14
Board: [Kd Jh 7s Qd]
Player VegetablesArentYummy does not show cards.Bets: 1. Collects: 0. Loses: 1.
*Player IlxxxlI mucks (does not show cards). Bets: 4. Collects: 8.55. Wins: 4.55.
Player IbetUmuck does not show cards.Bets: 0. Collects: 0. Wins: 0.
Player DonCesarGrinder does not show cards.Bets: 0. Collects: 0. Wins: 0.
Player LloydXmas does not show cards.Bets: 4. Collects: 0. Loses: 4.
Game ended at: 2016/11/29 14:41:29

Game started
Game ID: 787011518 0.50/1 (PRR) Karkadann - 3 (Hold'em)
Seat 2 is the button
Seat 1: zboiii (118.12).
Seat 2: ElvenEyes (167.25).
Seat 3: StephCurry (100).
Seat 4: gust (50.95).
Seat 5: pineapplesand (46.96).
Seat 7: IlxxxlI (41.50).
Seat 8: dankmann (152.19).
Seat 9: VegetablesArentYummy (260.41).
Player StephCurry has small blind (0.50)
Player gust has big blind (1)
Player IlxxxlI received card: [9d]
Player IlxxxlI received card: [2h]
Player pineapplesand folds
Player IlxxxlI folds
Player dankmann folds
Player VegetablesArentYummy folds
Player zboiii raises (3)
Player ElvenEyes folds
Player StephCurry folds
Player gust folds
Uncalled bet (2) returned to zboiii
Player zboiii mucks cards
------ Summary ------
Pot: 2.50. Rake 0
*Player zboiii mucks (does not show cards). Bets: 1. Collects: 2.50. Wins: 1.50.
Player ElvenEyes does not show cards.Bets: 0. Collects: 0. Wins: 0.
Player StephCurry does not show cards.Bets: 0.50. Collects: 0. Loses: 0.50.
Player gust does not show cards.Bets: 1. Collects: 0. Loses: 1.
Player pineapplesand does not show cards.Bets: 0. Collects: 0. Wins: 0.
Player IlxxxlI does not show cards.Bets: 0. Collects: 0. Wins: 0.
Player dankmann does not show cards.Bets: 0. Collects: 0. Wins: 0.
Player VegetablesArentYummy does not show cards.Bets: 0. Collects: 0. Wins: 0.
Game ended at: 2016/11/29 14:41:2

Game started
Game ID: 787011392 1/2 (PRR) Lakhey - 3 (Hold'em)
Seat 5 is the button
Seat 1: IlxxxlI (80).
Seat 2: gust (80).
Seat 3: VegetablesArentYummy (433.41).
Seat 4: DonCesarGrinder (766.16).
Seat 5: mjj475 (463.32).
Player IlxxxlI has small blind (1)
Player gust has big blind (2)
Player IlxxxlI received card: [10c]
Player IlxxxlI received card: [7s]
Player VegetablesArentYummy folds
Player DonCesarGrinder folds
Player mjj475 raises (6)
Player IlxxxlI folds
Player gust folds
Uncalled bet (4) returned to mjj475
Player mjj475 mucks cards
------ Summary ------
Pot: 5. Rake 0
Player IlxxxlI does not show cards.Bets: 1. Collects: 0. Loses: 1.
Player gust does not show cards.Bets: 2. Collects: 0. Loses: 2.
Player VegetablesArentYummy does not show cards.Bets: 0. Collects: 0. Wins: 0.
Player DonCesarGrinder does not show cards.Bets: 0. Collects: 0. Wins: 0.
*Player mjj475 mucks (does not show cards). Bets: 2. Collects: 5. Wins: 3.
Game ended at: 2016/11/29 14:40:42

Game started
Game ID: 787011380 1/2 (PRR) Longana (Short) - 2 (Hold'em)
Seat 4 is the button
Seat 1: aleks0v (100).
Seat 2: PANDAisEVIL (103).
Seat 3: VegetablesArentYummy (138.13).
Seat 4: gust (80).
Seat 5: thimk (74.12).
Seat 6: IlxxxlI (40).
Seat 7: pineapplesand (40).
Seat 8: StephCurry (119.50).
Seat 9: hotshothotgg (102.04).
Player thimk has small blind (1)
Player IlxxxlI has big blind (2)
Player IlxxxlI received card: [4c]
Player IlxxxlI received card: [5h]
Player pineapplesand folds
Player StephCurry folds
Player hotshothotgg folds
Player aleks0v folds
Player PANDAisEVIL folds
Player VegetablesArentYummy folds
Player gust raises (4)
Player thimk calls (3)
Player IlxxxlI calls (2)
*** FLOP ***: [Ks 7s Qd]
Player thimk checks
Player IlxxxlI checks
Player gust checks
*** TURN ***: [Ks 7s Qd] [5s]
Player thimk checks
Player IlxxxlI checks
Player gust bets (8)
Player thimk folds
Player IlxxxlI folds
Uncalled bet (8) returned to gust
Player gust mucks cards
------ Summary ------
Pot: 11.40. Rake 0.40. JP fee 0.20
Board: [Ks 7s Qd 5s]
Player aleks0v does not show cards.Bets: 0. Collects: 0. Wins: 0.
Player PANDAisEVIL does not show cards.Bets: 0. Collects: 0. Wins: 0.
Player VegetablesArentYummy does not show cards.Bets: 0. Collects: 0. Wins: 0.
*Player gust mucks (does not show cards). Bets: 4. Collects: 11.40. Wins: 7.40.
Player thimk does not show cards.Bets: 4. Collects: 0. Loses: 4.
Player IlxxxlI does not show cards.Bets: 4. Collects: 0. Loses: 4.
Player pineapplesand does not show cards.Bets: 0. Collects: 0. Wins: 0.
Player StephCurry does not show cards.Bets: 0. Collects: 0. Wins: 0.
Player hotshothotgg does not show cards.Bets: 0. Collects: 0. Wins: 0.
Game ended at: 2016/11/29 14:41:27

Game started
Game ID: 787011245 0.50/1 (PRR) Kraken - 16 (Hold'em)
Seat 3 is the button
Seat 1: aleks0v (102.28).
Seat 2: AironVega (100).
Seat 3: Sephiroth1 (149.79).
Seat 4: ali23imsirovic (100).
Seat 5: IlxxxlI (70.68).
Seat 6: gust (42.28).
Player ali23imsirovic has small blind (0.50)
Player IlxxxlI has big blind (1)
Player IlxxxlI received card: [Qs]
Player IlxxxlI received card: [Ac]
Player gust folds
Player aleks0v folds
Player AironVega raises (2.50)
Player Sephiroth1 folds
Player ali23imsirovic raises (8.50)
Player IlxxxlI calls (8)
Player AironVega calls (6.50)
*** FLOP ***: [2s 4d Qd]
Player ali23imsirovic checks
Player IlxxxlI bets (12.82)
Player AironVega folds
Player ali23imsirovic folds
Uncalled bet (12.82) returned to IlxxxlI
Player IlxxxlI mucks cards
------ Summary ------
Pot: 25.65. Rake 1.11. JP fee 0.24
Board: [2s 4d Qd]
Player aleks0v does not show cards.Bets: 0. Collects: 0. Wins: 0.
Player AironVega does not show cards.Bets: 9. Collects: 0. Loses: 9.
Player Sephiroth1 does not show cards.Bets: 0. Collects: 0. Wins: 0.
Player ali23imsirovic does not show cards.Bets: 9. Collects: 0. Loses: 9.
*Player IlxxxlI mucks (does not show cards). Bets: 9. Collects: 25.65. Wins: 16.65.
Player gust does not show cards.Bets: 0. Collects: 0. Wins: 0.
Game ended at: 2016/11/29 14:41:2

Game started
Game ID: 787011195 0.25/0.50 (PRR) Gorgons - 15 (Hold'em)
Seat 5 is the button
Seat 1: WeakAndWeary (75.25).
Seat 2: IampokerKidd (104.01).
Seat 4: IlxxxlI (30.25).
Seat 5: foreseen (55.15).
Player WeakAndWeary has small blind (0.25)
Player IampokerKidd has big blind (0.50)
Player IlxxxlI received card: [2h]
Player IlxxxlI received card: [2d]
Player IlxxxlI calls (0.50)
Player foreseen folds
Player WeakAndWeary calls (0.25)
Player IampokerKidd raises (1.50)
Player IlxxxlI calls (1.50)
Player WeakAndWeary calls (1.50)
*** FLOP ***: [7s 6s 10c]
Player WeakAndWeary checks
Player IampokerKidd checks
Player IlxxxlI checks
*** TURN ***: [7s 6s 10c] [Qd]
Player WeakAndWeary bets (4.50)
Player IampokerKidd folds
Player IlxxxlI folds
Uncalled bet (4.50) returned to WeakAndWeary
Player WeakAndWeary mucks cards
------ Summary ------
Pot: 5.70. Rake 0.20. JP fee 0.10
Board: [7s 6s 10c Qd]
*Player WeakAndWeary mucks (does not show cards). Bets: 2. Collects: 5.70. Wins: 3.70.
Player IampokerKidd does not show cards.Bets: 2. Collects: 0. Loses: 2.
Player IlxxxlI does not show cards.Bets: 2. Collects: 0. Loses: 2.
Player foreseen does not show cards.Bets: 0. Collects: 0. Wins: 0.
Game ended at: 2016/11/29 14:41:17

Game started
Game ID: 787011092 0.50/1 (PRR) Kraken - 23 (Hold'em)
Seat 6 is the button
Seat 1: WeakAndWeary (100).
Seat 2: gust (50.50).
Seat 3: LloydXmas (124.29).
Seat 4: Sephiroth1 (106.26).
Seat 5: ElvenEyes (121.63).
Seat 6: IlxxxlI (47.48).
Player WeakAndWeary has small blind (0.50)
Player gust has big blind (1)
Player IlxxxlI received card: [Ks]
Player IlxxxlI received card: [Ad]
Player LloydXmas folds
Player Sephiroth1 folds
Player ElvenEyes raises (2.58)
Player IlxxxlI raises (6.27)
Player WeakAndWeary folds
Player gust folds
Player ElvenEyes calls (3.69)
*** FLOP ***: [Qc 3s Qd]
Player ElvenEyes checks
Player IlxxxlI bets (4.44)
Player ElvenEyes calls (4.44)
*** TURN ***: [Qc 3s Qd] [6d]
Player ElvenEyes checks
Player IlxxxlI checks
*** RIVER ***: [Qc 3s Qd 6d] [Kc]
Player ElvenEyes checks
Player IlxxxlI bets (7.26)
Player ElvenEyes folds
Uncalled bet (7.26) returned to IlxxxlI
Player IlxxxlI mucks cards
------ Summary ------
Pot: 21.78. Rake 0.90. JP fee 0.24
Board: [Qc 3s Qd 6d Kc]
Player WeakAndWeary does not show cards.Bets: 0.50. Collects: 0. Loses: 0.50.
Player gust does not show cards.Bets: 1. Collects: 0. Loses: 1.
Player LloydXmas does not show cards.Bets: 0. Collects: 0. Wins: 0.
Player Sephiroth1 does not show cards.Bets: 0. Collects: 0. Wins: 0.
Player ElvenEyes does not show cards.Bets: 10.71. Collects: 0. Loses: 10.71.
*Player IlxxxlI mucks (does not show cards). Bets: 10.71. Collects: 21.78. Wins: 11.07.
Game ended at: 2016/11/29 14:41:17

Game started
Game ID: 787011071 1/2 (PRR) Longana (Short) - 2 (Hold'em)
Seat 3 is the button
Seat 1: aleks0v (100).
Seat 2: PANDAisEVIL (103).
Seat 3: VegetablesArentYummy (138.13).
Seat 4: gust (80).
Seat 5: thimk (76.12).
Seat 6: IlxxxlI (40).
Seat 7: pineapplesand (40).
Seat 8: StephCurry (116.50).
Seat 9: hotshothotgg (102.04).
Player gust has small blind (1)
Player thimk has big blind (2)
Player IlxxxlI received card: [4d]
Player IlxxxlI received card: [5h]
Player IlxxxlI folds
Player pineapplesand folds
Player StephCurry raises (6)
Player hotshothotgg folds
Player aleks0v folds
Player PANDAisEVIL folds
Player VegetablesArentYummy folds
Player gust folds
Player thimk folds
Uncalled bet (4) returned to StephCurry
Player StephCurry mucks cards
------ Summary ------
Pot: 5. Rake 0
Player aleks0v does not show cards.Bets: 0. Collects: 0. Wins: 0.
Player PANDAisEVIL does not show cards.Bets: 0. Collects: 0. Wins: 0.
Player VegetablesArentYummy does not show cards.Bets: 0. Collects: 0. Wins: 0.
Player gust does not show cards.Bets: 1. Collects: 0. Loses: 1.
Player thimk does not show cards.Bets: 2. Collects: 0. Loses: 2.
Player IlxxxlI does not show cards.Bets: 0. Collects: 0. Wins: 0.
Player pineapplesand does not show cards.Bets: 0. Collects: 0. Wins: 0.
*Player StephCurry mucks (does not show cards). Bets: 2. Collects: 5. Wins: 3.
Player hotshothotgg does not show cards.Bets: 0. Collects: 0. Wins: 0.
Game ended at: 2016/11/29 14:40:6

Game started
Game ID: 787011039 1/2 (PRR) Lakhey (Hold'em)
Seat 4 is the button
Seat 1: VegetablesArentYummy (221.65).
Seat 2: IlxxxlI (80).
Seat 3: IbetUmuck (857.50).
Seat 4: DonCesarGrinder (262.02).
Seat 6: LloydXmas (253.48).
Player LloydXmas has small blind (1)
Player VegetablesArentYummy has big blind (2)
Player IlxxxlI received card: [3h]
Player IlxxxlI received card: [6c]
Player IlxxxlI folds
Player IbetUmuck folds
Player DonCesarGrinder folds
Player LloydXmas raises (5)
Player VegetablesArentYummy calls (4)
*** FLOP ***: [Ac 3d 5c]
Player LloydXmas checks
Player VegetablesArentYummy bets (5.70)
Player LloydXmas folds
Uncalled bet (5.70) returned to VegetablesArentYummy
Player VegetablesArentYummy mucks cards
------ Summary ------
Pot: 11.40. Rake 0.40. JP fee 0.20
Board: [Ac 3d 5c]
*Player VegetablesArentYummy mucks (does not show cards). Bets: 6. Collects: 11.40. Wins: 5.40.
Player IlxxxlI does not show cards.Bets: 0. Collects: 0. Wins: 0.
Player IbetUmuck does not show cards.Bets: 0. Collects: 0. Wins: 0.
Player DonCesarGrinder does not show cards.Bets: 0. Collects: 0. Wins: 0.
Player LloydXmas does not show cards.Bets: 6. Collects: 0. Loses: 6.
Game ended at: 2016/11/29 14:40:34

Game started
Game ID: 787011031 0.50/1 (PRR) Karkadann - 3 (Hold'em)
Seat 1 is the button
Seat 1: zboiii (118.12).
Seat 2: ElvenEyes (157.30).
Seat 3: StephCurry (100).
Seat 4: gust (50.95).
Seat 5: pineapplesand (46.96).
Seat 7: IlxxxlI (41.50).
Seat 8: dankmann (162.19).
Seat 9: VegetablesArentYummy (260.41).
Player ElvenEyes has small blind (0.50)
Player StephCurry has big blind (1)
Player IlxxxlI received card: [5d]
Player IlxxxlI received card: [6c]
Player gust folds
Player pineapplesand folds
Player IlxxxlI folds
Player dankmann raises (3)
Player VegetablesArentYummy folds
Player zboiii folds
Player ElvenEyes raises (9.50)
Player StephCurry folds
Player dankmann calls (7)
*** FLOP ***: [5c Kc Ad]
Player ElvenEyes bets (9.97)
Player dankmann folds
Uncalled bet (9.97) returned to ElvenEyes
Player ElvenEyes mucks cards
------ Summary ------
Pot: 19.95. Rake 0.81. JP fee 0.24
Board: [5c Kc Ad]
Player zboiii does not show cards.Bets: 0. Collects: 0. Wins: 0.
*Player ElvenEyes mucks (does not show cards). Bets: 10. Collects: 19.95. Wins: 9.95.
Player StephCurry does not show cards.Bets: 1. Collects: 0. Loses: 1.
Player gust does not show cards.Bets: 0. Collects: 0. Wins: 0.
Player pineapplesand does not show cards.Bets: 0. Collects: 0. Wins: 0.
Player IlxxxlI does not show cards.Bets: 0. Collects: 0. Wins: 0.
Player dankmann does not show cards.Bets: 10. Collects: 0. Loses: 10.
Player VegetablesArentYummy does not show cards.Bets: 0. Collects: 0. Wins: 0.
Game ended at: 2016/11/29 14:40:25

Game started
Game ID: 787010866 1/2 (PRR) Lakhey (Hold'em)
Seat 3 is the button
Seat 1: VegetablesArentYummy (221.65).
Seat 2: IlxxxlI (80).
Seat 3: IbetUmuck (857.50).
Seat 4: DonCesarGrinder (263.02).
Seat 6: LloydXmas (252.48).
Player DonCesarGrinder has small blind (1)
Player LloydXmas has big blind (2)
Player IlxxxlI received card: [4d]
Player IlxxxlI received card: [Ah]
Player VegetablesArentYummy folds
Player IlxxxlI folds
Player IbetUmuck folds
Player DonCesarGrinder folds
Uncalled bet (1) returned to LloydXmas
Player LloydXmas mucks cards
------ Summary ------
Pot: 2. Rake 0
Player VegetablesArentYummy does not show cards.Bets: 0. Collects: 0. Wins: 0.
Player IlxxxlI does not show cards.Bets: 0. Collects: 0. Wins: 0.
Player IbetUmuck does not show cards.Bets: 0. Collects: 0. Wins: 0.
Player DonCesarGrinder does not show cards.Bets: 1. Collects: 0. Loses: 1.
*Player LloydXmas mucks (does not show cards). Bets: 1. Collects: 2. Wins: 1.
Game ended at: 2016/11/29 14:39:16

Game started
Game ID: 787010861 0.25/0.50 (PRR) Gorgons - 15 (Hold'em)
Seat 4 is the button
Seat 1: WeakAndWeary (74.75).
Seat 2: IampokerKidd (104.01).
Seat 4: IlxxxlI (30.25).
Seat 5: foreseen (55.65).
Seat 6: BiGFck (16.83).
Player foreseen has small blind (0.25)
Player BiGFck sitting out
Player WeakAndWeary has big blind (0.50)
Player IlxxxlI received card: [9d]
Player IlxxxlI received card: [2d]
Player IampokerKidd folds
Player IlxxxlI folds
Player foreseen calls (0.25)
Player WeakAndWeary raises (1)
Player foreseen folds
Uncalled bet (1) returned to WeakAndWeary
Player WeakAndWeary mucks cards
------ Summary ------
Pot: 1. Rake 0
*Player WeakAndWeary mucks (does not show cards). Bets: 0.50. Collects: 1. Wins: 0.50.
Player IampokerKidd does not show cards.Bets: 0. Collects: 0. Wins: 0.
Player IlxxxlI does not show cards.Bets: 0. Collects: 0. Wins: 0.
Player foreseen does not show cards.Bets: 0.50. Collects: 0. Loses: 0.50.
Player BiGFck does not show cards.Bets: 0. Collects: 0. Wins: 0.
Game ended at: 2016/11/29 14:39:38

Game started
Game ID: 787010839 0.50/1 (PRR) Kraken - 23 (Hold'em)
Seat 5 is the button
Seat 1: WeakAndWeary (100).
Seat 2: gust (50.50).
Seat 3: LloydXmas (122.79).
Seat 4: Sephiroth1 (106.26).
Seat 5: ElvenEyes (121.63).
Seat 6: IlxxxlI (47.98).
Player IlxxxlI has small blind (0.50)
Player WeakAndWeary has big blind (1)
Player IlxxxlI received card: [6s]
Player IlxxxlI received card: [3c]
Player gust folds
Player LloydXmas raises (3)
Player Sephiroth1 folds
Player ElvenEyes folds
Player IlxxxlI folds
Player WeakAndWeary folds
Uncalled bet (2) returned to LloydXmas
Player LloydXmas mucks cards
------ Summary ------
Pot: 2.50. Rake 0
Player WeakAndWeary does not show cards.Bets: 1. Collects: 0. Loses: 1.
Player gust does not show cards.Bets: 0. Collects: 0. Wins: 0.
*Player LloydXmas mucks (does not show cards). Bets: 1. Collects: 2.50. Wins: 1.50.
Player Sephiroth1 does not show cards.Bets: 0. Collects: 0. Wins: 0.
Player ElvenEyes does not show cards.Bets: 0. Collects: 0. Wins: 0.
Player IlxxxlI does not show cards.Bets: 0.50. Collects: 0. Loses: 0.50.
Game ended at: 2016/11/29 14:39:23

Game started
Game ID: 787010830 1/2 (PRR) Longana (Short) - 2 (Hold'em)
Seat 2 is the button
Seat 1: aleks0v (100).
Seat 2: PANDAisEVIL (100).
Seat 3: VegetablesArentYummy (139.13).
Seat 4: gust (82).
Seat 5: thimk (76.12).
Seat 6: IlxxxlI (40).
Seat 7: pineapplesand (40).
Seat 8: StephCurry (116.50).
Seat 9: hotshothotgg (102.04).
Player VegetablesArentYummy has small blind (1)
Player gust has big blind (2)
Player IlxxxlI received card: [Kc]
Player IlxxxlI received card: [5d]
Player thimk folds
Player IlxxxlI folds
Player pineapplesand folds
Player StephCurry folds
Player hotshothotgg folds
Player aleks0v folds
Player PANDAisEVIL raises (4.40)
Player VegetablesArentYummy folds
Player gust folds
Uncalled bet (2.40) returned to PANDAisEVIL
Player PANDAisEVIL mucks cards
------ Summary ------
Pot: 5. Rake 0
Player aleks0v does not show cards.Bets: 0. Collects: 0. Wins: 0.
*Player PANDAisEVIL mucks (does not show cards). Bets: 2. Collects: 5. Wins: 3.
Player VegetablesArentYummy does not show cards.Bets: 1. Collects: 0. Loses: 1.
Player gust does not show cards.Bets: 2. Collects: 0. Loses: 2.
Player thimk does not show cards.Bets: 0. Collects: 0. Wins: 0.
Player IlxxxlI does not show cards.Bets: 0. Collects: 0. Wins: 0.
Player pineapplesand does not show cards.Bets: 0. Collects: 0. Wins: 0.
Player StephCurry does not show cards.Bets: 0. Collects: 0. Wins: 0.
Player hotshothotgg does not show cards.Bets: 0. Collects: 0. Wins: 0.
Game ended at: 2016/11/29 14:39:21

Game started
Game ID: 787010804 0.50/1 (PRR) Karkadann - 3 (Hold'em)
Seat 9 is the button
Seat 1: zboiii (118.62).
Seat 2: ElvenEyes (156.80).
Seat 3: StephCurry (100).
Seat 4: gust (50.95).
Seat 5: pineapplesand (46.96).
Seat 7: IlxxxlI (41.50).
Seat 8: dankmann (162.19).
Seat 9: VegetablesArentYummy (260.41).
Player zboiii has small blind (0.50)
Player ElvenEyes has big blind (1)
Player IlxxxlI received card: [5d]
Player IlxxxlI received card: [Jd]
Player StephCurry folds
Player gust folds
Player pineapplesand folds
Player IlxxxlI folds
Player dankmann folds
Player VegetablesArentYummy folds
Player zboiii folds
Uncalled bet (0.50) returned to ElvenEyes
Player ElvenEyes mucks cards
------ Summary ------
Pot: 1. Rake 0
Player zboiii does not show cards.Bets: 0.50. Collects: 0. Loses: 0.50.
*Player ElvenEyes mucks (does not show cards). Bets: 0.50. Collects: 1. Wins: 0.50.
Player StephCurry does not show cards.Bets: 0. Collects: 0. Wins: 0.
Player gust does not show cards.Bets: 0. Collects: 0. Wins: 0.
Player pineapplesand does not show cards.Bets: 0. Collects: 0. Wins: 0.
Player IlxxxlI does not show cards.Bets: 0. Collects: 0. Wins: 0.
Player dankmann does not show cards.Bets: 0. Collects: 0. Wins: 0.
Player VegetablesArentYummy does not show cards.Bets: 0. Collects: 0. Wins: 0.
Game ended at: 2016/11/29 14:39:14

Game started
Game ID: 787010581 0.50/1 (PRR) Karkadann - 3 (Hold'em)
Seat 8 is the button
Seat 1: zboiii (119.62).
Seat 2: ElvenEyes (156.80).
Seat 3: StephCurry (100).
Seat 4: gust (50.95).
Seat 5: pineapplesand (46.96).
Seat 7: IlxxxlI (40).
Seat 8: dankmann (162.19).
Seat 9: VegetablesArentYummy (260.91).
Player VegetablesArentYummy has small blind (0.50)
Player zboiii has big blind (1)
Player IlxxxlI received card: [Kd]
Player IlxxxlI received card: [Jc]
Player ElvenEyes folds
Player StephCurry folds
Player gust folds
Player pineapplesand folds
Player IlxxxlI raises (2.40)
Player dankmann folds
Player VegetablesArentYummy folds
Player zboiii folds
Uncalled bet (1.40) returned to IlxxxlI
Player IlxxxlI mucks cards
------ Summary ------
Pot: 2.50. Rake 0
Player zboiii does not show cards.Bets: 1. Collects: 0. Loses: 1.
Player ElvenEyes does not show cards.Bets: 0. Collects: 0. Wins: 0.
Player StephCurry does not show cards.Bets: 0. Collects: 0. Wins: 0.
Player gust does not show cards.Bets: 0. Collects: 0. Wins: 0.
Player pineapplesand does not show cards.Bets: 0. Collects: 0. Wins: 0.
*Player IlxxxlI mucks (does not show cards). Bets: 1. Collects: 2.50. Wins: 1.50.
Player dankmann does not show cards.Bets: 0. Collects: 0. Wins: 0.
Player VegetablesArentYummy does not show cards.Bets: 0.50. Collects: 0. Loses: 0.50.
Game ended at: 2016/11/29 14:38:42

Game started
Game ID: 787010541 0.50/1 (PRR) Kraken - 23 (Hold'em)
Seat 4 is the button
Seat 1: WeakAndWeary (100).
Seat 2: gust (41.50).
Seat 3: LloydXmas (130.29).
Seat 4: Sephiroth1 (106.26).
Seat 5: ElvenEyes (122.13).
Seat 6: IlxxxlI (48.98).
Player ElvenEyes has small blind (0.50)
Player IlxxxlI has big blind (1)
Player IlxxxlI received card: [6h]
Player IlxxxlI received card: [5c]
Player WeakAndWeary folds
Player gust raises (2)
Player LloydXmas raises (7.50)
Player Sephiroth1 folds
Player ElvenEyes folds
Player IlxxxlI folds
Player gust allin (39.50)
Player LloydXmas folds
Uncalled bet (34) returned to gust
Player gust mucks cards
------ Summary ------
Pot: 16.50. Rake 0
Player WeakAndWeary does not show cards.Bets: 0. Collects: 0. Wins: 0.
*Player gust mucks (does not show cards). Bets: 7.50. Collects: 16.50. Wins: 9.
Player LloydXmas does not show cards.Bets: 7.50. Collects: 0. Loses: 7.50.
Player Sephiroth1 does not show cards.Bets: 0. Collects: 0. Wins: 0.
Player ElvenEyes does not show cards.Bets: 0.50. Collects: 0. Loses: 0.50.
Player IlxxxlI does not show cards.Bets: 1. Collects: 0. Loses: 1.
Game ended at: 2016/11/29 14:38:46

Game started
Game ID: 787010523 0.50/1 (PRR) Kraken (Hold'em)
Seat 5 is the button
Seat 1: WeakAndWeary (173.51).
Seat 2: aleks0v (100).
Seat 3: Sephiroth1 (138.83).
Seat 4: IlxxxlI (65.11).
Seat 5: gust (43.08).
Player WeakAndWeary has small blind (0.50)
Player aleks0v has big blind (1)
Player IlxxxlI received card: [9h]
Player IlxxxlI received card: [2c]
Player Sephiroth1 folds
Player IlxxxlI folds
Player gust raises (2)
Player WeakAndWeary folds
Player aleks0v folds
Uncalled bet (1) returned to gust
Player gust mucks cards
------ Summary ------
Pot: 2.50. Rake 0
Player WeakAndWeary does not show cards.Bets: 0.50. Collects: 0. Loses: 0.50.
Player aleks0v does not show cards.Bets: 1. Collects: 0. Loses: 1.
Player Sephiroth1 does not show cards.Bets: 0. Collects: 0. Wins: 0.
Player IlxxxlI does not show cards.Bets: 0. Collects: 0. Wins: 0.
*Player gust mucks (does not show cards). Bets: 1. Collects: 2.50. Wins: 1.50.
Game ended at: 2016/11/29 14:38:29

Game started
Game ID: 787010496 0.25/0.50 (PRR) Gorgons - 15 (Hold'em)
Seat 3 is the button
Seat 1: WeakAndWeary (74.75).
Seat 2: IampokerKidd (104.01).
Seat 3: imger8 (2.15).
Seat 4: IlxxxlI (30.50).
Seat 5: foreseen (55.40).
Seat 6: BiGFck (16.83).
Player IlxxxlI has small blind (0.25)
Player foreseen has big blind (0.50)
Player IlxxxlI received card: [7c]
Player IlxxxlI received card: [Qh]
Player BiGFck folds
Player WeakAndWeary folds
Player IampokerKidd folds
Player imger8 folds
Player IlxxxlI folds
Uncalled bet (0.25) returned to foreseen
Player foreseen mucks cards
------ Summary ------
Pot: 0.50. Rake 0
Player WeakAndWeary does not show cards.Bets: 0. Collects: 0. Wins: 0.
Player IampokerKidd does not show cards.Bets: 0. Collects: 0. Wins: 0.
Player imger8 does not show cards.Bets: 0. Collects: 0. Wins: 0.
Player IlxxxlI does not show cards.Bets: 0.25. Collects: 0. Loses: 0.25.
*Player foreseen mucks (does not show cards). Bets: 0.25. Collects: 0.50. Wins: 0.25.
Player BiGFck does not show cards.Bets: 0. Collects: 0. Wins: 0.
Game ended at: 2016/11/29 14:38:50

Game started
Game ID: 787010371 1/2 (PRR) Longana (Short) - 2 (Hold'em)
Seat 1 is the button
Seat 1: aleks0v (100).
Seat 2: PANDAisEVIL (100).
Seat 3: VegetablesArentYummy (141.13).
Seat 4: gust (82).
Seat 5: thimk (76.12).
Seat 6: IlxxxlI (40).
Seat 7: pineapplesand (40).
Seat 8: StephCurry (109.50).
Seat 9: hotshothotgg (102.04).
Player PANDAisEVIL has small blind (1)
Player VegetablesArentYummy has big blind (2)
Player IlxxxlI received card: [4h]
Player IlxxxlI received card: [8s]
Player gust folds
Player thimk folds
Player IlxxxlI folds
Player pineapplesand raises (4)
Player StephCurry raises (14)
Player hotshothotgg folds
Player aleks0v folds
Player PANDAisEVIL folds
Player VegetablesArentYummy folds
Player pineapplesand folds
Uncalled bet (10) returned to StephCurry
Player StephCurry mucks cards
------ Summary ------
Pot: 11. Rake 0
Player aleks0v does not show cards.Bets: 0. Collects: 0. Wins: 0.
Player PANDAisEVIL does not show cards.Bets: 1. Collects: 0. Loses: 1.
Player VegetablesArentYummy does not show cards.Bets: 2. Collects: 0. Loses: 2.
Player gust does not show cards.Bets: 0. Collects: 0. Wins: 0.
Player thimk does not show cards.Bets: 0. Collects: 0. Wins: 0.
Player IlxxxlI does not show cards.Bets: 0. Collects: 0. Wins: 0.
Player pineapplesand does not show cards.Bets: 4. Collects: 0. Loses: 4.
*Player StephCurry mucks (does not show cards). Bets: 4. Collects: 11. Wins: 7.
Player hotshothotgg does not show cards.Bets: 0. Collects: 0. Wins: 0.
Game ended at: 2016/11/29 14:38:45

Game started
Game ID: 787010225 0.50/1 (PRR) Kraken (Hold'em)
Seat 4 is the button
Seat 1: WeakAndWeary (175.51).
Seat 3: Sephiroth1 (138.83).
Seat 4: IlxxxlI (65.11).
Seat 5: gust (41.28).
Seat 6: ElvenEyes (110.11).
Player gust has small blind (0.50)
Player ElvenEyes sitting out
Player WeakAndWeary has big blind (1)
Player IlxxxlI received card: [6h]
Player IlxxxlI received card: [4c]
Player Sephiroth1 folds
Player IlxxxlI folds
Player gust raises (1.50)
Player WeakAndWeary calls (1)
*** FLOP ***: [Jc 3d 4h]
Player gust bets (1.90)
Player WeakAndWeary folds
Uncalled bet (1.90) returned to gust
Player gust mucks cards
------ Summary ------
Pot: 3.80. Rake 0.14. JP fee 0.06
Board: [Jc 3d 4h]
Player WeakAndWeary does not show cards.Bets: 2. Collects: 0. Loses: 2.
Player Sephiroth1 does not show cards.Bets: 0. Collects: 0. Wins: 0.
Player IlxxxlI does not show cards.Bets: 0. Collects: 0. Wins: 0.
*Player gust mucks (does not show cards). Bets: 2. Collects: 3.80. Wins: 1.80.
Player ElvenEyes does not show cards.Bets: 0. Collects: 0. Wins: 0.
Game ended at: 2016/11/29 14:37:58

Game started
Game ID: 787010207 0.50/1 (PRR) Kraken - 23 (Hold'em)
Seat 3 is the button
Seat 1: WeakAndWeary (100).
Seat 2: gust (40).
Seat 3: LloydXmas (130.29).
Seat 4: Sephiroth1 (106.76).
Seat 5: ElvenEyes (123.13).
Seat 6: IlxxxlI (48.98).
Player Sephiroth1 has small blind (0.50)
Player ElvenEyes has big blind (1)
Player IlxxxlI received card: [9c]
Player IlxxxlI received card: [5h]
Player IlxxxlI folds
Player WeakAndWeary folds
Player gust raises (2)
Player LloydXmas folds
Player Sephiroth1 folds
Player ElvenEyes folds
Uncalled bet (1) returned to gust
Player gust mucks cards
------ Summary ------
Pot: 2.50. Rake 0
Player WeakAndWeary does not show cards.Bets: 0. Collects: 0. Wins: 0.
*Player gust mucks (does not show cards). Bets: 1. Collects: 2.50. Wins: 1.50.
Player LloydXmas does not show cards.Bets: 0. Collects: 0. Wins: 0.
Player Sephiroth1 does not show cards.Bets: 0.50. Collects: 0. Loses: 0.50.
Player ElvenEyes does not show cards.Bets: 1. Collects: 0. Loses: 1.
Player IlxxxlI does not show cards.Bets: 0. Collects: 0. Wins: 0.
Game ended at: 2016/11/29 14:38:2

Game started
Game ID: 787010101 1/2 (PRR) Longana (Short) - 2 (Hold'em)
Seat 9 is the button
Seat 1: aleks0v (100).
Seat 2: PANDAisEVIL (100).
Seat 3: VegetablesArentYummy (141.13).
Seat 4: gust (86).
Seat 5: thimk (69.67).
Seat 6: IlxxxlI (40).
Seat 7: pineapplesand (40).
Seat 8: StephCurry (109.50).
Seat 9: hotshothotgg (102.04).
Player aleks0v has small blind (1)
Player PANDAisEVIL has big blind (2)
Player IlxxxlI received card: [6h]
Player IlxxxlI received card: [4d]
Player VegetablesArentYummy folds
Player gust raises (4)
Player thimk calls (4)
Player IlxxxlI folds
Player pineapplesand folds
Player StephCurry folds
Player hotshothotgg folds
Player aleks0v folds
Player PANDAisEVIL folds
*** FLOP ***: [3c Ad Kh]
Player gust checks
Player thimk bets (5.22)
Player gust folds
Uncalled bet (5.22) returned to thimk
Player thimk mucks cards
------ Summary ------
Pot: 10.45. Rake 0.37. JP fee 0.18
Board: [3c Ad Kh]
Player aleks0v does not show cards.Bets: 1. Collects: 0. Loses: 1.
Player PANDAisEVIL does not show cards.Bets: 2. Collects: 0. Loses: 2.
Player VegetablesArentYummy does not show cards.Bets: 0. Collects: 0. Wins: 0.
Player gust does not show cards.Bets: 4. Collects: 0. Loses: 4.
*Player thimk mucks (does not show cards). Bets: 4. Collects: 10.45. Wins: 6.45.
Player IlxxxlI does not show cards.Bets: 0. Collects: 0. Wins: 0.
Player pineapplesand does not show cards.Bets: 0. Collects: 0. Wins: 0.
Player StephCurry does not show cards.Bets: 0. Collects: 0. Wins: 0.
Player hotshothotgg does not show cards.Bets: 0. Collects: 0. Wins: 0.
Game ended at: 2016/11/29 14:37:37

Game started
Game ID: 787009986 0.50/1 (PRR) Karkadann - 3 (Hold'em)
Seat 7 is the button
Seat 1: zboiii (119.62).
Seat 2: ElvenEyes (156.80).
Seat 3: StephCurry (100).
Seat 4: gust (52.95).
Seat 5: pineapplesand (46.96).
Seat 7: IlxxxlI (40).
Seat 8: dankmann (162.69).
Seat 9: VegetablesArentYummy (258.63).
Player dankmann has small blind (0.50)
Player VegetablesArentYummy has big blind (1)
Player IlxxxlI received card: [Ah]
Player IlxxxlI received card: [6s]
Player zboiii folds
Player ElvenEyes folds
Player StephCurry folds
Player gust raises (2)
Player pineapplesand folds
Player IlxxxlI folds
Player dankmann folds
Player VegetablesArentYummy calls (1)
*** FLOP ***: [5s 9d 6h]
Player VegetablesArentYummy checks
Player gust is timed out.
Player gust checks
*** TURN ***: [5s 9d 6h] [4h]
Player VegetablesArentYummy bets (3.35)
Player gust folds
Uncalled bet (3.35) returned to VegetablesArentYummy
Player VegetablesArentYummy mucks cards
------ Summary ------
Pot: 4.28. Rake 0.16. JP fee 0.06
Board: [5s 9d 6h 4h]
Player zboiii does not show cards.Bets: 0. Collects: 0. Wins: 0.
Player ElvenEyes does not show cards.Bets: 0. Collects: 0. Wins: 0.
Player StephCurry does not show cards.Bets: 0. Collects: 0. Wins: 0.
Player gust does not show cards.Bets: 2. Collects: 0. Loses: 2.
Player pineapplesand does not show cards.Bets: 0. Collects: 0. Wins: 0.
Player IlxxxlI does not show cards.Bets: 0. Collects: 0. Wins: 0.
Player dankmann does not show cards.Bets: 0.50. Collects: 0. Loses: 0.50.
*Player VegetablesArentYummy mucks (does not show cards). Bets: 2. Collects: 4.28. Wins: 2.28.
Game ended at: 2016/11/29 14:38:8

Game started
Game ID: 787010010 0.50/1 (PRR) Kraken (Hold'em)
Seat 3 is the button
Seat 1: WeakAndWeary (175.51).
Seat 3: Sephiroth1 (137.33).
Seat 4: IlxxxlI (65.61).
Seat 5: gust (42.28).
Seat 6: ElvenEyes (110.11).
Player IlxxxlI has small blind (0.50)
Player gust has big blind (1)
Player IlxxxlI received card: [4d]
Player IlxxxlI received card: [2h]
Player ElvenEyes folds
Player WeakAndWeary folds
Player Sephiroth1 raises (3)
Player IlxxxlI folds
Player gust folds
Uncalled bet (2) returned to Sephiroth1
Player Sephiroth1 mucks cards
------ Summary ------
Pot: 2.50. Rake 0
Player WeakAndWeary does not show cards.Bets: 0. Collects: 0. Wins: 0.
*Player Sephiroth1 mucks (does not show cards). Bets: 1. Collects: 2.50. Wins: 1.50.
Player IlxxxlI does not show cards.Bets: 0.50. Collects: 0. Loses: 0.50.
Player gust does not show cards.Bets: 1. Collects: 0. Loses: 1.
Player ElvenEyes does not show cards.Bets: 0. Collects: 0. Wins: 0.
Game ended at: 2016/11/29 14:37:15

Game started
Game ID: 787009983 0.25/0.50 (PRR) Gorgons - 15 (Hold'em)
Seat 2 is the button
Seat 1: WeakAndWeary (74.75).
Seat 2: IampokerKidd (104.01).
Seat 3: imger8 (12.15).
Seat 4: IlxxxlI (21.50).
Seat 5: foreseen (55.40).
Seat 6: BiGFck (16.83).
Player imger8 has small blind (0.25)
Player IlxxxlI has big blind (0.50)
Player IlxxxlI received card: [7s]
Player IlxxxlI received card: [10d]
Player foreseen folds
Player BiGFck folds
Player WeakAndWeary folds
Player IampokerKidd folds
Player imger8 calls (0.25)
Player IlxxxlI checks
*** FLOP ***: [5d 7d Jd]
Player imger8 checks
Player IlxxxlI checks
*** TURN ***: [5d 7d Jd] [10s]
Player imger8 checks
Player IlxxxlI bets (2.50)
Player imger8 calls (2.50)
*** RIVER ***: [5d 7d Jd 10s] [Ah]
Player imger8 checks
Player IlxxxlI bets (7)
Player imger8 calls (7)
Player imger8 mucks cards
------ Summary ------
Pot: 19. Rake 0.76. JP fee 0.24
Board: [5d 7d Jd 10s Ah]
Player WeakAndWeary does not show cards.Bets: 0. Collects: 0. Wins: 0.
Player IampokerKidd does not show cards.Bets: 0. Collects: 0. Wins: 0.
Player imger8 mucks (does not show cards). Bets: 10. Collects: 0. Loses: 10.
*Player IlxxxlI shows: Two pairs. 10s and 7s [7s 10d]. Bets: 10. Collects: 19. Wins: 9.
Player foreseen does not show cards.Bets: 0. Collects: 0. Wins: 0.
Player BiGFck does not show cards.Bets: 0. Collects: 0. Wins: 0.
Game ended at: 2016/11/29 14:37:52

Game started
Game ID: 787009953 1/2 (PRR) Lakhey (Hold'em)
Seat 2 is the button
Seat 1: VegetablesArentYummy (221.65).
Seat 2: IlxxxlI (80).
Seat 3: IbetUmuck (858.50).
Seat 4: DonCesarGrinder (265.02).
Seat 5: MadLifeGrinder (210.06).
Seat 6: LloydXmas (252.48).
Player IbetUmuck has small blind (1)
Player DonCesarGrinder has big blind (2)
Player IlxxxlI received card: [Ah]
Player IlxxxlI received card: [Qs]
Player MadLifeGrinder folds
Player LloydXmas raises (5.75)
Player VegetablesArentYummy raises (18.75)
Player IlxxxlI folds
Player IbetUmuck folds
Player DonCesarGrinder folds
Player LloydXmas calls (13)
*** FLOP ***: [Kd 7c Qc]
Player LloydXmas checks
Player VegetablesArentYummy bets (13.82)
Player LloydXmas calls (13.82)
*** TURN ***: [Kd 7c Qc] [5s]
Player LloydXmas checks
Player VegetablesArentYummy bets (44.42)
Player LloydXmas calls (44.42)
*** RIVER ***: [Kd 7c Qc 5s] [3h]
Player LloydXmas checks
Player VegetablesArentYummy allin (144.66)
Player LloydXmas calls (144.66)
------ Summary ------
Pot: 443.30. Rake 2.76. JP fee 0.24
Board: [Kd 7c Qc 5s 3h]
*Player VegetablesArentYummy shows: One pair of Ks [As Kc]. Bets: 221.65. Collects: 221.65. Wins: 0.
Player IlxxxlI does not show cards.Bets: 0. Collects: 0. Wins: 0.
Player IbetUmuck does not show cards.Bets: 1. Collects: 0. Loses: 1.
Player DonCesarGrinder does not show cards.Bets: 2. Collects: 0. Loses: 2.
Player MadLifeGrinder does not show cards.Bets: 0. Collects: 0. Wins: 0.
*Player LloydXmas shows: One pair of Ks [Ad Kh]. Bets: 221.65. Collects: 221.65. Wins: 0.
Game ended at: 2016/11/29 14:38:51

Game started
Game ID: 787009759 0.50/1 (PRR) Kraken - 23 (Hold'em)
Seat 2 is the button
Seat 1: WeakAndWeary (100).
Seat 2: gust (40).
Seat 3: LloydXmas (130.79).
Seat 4: Sephiroth1 (107.76).
Seat 5: ElvenEyes (123.13).
Seat 6: IlxxxlI (47.48).
Player LloydXmas has small blind (0.50)
Player Sephiroth1 has big blind (1)
Player IlxxxlI received card: [Kc]
Player IlxxxlI received card: [Qc]
Player ElvenEyes folds
Player IlxxxlI raises (3.50)
Player WeakAndWeary folds
Player gust folds
Player LloydXmas folds
Player Sephiroth1 folds
Uncalled bet (2.50) returned to IlxxxlI
Player IlxxxlI mucks cards
------ Summary ------
Pot: 2.50. Rake 0
Player WeakAndWeary does not show cards.Bets: 0. Collects: 0. Wins: 0.
Player gust does not show cards.Bets: 0. Collects: 0. Wins: 0.
Player LloydXmas does not show cards.Bets: 0.50. Collects: 0. Loses: 0.50.
Player Sephiroth1 does not show cards.Bets: 1. Collects: 0. Loses: 1.
Player ElvenEyes does not show cards.Bets: 0. Collects: 0. Wins: 0.
*Player IlxxxlI mucks (does not show cards). Bets: 1. Collects: 2.50. Wins: 1.50.
Game ended at: 2016/11/29 14:37:13

Game started
Game ID: 787009754 0.50/1 (PRR) Kraken - 16 (Hold'em)
Seat 6 is the button
Seat 1: aleks0v (100).
Seat 3: Sephiroth1 (150.01).
Seat 4: Beep_Beep (123.54).
Seat 5: IlxxxlI (69.18).
Seat 6: gust (40).
Player aleks0v has small blind (0.50)
Player Sephiroth1 has big blind (1)
Player IlxxxlI received card: [Kc]
Player IlxxxlI received card: [Jd]
Player Beep_Beep folds
Player IlxxxlI raises (2.40)
Player gust folds
Player aleks0v folds
Player Sephiroth1 folds
Uncalled bet (1.40) returned to IlxxxlI
Player IlxxxlI mucks cards
------ Summary ------
Pot: 2.50. Rake 0
Player aleks0v does not show cards.Bets: 0.50. Collects: 0. Loses: 0.50.
Player Sephiroth1 does not show cards.Bets: 1. Collects: 0. Loses: 1.
Player Beep_Beep does not show cards.Bets: 0. Collects: 0. Wins: 0.
*Player IlxxxlI mucks (does not show cards). Bets: 1. Collects: 2.50. Wins: 1.50.
Player gust does not show cards.Bets: 0. Collects: 0. Wins: 0.
Game ended at: 2016/11/29 14:36:22

Game started
Game ID: 787009724 1/2 (PRR) Longana (Short) - 2 (Hold'em)
Seat 8 is the button
Seat 1: aleks0v (100).
Seat 3: VegetablesArentYummy (141.13).
Seat 4: gust (86).
Seat 5: thimk (69.67).
Seat 6: IlxxxlI (40).
Seat 7: pineapplesand (40).
Seat 8: StephCurry (106.50).
Seat 9: hotshothotgg (103.04).
Player hotshothotgg has small blind (1)
Player aleks0v has big blind (2)
Player IlxxxlI received card: [9s]
Player IlxxxlI received card: [Ad]
Player VegetablesArentYummy folds
Player gust folds
Player thimk folds
Player IlxxxlI folds
Player pineapplesand folds
Player StephCurry raises (4)
Player hotshothotgg folds
Player aleks0v folds
Uncalled bet (2) returned to StephCurry
Player StephCurry mucks cards
------ Summary ------
Pot: 5. Rake 0
Player aleks0v does not show cards.Bets: 2. Collects: 0. Loses: 2.
Player VegetablesArentYummy does not show cards.Bets: 0. Collects: 0. Wins: 0.
Player gust does not show cards.Bets: 0. Collects: 0. Wins: 0.
Player thimk does not show cards.Bets: 0. Collects: 0. Wins: 0.
Player IlxxxlI does not show cards.Bets: 0. Collects: 0. Wins: 0.
Player pineapplesand does not show cards.Bets: 0. Collects: 0. Wins: 0.
*Player StephCurry mucks (does not show cards). Bets: 2. Collects: 5. Wins: 3.
Player hotshothotgg does not show cards.Bets: 1. Collects: 0. Loses: 1.
Game ended at: 2016/11/29 14:36:58

Game started
Game ID: 787009668 0.50/1 (PRR) Karkadann - 3 (Hold'em)
Seat 5 is the button
Seat 1: zboiii (119.62).
Seat 2: ElvenEyes (156.80).
Seat 3: StephCurry (100).
Seat 4: gust (52.95).
Seat 5: pineapplesand (46.96).
Seat 7: IlxxxlI (40).
Seat 8: dankmann (163.69).
Seat 9: VegetablesArentYummy (257.13).
Player IlxxxlI has small blind (0.50)
Player dankmann has big blind (1)
Player IlxxxlI received card: [7s]
Player IlxxxlI received card: [Qd]
Player VegetablesArentYummy raises (2.50)
Player zboiii folds
Player ElvenEyes folds
Player StephCurry folds
Player gust folds
Player pineapplesand folds
Player IlxxxlI folds
Player dankmann folds
Uncalled bet (1.50) returned to VegetablesArentYummy
Player VegetablesArentYummy mucks cards
------ Summary ------
Pot: 2.50. Rake 0
Player zboiii does not show cards.Bets: 0. Collects: 0. Wins: 0.
Player ElvenEyes does not show cards.Bets: 0. Collects: 0. Wins: 0.
Player StephCurry does not show cards.Bets: 0. Collects: 0. Wins: 0.
Player gust does not show cards.Bets: 0. Collects: 0. Wins: 0.
Player pineapplesand does not show cards.Bets: 0. Collects: 0. Wins: 0.
Player IlxxxlI does not show cards.Bets: 0.50. Collects: 0. Loses: 0.50.
Player dankmann does not show cards.Bets: 1. Collects: 0. Loses: 1.
*Player VegetablesArentYummy mucks (does not show cards). Bets: 1. Collects: 2.50. Wins: 1.50.
Game ended at: 2016/11/29 14:36:43

Game started
Game ID: 787009616 0.50/1 (PRR) Kraken - 16 (Hold'em)
Seat 5 is the button
Seat 1: aleks0v (100).
Seat 2: MadLifeGrinder (100).
Seat 3: Sephiroth1 (150.01).
Seat 4: Beep_Beep (123.54).
Seat 5: IlxxxlI (67.68).
Seat 6: gust (40).
Player gust has small blind (0.50)
Player aleks0v has big blind (1)
Player IlxxxlI received card: [Ac]
Player IlxxxlI received card: [Qh]
Player MadLifeGrinder folds
Player Sephiroth1 folds
Player Beep_Beep folds
Player IlxxxlI raises (3)
Player gust folds
Player aleks0v folds
Uncalled bet (2) returned to IlxxxlI
Player IlxxxlI mucks cards
------ Summary ------
Pot: 2.50. Rake 0
Player aleks0v does not show cards.Bets: 1. Collects: 0. Loses: 1.
Player MadLifeGrinder does not show cards.Bets: 0. Collects: 0. Wins: 0.
Player Sephiroth1 does not show cards.Bets: 0. Collects: 0. Wins: 0.
Player Beep_Beep does not show cards.Bets: 0. Collects: 0. Wins: 0.
*Player IlxxxlI mucks (does not show cards). Bets: 1. Collects: 2.50. Wins: 1.50.
Player gust does not show cards.Bets: 0.50. Collects: 0. Loses: 0.50.
Game ended at: 2016/11/29 14:36:7

Game started
Game ID: 787009581 0.50/1 (PRR) Kraken - 23 (Hold'em)
Seat 1 is the button
Seat 1: WeakAndWeary (100).
Seat 2: gust (40).
Seat 3: LloydXmas (130.29).
Seat 4: Sephiroth1 (107.76).
Seat 5: ElvenEyes (123.13).
Seat 6: IlxxxlI (47.48).
Player gust has small blind (0.50)
Player LloydXmas has big blind (1)
Player IlxxxlI received card: [5c]
Player IlxxxlI received card: [Kd]
Player Sephiroth1 folds
Player ElvenEyes folds
Player IlxxxlI folds
Player WeakAndWeary folds
Player gust folds
Uncalled bet (0.50) returned to LloydXmas
Player LloydXmas mucks cards
------ Summary ------
Pot: 1. Rake 0
Player WeakAndWeary does not show cards.Bets: 0. Collects: 0. Wins: 0.
Player gust does not show cards.Bets: 0.50. Collects: 0. Loses: 0.50.
*Player LloydXmas mucks (does not show cards). Bets: 0.50. Collects: 1. Wins: 0.50.
Player Sephiroth1 does not show cards.Bets: 0. Collects: 0. Wins: 0.
Player ElvenEyes does not show cards.Bets: 0. Collects: 0. Wins: 0.
Player IlxxxlI does not show cards.Bets: 0. Collects: 0. Wins: 0.
Game ended at: 2016/11/29 14:36:8

Game started
Game ID: 787009553 1/2 (PRR) Lakhey (Hold'em)
Seat 1 is the button
Seat 1: VegetablesArentYummy (221.65).
Seat 2: IlxxxlI (94.13).
Seat 3: IbetUmuck (860.50).
Seat 4: DonCesarGrinder (265.02).
Seat 5: MadLifeGrinder (215.06).
Seat 6: LloydXmas (227.73).
Player IlxxxlI has small blind (1)
Player IbetUmuck has big blind (2)
Player IlxxxlI received card: [Kd]
Player IlxxxlI received card: [Qd]
Player DonCesarGrinder folds
Player MadLifeGrinder raises (5)
Player LloydXmas calls (5)
Player VegetablesArentYummy folds
Player IlxxxlI raises (16.75)
Player IbetUmuck folds
Player MadLifeGrinder folds
Player LloydXmas allin (222.73)
Player IlxxxlI folds
Uncalled bet (209.98) returned to LloydXmas
Player LloydXmas mucks cards
------ Summary ------
Pot: 42.50. Rake 0
Player VegetablesArentYummy does not show cards.Bets: 0. Collects: 0. Wins: 0.
Player IlxxxlI does not show cards.Bets: 17.75. Collects: 0. Loses: 17.75.
Player IbetUmuck does not show cards.Bets: 2. Collects: 0. Loses: 2.
Player DonCesarGrinder does not show cards.Bets: 0. Collects: 0. Wins: 0.
Player MadLifeGrinder does not show cards.Bets: 5. Collects: 0. Loses: 5.
*Player LloydXmas mucks (does not show cards). Bets: 17.75. Collects: 42.50. Wins: 24.75.
Game ended at: 2016/11/29 14:36:37

Game started
Game ID: 787009544 1/2 (PRR) Longana (Short) - 2 (Hold'em)
Seat 7 is the button
Seat 3: VegetablesArentYummy (141.13).
Seat 4: gust (86).
Seat 5: thimk (69.67).
Seat 6: IlxxxlI (40).
Seat 7: pineapplesand (40).
Seat 8: StephCurry (107.50).
Seat 9: hotshothotgg (102.04).
Player StephCurry has small blind (1)
Player hotshothotgg has big blind (2)
Player IlxxxlI received card: [10c]
Player IlxxxlI received card: [8h]
Player VegetablesArentYummy folds
Player gust folds
Player thimk folds
Player IlxxxlI folds
Player pineapplesand folds
Player StephCurry folds
Uncalled bet (1) returned to hotshothotgg
Player hotshothotgg mucks cards
------ Summary ------
Pot: 2. Rake 0
Player VegetablesArentYummy does not show cards.Bets: 0. Collects: 0. Wins: 0.
Player gust does not show cards.Bets: 0. Collects: 0. Wins: 0.
Player thimk does not show cards.Bets: 0. Collects: 0. Wins: 0.
Player IlxxxlI does not show cards.Bets: 0. Collects: 0. Wins: 0.
Player pineapplesand does not show cards.Bets: 0. Collects: 0. Wins: 0.
Player StephCurry does not show cards.Bets: 1. Collects: 0. Loses: 1.
*Player hotshothotgg mucks (does not show cards). Bets: 1. Collects: 2. Wins: 1.
Game ended at: 2016/11/29 14:36:5

Game started
Game ID: 787009456 0.50/1 (PRR) Kraken (Hold'em)
Seat 1 is the button
Seat 1: WeakAndWeary (189.51).
Seat 3: Sephiroth1 (137.83).
Seat 4: IlxxxlI (52.53).
Seat 5: gust (42.28).
Seat 6: ElvenEyes (110.11).
Player Sephiroth1 has small blind (0.50)
Player IlxxxlI has big blind (1)
Player IlxxxlI received card: [Qd]
Player IlxxxlI received card: [7d]
Player gust folds
Player ElvenEyes folds
Player WeakAndWeary raises (3)
Player Sephiroth1 folds
Player IlxxxlI calls (2)
*** FLOP ***: [Jc Qh 9d]
Player IlxxxlI checks
Player WeakAndWeary checks
*** TURN ***: [Jc Qh 9d] [Qs]
Player IlxxxlI bets (11)
Player WeakAndWeary calls (11)
*** RIVER ***: [Jc Qh 9d Qs] [7s]
Player IlxxxlI bets (32)
Player WeakAndWeary folds
Uncalled bet (32) returned to IlxxxlI
Player IlxxxlI mucks cards
------ Summary ------
Pot: 27.08. Rake 1.18. JP fee 0.24
Board: [Jc Qh 9d Qs 7s]
Player WeakAndWeary does not show cards.Bets: 14. Collects: 0. Loses: 14.
Player Sephiroth1 does not show cards.Bets: 0.50. Collects: 0. Loses: 0.50.
*Player IlxxxlI mucks (does not show cards). Bets: 14. Collects: 27.08. Wins: 13.08.
Player gust does not show cards.Bets: 0. Collects: 0. Wins: 0.
Player ElvenEyes does not show cards.Bets: 0. Collects: 0. Wins: 0.
Game ended at: 2016/11/29 14:36:44

Game started
Game ID: 787009397 0.50/1 (PRR) Karkadann - 3 (Hold'em)
Seat 4 is the button
Seat 1: zboiii (119.62).
Seat 2: ElvenEyes (156.80).
Seat 3: StephCurry (100).
Seat 4: gust (52.95).
Seat 5: pineapplesand (47.46).
Seat 7: IlxxxlI (42.50).
Seat 8: dankmann (163.69).
Seat 9: VegetablesArentYummy (254.40).
Player pineapplesand has small blind (0.50)
Player IlxxxlI has big blind (1)
Player IlxxxlI received card: [4s]
Player IlxxxlI received card: [8s]
Player dankmann folds
Player VegetablesArentYummy raises (2.50)
Player zboiii folds
Player ElvenEyes folds
Player StephCurry folds
Player gust folds
Player pineapplesand folds
Player IlxxxlI calls (1.50)
*** FLOP ***: [Jc 9c 7d]
Player IlxxxlI checks
Player VegetablesArentYummy bets (2.61)
Player IlxxxlI folds
Uncalled bet (2.61) returned to VegetablesArentYummy
Player VegetablesArentYummy mucks cards
------ Summary ------
Pot: 5.23. Rake 0.19. JP fee 0.08
Board: [Jc 9c 7d]
Player zboiii does not show cards.Bets: 0. Collects: 0. Wins: 0.
Player ElvenEyes does not show cards.Bets: 0. Collects: 0. Wins: 0.
Player StephCurry does not show cards.Bets: 0. Collects: 0. Wins: 0.
Player gust does not show cards.Bets: 0. Collects: 0. Wins: 0.
Player pineapplesand does not show cards.Bets: 0.50. Collects: 0. Loses: 0.50.
Player IlxxxlI does not show cards.Bets: 2.50. Collects: 0. Loses: 2.50.
Player dankmann does not show cards.Bets: 0. Collects: 0. Wins: 0.
*Player VegetablesArentYummy mucks (does not show cards). Bets: 2.50. Collects: 5.23. Wins: 2.73.
Game ended at: 2016/11/29 14:35:57

Game started
Game ID: 787009396 1/2 (PRR) Lakhey (Hold'em)
Seat 6 is the button
Seat 1: VegetablesArentYummy (222.65).
Seat 2: IlxxxlI (93.13).
Seat 3: IbetUmuck (860.50).
Seat 4: DonCesarGrinder (265.02).
Seat 5: MadLifeGrinder (215.06).
Seat 6: LloydXmas (227.73).
Player VegetablesArentYummy has small blind (1)
Player IlxxxlI has big blind (2)
Player IlxxxlI received card: [6d]
Player IlxxxlI received card: [10s]
Player IbetUmuck folds
Player DonCesarGrinder folds
Player MadLifeGrinder folds
Player LloydXmas folds
Player VegetablesArentYummy folds
Uncalled bet (1) returned to IlxxxlI
Player IlxxxlI mucks cards
------ Summary ------
Pot: 2. Rake 0
Player VegetablesArentYummy does not show cards.Bets: 1. Collects: 0. Loses: 1.
*Player IlxxxlI mucks (does not show cards). Bets: 1. Collects: 2. Wins: 1.
Player IbetUmuck does not show cards.Bets: 0. Collects: 0. Wins: 0.
Player DonCesarGrinder does not show cards.Bets: 0. Collects: 0. Wins: 0.
Player MadLifeGrinder does not show cards.Bets: 0. Collects: 0. Wins: 0.
Player LloydXmas does not show cards.Bets: 0. Collects: 0. Wins: 0.
Game ended at: 2016/11/29 14:35:40

Game started
Game ID: 787009330 1/2 (PRR) Longana (Short) - 2 (Hold'em)
Seat 6 is the button
Seat 3: VegetablesArentYummy (141.13).
Seat 4: gust (86).
Seat 5: thimk (69.67).
Seat 6: IlxxxlI (40).
Seat 7: pineapplesand (40).
Seat 8: StephCurry (106.50).
Seat 9: hotshothotgg (102.04).
Player pineapplesand has small blind (1)
Player StephCurry has big blind (2)
Player IlxxxlI received card: [5h]
Player IlxxxlI received card: [Ks]
Player hotshothotgg folds
Player VegetablesArentYummy folds
Player gust folds
Player thimk folds
Player IlxxxlI folds
Player pineapplesand folds
Uncalled bet (1) returned to StephCurry
Player StephCurry mucks cards
------ Summary ------
Pot: 2. Rake 0
Player VegetablesArentYummy does not show cards.Bets: 0. Collects: 0. Wins: 0.
Player gust does not show cards.Bets: 0. Collects: 0. Wins: 0.
Player thimk does not show cards.Bets: 0. Collects: 0. Wins: 0.
Player IlxxxlI does not show cards.Bets: 0. Collects: 0. Wins: 0.
Player pineapplesand does not show cards.Bets: 1. Collects: 0. Loses: 1.
*Player StephCurry mucks (does not show cards). Bets: 1. Collects: 2. Wins: 1.
Player hotshothotgg does not show cards.Bets: 0. Collects: 0. Wins: 0.
Game ended at: 2016/11/29 14:35:39

Game started
Game ID: 787009276 0.50/1 (PRR) Kraken - 23 (Hold'em)
Seat 6 is the button
Seat 1: WeakAndWeary (100).
Seat 2: gust (40).
Seat 3: LloydXmas (130.29).
Seat 4: Sephiroth1 (107.76).
Seat 5: ElvenEyes (123.13).
Seat 6: IlxxxlI (45.98).
Player WeakAndWeary has small blind (0.50)
Player gust has big blind (1)
Player IlxxxlI received card: [3s]
Player IlxxxlI received card: [3c]
Player LloydXmas folds
Player Sephiroth1 folds
Player ElvenEyes folds
Player IlxxxlI raises (3)
Player WeakAndWeary folds
Player gust folds
Uncalled bet (2) returned to IlxxxlI
Player IlxxxlI mucks cards
------ Summary ------
Pot: 2.50. Rake 0
Player WeakAndWeary does not show cards.Bets: 0.50. Collects: 0. Loses: 0.50.
Player gust does not show cards.Bets: 1. Collects: 0. Loses: 1.
Player LloydXmas does not show cards.Bets: 0. Collects: 0. Wins: 0.
Player Sephiroth1 does not show cards.Bets: 0. Collects: 0. Wins: 0.
Player ElvenEyes does not show cards.Bets: 0. Collects: 0. Wins: 0.
*Player IlxxxlI mucks (does not show cards). Bets: 1. Collects: 2.50. Wins: 1.50.
Game ended at: 2016/11/29 14:35:44

Game started
Game ID: 787009263 1/2 (PRR) Lakhey (Hold'em)
Seat 5 is the button
Seat 1: VegetablesArentYummy (224.65).
Seat 2: IlxxxlI (93.13).
Seat 3: IbetUmuck (860.50).
Seat 4: DonCesarGrinder (265.02).
Seat 5: MadLifeGrinder (212.06).
Seat 6: LloydXmas (228.73).
Player LloydXmas has small blind (1)
Player VegetablesArentYummy has big blind (2)
Player IlxxxlI received card: [5h]
Player IlxxxlI received card: [6h]
Player IlxxxlI folds
Player IbetUmuck folds
Player DonCesarGrinder folds
Player MadLifeGrinder raises (5)
Player LloydXmas folds
Player VegetablesArentYummy folds
Uncalled bet (3) returned to MadLifeGrinder
Player MadLifeGrinder mucks cards
------ Summary ------
Pot: 5. Rake 0
Player VegetablesArentYummy does not show cards.Bets: 2. Collects: 0. Loses: 2.
Player IlxxxlI does not show cards.Bets: 0. Collects: 0. Wins: 0.
Player IbetUmuck does not show cards.Bets: 0. Collects: 0. Wins: 0.
Player DonCesarGrinder does not show cards.Bets: 0. Collects: 0. Wins: 0.
*Player MadLifeGrinder mucks (does not show cards). Bets: 2. Collects: 5. Wins: 3.
Player LloydXmas does not show cards.Bets: 1. Collects: 0. Loses: 1.
Game ended at: 2016/11/29 14:35:16

Game started
Game ID: 787009163 0.25/0.50 (PRR) Gorgons - 15 (Hold'em)
Seat 1 is the button
Seat 1: WeakAndWeary (58.92).
Seat 2: IampokerKidd (104.26).
Seat 3: imger8 (28.15).
Seat 4: IlxxxlI (21.50).
Seat 5: foreseen (56.65).
Seat 6: BiGFck (16.83).
Player IampokerKidd has small blind (0.25)
Player imger8 has big blind (0.50)
Player IlxxxlI received card: [Qd]
Player IlxxxlI received card: [7d]
Player IlxxxlI folds
Player foreseen raises (1.25)
Player BiGFck folds
Player WeakAndWeary raises (4)
Player IampokerKidd folds
Player imger8 calls (3.50)
Player foreseen folds
*** FLOP ***: [Jh Qs 7c]
Player imger8 checks
Player WeakAndWeary checks
*** TURN ***: [Jh Qs 7c] [Kh]
Player imger8 bets (5)
Player WeakAndWeary calls (5)
*** RIVER ***: [Jh Qs 7c Kh] [9s]
Player imger8 bets (7)
Player WeakAndWeary allin (49.92)
Player imger8 folds
Uncalled bet (42.92) returned to WeakAndWeary
Player WeakAndWeary mucks cards
------ Summary ------
Pot: 31.83. Rake 1.43. JP fee 0.24
Board: [Jh Qs 7c Kh 9s]
*Player WeakAndWeary mucks (does not show cards). Bets: 16. Collects: 31.83. Wins: 15.83.
Player IampokerKidd does not show cards.Bets: 0.25. Collects: 0. Loses: 0.25.
Player imger8 does not show cards.Bets: 16. Collects: 0. Loses: 16.
Player IlxxxlI does not show cards.Bets: 0. Collects: 0. Wins: 0.
Player foreseen does not show cards.Bets: 1.25. Collects: 0. Loses: 1.25.
Player BiGFck does not show cards.Bets: 0. Collects: 0. Wins: 0.
Game ended at: 2016/11/29 14:36:40

Game started
Game ID: 787009112 0.50/1 (PRR) Kraken (Hold'em)
Seat 6 is the button
Seat 1: WeakAndWeary (190.01).
Seat 2: MadLifeGrinder (114.62).
Seat 3: Sephiroth1 (139.83).
Seat 4: IlxxxlI (52.53).
Seat 5: gust (40).
Seat 6: ElvenEyes (110.11).
Player WeakAndWeary has small blind (0.50)
Player MadLifeGrinder sitting out
Player Sephiroth1 has big blind (1)
Player IlxxxlI received card: [7d]
Player IlxxxlI received card: [Ks]
Player IlxxxlI folds
Player gust raises (2)
Player ElvenEyes folds
Player WeakAndWeary folds
Player Sephiroth1 calls (1)
*** FLOP ***: [9s 6d 8h]
Player Sephiroth1 checks
Player gust bets (2.85)
Player Sephiroth1 folds
Uncalled bet (2.85) returned to gust
Player gust mucks cards
------ Summary ------
Pot: 4.28. Rake 0.16. JP fee 0.06
Board: [9s 6d 8h]
Player WeakAndWeary does not show cards.Bets: 0.50. Collects: 0. Loses: 0.50.
Player MadLifeGrinder does not show cards.Bets: 0. Collects: 0. Wins: 0.
Player Sephiroth1 does not show cards.Bets: 2. Collects: 0. Loses: 2.
Player IlxxxlI does not show cards.Bets: 0. Collects: 0. Wins: 0.
*Player gust mucks (does not show cards). Bets: 2. Collects: 4.28. Wins: 2.28.
Player ElvenEyes does not show cards.Bets: 0. Collects: 0. Wins: 0.
Game ended at: 2016/11/29 14:35:24

Game started
Game ID: 787009102 1/2 (PRR) Lakhey (Hold'em)
Seat 4 is the button
Seat 1: VegetablesArentYummy (224.65).
Seat 2: IlxxxlI (93.13).
Seat 3: IbetUmuck (860.50).
Seat 4: DonCesarGrinder (262.02).
Seat 5: MadLifeGrinder (213.06).
Seat 6: LloydXmas (230.73).
Player MadLifeGrinder has small blind (1)
Player LloydXmas has big blind (2)
Player IlxxxlI received card: [6d]
Player IlxxxlI received card: [10s]
Player VegetablesArentYummy folds
Player IlxxxlI folds
Player IbetUmuck folds
Player DonCesarGrinder raises (5)
Player MadLifeGrinder folds
Player LloydXmas folds
Uncalled bet (3) returned to DonCesarGrinder
Player DonCesarGrinder mucks cards
------ Summary ------
Pot: 5. Rake 0
Player VegetablesArentYummy does not show cards.Bets: 0. Collects: 0. Wins: 0.
Player IlxxxlI does not show cards.Bets: 0. Collects: 0. Wins: 0.
Player IbetUmuck does not show cards.Bets: 0. Collects: 0. Wins: 0.
*Player DonCesarGrinder mucks (does not show cards). Bets: 2. Collects: 5. Wins: 3.
Player MadLifeGrinder does not show cards.Bets: 1. Collects: 0. Loses: 1.
Player LloydXmas does not show cards.Bets: 2. Collects: 0. Loses: 2.
Game ended at: 2016/11/29 14:34:57

Game started
Game ID: 787009067 0.50/1 (PRR) Kraken - 23 (Hold'em)
Seat 5 is the button
Seat 1: WeakAndWeary (100).
Seat 2: gust (40).
Seat 3: LloydXmas (130.29).
Seat 4: Sephiroth1 (107.76).
Seat 5: ElvenEyes (121.63).
Seat 6: IlxxxlI (46.48).
Player IlxxxlI has small blind (0.50)
Player WeakAndWeary has big blind (1)
Player IlxxxlI received card: [Jh]
Player IlxxxlI received card: [6h]
Player gust folds
Player LloydXmas folds
Player Sephiroth1 folds
Player ElvenEyes raises (3)
Player IlxxxlI folds
Player WeakAndWeary folds
Uncalled bet (2) returned to ElvenEyes
Player ElvenEyes mucks cards
------ Summary ------
Pot: 2.50. Rake 0
Player WeakAndWeary does not show cards.Bets: 1. Collects: 0. Loses: 1.
Player gust does not show cards.Bets: 0. Collects: 0. Wins: 0.
Player LloydXmas does not show cards.Bets: 0. Collects: 0. Wins: 0.
Player Sephiroth1 does not show cards.Bets: 0. Collects: 0. Wins: 0.
*Player ElvenEyes mucks (does not show cards). Bets: 1. Collects: 2.50. Wins: 1.50.
Player IlxxxlI does not show cards.Bets: 0.50. Collects: 0. Loses: 0.50.
Game ended at: 2016/11/29 14:34:58

Game started
Game ID: 787009017 0.50/1 (PRR) Kraken (Hold'em)
Seat 5 is the button
Seat 1: WeakAndWeary (189.51).
Seat 2: MadLifeGrinder (114.62).
Seat 3: Sephiroth1 (139.83).
Seat 4: IlxxxlI (52.53).
Seat 5: gust (40).
Seat 6: ElvenEyes (110.61).
Player ElvenEyes has small blind (0.50)
Player WeakAndWeary has big blind (1)
Player IlxxxlI received card: [Jc]
Player IlxxxlI received card: [6c]
Player MadLifeGrinder folds
Player Sephiroth1 folds
Player IlxxxlI folds
Player gust folds
Player ElvenEyes folds
Uncalled bet (0.50) returned to WeakAndWeary
Player WeakAndWeary mucks cards
------ Summary ------
Pot: 1. Rake 0
*Player WeakAndWeary mucks (does not show cards). Bets: 0.50. Collects: 1. Wins: 0.50.
Player MadLifeGrinder does not show cards.Bets: 0. Collects: 0. Wins: 0.
Player Sephiroth1 does not show cards.Bets: 0. Collects: 0. Wins: 0.
Player IlxxxlI does not show cards.Bets: 0. Collects: 0. Wins: 0.
Player gust does not show cards.Bets: 0. Collects: 0. Wins: 0.
Player ElvenEyes does not show cards.Bets: 0.50. Collects: 0. Loses: 0.50.
Game ended at: 2016/11/29 14:34:38

Game started
Game ID: 787008901 0.50/1 (PRR) Kraken - 23 (Hold'em)
Seat 4 is the button
Seat 1: WeakAndWeary (100).
Seat 2: gust (40).
Seat 3: LloydXmas (130.29).
Seat 4: Sephiroth1 (107.76).
Seat 5: ElvenEyes (120.63).
Seat 6: IlxxxlI (47.48).
Player ElvenEyes has small blind (0.50)
Player IlxxxlI has big blind (1)
Player IlxxxlI received card: [3s]
Player IlxxxlI received card: [9c]
Player WeakAndWeary folds
Player gust folds
Player LloydXmas folds
Player Sephiroth1 folds
Player ElvenEyes raises (2.50)
Player IlxxxlI folds
Uncalled bet (2) returned to ElvenEyes
Player ElvenEyes mucks cards
------ Summary ------
Pot: 2. Rake 0
Player WeakAndWeary does not show cards.Bets: 0. Collects: 0. Wins: 0.
Player gust does not show cards.Bets: 0. Collects: 0. Wins: 0.
Player LloydXmas does not show cards.Bets: 0. Collects: 0. Wins: 0.
Player Sephiroth1 does not show cards.Bets: 0. Collects: 0. Wins: 0.
*Player ElvenEyes mucks (does not show cards). Bets: 1. Collects: 2. Wins: 1.
Player IlxxxlI does not show cards.Bets: 1. Collects: 0. Loses: 1.
Game ended at: 2016/11/29 14:34:30

Game started
Game ID: 787008882 0.50/1 (PRR) Kraken - 16 (Hold'em)
Seat 4 is the button
Seat 2: MadLifeGrinder (103.35).
Seat 3: Sephiroth1 (150.01).
Seat 4: Beep_Beep (123.54).
Seat 5: IlxxxlI (54.86).
Seat 6: gust (40).
Player IlxxxlI has small blind (0.50)
Player gust has big blind (1)
Player IlxxxlI received card: [Ah]
Player IlxxxlI received card: [Kc]
Player MadLifeGrinder raises (2.50)
Player Sephiroth1 folds
Player Beep_Beep folds
Player IlxxxlI raises (5.88)
Player gust folds
Player MadLifeGrinder calls (3.88)
*** FLOP ***: [As Kd Jd]
Player IlxxxlI bets (6.80)
Player MadLifeGrinder calls (6.80)
*** TURN ***: [As Kd Jd] [Jh]
Player IlxxxlI checks
Player MadLifeGrinder checks
*** RIVER ***: [As Kd Jd Jh] [Qh]
Player IlxxxlI checks
Player MadLifeGrinder checks
Player MadLifeGrinder mucks cards
------ Summary ------
Pot: 26. Rake 1.12. JP fee 0.24
Board: [As Kd Jd Jh Qh]
Player MadLifeGrinder mucks (does not show cards). Bets: 13.18. Collects: 0. Loses: 13.18.
Player Sephiroth1 does not show cards.Bets: 0. Collects: 0. Wins: 0.
Player Beep_Beep does not show cards.Bets: 0. Collects: 0. Wins: 0.
*Player IlxxxlI shows: Two pairs. As and Ks [Ah Kc]. Bets: 13.18. Collects: 26. Wins: 12.82.
Player gust does not show cards.Bets: 1. Collects: 0. Loses: 1.
Game ended at: 2016/11/29 14:35:48

Game started
Game ID: 787008749 0.25/0.50 (PRR) Gorgons - 15 (Hold'em)
Seat 6 is the button
Seat 1: WeakAndWeary (59.17).
Seat 2: IampokerKidd (104.76).
Seat 3: imger8 (29.65).
Seat 4: IlxxxlI (21.50).
Seat 5: foreseen (59.80).
Seat 6: BiGFck (11.43).
Player WeakAndWeary has small blind (0.25)
Player IampokerKidd has big blind (0.50)
Player IlxxxlI received card: [3h]
Player IlxxxlI received card: [5s]
Player imger8 raises (1.50)
Player IlxxxlI folds
Player foreseen raises (3.15)
Player BiGFck allin (11.43)
Player WeakAndWeary folds
Player IampokerKidd folds
Player imger8 folds
Player foreseen folds
Uncalled bet (8.28) returned to BiGFck
Player BiGFck mucks cards
------ Summary ------
Pot: 8.55. Rake 0
Player WeakAndWeary does not show cards.Bets: 0.25. Collects: 0. Loses: 0.25.
Player IampokerKidd does not show cards.Bets: 0.50. Collects: 0. Loses: 0.50.
Player imger8 does not show cards.Bets: 1.50. Collects: 0. Loses: 1.50.
Player IlxxxlI does not show cards.Bets: 0. Collects: 0. Wins: 0.
Player foreseen does not show cards.Bets: 3.15. Collects: 0. Loses: 3.15.
*Player BiGFck mucks (does not show cards). Bets: 3.15. Collects: 8.55. Wins: 5.40.
Game ended at: 2016/11/29 14:34:45

Game started
Game ID: 787008741 0.50/1 (PRR) Kraken - 23 (Hold'em)
Seat 3 is the button
Seat 1: WeakAndWeary (100).
Seat 2: gust (40).
Seat 3: LloydXmas (130.29).
Seat 4: Sephiroth1 (106.76).
Seat 5: ElvenEyes (121.63).
Seat 6: IlxxxlI (47.48).
Player Sephiroth1 has small blind (0.50)
Player ElvenEyes has big blind (1)
Player IlxxxlI received card: [3h]
Player IlxxxlI received card: [2d]
Player IlxxxlI folds
Player WeakAndWeary folds
Player gust folds
Player LloydXmas folds
Player Sephiroth1 raises (2.50)
Player ElvenEyes folds
Uncalled bet (2) returned to Sephiroth1
Player Sephiroth1 mucks cards
------ Summary ------
Pot: 2. Rake 0
Player WeakAndWeary does not show cards.Bets: 0. Collects: 0. Wins: 0.
Player gust does not show cards.Bets: 0. Collects: 0. Wins: 0.
Player LloydXmas does not show cards.Bets: 0. Collects: 0. Wins: 0.
*Player Sephiroth1 mucks (does not show cards). Bets: 1. Collects: 2. Wins: 1.
Player ElvenEyes does not show cards.Bets: 1. Collects: 0. Loses: 1.
Player IlxxxlI does not show cards.Bets: 0. Collects: 0. Wins: 0.
Game ended at: 2016/11/29 14:34:8

Game started
Game ID: 787008726 1/2 (PRR) Longana (Short) - 2 (Hold'em)
Seat 5 is the button
Seat 3: VegetablesArentYummy (141.13).
Seat 4: gust (86).
Seat 5: thimk (69.67).
Seat 6: IlxxxlI (40).
Seat 7: pineapplesand (43).
Seat 8: StephCurry (106.50).
Seat 9: hotshothotgg (60.19).
Player IlxxxlI has small blind (1)
Player pineapplesand has big blind (2)
Player IlxxxlI received card: [Kc]
Player IlxxxlI received card: [Js]
Player StephCurry folds
Player hotshothotgg calls (2)
Player VegetablesArentYummy folds
Player gust folds
Player thimk folds
Player IlxxxlI calls (1)
Player pineapplesand checks
*** FLOP ***: [5d Jd 10c]
Player IlxxxlI bets (2.85)
Player pineapplesand calls (2.85)
Player hotshothotgg allin (58.19)
Player IlxxxlI allin (35.15)
Player pineapplesand folds
Uncalled bet (20.19) returned to hotshothotgg
*** TURN ***: [5d Jd 10c] [Ah]
*** RIVER ***: [5d Jd 10c Ah] [4s]
------ Summary ------
Pot: 81.85. Rake 2.76. JP fee 0.24
Board: [5d Jd 10c Ah 4s]
Player VegetablesArentYummy does not show cards.Bets: 0. Collects: 0. Wins: 0.
Player gust does not show cards.Bets: 0. Collects: 0. Wins: 0.
Player thimk does not show cards.Bets: 0. Collects: 0. Wins: 0.
Player IlxxxlI shows: One pair of Js [Kc Js]. Bets: 40. Collects: 0. Loses: 40.
Player pineapplesand does not show cards.Bets: 4.85. Collects: 0. Loses: 4.85.
Player StephCurry does not show cards.Bets: 0. Collects: 0. Wins: 0.
*Player hotshothotgg shows: Three Of Kind of 5s [5s 5c]. Bets: 40. Collects: 81.85. Wins: 41.85.
Game ended at: 2016/11/29 14:35:5

Game started
Game ID: 787008652 0.50/1 (PRR) Kraken (Hold'em)
Seat 4 is the button
Seat 1: WeakAndWeary (189.51).
Seat 2: MadLifeGrinder (114.62).
Seat 3: Sephiroth1 (139.83).
Seat 4: IlxxxlI (49.35).
Seat 5: gust (40).
Seat 6: ElvenEyes (113.61).
Player gust has small blind (0.50)
Player ElvenEyes has big blind (1)
Player IlxxxlI received card: [9h]
Player IlxxxlI received card: [Qs]
Player WeakAndWeary folds
Player MadLifeGrinder folds
Player Sephiroth1 folds
Player IlxxxlI raises (3)
Player gust folds
Player ElvenEyes calls (2)
*** FLOP ***: [Kh Qc 9s]
Player ElvenEyes checks
Player IlxxxlI bets (4)
Player ElvenEyes folds
Uncalled bet (4) returned to IlxxxlI
Player IlxxxlI mucks cards
------ Summary ------
Pot: 6.18. Rake 0.22. JP fee 0.10
Board: [Kh Qc 9s]
Player WeakAndWeary does not show cards.Bets: 0. Collects: 0. Wins: 0.
Player MadLifeGrinder does not show cards.Bets: 0. Collects: 0. Wins: 0.
Player Sephiroth1 does not show cards.Bets: 0. Collects: 0. Wins: 0.
*Player IlxxxlI mucks (does not show cards). Bets: 3. Collects: 6.18. Wins: 3.18.
Player gust does not show cards.Bets: 0.50. Collects: 0. Loses: 0.50.
Player ElvenEyes does not show cards.Bets: 3. Collects: 0. Loses: 3.
Game ended at: 2016/11/29 14:34:23

Game started
Game ID: 787008651 1/2 (PRR) Lakhey (Hold'em)
Seat 3 is the button
Seat 1: VegetablesArentYummy (229.65).
Seat 2: IlxxxlI (93.13).
Seat 3: IbetUmuck (853.15).
Seat 4: DonCesarGrinder (263.02).
Seat 5: MadLifeGrinder (215.06).
Seat 6: LloydXmas (230.73).
Player DonCesarGrinder has small blind (1)
Player MadLifeGrinder has big blind (2)
Player IlxxxlI received card: [3h]
Player IlxxxlI received card: [Qc]
Player LloydXmas folds
Player VegetablesArentYummy raises (5)
Player IlxxxlI folds
Player IbetUmuck calls (5)
Player DonCesarGrinder folds
Player MadLifeGrinder folds
*** FLOP ***: [9s 3d 8d]
Player VegetablesArentYummy checks
Player IbetUmuck bets (6.18)
Player VegetablesArentYummy folds
Uncalled bet (6.18) returned to IbetUmuck
Player IbetUmuck mucks cards
------ Summary ------
Pot: 12.35. Rake 0.45. JP fee 0.20
Board: [9s 3d 8d]
Player VegetablesArentYummy does not show cards.Bets: 5. Collects: 0. Loses: 5.
Player IlxxxlI does not show cards.Bets: 0. Collects: 0. Wins: 0.
*Player IbetUmuck mucks (does not show cards). Bets: 5. Collects: 12.35. Wins: 7.35.
Player DonCesarGrinder does not show cards.Bets: 1. Collects: 0. Loses: 1.
Player MadLifeGrinder does not show cards.Bets: 2. Collects: 0. Loses: 2.
Player LloydXmas does not show cards.Bets: 0. Collects: 0. Wins: 0.
Game ended at: 2016/11/29 14:34:36

Game started
Game ID: 787008526 0.50/1 (PRR) Kraken - 16 (Hold'em)
Seat 3 is the button
Seat 2: MadLifeGrinder (103.35).
Seat 3: Sephiroth1 (156.10).
Seat 4: Beep_Beep (124.04).
Seat 5: IlxxxlI (48.90).
Seat 6: gust (40).
Player Beep_Beep has small blind (0.50)
Player IlxxxlI has big blind (1)
Player IlxxxlI received card: [Ah]
Player IlxxxlI received card: [9c]
Player gust folds
Player MadLifeGrinder folds
Player Sephiroth1 raises (3)
Player Beep_Beep folds
Player IlxxxlI calls (2)
*** FLOP ***: [5d 9d Ks]
Player IlxxxlI checks
Player Sephiroth1 checks
*** TURN ***: [5d 9d Ks] [Jh]
Player IlxxxlI checks
Player Sephiroth1 checks
*** RIVER ***: [5d 9d Ks Jh] [Kd]
Player IlxxxlI bets (3.09)
Player Sephiroth1 calls (3.09)
Player Sephiroth1 mucks cards
------ Summary ------
Pot: 12.05. Rake 0.43. JP fee 0.20
Board: [5d 9d Ks Jh Kd]
Player MadLifeGrinder does not show cards.Bets: 0. Collects: 0. Wins: 0.
Player Sephiroth1 mucks (does not show cards). Bets: 6.09. Collects: 0. Loses: 6.09.
Player Beep_Beep does not show cards.Bets: 0.50. Collects: 0. Loses: 0.50.
*Player IlxxxlI shows: Two pairs. Ks and 9s [Ah 9c]. Bets: 6.09. Collects: 12.05. Wins: 5.96.
Player gust does not show cards.Bets: 0. Collects: 0. Wins: 0.
Game ended at: 2016/11/29 14:34:3

Game started
Game ID: 787008516 1/2 (PRR) Lakhey (Hold'em)
Seat 2 is the button
Seat 1: VegetablesArentYummy (229.65).
Seat 2: IlxxxlI (93.13).
Seat 3: IbetUmuck (854.15).
Seat 4: DonCesarGrinder (262.02).
Seat 5: MadLifeGrinder (215.06).
Seat 6: LloydXmas (230.73).
Player IbetUmuck has small blind (1)
Player DonCesarGrinder has big blind (2)
Player IlxxxlI received card: [2c]
Player IlxxxlI received card: [Qh]
Player MadLifeGrinder folds
Player LloydXmas folds
Player VegetablesArentYummy folds
Player IlxxxlI folds
Player IbetUmuck folds
Uncalled bet (1) returned to DonCesarGrinder
Player DonCesarGrinder mucks cards
------ Summary ------
Pot: 2. Rake 0
Player VegetablesArentYummy does not show cards.Bets: 0. Collects: 0. Wins: 0.
Player IlxxxlI does not show cards.Bets: 0. Collects: 0. Wins: 0.
Player IbetUmuck does not show cards.Bets: 1. Collects: 0. Loses: 1.
*Player DonCesarGrinder mucks (does not show cards). Bets: 1. Collects: 2. Wins: 1.
Player MadLifeGrinder does not show cards.Bets: 0. Collects: 0. Wins: 0.
Player LloydXmas does not show cards.Bets: 0. Collects: 0. Wins: 0.
Game ended at: 2016/11/29 14:33:33

Game started
Game ID: 787008482 1/2 (PRR) Longana (Short) - 2 (Hold'em)
Seat 4 is the button
Seat 3: VegetablesArentYummy (141.13).
Seat 4: gust (86).
Seat 5: thimk (67.67).
Seat 6: IlxxxlI (40).
Seat 7: pineapplesand (43).
Seat 8: StephCurry (106.50).
Seat 9: hotshothotgg (60.19).
Player thimk has small blind (1)
Player IlxxxlI has big blind (2)
Player IlxxxlI received card: [Qc]
Player IlxxxlI received card: [7s]
Player pineapplesand folds
Player StephCurry folds
Player hotshothotgg folds
Player VegetablesArentYummy folds
Player gust folds
Player thimk raises (3)
Player IlxxxlI folds
Uncalled bet (2) returned to thimk
Player thimk is timed out.
Player thimk mucks cards
------ Summary ------
Pot: 4. Rake 0
Player VegetablesArentYummy does not show cards.Bets: 0. Collects: 0. Wins: 0.
Player gust does not show cards.Bets: 0. Collects: 0. Wins: 0.
*Player thimk mucks (does not show cards). Bets: 2. Collects: 4. Wins: 2.
Player IlxxxlI does not show cards.Bets: 2. Collects: 0. Loses: 2.
Player pineapplesand does not show cards.Bets: 0. Collects: 0. Wins: 0.
Player StephCurry does not show cards.Bets: 0. Collects: 0. Wins: 0.
Player hotshothotgg does not show cards.Bets: 0. Collects: 0. Wins: 0.
Game ended at: 2016/11/29 14:33:44

Game started
Game ID: 787008454 0.25/0.50 (PRR) Gorgons - 15 (Hold'em)
Seat 5 is the button
Seat 1: WeakAndWeary (59.67).
Seat 2: IampokerKidd (104.76).
Seat 3: imger8 (29.65).
Seat 4: IlxxxlI (20.75).
Seat 5: foreseen (59.80).
Seat 6: BiGFck (11.68).
Player BiGFck has small blind (0.25)
Player WeakAndWeary has big blind (0.50)
Player IlxxxlI received card: [9h]
Player IlxxxlI received card: [7h]
Player IampokerKidd folds
Player imger8 folds
Player IlxxxlI raises (1.20)
Player foreseen folds
Player BiGFck folds
Player WeakAndWeary folds
Uncalled bet (0.70) returned to IlxxxlI
Player IlxxxlI mucks cards
------ Summary ------
Pot: 1.25. Rake 0
Player WeakAndWeary does not show cards.Bets: 0.50. Collects: 0. Loses: 0.50.
Player IampokerKidd does not show cards.Bets: 0. Collects: 0. Wins: 0.
Player imger8 does not show cards.Bets: 0. Collects: 0. Wins: 0.
*Player IlxxxlI mucks (does not show cards). Bets: 0.50. Collects: 1.25. Wins: 0.75.
Player foreseen does not show cards.Bets: 0. Collects: 0. Wins: 0.
Player BiGFck does not show cards.Bets: 0.25. Collects: 0. Loses: 0.25.
Game ended at: 2016/11/29 14:33:46

Game started
Game ID: 787008395 0.50/1 (PRR) Kraken (Hold'em)
Seat 3 is the button
Seat 1: WeakAndWeary (189.51).
Seat 2: MadLifeGrinder (114.62).
Seat 3: Sephiroth1 (138.33).
Seat 4: IlxxxlI (49.85).
Seat 5: gust (40).
Seat 6: ElvenEyes (113.61).
Player IlxxxlI has small blind (0.50)
Player gust has big blind (1)
Player IlxxxlI received card: [2d]
Player IlxxxlI received card: [Ks]
Player ElvenEyes folds
Player WeakAndWeary folds
Player MadLifeGrinder folds
Player Sephiroth1 raises (3)
Player IlxxxlI folds
Player gust folds
Uncalled bet (2) returned to Sephiroth1
Player Sephiroth1 mucks cards
------ Summary ------
Pot: 2.50. Rake 0
Player WeakAndWeary does not show cards.Bets: 0. Collects: 0. Wins: 0.
Player MadLifeGrinder does not show cards.Bets: 0. Collects: 0. Wins: 0.
*Player Sephiroth1 mucks (does not show cards). Bets: 1. Collects: 2.50. Wins: 1.50.
Player IlxxxlI does not show cards.Bets: 0.50. Collects: 0. Loses: 0.50.
Player gust does not show cards.Bets: 1. Collects: 0. Loses: 1.
Player ElvenEyes does not show cards.Bets: 0. Collects: 0. Wins: 0.
Game ended at: 2016/11/29 14:33:33

Game started
Game ID: 787008351 0.50/1 (PRR) Kraken - 16 (Hold'em)
Seat 2 is the button
Seat 2: MadLifeGrinder (101.85).
Seat 3: Sephiroth1 (156.60).
Seat 4: Beep_Beep (125.04).
Seat 5: IlxxxlI (48.90).
Seat 6: gust (40).
Player Sephiroth1 has small blind (0.50)
Player Beep_Beep has big blind (1)
Player IlxxxlI received card: [Jh]
Player IlxxxlI received card: [4h]
Player IlxxxlI folds
Player gust folds
Player MadLifeGrinder raises (2.50)
Player Sephiroth1 folds
Player Beep_Beep folds
Uncalled bet (1.50) returned to MadLifeGrinder
Player MadLifeGrinder mucks cards
------ Summary ------
Pot: 2.50. Rake 0
*Player MadLifeGrinder mucks (does not show cards). Bets: 1. Collects: 2.50. Wins: 1.50.
Player Sephiroth1 does not show cards.Bets: 0.50. Collects: 0. Loses: 0.50.
Player Beep_Beep does not show cards.Bets: 1. Collects: 0. Loses: 1.
Player IlxxxlI does not show cards.Bets: 0. Collects: 0. Wins: 0.
Player gust does not show cards.Bets: 0. Collects: 0. Wins: 0.
Game ended at: 2016/11/29 14:33:16

Game started
Game ID: 787008264 0.50/1 (PRR) Kraken - 23 (Hold'em)
Seat 2 is the button
Seat 1: WeakAndWeary (100).
Seat 2: gust (42.50).
Seat 3: LloydXmas (130.79).
Seat 4: Sephiroth1 (101.78).
Seat 5: ElvenEyes (121.63).
Seat 6: IlxxxlI (47.48).
Player LloydXmas has small blind (0.50)
Player Sephiroth1 has big blind (1)
Player IlxxxlI received card: [Ks]
Player IlxxxlI received card: [3s]
Player ElvenEyes folds
Player IlxxxlI folds
Player WeakAndWeary folds
Player gust raises (2)
Player LloydXmas folds
Player Sephiroth1 calls (1)
*** FLOP ***: [4s Js 9d]
Player Sephiroth1 checks
Player gust checks
*** TURN ***: [4s Js 9d] [Qs]
Player Sephiroth1 bets (3)
Player gust calls (3)
*** RIVER ***: [4s Js 9d Qs] [8h]
Player Sephiroth1 checks
Player gust checks
Player gust mucks cards
------ Summary ------
Pot: 9.98. Rake 0.36. JP fee 0.16
Board: [4s Js 9d Qs 8h]
Player WeakAndWeary does not show cards.Bets: 0. Collects: 0. Wins: 0.
Player gust mucks (does not show cards). Bets: 5. Collects: 0. Loses: 5.
Player LloydXmas does not show cards.Bets: 0.50. Collects: 0. Loses: 0.50.
*Player Sephiroth1 shows: Straight to Q [10c Qd]. Bets: 5. Collects: 9.98. Wins: 4.98.
Player ElvenEyes does not show cards.Bets: 0. Collects: 0. Wins: 0.
Player IlxxxlI does not show cards.Bets: 0. Collects: 0. Wins: 0.
Game ended at: 2016/11/29 14:33:43

Game started
Game ID: 787008233 1/2 (PRR) Longana (Short) - 2 (Hold'em)
Seat 3 is the button
Seat 3: VegetablesArentYummy (141.13).
Seat 4: gust (87).
Seat 5: thimk (69.67).
Seat 6: IlxxxlI (40).
Seat 7: pineapplesand (40).
Seat 8: StephCurry (106.50).
Seat 9: hotshothotgg (60.19).
Player gust has small blind (1)
Player thimk has big blind (2)
Player IlxxxlI received card: [5s]
Player IlxxxlI received card: [7h]
Player IlxxxlI folds
Player pineapplesand raises (4)
Player StephCurry folds
Player hotshothotgg folds
Player VegetablesArentYummy folds
Player gust folds
Player thimk folds
Uncalled bet (2) returned to pineapplesand
Player pineapplesand mucks cards
------ Summary ------
Pot: 5. Rake 0
Player VegetablesArentYummy does not show cards.Bets: 0. Collects: 0. Wins: 0.
Player gust does not show cards.Bets: 1. Collects: 0. Loses: 1.
Player thimk does not show cards.Bets: 2. Collects: 0. Loses: 2.
Player IlxxxlI does not show cards.Bets: 0. Collects: 0. Wins: 0.
*Player pineapplesand mucks (does not show cards). Bets: 2. Collects: 5. Wins: 3.
Player StephCurry does not show cards.Bets: 0. Collects: 0. Wins: 0.
Player hotshothotgg does not show cards.Bets: 0. Collects: 0. Wins: 0.
Game ended at: 2016/11/29 14:33:10

Game started
Game ID: 787008222 0.50/1 (PRR) Karkadann - 3 (Hold'em)
Seat 3 is the button
Seat 1: zboiii (119.62).
Seat 2: ElvenEyes (156.80).
Seat 3: StephCurry (100).
Seat 4: gust (53.45).
Seat 5: pineapplesand (50.46).
Seat 7: IlxxxlI (42.50).
Seat 8: dankmann (160.51).
Seat 9: VegetablesArentYummy (254.40).
Player gust has small blind (0.50)
Player pineapplesand has big blind (1)
Player IlxxxlI received card: [8d]
Player IlxxxlI received card: [5h]
Player IlxxxlI folds
Player dankmann raises (3)
Player VegetablesArentYummy folds
Player zboiii folds
Player ElvenEyes folds
Player StephCurry folds
Player gust folds
Player pineapplesand calls (2)
*** FLOP ***: [3h 7h Jh]
Player pineapplesand checks
Player dankmann checks
*** TURN ***: [3h 7h Jh] [5c]
Player pineapplesand checks
Player dankmann checks
*** RIVER ***: [3h 7h Jh 5c] [9c]
Player pineapplesand checks
Player dankmann checks
Player pineapplesand mucks cards
------ Summary ------
Pot: 6.18. Rake 0.22. JP fee 0.10
Board: [3h 7h Jh 5c 9c]
Player zboiii does not show cards.Bets: 0. Collects: 0. Wins: 0.
Player ElvenEyes does not show cards.Bets: 0. Collects: 0. Wins: 0.
Player StephCurry does not show cards.Bets: 0. Collects: 0. Wins: 0.
Player gust does not show cards.Bets: 0.50. Collects: 0. Loses: 0.50.
Player pineapplesand mucks (does not show cards). Bets: 3. Collects: 0. Loses: 3.
Player IlxxxlI does not show cards.Bets: 0. Collects: 0. Wins: 0.
*Player dankmann shows: One pair of 6s [6h 6c]. Bets: 3. Collects: 6.18. Wins: 3.18.
Player VegetablesArentYummy does not show cards.Bets: 0. Collects: 0. Wins: 0.
Game ended at: 2016/11/29 14:35:15

Game started
Game ID: 787008210 0.50/1 (PRR) Kraken (Hold'em)
Seat 2 is the button
Seat 1: WeakAndWeary (189.51).
Seat 2: MadLifeGrinder (114.62).
Seat 3: Sephiroth1 (138.83).
Seat 4: IlxxxlI (50.85).
Seat 5: gust (40).
Seat 6: ElvenEyes (112.11).
Player Sephiroth1 has small blind (0.50)
Player IlxxxlI has big blind (1)
Player IlxxxlI received card: [3h]
Player IlxxxlI received card: [5s]
Player gust folds
Player ElvenEyes raises (2)
Player WeakAndWeary folds
Player MadLifeGrinder folds
Player Sephiroth1 folds
Player IlxxxlI folds
Uncalled bet (1) returned to ElvenEyes
Player ElvenEyes mucks cards
------ Summary ------
Pot: 2.50. Rake 0
Player WeakAndWeary does not show cards.Bets: 0. Collects: 0. Wins: 0.
Player MadLifeGrinder does not show cards.Bets: 0. Collects: 0. Wins: 0.
Player Sephiroth1 does not show cards.Bets: 0.50. Collects: 0. Loses: 0.50.
Player IlxxxlI does not show cards.Bets: 1. Collects: 0. Loses: 1.
Player gust does not show cards.Bets: 0. Collects: 0. Wins: 0.
*Player ElvenEyes mucks (does not show cards). Bets: 1. Collects: 2.50. Wins: 1.50.
Game ended at: 2016/11/29 14:32:57

Game started
Game ID: 787008158 0.25/0.50 (PRR) Gorgons - 15 (Hold'em)
Seat 4 is the button
Seat 1: WeakAndWeary (58.92).
Seat 2: IampokerKidd (104.76).
Seat 3: imger8 (29.65).
Seat 4: IlxxxlI (20.75).
Seat 5: foreseen (60.05).
Seat 6: BiGFck (12.18).
Player foreseen has small blind (0.25)
Player BiGFck has big blind (0.50)
Player IlxxxlI received card: [8h]
Player IlxxxlI received card: [Jd]
Player WeakAndWeary raises (1.50)
Player IampokerKidd folds
Player imger8 folds
Player IlxxxlI folds
Player foreseen folds
Player BiGFck folds
Uncalled bet (1) returned to WeakAndWeary
Player WeakAndWeary mucks cards
------ Summary ------
Pot: 1.25. Rake 0
*Player WeakAndWeary mucks (does not show cards). Bets: 0.50. Collects: 1.25. Wins: 0.75.
Player IampokerKidd does not show cards.Bets: 0. Collects: 0. Wins: 0.
Player imger8 does not show cards.Bets: 0. Collects: 0. Wins: 0.
Player IlxxxlI does not show cards.Bets: 0. Collects: 0. Wins: 0.
Player foreseen does not show cards.Bets: 0.25. Collects: 0. Loses: 0.25.
Player BiGFck does not show cards.Bets: 0.50. Collects: 0. Loses: 0.50.
Game ended at: 2016/11/29 14:33:7

Game started
Game ID: 787008073 1/2 (PRR) Lakhey (Hold'em)
Seat 1 is the button
Seat 1: VegetablesArentYummy (229.65).
Seat 2: IlxxxlI (84.35).
Seat 3: IbetUmuck (863.90).
Seat 4: DonCesarGrinder (262.02).
Seat 5: MadLifeGrinder (215.06).
Seat 6: LloydXmas (230.73).
Player IlxxxlI has small blind (1)
Player IbetUmuck has big blind (2)
Player IlxxxlI received card: [7c]
Player IlxxxlI received card: [5c]
Player DonCesarGrinder folds
Player MadLifeGrinder folds
Player LloydXmas folds
Player VegetablesArentYummy folds
Player IlxxxlI raises (4)
Player IbetUmuck calls (3)
*** FLOP ***: [Jd 3h 7d]
Player IlxxxlI checks
Player IbetUmuck bets (4.75)
Player IlxxxlI calls (4.75)
*** TURN ***: [Jd 3h 7d] [5d]
Player IlxxxlI bets (8)
Player IbetUmuck folds
Uncalled bet (8) returned to IlxxxlI
Player IlxxxlI mucks cards
------ Summary ------
Pot: 18.53. Rake 0.73. JP fee 0.24
Board: [Jd 3h 7d 5d]
Player VegetablesArentYummy does not show cards.Bets: 0. Collects: 0. Wins: 0.
*Player IlxxxlI mucks (does not show cards). Bets: 9.75. Collects: 18.53. Wins: 8.78.
Player IbetUmuck does not show cards.Bets: 9.75. Collects: 0. Loses: 9.75.
Player DonCesarGrinder does not show cards.Bets: 0. Collects: 0. Wins: 0.
Player MadLifeGrinder does not show cards.Bets: 0. Collects: 0. Wins: 0.
Player LloydXmas does not show cards.Bets: 0. Collects: 0. Wins: 0.
Game ended at: 2016/11/29 14:33:16

Game started
Game ID: 787008071 0.50/1 (PRR) Kraken - 23 (Hold'em)
Seat 1 is the button
Seat 1: WeakAndWeary (100).
Seat 2: gust (43).
Seat 3: LloydXmas (130.29).
Seat 4: Sephiroth1 (101.78).
Seat 5: ElvenEyes (121.63).
Seat 6: IlxxxlI (47.48).
Player gust has small blind (0.50)
Player LloydXmas has big blind (1)
Player IlxxxlI received card: [6s]
Player IlxxxlI received card: [5h]
Player Sephiroth1 folds
Player ElvenEyes folds
Player IlxxxlI folds
Player WeakAndWeary folds
Player gust folds
Uncalled bet (0.50) returned to LloydXmas
Player LloydXmas mucks cards
------ Summary ------
Pot: 1. Rake 0
Player WeakAndWeary does not show cards.Bets: 0. Collects: 0. Wins: 0.
Player gust does not show cards.Bets: 0.50. Collects: 0. Loses: 0.50.
*Player LloydXmas mucks (does not show cards). Bets: 0.50. Collects: 1. Wins: 0.50.
Player Sephiroth1 does not show cards.Bets: 0. Collects: 0. Wins: 0.
Player ElvenEyes does not show cards.Bets: 0. Collects: 0. Wins: 0.
Player IlxxxlI does not show cards.Bets: 0. Collects: 0. Wins: 0.
Game ended at: 2016/11/29 14:32:39

Game started
Game ID: 787008050 1/2 (PRR) Longana (Short) - 2 (Hold'em)
Seat 9 is the button
Seat 3: VegetablesArentYummy (139.13).
Seat 4: gust (89).
Seat 5: thimk (69.67).
Seat 6: IlxxxlI (40).
Seat 7: pineapplesand (40).
Seat 8: StephCurry (106.50).
Seat 9: hotshothotgg (60.19).
Player VegetablesArentYummy has small blind (1)
Player gust has big blind (2)
Player IlxxxlI received card: [2d]
Player IlxxxlI received card: [Jh]
Player thimk folds
Player IlxxxlI folds
Player pineapplesand folds
Player StephCurry folds
Player hotshothotgg folds
Player VegetablesArentYummy raises (4)
Player gust folds
Uncalled bet (3) returned to VegetablesArentYummy
Player VegetablesArentYummy mucks cards
------ Summary ------
Pot: 4. Rake 0
*Player VegetablesArentYummy mucks (does not show cards). Bets: 2. Collects: 4. Wins: 2.
Player gust does not show cards.Bets: 2. Collects: 0. Loses: 2.
Player thimk does not show cards.Bets: 0. Collects: 0. Wins: 0.
Player IlxxxlI does not show cards.Bets: 0. Collects: 0. Wins: 0.
Player pineapplesand does not show cards.Bets: 0. Collects: 0. Wins: 0.
Player StephCurry does not show cards.Bets: 0. Collects: 0. Wins: 0.
Player hotshothotgg does not show cards.Bets: 0. Collects: 0. Wins: 0.
Game ended at: 2016/11/29 14:32:35

Game started
Game ID: 787007972 0.50/1 (PRR) Karkadann - 3 (Hold'em)
Seat 2 is the button
Seat 1: zboiii (119.62).
Seat 2: ElvenEyes (156.80).
Seat 3: StephCurry (100.50).
Seat 4: gust (54.45).
Seat 5: pineapplesand (50.46).
Seat 7: IlxxxlI (41).
Seat 8: dankmann (160.51).
Seat 9: VegetablesArentYummy (254.40).
Player StephCurry has small blind (0.50)
Player gust has big blind (1)
Player IlxxxlI received card: [Qc]
Player IlxxxlI received card: [Ac]
Player pineapplesand folds
Player IlxxxlI raises (3.50)
Player dankmann folds
Player VegetablesArentYummy folds
Player zboiii folds
Player ElvenEyes folds
Player StephCurry folds
Player gust folds
Uncalled bet (2.50) returned to IlxxxlI
Player IlxxxlI mucks cards
------ Summary ------
Pot: 2.50. Rake 0
Player zboiii does not show cards.Bets: 0. Collects: 0. Wins: 0.
Player ElvenEyes does not show cards.Bets: 0. Collects: 0. Wins: 0.
Player StephCurry does not show cards.Bets: 0.50. Collects: 0. Loses: 0.50.
Player gust does not show cards.Bets: 1. Collects: 0. Loses: 1.
Player pineapplesand does not show cards.Bets: 0. Collects: 0. Wins: 0.
*Player IlxxxlI mucks (does not show cards). Bets: 1. Collects: 2.50. Wins: 1.50.
Player dankmann does not show cards.Bets: 0. Collects: 0. Wins: 0.
Player VegetablesArentYummy does not show cards.Bets: 0. Collects: 0. Wins: 0.
Game ended at: 2016/11/29 14:32:33

Game started
Game ID: 787007916 0.50/1 (PRR) Kraken - 16 (Hold'em)
Seat 6 is the button
Seat 2: MadLifeGrinder (102.35).
Seat 3: Sephiroth1 (159.60).
Seat 4: Beep_Beep (119.01).
Seat 5: IlxxxlI (48.90).
Seat 6: gust (40).
Player MadLifeGrinder has small blind (0.50)
Player Sephiroth1 has big blind (1)
Player IlxxxlI received card: [As]
Player IlxxxlI received card: [4c]
Player Beep_Beep raises (3)
Player IlxxxlI folds
Player gust calls (3)
Player MadLifeGrinder folds
Player Sephiroth1 calls (2)
*** FLOP ***: [9h 7d 8h]
Player Sephiroth1 checks
Player Beep_Beep bets (7)
Player gust folds
Player Sephiroth1 folds
Uncalled bet (7) returned to Beep_Beep
Player Beep_Beep mucks cards
------ Summary ------
Pot: 9.03. Rake 0.33. JP fee 0.14
Board: [9h 7d 8h]
Player MadLifeGrinder does not show cards.Bets: 0.50. Collects: 0. Loses: 0.50.
Player Sephiroth1 does not show cards.Bets: 3. Collects: 0. Loses: 3.
*Player Beep_Beep mucks (does not show cards). Bets: 3. Collects: 9.03. Wins: 6.03.
Player IlxxxlI does not show cards.Bets: 0. Collects: 0. Wins: 0.
Player gust does not show cards.Bets: 3. Collects: 0. Loses: 3.
Game ended at: 2016/11/29 14:32:52

Game started
Game ID: 787007865 0.50/1 (PRR) Kraken (Hold'em)
Seat 1 is the button
Seat 1: WeakAndWeary (188.01).
Seat 2: MadLifeGrinder (115.12).
Seat 3: Sephiroth1 (139.83).
Seat 4: IlxxxlI (50.85).
Seat 5: gust (40).
Seat 6: ElvenEyes (112.11).
Player MadLifeGrinder has small blind (0.50)
Player Sephiroth1 has big blind (1)
Player IlxxxlI received card: [8h]
Player IlxxxlI received card: [5d]
Player IlxxxlI folds
Player gust folds
Player ElvenEyes folds
Player WeakAndWeary raises (2)
Player MadLifeGrinder folds
Player Sephiroth1 folds
Uncalled bet (1) returned to WeakAndWeary
Player WeakAndWeary mucks cards
------ Summary ------
Pot: 2.50. Rake 0
*Player WeakAndWeary mucks (does not show cards). Bets: 1. Collects: 2.50. Wins: 1.50.
Player MadLifeGrinder does not show cards.Bets: 0.50. Collects: 0. Loses: 0.50.
Player Sephiroth1 does not show cards.Bets: 1. Collects: 0. Loses: 1.
Player IlxxxlI does not show cards.Bets: 0. Collects: 0. Wins: 0.
Player gust does not show cards.Bets: 0. Collects: 0. Wins: 0.
Player ElvenEyes does not show cards.Bets: 0. Collects: 0. Wins: 0.
Game ended at: 2016/11/29 14:32:32

Game started
Game ID: 787007858 0.50/1 (PRR) Karkadann - 3 (Hold'em)
Seat 1 is the button
Seat 1: zboiii (119.62).
Seat 2: ElvenEyes (157.30).
Seat 3: StephCurry (101.50).
Seat 4: gust (52.95).
Seat 5: pineapplesand (50.46).
Seat 7: IlxxxlI (41).
Seat 8: dankmann (160.51).
Seat 9: VegetablesArentYummy (254.40).
Player ElvenEyes has small blind (0.50)
Player StephCurry has big blind (1)
Player IlxxxlI received card: [4d]
Player IlxxxlI received card: [3h]
Player gust raises (2)
Player pineapplesand folds
Player IlxxxlI folds
Player dankmann folds
Player VegetablesArentYummy folds
Player zboiii folds
Player ElvenEyes folds
Player StephCurry folds
Uncalled bet (1) returned to gust
Player gust mucks cards
------ Summary ------
Pot: 2.50. Rake 0
Player zboiii does not show cards.Bets: 0. Collects: 0. Wins: 0.
Player ElvenEyes does not show cards.Bets: 0.50. Collects: 0. Loses: 0.50.
Player StephCurry does not show cards.Bets: 1. Collects: 0. Loses: 1.
*Player gust mucks (does not show cards). Bets: 1. Collects: 2.50. Wins: 1.50.
Player pineapplesand does not show cards.Bets: 0. Collects: 0. Wins: 0.
Player IlxxxlI does not show cards.Bets: 0. Collects: 0. Wins: 0.
Player dankmann does not show cards.Bets: 0. Collects: 0. Wins: 0.
Player VegetablesArentYummy does not show cards.Bets: 0. Collects: 0. Wins: 0.
Game ended at: 2016/11/29 14:32:0

Game started
Game ID: 787007844 1/2 (PRR) Lakhey (Hold'em)
Seat 6 is the button
Seat 1: VegetablesArentYummy (230.65).
Seat 2: IlxxxlI (86.35).
Seat 3: IbetUmuck (863.90).
Seat 4: DonCesarGrinder (262.02).
Seat 5: MadLifeGrinder (215.06).
Seat 6: LloydXmas (227.73).
Player VegetablesArentYummy has small blind (1)
Player IlxxxlI has big blind (2)
Player IlxxxlI received card: [5c]
Player IlxxxlI received card: [3d]
Player IbetUmuck folds
Player DonCesarGrinder folds
Player MadLifeGrinder folds
Player LloydXmas raises (4.50)
Player VegetablesArentYummy folds
Player IlxxxlI folds
Uncalled bet (2.50) returned to LloydXmas
Player LloydXmas mucks cards
------ Summary ------
Pot: 5. Rake 0
Player VegetablesArentYummy does not show cards.Bets: 1. Collects: 0. Loses: 1.
Player IlxxxlI does not show cards.Bets: 2. Collects: 0. Loses: 2.
Player IbetUmuck does not show cards.Bets: 0. Collects: 0. Wins: 0.
Player DonCesarGrinder does not show cards.Bets: 0. Collects: 0. Wins: 0.
Player MadLifeGrinder does not show cards.Bets: 0. Collects: 0. Wins: 0.
*Player LloydXmas mucks (does not show cards). Bets: 2. Collects: 5. Wins: 3.
Game ended at: 2016/11/29 14:32:13

Game started
Game ID: 787007841 0.25/0.50 (PRR) Gorgons - 15 (Hold'em)
Seat 3 is the button
Seat 1: WeakAndWeary (58.92).
Seat 2: IampokerKidd (104.76).
Seat 3: imger8 (28.90).
Seat 4: IlxxxlI (21).
Seat 5: foreseen (60.55).
Seat 6: BiGFck (12.18).
Player IlxxxlI has small blind (0.25)
Player foreseen has big blind (0.50)
Player IlxxxlI received card: [10c]
Player IlxxxlI received card: [8h]
Player BiGFck folds
Player WeakAndWeary folds
Player IampokerKidd folds
Player imger8 raises (1.50)
Player IlxxxlI folds
Player foreseen folds
Uncalled bet (1) returned to imger8
Player imger8 mucks cards
------ Summary ------
Pot: 1.25. Rake 0
Player WeakAndWeary does not show cards.Bets: 0. Collects: 0. Wins: 0.
Player IampokerKidd does not show cards.Bets: 0. Collects: 0. Wins: 0.
*Player imger8 mucks (does not show cards). Bets: 0.50. Collects: 1.25. Wins: 0.75.
Player IlxxxlI does not show cards.Bets: 0.25. Collects: 0. Loses: 0.25.
Player foreseen does not show cards.Bets: 0.50. Collects: 0. Loses: 0.50.
Player BiGFck does not show cards.Bets: 0. Collects: 0. Wins: 0.
Game ended at: 2016/11/29 14:32:27

Game started
Game ID: 787007698 0.50/1 (PRR) Kraken - 23 (Hold'em)
Seat 6 is the button
Seat 1: WeakAndWeary (100.50).
Seat 2: gust (44).
Seat 3: LloydXmas (130.29).
Seat 4: Sephiroth1 (101.78).
Seat 5: ElvenEyes (124.21).
Seat 6: IlxxxlI (43.40).
Player WeakAndWeary has small blind (0.50)
Player gust has big blind (1)
Player IlxxxlI received card: [Jh]
Player IlxxxlI received card: [Jc]
Player LloydXmas folds
Player Sephiroth1 folds
Player ElvenEyes raises (2.58)
Player IlxxxlI raises (7)
Player WeakAndWeary folds
Player gust folds
Player ElvenEyes folds
Uncalled bet (4.42) returned to IlxxxlI
Player IlxxxlI mucks cards
------ Summary ------
Pot: 6.66. Rake 0
Player WeakAndWeary does not show cards.Bets: 0.50. Collects: 0. Loses: 0.50.
Player gust does not show cards.Bets: 1. Collects: 0. Loses: 1.
Player LloydXmas does not show cards.Bets: 0. Collects: 0. Wins: 0.
Player Sephiroth1 does not show cards.Bets: 0. Collects: 0. Wins: 0.
Player ElvenEyes does not show cards.Bets: 2.58. Collects: 0. Loses: 2.58.
*Player IlxxxlI mucks (does not show cards). Bets: 2.58. Collects: 6.66. Wins: 4.08.
Game ended at: 2016/11/29 14:32:13

Game started
Game ID: 787007647 0.50/1 (PRR) Karkadann - 3 (Hold'em)
Seat 9 is the button
Seat 1: zboiii (120.12).
Seat 2: ElvenEyes (158.30).
Seat 3: StephCurry (101.50).
Seat 4: gust (52.95).
Seat 5: pineapplesand (50.46).
Seat 7: IlxxxlI (41).
Seat 8: dankmann (160.51).
Seat 9: VegetablesArentYummy (252.90).
Player zboiii has small blind (0.50)
Player ElvenEyes has big blind (1)
Player IlxxxlI received card: [10h]
Player IlxxxlI received card: [6s]
Player StephCurry folds
Player gust folds
Player pineapplesand folds
Player IlxxxlI folds
Player dankmann folds
Player VegetablesArentYummy raises (2.50)
Player zboiii folds
Player ElvenEyes folds
Uncalled bet (1.50) returned to VegetablesArentYummy
Player VegetablesArentYummy mucks cards
------ Summary ------
Pot: 2.50. Rake 0
Player zboiii does not show cards.Bets: 0.50. Collects: 0. Loses: 0.50.
Player ElvenEyes does not show cards.Bets: 1. Collects: 0. Loses: 1.
Player StephCurry does not show cards.Bets: 0. Collects: 0. Wins: 0.
Player gust does not show cards.Bets: 0. Collects: 0. Wins: 0.
Player pineapplesand does not show cards.Bets: 0. Collects: 0. Wins: 0.
Player IlxxxlI does not show cards.Bets: 0. Collects: 0. Wins: 0.
Player dankmann does not show cards.Bets: 0. Collects: 0. Wins: 0.
*Player VegetablesArentYummy mucks (does not show cards). Bets: 1. Collects: 2.50. Wins: 1.50.
Game ended at: 2016/11/29 14:31:46

Game started
Game ID: 787007619 0.50/1 (PRR) Kraken - 23 (Hold'em)
Seat 5 is the button
Seat 1: WeakAndWeary (100).
Seat 2: gust (44).
Seat 3: LloydXmas (130.29).
Seat 4: Sephiroth1 (101.78).
Seat 5: ElvenEyes (124.21).
Seat 6: IlxxxlI (43.90).
Player IlxxxlI has small blind (0.50)
Player WeakAndWeary has big blind (1)
Player IlxxxlI received card: [5d]
Player IlxxxlI received card: [Kh]
Player gust folds
Player LloydXmas folds
Player Sephiroth1 folds
Player ElvenEyes folds
Player IlxxxlI folds
Uncalled bet (0.50) returned to WeakAndWeary
Player WeakAndWeary mucks cards
------ Summary ------
Pot: 1. Rake 0
*Player WeakAndWeary mucks (does not show cards). Bets: 0.50. Collects: 1. Wins: 0.50.
Player gust does not show cards.Bets: 0. Collects: 0. Wins: 0.
Player LloydXmas does not show cards.Bets: 0. Collects: 0. Wins: 0.
Player Sephiroth1 does not show cards.Bets: 0. Collects: 0. Wins: 0.
Player ElvenEyes does not show cards.Bets: 0. Collects: 0. Wins: 0.
Player IlxxxlI does not show cards.Bets: 0.50. Collects: 0. Loses: 0.50.
Game ended at: 2016/11/29 14:31:24

Game started
Game ID: 787007549 0.50/1 (PRR) Kraken (Hold'em)
Seat 6 is the button
Seat 1: WeakAndWeary (188.51).
Seat 2: MadLifeGrinder (116.12).
Seat 3: Sephiroth1 (139.83).
Seat 4: IlxxxlI (49.35).
Seat 5: gust (40).
Seat 6: ElvenEyes (112.11).
Player WeakAndWeary has small blind (0.50)
Player MadLifeGrinder has big blind (1)
Player IlxxxlI received card: [Jc]
Player IlxxxlI received card: [Kc]
Player Sephiroth1 folds
Player IlxxxlI raises (3.50)
Player gust folds
Player ElvenEyes folds
Player WeakAndWeary folds
Player MadLifeGrinder folds
Uncalled bet (2.50) returned to IlxxxlI
Player IlxxxlI mucks cards
------ Summary ------
Pot: 2.50. Rake 0
Player WeakAndWeary does not show cards.Bets: 0.50. Collects: 0. Loses: 0.50.
Player MadLifeGrinder does not show cards.Bets: 1. Collects: 0. Loses: 1.
Player Sephiroth1 does not show cards.Bets: 0. Collects: 0. Wins: 0.
*Player IlxxxlI mucks (does not show cards). Bets: 1. Collects: 2.50. Wins: 1.50.
Player gust does not show cards.Bets: 0. Collects: 0. Wins: 0.
Player ElvenEyes does not show cards.Bets: 0. Collects: 0. Wins: 0.
Game ended at: 2016/11/29 14:31:46

Game started
Game ID: 787007471 0.50/1 (PRR) Kraken - 16 (Hold'em)
Seat 5 is the button
Seat 2: MadLifeGrinder (104.35).
Seat 3: Sephiroth1 (157.32).
Seat 4: Beep_Beep (119.01).
Seat 5: IlxxxlI (48.90).
Seat 6: gust (40).
Player gust has small blind (0.50)
Player MadLifeGrinder has big blind (1)
Player IlxxxlI received card: [Qd]
Player IlxxxlI received card: [6h]
Player Sephiroth1 raises (2)
Player Beep_Beep folds
Player IlxxxlI folds
Player gust folds
Player MadLifeGrinder calls (1)
*** FLOP ***: [7s 5s Qs]
Player MadLifeGrinder checks
Player Sephiroth1 checks
*** TURN ***: [7s 5s Qs] [5c]
Player MadLifeGrinder checks
Player Sephiroth1 bets (3)
Player MadLifeGrinder folds
Uncalled bet (3) returned to Sephiroth1
Player Sephiroth1 mucks cards
------ Summary ------
Pot: 4.28. Rake 0.16. JP fee 0.06
Board: [7s 5s Qs 5c]
Player MadLifeGrinder does not show cards.Bets: 2. Collects: 0. Loses: 2.
*Player Sephiroth1 mucks (does not show cards). Bets: 2. Collects: 4.28. Wins: 2.28.
Player Beep_Beep does not show cards.Bets: 0. Collects: 0. Wins: 0.
Player IlxxxlI does not show cards.Bets: 0. Collects: 0. Wins: 0.
Player gust does not show cards.Bets: 0.50. Collects: 0. Loses: 0.50.
Game ended at: 2016/11/29 14:31:52

Game started
Game ID: 787007407 0.50/1 (PRR) Karkadann - 3 (Hold'em)
Seat 8 is the button
Seat 1: zboiii (121.12).
Seat 2: ElvenEyes (158.30).
Seat 3: StephCurry (100).
Seat 4: gust (52.95).
Seat 5: pineapplesand (50.46).
Seat 7: IlxxxlI (41).
Seat 8: dankmann (160.51).
Seat 9: VegetablesArentYummy (253.40).
Player VegetablesArentYummy has small blind (0.50)
Player zboiii has big blind (1)
Player IlxxxlI received card: [Js]
Player IlxxxlI received card: [3h]
Player ElvenEyes folds
Player StephCurry raises (3)
Player gust folds
Player pineapplesand folds
Player IlxxxlI folds
Player dankmann folds
Player VegetablesArentYummy folds
Player zboiii folds
Uncalled bet (2) returned to StephCurry
Player StephCurry mucks cards
------ Summary ------
Pot: 2.50. Rake 0
Player zboiii does not show cards.Bets: 1. Collects: 0. Loses: 1.
Player ElvenEyes does not show cards.Bets: 0. Collects: 0. Wins: 0.
*Player StephCurry mucks (does not show cards). Bets: 1. Collects: 2.50. Wins: 1.50.
Player gust does not show cards.Bets: 0. Collects: 0. Wins: 0.
Player pineapplesand does not show cards.Bets: 0. Collects: 0. Wins: 0.
Player IlxxxlI does not show cards.Bets: 0. Collects: 0. Wins: 0.
Player dankmann does not show cards.Bets: 0. Collects: 0. Wins: 0.
Player VegetablesArentYummy does not show cards.Bets: 0.50. Collects: 0. Loses: 0.50.
Game ended at: 2016/11/29 14:31:17

Game started
Game ID: 787007391 0.50/1 (PRR) Kraken - 23 (Hold'em)
Seat 4 is the button
Seat 1: WeakAndWeary (100).
Seat 2: gust (44).
Seat 3: LloydXmas (130.29).
Seat 4: Sephiroth1 (101.78).
Seat 5: ElvenEyes (123.21).
Seat 6: IlxxxlI (44.90).
Player ElvenEyes has small blind (0.50)
Player IlxxxlI has big blind (1)
Player IlxxxlI received card: [6s]
Player IlxxxlI received card: [2c]
Player WeakAndWeary folds
Player gust folds
Player LloydXmas folds
Player Sephiroth1 folds
Player ElvenEyes raises (2.50)
Player IlxxxlI folds
Uncalled bet (2) returned to ElvenEyes
Player ElvenEyes mucks cards
------ Summary ------
Pot: 2. Rake 0
Player WeakAndWeary does not show cards.Bets: 0. Collects: 0. Wins: 0.
Player gust does not show cards.Bets: 0. Collects: 0. Wins: 0.
Player LloydXmas does not show cards.Bets: 0. Collects: 0. Wins: 0.
Player Sephiroth1 does not show cards.Bets: 0. Collects: 0. Wins: 0.
*Player ElvenEyes mucks (does not show cards). Bets: 1. Collects: 2. Wins: 1.
Player IlxxxlI does not show cards.Bets: 1. Collects: 0. Loses: 1.
Game ended at: 2016/11/29 14:31:12

Game started
Game ID: 787007368 1/2 (PRR) Longana (Short) - 2 (Hold'em)
Seat 8 is the button
Seat 1: actionjax24 (96.46).
Seat 3: VegetablesArentYummy (135.53).
Seat 4: gust (89).
Seat 5: thimk (69.67).
Seat 6: IlxxxlI (40).
Seat 7: pineapplesand (40).
Seat 8: StephCurry (106.50).
Seat 9: hotshothotgg (64.19).
Player hotshothotgg has small blind (1)
Player actionjax24 sitting out
Player VegetablesArentYummy has big blind (2)
Player IlxxxlI received card: [2s]
Player IlxxxlI received card: [Jh]
Player gust folds
Player thimk folds
Player IlxxxlI folds
Player pineapplesand folds
Player StephCurry folds
Player hotshothotgg raises (3)
Player VegetablesArentYummy calls (2)
*** FLOP ***: [Kd Qh 10d]
Player hotshothotgg checks
Player VegetablesArentYummy checks
*** TURN ***: [Kd Qh 10d] [8s]
Player hotshothotgg checks
Player VegetablesArentYummy bets (5.06)
Player hotshothotgg folds
Uncalled bet (5.06) returned to VegetablesArentYummy
Player VegetablesArentYummy mucks cards
------ Summary ------
Pot: 7.60. Rake 0.28. JP fee 0.12
Board: [Kd Qh 10d 8s]
Player actionjax24 does not show cards.Bets: 0. Collects: 0. Wins: 0.
*Player VegetablesArentYummy mucks (does not show cards). Bets: 4. Collects: 7.60. Wins: 3.60.
Player gust does not show cards.Bets: 0. Collects: 0. Wins: 0.
Player thimk does not show cards.Bets: 0. Collects: 0. Wins: 0.
Player IlxxxlI does not show cards.Bets: 0. Collects: 0. Wins: 0.
Player pineapplesand does not show cards.Bets: 0. Collects: 0. Wins: 0.
Player StephCurry does not show cards.Bets: 0. Collects: 0. Wins: 0.
Player hotshothotgg does not show cards.Bets: 4. Collects: 0. Loses: 4.
Game ended at: 2016/11/29 14:32:11

Game started
Game ID: 787007268 0.25/0.50 (PRR) Gorgons - 15 (Hold'em)
Seat 2 is the button
Seat 1: WeakAndWeary (58.92).
Seat 2: IampokerKidd (104.76).
Seat 3: imger8 (37.09).
Seat 4: IlxxxlI (21.50).
Seat 5: foreseen (52.70).
Seat 6: BiGFck (12.18).
Player imger8 has small blind (0.25)
Player IlxxxlI has big blind (0.50)
Player IlxxxlI received card: [3h]
Player IlxxxlI received card: [7d]
Player foreseen raises (1.25)
Player BiGFck folds
Player WeakAndWeary folds
Player IampokerKidd folds
Player imger8 calls (1)
Player IlxxxlI folds
*** FLOP ***: [5d 5s 10c]
Player imger8 checks
Player foreseen bets (0.94)
Player imger8 calls (0.94)
*** TURN ***: [5d 5s 10c] [Js]
Player imger8 bets (2)
Player foreseen calls (2)
*** RIVER ***: [5d 5s 10c Js] [8h]
Player imger8 bets (4)
Player foreseen calls (4)
------ Summary ------
Pot: 16.04. Rake 0.60. JP fee 0.24
Board: [5d 5s 10c Js 8h]
Player WeakAndWeary does not show cards.Bets: 0. Collects: 0. Wins: 0.
Player IampokerKidd does not show cards.Bets: 0. Collects: 0. Wins: 0.
Player imger8 shows: Two pairs. 10s and 5s [10h 6h]. Bets: 8.19. Collects: 0. Loses: 8.19.
Player IlxxxlI does not show cards.Bets: 0.50. Collects: 0. Loses: 0.50.
*Player foreseen shows: Two pairs. 10s and 5s (kicker Q) [10d Qd]. Bets: 8.19. Collects: 16.04. Wins: 7.85.
Player BiGFck does not show cards.Bets: 0. Collects: 0. Wins: 0.
Game ended at: 2016/11/29 14:31:41

Game started
Game ID: 787007194 1/2 (PRR) Longana (Short) - 2 (Hold'em)
Seat 7 is the button
Seat 1: actionjax24 (96.46).
Seat 3: VegetablesArentYummy (135.53).
Seat 4: gust (89).
Seat 5: thimk (69.67).
Seat 6: IlxxxlI (40).
Seat 7: pineapplesand (40).
Seat 8: StephCurry (107.50).
Seat 9: hotshothotgg (63.19).
Player StephCurry has small blind (1)
Player hotshothotgg has big blind (2)
Player IlxxxlI received card: [Qh]
Player IlxxxlI received card: [2h]
Player actionjax24 folds
Player VegetablesArentYummy folds
Player gust folds
Player thimk folds
Player IlxxxlI folds
Player pineapplesand folds
Player StephCurry folds
Uncalled bet (1) returned to hotshothotgg
Player hotshothotgg mucks cards
------ Summary ------
Pot: 2. Rake 0
Player actionjax24 does not show cards.Bets: 0. Collects: 0. Wins: 0.
Player VegetablesArentYummy does not show cards.Bets: 0. Collects: 0. Wins: 0.
Player gust does not show cards.Bets: 0. Collects: 0. Wins: 0.
Player thimk does not show cards.Bets: 0. Collects: 0. Wins: 0.
Player IlxxxlI does not show cards.Bets: 0. Collects: 0. Wins: 0.
Player pineapplesand does not show cards.Bets: 0. Collects: 0. Wins: 0.
Player StephCurry does not show cards.Bets: 1. Collects: 0. Loses: 1.
*Player hotshothotgg mucks (does not show cards). Bets: 1. Collects: 2. Wins: 1.
Game ended at: 2016/11/29 14:30:39

Game started
Game ID: 787007179 0.50/1 (PRR) Kraken (Hold'em)
Seat 5 is the button
Seat 1: WeakAndWeary (187.61).
Seat 2: MadLifeGrinder (116.12).
Seat 3: Sephiroth1 (139.83).
Seat 4: IlxxxlI (49.35).
Seat 5: gust (40).
Seat 6: ElvenEyes (113.11).
Player ElvenEyes has small blind (0.50)
Player WeakAndWeary has big blind (1)
Player IlxxxlI received card: [2s]
Player IlxxxlI received card: [10s]
Player MadLifeGrinder folds
Player Sephiroth1 folds
Player IlxxxlI folds
Player gust folds
Player ElvenEyes calls (0.50)
Player WeakAndWeary checks
*** FLOP ***: [10h 7h 6s]
Player ElvenEyes checks
Player WeakAndWeary bets (1.43)
Player ElvenEyes folds
Uncalled bet (1.43) returned to WeakAndWeary
Player WeakAndWeary mucks cards
------ Summary ------
Pot: 1.90. Rake 0.08. JP fee 0.02
Board: [10h 7h 6s]
*Player WeakAndWeary mucks (does not show cards). Bets: 1. Collects: 1.90. Wins: 0.90.
Player MadLifeGrinder does not show cards.Bets: 0. Collects: 0. Wins: 0.
Player Sephiroth1 does not show cards.Bets: 0. Collects: 0. Wins: 0.
Player IlxxxlI does not show cards.Bets: 0. Collects: 0. Wins: 0.
Player gust does not show cards.Bets: 0. Collects: 0. Wins: 0.
Player ElvenEyes does not show cards.Bets: 1. Collects: 0. Loses: 1.
Game ended at: 2016/11/29 14:31:4

Game started
Game ID: 787007167 0.50/1 (PRR) Kraken - 23 (Hold'em)
Seat 3 is the button
Seat 1: WeakAndWeary (100).
Seat 2: gust (42.50).
Seat 3: LloydXmas (130.29).
Seat 4: Sephiroth1 (102.28).
Seat 5: ElvenEyes (124.21).
Seat 6: IlxxxlI (44.90).
Player Sephiroth1 has small blind (0.50)
Player ElvenEyes has big blind (1)
Player IlxxxlI received card: [5c]
Player IlxxxlI received card: [9c]
Player IlxxxlI folds
Player WeakAndWeary folds
Player gust raises (2)
Player LloydXmas folds
Player Sephiroth1 folds
Player ElvenEyes folds
Uncalled bet (1) returned to gust
Player gust mucks cards
------ Summary ------
Pot: 2.50. Rake 0
Player WeakAndWeary does not show cards.Bets: 0. Collects: 0. Wins: 0.
*Player gust mucks (does not show cards). Bets: 1. Collects: 2.50. Wins: 1.50.
Player LloydXmas does not show cards.Bets: 0. Collects: 0. Wins: 0.
Player Sephiroth1 does not show cards.Bets: 0.50. Collects: 0. Loses: 0.50.
Player ElvenEyes does not show cards.Bets: 1. Collects: 0. Loses: 1.
Player IlxxxlI does not show cards.Bets: 0. Collects: 0. Wins: 0.
Game ended at: 2016/11/29 14:30:42

Game started
Game ID: 787007048 1/2 (PRR) Lakhey (Hold'em)
Seat 5 is the button
Seat 1: VegetablesArentYummy (239.65).
Seat 2: IlxxxlI (86.35).
Seat 3: IbetUmuck (863.90).
Seat 4: DonCesarGrinder (262.02).
Seat 5: MadLifeGrinder (215.06).
Seat 6: LloydXmas (219.63).
Player LloydXmas has small blind (1)
Player VegetablesArentYummy has big blind (2)
Player IlxxxlI received card: [4d]
Player IlxxxlI received card: [Qd]
Player IlxxxlI folds
Player IbetUmuck folds
Player DonCesarGrinder folds
Player MadLifeGrinder folds
Player LloydXmas raises (3)
Player VegetablesArentYummy calls (2)
*** FLOP ***: [5h 7c 10s]
Player LloydXmas checks
Player VegetablesArentYummy checks
*** TURN ***: [5h 7c 10s] [3c]
Player LloydXmas bets (5)
Player VegetablesArentYummy calls (5)
*** RIVER ***: [5h 7c 10s 3c] [2s]
Player LloydXmas checks
Player VegetablesArentYummy checks
Player VegetablesArentYummy mucks cards
------ Summary ------
Pot: 17.10. Rake 0.66. JP fee 0.24
Board: [5h 7c 10s 3c 2s]
Player VegetablesArentYummy mucks (does not show cards). Bets: 9. Collects: 0. Loses: 9.
Player IlxxxlI does not show cards.Bets: 0. Collects: 0. Wins: 0.
Player IbetUmuck does not show cards.Bets: 0. Collects: 0. Wins: 0.
Player DonCesarGrinder does not show cards.Bets: 0. Collects: 0. Wins: 0.
Player MadLifeGrinder does not show cards.Bets: 0. Collects: 0. Wins: 0.
*Player LloydXmas shows: One pair of 7s [Kh 7h]. Bets: 9. Collects: 17.10. Wins: 8.10.
Game ended at: 2016/11/29 14:31:41

Game started
Game ID: 787006994 0.50/1 (PRR) Kraken - 16 (Hold'em)
Seat 4 is the button
Seat 2: MadLifeGrinder (106.85).
Seat 3: Sephiroth1 (157.32).
Seat 4: Beep_Beep (119.01).
Seat 5: IlxxxlI (45.70).
Seat 6: gust (40).
Player IlxxxlI has small blind (0.50)
Player gust has big blind (1)
Player IlxxxlI received card: [Ah]
Player IlxxxlI received card: [As]
Player MadLifeGrinder raises (2.50)
Player Sephiroth1 folds
Player Beep_Beep folds
Player IlxxxlI calls (2)
Player gust folds
*** FLOP ***: [9h Kh 5c]
Player IlxxxlI checks
Player MadLifeGrinder checks
*** TURN ***: [9h Kh 5c] [3h]
Player IlxxxlI bets (5)
Player MadLifeGrinder folds
Uncalled bet (5) returned to IlxxxlI
Player IlxxxlI mucks cards
------ Summary ------
Pot: 5.70. Rake 0.20. JP fee 0.10
Board: [9h Kh 5c 3h]
Player MadLifeGrinder does not show cards.Bets: 2.50. Collects: 0. Loses: 2.50.
Player Sephiroth1 does not show cards.Bets: 0. Collects: 0. Wins: 0.
Player Beep_Beep does not show cards.Bets: 0. Collects: 0. Wins: 0.
*Player IlxxxlI mucks (does not show cards). Bets: 2.50. Collects: 5.70. Wins: 3.20.
Player gust does not show cards.Bets: 1. Collects: 0. Loses: 1.
Game ended at: 2016/11/29 14:30:53

Game started
Game ID: 787006955 0.50/1 (PRR) Kraken (Hold'em)
Seat 4 is the button
Seat 1: WeakAndWeary (187.61).
Seat 2: MadLifeGrinder (116.12).
Seat 3: Sephiroth1 (139.83).
Seat 4: IlxxxlI (47.85).
Seat 5: gust (40).
Seat 6: ElvenEyes (114.11).
Player gust has small blind (0.50)
Player ElvenEyes has big blind (1)
Player IlxxxlI received card: [8s]
Player IlxxxlI received card: [Js]
Player WeakAndWeary folds
Player MadLifeGrinder folds
Player Sephiroth1 folds
Player IlxxxlI raises (3)
Player gust folds
Player ElvenEyes folds
Uncalled bet (2) returned to IlxxxlI
Player IlxxxlI mucks cards
------ Summary ------
Pot: 2.50. Rake 0
Player WeakAndWeary does not show cards.Bets: 0. Collects: 0. Wins: 0.
Player MadLifeGrinder does not show cards.Bets: 0. Collects: 0. Wins: 0.
Player Sephiroth1 does not show cards.Bets: 0. Collects: 0. Wins: 0.
*Player IlxxxlI mucks (does not show cards). Bets: 1. Collects: 2.50. Wins: 1.50.
Player gust does not show cards.Bets: 0.50. Collects: 0. Loses: 0.50.
Player ElvenEyes does not show cards.Bets: 1. Collects: 0. Loses: 1.
Game ended at: 2016/11/29 14:30:12

Game started
Game ID: 787006935 0.50/1 (PRR) Karkadann - 3 (Hold'em)
Seat 7 is the button
Seat 1: zboiii (121.12).
Seat 2: ElvenEyes (158.30).
Seat 3: StephCurry (100).
Seat 4: gust (52.95).
Seat 5: pineapplesand (48.96).
Seat 7: IlxxxlI (41).
Seat 8: dankmann (161.01).
Seat 9: VegetablesArentYummy (254.40).
Player dankmann has small blind (0.50)
Player VegetablesArentYummy has big blind (1)
Player IlxxxlI received card: [Js]
Player IlxxxlI received card: [9s]
Player zboiii folds
Player ElvenEyes folds
Player StephCurry folds
Player gust folds
Player pineapplesand raises (2)
Player IlxxxlI folds
Player dankmann folds
Player VegetablesArentYummy folds
Uncalled bet (1) returned to pineapplesand
Player pineapplesand mucks cards
------ Summary ------
Pot: 2.50. Rake 0
Player zboiii does not show cards.Bets: 0. Collects: 0. Wins: 0.
Player ElvenEyes does not show cards.Bets: 0. Collects: 0. Wins: 0.
Player StephCurry does not show cards.Bets: 0. Collects: 0. Wins: 0.
Player gust does not show cards.Bets: 0. Collects: 0. Wins: 0.
*Player pineapplesand mucks (does not show cards). Bets: 1. Collects: 2.50. Wins: 1.50.
Player IlxxxlI does not show cards.Bets: 0. Collects: 0. Wins: 0.
Player dankmann does not show cards.Bets: 0.50. Collects: 0. Loses: 0.50.
Player VegetablesArentYummy does not show cards.Bets: 1. Collects: 0. Loses: 1.
Game ended at: 2016/11/29 14:30:45

Game started
Game ID: 787006907 1/2 (PRR) Lakhey (Hold'em)
Seat 4 is the button
Seat 1: VegetablesArentYummy (239.65).
Seat 2: IlxxxlI (86.35).
Seat 3: IbetUmuck (863.90).
Seat 4: DonCesarGrinder (262.02).
Seat 5: MadLifeGrinder (216.06).
Seat 6: LloydXmas (218.63).
Player MadLifeGrinder has small blind (1)
Player LloydXmas has big blind (2)
Player IlxxxlI received card: [Qc]
Player IlxxxlI received card: [Jh]
Player VegetablesArentYummy folds
Player IlxxxlI folds
Player IbetUmuck folds
Player DonCesarGrinder folds
Player MadLifeGrinder folds
Uncalled bet (1) returned to LloydXmas
Player LloydXmas mucks cards
------ Summary ------
Pot: 2. Rake 0
Player VegetablesArentYummy does not show cards.Bets: 0. Collects: 0. Wins: 0.
Player IlxxxlI does not show cards.Bets: 0. Collects: 0. Wins: 0.
Player IbetUmuck does not show cards.Bets: 0. Collects: 0. Wins: 0.
Player DonCesarGrinder does not show cards.Bets: 0. Collects: 0. Wins: 0.
Player MadLifeGrinder does not show cards.Bets: 1. Collects: 0. Loses: 1.
*Player LloydXmas mucks (does not show cards). Bets: 1. Collects: 2. Wins: 1.
Game ended at: 2016/11/29 14:29:54

Game started
Game ID: 787006740 0.50/1 (PRR) Kraken (Hold'em)
Seat 3 is the button
Seat 1: WeakAndWeary (187.61).
Seat 2: MadLifeGrinder (114.62).
Seat 3: Sephiroth1 (139.83).
Seat 4: IlxxxlI (48.35).
Seat 5: gust (40).
Seat 6: ElvenEyes (114.11).
Player IlxxxlI has small blind (0.50)
Player gust has big blind (1)
Player IlxxxlI received card: [Qd]
Player IlxxxlI received card: [6h]
Player ElvenEyes folds
Player WeakAndWeary folds
Player MadLifeGrinder raises (2.50)
Player Sephiroth1 folds
Player IlxxxlI folds
Player gust folds
Uncalled bet (1.50) returned to MadLifeGrinder
Player MadLifeGrinder mucks cards
------ Summary ------
Pot: 2.50. Rake 0
Player WeakAndWeary does not show cards.Bets: 0. Collects: 0. Wins: 0.
*Player MadLifeGrinder mucks (does not show cards). Bets: 1. Collects: 2.50. Wins: 1.50.
Player Sephiroth1 does not show cards.Bets: 0. Collects: 0. Wins: 0.
Player IlxxxlI does not show cards.Bets: 0.50. Collects: 0. Loses: 0.50.
Player gust does not show cards.Bets: 1. Collects: 0. Loses: 1.
Player ElvenEyes does not show cards.Bets: 0. Collects: 0. Wins: 0.
Game ended at: 2016/11/29 14:29:40

Game started
Game ID: 787006683 0.50/1 (PRR) Kraken - 23 (Hold'em)
Seat 2 is the button
Seat 1: WeakAndWeary (100).
Seat 2: gust (44.50).
Seat 3: LloydXmas (130.79).
Seat 4: Sephiroth1 (100).
Seat 5: ElvenEyes (124.21).
Seat 6: IlxxxlI (44.90).
Player LloydXmas has small blind (0.50)
Player Sephiroth1 has big blind (1)
Player IlxxxlI received card: [Qs]
Player IlxxxlI received card: [6d]
Player ElvenEyes folds
Player IlxxxlI folds
Player WeakAndWeary folds
Player gust raises (2)
Player LloydXmas folds
Player Sephiroth1 calls (1)
*** FLOP ***: [Kd 5c 10d]
Player Sephiroth1 checks
Player gust checks
*** TURN ***: [Kd 5c 10d] [2s]
Player Sephiroth1 bets (2.85)
Player gust folds
Uncalled bet (2.85) returned to Sephiroth1
Player Sephiroth1 mucks cards
------ Summary ------
Pot: 4.28. Rake 0.16. JP fee 0.06
Board: [Kd 5c 10d 2s]
Player WeakAndWeary does not show cards.Bets: 0. Collects: 0. Wins: 0.
Player gust does not show cards.Bets: 2. Collects: 0. Loses: 2.
Player LloydXmas does not show cards.Bets: 0.50. Collects: 0. Loses: 0.50.
*Player Sephiroth1 mucks (does not show cards). Bets: 2. Collects: 4.28. Wins: 2.28.
Player ElvenEyes does not show cards.Bets: 0. Collects: 0. Wins: 0.
Player IlxxxlI does not show cards.Bets: 0. Collects: 0. Wins: 0.
Game ended at: 2016/11/29 14:30:10

Game started
Game ID: 787006584 1/2 (PRR) Longana (Short) - 2 (Hold'em)
Seat 6 is the button
Seat 1: actionjax24 (98.46).
Seat 3: VegetablesArentYummy (135.53).
Seat 4: gust (89).
Seat 5: thimk (65.02).
Seat 6: IlxxxlI (40).
Seat 7: pineapplesand (40).
Seat 8: StephCurry (109.50).
Seat 9: hotshothotgg (63.19).
Player pineapplesand has small blind (1)
Player StephCurry has big blind (2)
Player IlxxxlI received card: [4d]
Player IlxxxlI received card: [5h]
Player hotshothotgg folds
Player actionjax24 calls (2)
Player VegetablesArentYummy folds
Player gust folds
Player thimk calls (2)
Player IlxxxlI folds
Player pineapplesand folds
Player StephCurry checks
*** FLOP ***: [Qc 7h 8h]
Player StephCurry checks
Player actionjax24 checks
Player thimk bets (3.32)
Player StephCurry folds
Player actionjax24 folds
Uncalled bet (3.32) returned to thimk
Player thimk mucks cards
------ Summary ------
Pot: 6.65. Rake 0.25. JP fee 0.10
Board: [Qc 7h 8h]
Player actionjax24 does not show cards.Bets: 2. Collects: 0. Loses: 2.
Player VegetablesArentYummy does not show cards.Bets: 0. Collects: 0. Wins: 0.
Player gust does not show cards.Bets: 0. Collects: 0. Wins: 0.
*Player thimk mucks (does not show cards). Bets: 2. Collects: 6.65. Wins: 4.65.
Player IlxxxlI does not show cards.Bets: 0. Collects: 0. Wins: 0.
Player pineapplesand does not show cards.Bets: 1. Collects: 0. Loses: 1.
Player StephCurry does not show cards.Bets: 2. Collects: 0. Loses: 2.
Player hotshothotgg does not show cards.Bets: 0. Collects: 0. Wins: 0.
Game ended at: 2016/11/29 14:30:14

Game started
Game ID: 787006504 0.25/0.50 (PRR) Gorgons - 15 (Hold'em)
Seat 1 is the button
Seat 1: WeakAndWeary (52.33).
Seat 2: IampokerKidd (105.01).
Seat 3: imger8 (43.09).
Seat 4: IlxxxlI (21.50).
Seat 5: foreseen (52.70).
Seat 6: BiGFck (13.18).
Player IampokerKidd has small blind (0.25)
Player imger8 has big blind (0.50)
Player IlxxxlI received card: [9s]
Player IlxxxlI received card: [Kd]
Player IlxxxlI folds
Player foreseen folds
Player BiGFck raises (1)
Player WeakAndWeary raises (2.50)
Player IampokerKidd folds
Player imger8 calls (2)
Player BiGFck folds
*** FLOP ***: [10c 4c 2d]
Player imger8 checks
Player WeakAndWeary checks
*** TURN ***: [10c 4c 2d] [3h]
Player imger8 bets (3.50)
Player WeakAndWeary raises (16)
Player imger8 folds
Uncalled bet (12.50) returned to WeakAndWeary
Player WeakAndWeary mucks cards
------ Summary ------
Pot: 12.59. Rake 0.44. JP fee 0.22
Board: [10c 4c 2d 3h]
*Player WeakAndWeary mucks (does not show cards). Bets: 6. Collects: 12.59. Wins: 6.59.
Player IampokerKidd does not show cards.Bets: 0.25. Collects: 0. Loses: 0.25.
Player imger8 does not show cards.Bets: 6. Collects: 0. Loses: 6.
Player IlxxxlI does not show cards.Bets: 0. Collects: 0. Wins: 0.
Player foreseen does not show cards.Bets: 0. Collects: 0. Wins: 0.
Player BiGFck does not show cards.Bets: 1. Collects: 0. Loses: 1.
Game ended at: 2016/11/29 14:30:23

Game started
Game ID: 787006470 1/2 (PRR) Lakhey (Hold'em)
Seat 3 is the button
Seat 1: VegetablesArentYummy (234.20).
Seat 2: IlxxxlI (86.35).
Seat 3: IbetUmuck (863.90).
Seat 4: DonCesarGrinder (263.02).
Seat 5: MadLifeGrinder (221.06).
Seat 6: LloydXmas (218.63).
Player DonCesarGrinder has small blind (1)
Player MadLifeGrinder has big blind (2)
Player IlxxxlI received card: [9h]
Player IlxxxlI received card: [Qd]
Player LloydXmas folds
Player VegetablesArentYummy raises (5)
Player IlxxxlI folds
Player IbetUmuck folds
Player DonCesarGrinder folds
Player MadLifeGrinder calls (3)
*** FLOP ***: [Kh Ah Qs]
Player MadLifeGrinder checks
Player VegetablesArentYummy bets (4.22)
Player MadLifeGrinder folds
Uncalled bet (4.22) returned to VegetablesArentYummy
Player VegetablesArentYummy mucks cards
------ Summary ------
Pot: 10.45. Rake 0.37. JP fee 0.18
Board: [Kh Ah Qs]
*Player VegetablesArentYummy mucks (does not show cards). Bets: 5. Collects: 10.45. Wins: 5.45.
Player IlxxxlI does not show cards.Bets: 0. Collects: 0. Wins: 0.
Player IbetUmuck does not show cards.Bets: 0. Collects: 0. Wins: 0.
Player DonCesarGrinder does not show cards.Bets: 1. Collects: 0. Loses: 1.
Player MadLifeGrinder does not show cards.Bets: 5. Collects: 0. Loses: 5.
Player LloydXmas does not show cards.Bets: 0. Collects: 0. Wins: 0.
Game ended at: 2016/11/29 14:29:34

Game started
Game ID: 787006429 0.50/1 (PRR) Kraken - 16 (Hold'em)
Seat 3 is the button
Seat 2: MadLifeGrinder (106.85).
Seat 3: Sephiroth1 (157.32).
Seat 4: Beep_Beep (122.01).
Seat 5: IlxxxlI (43).
Seat 6: gust (40).
Player Beep_Beep has small blind (0.50)
Player IlxxxlI has big blind (1)
Player IlxxxlI received card: [9c]
Player IlxxxlI received card: [10d]
Player gust folds
Player MadLifeGrinder folds
Player Sephiroth1 folds
Player Beep_Beep raises (2.50)
Player IlxxxlI calls (2)
*** FLOP ***: [8h As Ad]
Player Beep_Beep checks
Player IlxxxlI checks
*** TURN ***: [8h As Ad] [9h]
Player Beep_Beep checks
Player IlxxxlI bets (1.90)
Player Beep_Beep folds
Uncalled bet (1.90) returned to IlxxxlI
Player IlxxxlI mucks cards
------ Summary ------
Pot: 5.70. Rake 0.20. JP fee 0.10
Board: [8h As Ad 9h]
Player MadLifeGrinder does not show cards.Bets: 0. Collects: 0. Wins: 0.
Player Sephiroth1 does not show cards.Bets: 0. Collects: 0. Wins: 0.
Player Beep_Beep does not show cards.Bets: 3. Collects: 0. Loses: 3.
*Player IlxxxlI mucks (does not show cards). Bets: 3. Collects: 5.70. Wins: 2.70.
Player gust does not show cards.Bets: 0. Collects: 0. Wins: 0.
Game ended at: 2016/11/29 14:29:45

Game started
Game ID: 787006391 0.50/1 (PRR) Kraken - 23 (Hold'em)
Seat 1 is the button
Seat 1: WeakAndWeary (100).
Seat 2: gust (45).
Seat 3: LloydXmas (131.79).
Seat 4: Sephiroth1 (100).
Seat 5: ElvenEyes (124.21).
Seat 6: IlxxxlI (43.40).
Player gust has small blind (0.50)
Player LloydXmas has big blind (1)
Player IlxxxlI received card: [4d]
Player IlxxxlI received card: [4s]
Player Sephiroth1 folds
Player ElvenEyes folds
Player IlxxxlI raises (2.40)
Player WeakAndWeary folds
Player gust folds
Player LloydXmas folds
Uncalled bet (1.40) returned to IlxxxlI
Player IlxxxlI mucks cards
------ Summary ------
Pot: 2.50. Rake 0
Player WeakAndWeary does not show cards.Bets: 0. Collects: 0. Wins: 0.
Player gust does not show cards.Bets: 0.50. Collects: 0. Loses: 0.50.
Player LloydXmas does not show cards.Bets: 1. Collects: 0. Loses: 1.
Player Sephiroth1 does not show cards.Bets: 0. Collects: 0. Wins: 0.
Player ElvenEyes does not show cards.Bets: 0. Collects: 0. Wins: 0.
*Player IlxxxlI mucks (does not show cards). Bets: 1. Collects: 2.50. Wins: 1.50.
Game ended at: 2016/11/29 14:29:3

Game started
Game ID: 787006342 0.50/1 (PRR) Kraken (Hold'em)
Seat 2 is the button
Seat 1: WeakAndWeary (187.61).
Seat 2: MadLifeGrinder (114.62).
Seat 3: Sephiroth1 (146.63).
Seat 4: IlxxxlI (42.23).
Seat 5: gust (40).
Seat 6: ElvenEyes (114.11).
Player Sephiroth1 has small blind (0.50)
Player IlxxxlI has big blind (1)
Player IlxxxlI received card: [10h]
Player IlxxxlI received card: [Js]
Player gust folds
Player ElvenEyes folds
Player WeakAndWeary folds
Player MadLifeGrinder folds
Player Sephiroth1 raises (2.50)
Player IlxxxlI calls (2)
*** FLOP ***: [Kd 7c 10s]
Player Sephiroth1 checks
Player IlxxxlI checks
*** TURN ***: [Kd 7c 10s] [Jc]
Player Sephiroth1 bets (3.80)
Player IlxxxlI raises (14)
Player Sephiroth1 folds
Uncalled bet (10.20) returned to IlxxxlI
Player IlxxxlI mucks cards
------ Summary ------
Pot: 12.92. Rake 0.46. JP fee 0.22
Board: [Kd 7c 10s Jc]
Player WeakAndWeary does not show cards.Bets: 0. Collects: 0. Wins: 0.
Player MadLifeGrinder does not show cards.Bets: 0. Collects: 0. Wins: 0.
Player Sephiroth1 does not show cards.Bets: 6.80. Collects: 0. Loses: 6.80.
*Player IlxxxlI mucks (does not show cards). Bets: 6.80. Collects: 12.92. Wins: 6.12.
Player gust does not show cards.Bets: 0. Collects: 0. Wins: 0.
Player ElvenEyes does not show cards.Bets: 0. Collects: 0. Wins: 0.
Game ended at: 2016/11/29 14:29:11

Game started
Game ID: 787006286 1/2 (PRR) Longana (Short) - 2 (Hold'em)
Seat 5 is the button
Seat 1: actionjax24 (104.46).
Seat 3: VegetablesArentYummy (135.53).
Seat 4: gust (80).
Seat 5: thimk (65.02).
Seat 6: IlxxxlI (40).
Seat 7: pineapplesand (42).
Seat 8: StephCurry (109.50).
Seat 9: hotshothotgg (63.19).
Player IlxxxlI has small blind (1)
Player pineapplesand has big blind (2)
Player IlxxxlI received card: [5d]
Player IlxxxlI received card: [4s]
Player StephCurry folds
Player hotshothotgg folds
Player actionjax24 raises (6)
Player VegetablesArentYummy folds
Player gust raises (14)
Player thimk folds
Player IlxxxlI folds
Player pineapplesand folds
Player actionjax24 folds
Uncalled bet (8) returned to gust
Player gust mucks cards
------ Summary ------
Pot: 15. Rake 0
Player actionjax24 does not show cards.Bets: 6. Collects: 0. Loses: 6.
Player VegetablesArentYummy does not show cards.Bets: 0. Collects: 0. Wins: 0.
*Player gust mucks (does not show cards). Bets: 6. Collects: 15. Wins: 9.
Player thimk does not show cards.Bets: 0. Collects: 0. Wins: 0.
Player IlxxxlI does not show cards.Bets: 1. Collects: 0. Loses: 1.
Player pineapplesand does not show cards.Bets: 2. Collects: 0. Loses: 2.
Player StephCurry does not show cards.Bets: 0. Collects: 0. Wins: 0.
Player hotshothotgg does not show cards.Bets: 0. Collects: 0. Wins: 0.
Game ended at: 2016/11/29 14:28:50

Game started
Game ID: 787006280 0.50/1 (PRR) Kraken - 16 (Hold'em)
Seat 2 is the button
Seat 2: MadLifeGrinder (106.85).
Seat 3: Sephiroth1 (157.82).
Seat 4: Beep_Beep (123.01).
Seat 5: IlxxxlI (41.50).
Seat 6: gust (40).
Player Sephiroth1 has small blind (0.50)
Player Beep_Beep has big blind (1)
Player IlxxxlI received card: [Kd]
Player IlxxxlI received card: [Qh]
Player IlxxxlI raises (3.50)
Player gust folds
Player MadLifeGrinder folds
Player Sephiroth1 folds
Player Beep_Beep folds
Uncalled bet (2.50) returned to IlxxxlI
Player IlxxxlI mucks cards
------ Summary ------
Pot: 2.50. Rake 0
Player MadLifeGrinder does not show cards.Bets: 0. Collects: 0. Wins: 0.
Player Sephiroth1 does not show cards.Bets: 0.50. Collects: 0. Loses: 0.50.
Player Beep_Beep does not show cards.Bets: 1. Collects: 0. Loses: 1.
*Player IlxxxlI mucks (does not show cards). Bets: 1. Collects: 2.50. Wins: 1.50.
Player gust does not show cards.Bets: 0. Collects: 0. Wins: 0.
Game ended at: 2016/11/29 14:28:29

Game started
Game ID: 787006212 0.50/1 (PRR) Karkadann - 3 (Hold'em)
Seat 5 is the button
Seat 1: zboiii (121.12).
Seat 2: ElvenEyes (158.30).
Seat 3: StephCurry (100).
Seat 4: gust (42.28).
Seat 5: pineapplesand (48.96).
Seat 7: IlxxxlI (41.50).
Seat 8: dankmann (162.01).
Seat 9: VegetablesArentYummy (264.67).
Player IlxxxlI has small blind (0.50)
Player dankmann has big blind (1)
Player IlxxxlI received card: [9c]
Player IlxxxlI received card: [10c]
Player VegetablesArentYummy raises (2.50)
Player zboiii folds
Player ElvenEyes folds
Player StephCurry folds
Player gust raises (6)
Player pineapplesand folds
Player IlxxxlI folds
Player dankmann folds
Player VegetablesArentYummy calls (3.50)
*** FLOP ***: [5s 9h Ah]
Player VegetablesArentYummy checks
Player gust bets (4.27)
Player VegetablesArentYummy calls (4.27)
*** TURN ***: [5s 9h Ah] [Jd]
Player VegetablesArentYummy checks
Player gust bets (6.98)
Player VegetablesArentYummy folds
Uncalled bet (6.98) returned to gust
Player gust mucks cards
------ Summary ------
Pot: 20.94. Rake 0.86. JP fee 0.24
Board: [5s 9h Ah Jd]
Player zboiii does not show cards.Bets: 0. Collects: 0. Wins: 0.
Player ElvenEyes does not show cards.Bets: 0. Collects: 0. Wins: 0.
Player StephCurry does not show cards.Bets: 0. Collects: 0. Wins: 0.
*Player gust mucks (does not show cards). Bets: 10.27. Collects: 20.94. Wins: 10.67.
Player pineapplesand does not show cards.Bets: 0. Collects: 0. Wins: 0.
Player IlxxxlI does not show cards.Bets: 0.50. Collects: 0. Loses: 0.50.
Player dankmann does not show cards.Bets: 1. Collects: 0. Loses: 1.
Player VegetablesArentYummy does not show cards.Bets: 10.27. Collects: 0. Loses: 10.27.
Game ended at: 2016/11/29 14:29:37

Game started
Game ID: 787006146 1/2 (PRR) Lakhey (Hold'em)
Seat 2 is the button
Seat 1: VegetablesArentYummy (234.20).
Seat 2: IlxxxlI (80).
Seat 3: IbetUmuck (864.90).
Seat 4: DonCesarGrinder (269.02).
Seat 5: MadLifeGrinder (221.06).
Seat 6: LloydXmas (218.63).
Player IbetUmuck has small blind (1)
Player DonCesarGrinder has big blind (2)
Player IlxxxlI received card: [Qd]
Player IlxxxlI received card: [Ac]
Player MadLifeGrinder folds
Player LloydXmas folds
Player VegetablesArentYummy folds
Player IlxxxlI raises (6)
Player IbetUmuck folds
Player DonCesarGrinder calls (4)
*** FLOP ***: [As Qc 5s]
Player DonCesarGrinder checks
Player IlxxxlI bets (6.42)
Player DonCesarGrinder folds
Uncalled bet (6.42) returned to IlxxxlI
Player IlxxxlI mucks cards
------ Summary ------
Pot: 12.35. Rake 0.45. JP fee 0.20
Board: [As Qc 5s]
Player VegetablesArentYummy does not show cards.Bets: 0. Collects: 0. Wins: 0.
*Player IlxxxlI mucks (does not show cards). Bets: 6. Collects: 12.35. Wins: 6.35.
Player IbetUmuck does not show cards.Bets: 1. Collects: 0. Loses: 1.
Player DonCesarGrinder does not show cards.Bets: 6. Collects: 0. Loses: 6.
Player MadLifeGrinder does not show cards.Bets: 0. Collects: 0. Wins: 0.
Player LloydXmas does not show cards.Bets: 0. Collects: 0. Wins: 0.
Game ended at: 2016/11/29 14:28:33

Game started
Game ID: 787006081 0.50/1 (PRR) Kraken - 23 (Hold'em)
Seat 6 is the button
Seat 1: WeakAndWeary (100).
Seat 2: gust (46).
Seat 3: LloydXmas (130.29).
Seat 4: Sephiroth1 (100).
Seat 5: ElvenEyes (124.21).
Seat 6: IlxxxlI (43.40).
Player WeakAndWeary has small blind (0.50)
Player gust has big blind (1)
Player IlxxxlI received card: [10s]
Player IlxxxlI received card: [8c]
Player LloydXmas raises (3)
Player Sephiroth1 folds
Player ElvenEyes folds
Player IlxxxlI folds
Player WeakAndWeary folds
Player gust folds
Uncalled bet (2) returned to LloydXmas
Player LloydXmas mucks cards
------ Summary ------
Pot: 2.50. Rake 0
Player WeakAndWeary does not show cards.Bets: 0.50. Collects: 0. Loses: 0.50.
Player gust does not show cards.Bets: 1. Collects: 0. Loses: 1.
*Player LloydXmas mucks (does not show cards). Bets: 1. Collects: 2.50. Wins: 1.50.
Player Sephiroth1 does not show cards.Bets: 0. Collects: 0. Wins: 0.
Player ElvenEyes does not show cards.Bets: 0. Collects: 0. Wins: 0.
Player IlxxxlI does not show cards.Bets: 0. Collects: 0. Wins: 0.
Game ended at: 2016/11/29 14:28:25

Game started
Game ID: 787006035 0.50/1 (PRR) Kraken - 16 (Hold'em)
Seat 6 is the button
Seat 2: MadLifeGrinder (107.35).
Seat 3: Sephiroth1 (157.32).
Seat 4: Beep_Beep (123.01).
Seat 5: IlxxxlI (41.50).
Seat 6: gust (40).
Player MadLifeGrinder has small blind (0.50)
Player Sephiroth1 has big blind (1)
Player IlxxxlI received card: [3d]
Player IlxxxlI received card: [10c]
Player Beep_Beep folds
Player IlxxxlI folds
Player gust folds
Player MadLifeGrinder folds
Uncalled bet (0.50) returned to Sephiroth1
Player Sephiroth1 mucks cards
------ Summary ------
Pot: 1. Rake 0
Player MadLifeGrinder does not show cards.Bets: 0.50. Collects: 0. Loses: 0.50.
*Player Sephiroth1 mucks (does not show cards). Bets: 0.50. Collects: 1. Wins: 0.50.
Player Beep_Beep does not show cards.Bets: 0. Collects: 0. Wins: 0.
Player IlxxxlI does not show cards.Bets: 0. Collects: 0. Wins: 0.
Player gust does not show cards.Bets: 0. Collects: 0. Wins: 0.
Game ended at: 2016/11/29 14:28:10

Game started
Game ID: 787006034 1/2 (PRR) Lakhey (Hold'em)
Seat 1 is the button
Seat 1: VegetablesArentYummy (231.20).
Seat 2: IlxxxlI (80).
Seat 3: IbetUmuck (866.90).
Seat 4: DonCesarGrinder (269.02).
Seat 5: MadLifeGrinder (221.06).
Seat 6: LloydXmas (218.63).
Player IlxxxlI has small blind (1)
Player IbetUmuck has big blind (2)
Player IlxxxlI received card: [6c]
Player IlxxxlI received card: [Kd]
Player DonCesarGrinder folds
Player MadLifeGrinder folds
Player LloydXmas folds
Player VegetablesArentYummy raises (5)
Player IlxxxlI folds
Player IbetUmuck folds
Uncalled bet (3) returned to VegetablesArentYummy
Player VegetablesArentYummy mucks cards
------ Summary ------
Pot: 5. Rake 0
*Player VegetablesArentYummy mucks (does not show cards). Bets: 2. Collects: 5. Wins: 3.
Player IlxxxlI does not show cards.Bets: 1. Collects: 0. Loses: 1.
Player IbetUmuck does not show cards.Bets: 2. Collects: 0. Loses: 2.
Player DonCesarGrinder does not show cards.Bets: 0. Collects: 0. Wins: 0.
Player MadLifeGrinder does not show cards.Bets: 0. Collects: 0. Wins: 0.
Player LloydXmas does not show cards.Bets: 0. Collects: 0. Wins: 0.
Game ended at: 2016/11/29 14:27:52

Game started
Game ID: 787006007 1/2 (PRR) Longana (Short) - 2 (Hold'em)
Seat 4 is the button
Seat 1: actionjax24 (104.46).
Seat 3: VegetablesArentYummy (132.53).
Seat 4: gust (80).
Seat 5: thimk (66.02).
Seat 6: IlxxxlI (40).
Seat 7: pineapplesand (42).
Seat 8: StephCurry (109.50).
Seat 9: hotshothotgg (63.19).
Player thimk has small blind (1)
Player IlxxxlI has big blind (2)
Player IlxxxlI received card: [Kd]
Player IlxxxlI received card: [2s]
Player pineapplesand folds
Player StephCurry folds
Player hotshothotgg folds
Player actionjax24 folds
Player VegetablesArentYummy raises (5)
Player gust folds
Player thimk folds
Player IlxxxlI folds
Uncalled bet (3) returned to VegetablesArentYummy
Player VegetablesArentYummy mucks cards
------ Summary ------
Pot: 5. Rake 0
Player actionjax24 does not show cards.Bets: 0. Collects: 0. Wins: 0.
*Player VegetablesArentYummy mucks (does not show cards). Bets: 2. Collects: 5. Wins: 3.
Player gust does not show cards.Bets: 0. Collects: 0. Wins: 0.
Player thimk does not show cards.Bets: 1. Collects: 0. Loses: 1.
Player IlxxxlI does not show cards.Bets: 2. Collects: 0. Loses: 2.
Player pineapplesand does not show cards.Bets: 0. Collects: 0. Wins: 0.
Player StephCurry does not show cards.Bets: 0. Collects: 0. Wins: 0.
Player hotshothotgg does not show cards.Bets: 0. Collects: 0. Wins: 0.
Game ended at: 2016/11/29 14:28:12

Game started
Game ID: 787005990 0.50/1 (PRR) Kraken (Hold'em)
Seat 1 is the button
Seat 1: WeakAndWeary (187.61).
Seat 2: MadLifeGrinder (115.12).
Seat 3: Sephiroth1 (146.13).
Seat 4: IlxxxlI (42.23).
Seat 5: gust (40).
Seat 6: ElvenEyes (114.11).
Player MadLifeGrinder has small blind (0.50)
Player Sephiroth1 has big blind (1)
Player IlxxxlI received card: [5d]
Player IlxxxlI received card: [Qd]
Player IlxxxlI folds
Player gust folds
Player ElvenEyes folds
Player WeakAndWeary folds
Player MadLifeGrinder folds
Uncalled bet (0.50) returned to Sephiroth1
Player Sephiroth1 mucks cards
------ Summary ------
Pot: 1. Rake 0
Player WeakAndWeary does not show cards.Bets: 0. Collects: 0. Wins: 0.
Player MadLifeGrinder does not show cards.Bets: 0.50. Collects: 0. Loses: 0.50.
*Player Sephiroth1 mucks (does not show cards). Bets: 0.50. Collects: 1. Wins: 0.50.
Player IlxxxlI does not show cards.Bets: 0. Collects: 0. Wins: 0.
Player gust does not show cards.Bets: 0. Collects: 0. Wins: 0.
Player ElvenEyes does not show cards.Bets: 0. Collects: 0. Wins: 0.
Game ended at: 2016/11/29 14:28:19

Game started
Game ID: 787005986 0.25/0.50 (PRR) Gorgons - 15 (Hold'em)
Seat 6 is the button
Seat 1: WeakAndWeary (52.58).
Seat 2: IampokerKidd (106.51).
Seat 3: imger8 (41.50).
Seat 4: IlxxxlI (21.50).
Seat 5: foreseen (52.70).
Seat 6: BiGFck (13.18).
Player WeakAndWeary has small blind (0.25)
Player IampokerKidd has big blind (0.50)
Player IlxxxlI received card: [Jc]
Player IlxxxlI received card: [5h]
Player imger8 raises (1.50)
Player IlxxxlI folds
Player foreseen folds
Player BiGFck folds
Player WeakAndWeary folds
Player IampokerKidd calls (1)
*** FLOP ***: [8d Qs 4h]
Player IampokerKidd checks
Player imger8 bets (3)
Player IampokerKidd folds
Uncalled bet (3) returned to imger8
Player imger8 mucks cards
------ Summary ------
Pot: 3.09. Rake 0.12. JP fee 0.04
Board: [8d Qs 4h]
Player WeakAndWeary does not show cards.Bets: 0.25. Collects: 0. Loses: 0.25.
Player IampokerKidd does not show cards.Bets: 1.50. Collects: 0. Loses: 1.50.
*Player imger8 mucks (does not show cards). Bets: 1.50. Collects: 3.09. Wins: 1.59.
Player IlxxxlI does not show cards.Bets: 0. Collects: 0. Wins: 0.
Player foreseen does not show cards.Bets: 0. Collects: 0. Wins: 0.
Player BiGFck does not show cards.Bets: 0. Collects: 0. Wins: 0.
Game ended at: 2016/11/29 14:28:38

Game started
Game ID: 787005801 1/2 (PRR) Longana (Short) - 2 (Hold'em)
Seat 3 is the button
Seat 1: actionjax24 (104.46).
Seat 3: VegetablesArentYummy (132.53).
Seat 4: gust (80).
Seat 5: thimk (65.02).
Seat 6: IlxxxlI (40).
Seat 7: pineapplesand (42).
Seat 8: StephCurry (109.50).
Seat 9: hotshothotgg (63.19).
Player gust has small blind (1)
Player thimk has big blind (2)
Player IlxxxlI received card: [8h]
Player IlxxxlI received card: [Ac]
Player IlxxxlI folds
Player pineapplesand folds
Player StephCurry folds
Player hotshothotgg folds
Player actionjax24 folds
Player VegetablesArentYummy folds
Player gust folds
Uncalled bet (1) returned to thimk
Player thimk is timed out.
Player thimk mucks cards
------ Summary ------
Pot: 2. Rake 0
Player actionjax24 does not show cards.Bets: 0. Collects: 0. Wins: 0.
Player VegetablesArentYummy does not show cards.Bets: 0. Collects: 0. Wins: 0.
Player gust does not show cards.Bets: 1. Collects: 0. Loses: 1.
*Player thimk mucks (does not show cards). Bets: 1. Collects: 2. Wins: 1.
Player IlxxxlI does not show cards.Bets: 0. Collects: 0. Wins: 0.
Player pineapplesand does not show cards.Bets: 0. Collects: 0. Wins: 0.
Player StephCurry does not show cards.Bets: 0. Collects: 0. Wins: 0.
Player hotshothotgg does not show cards.Bets: 0. Collects: 0. Wins: 0.
Game ended at: 2016/11/29 14:27:35

Game started
Game ID: 787005767 1/2 (PRR) Lakhey (Hold'em)
Seat 6 is the button
Seat 1: VegetablesArentYummy (232.20).
Seat 2: IlxxxlI (80).
Seat 3: IbetUmuck (866.90).
Seat 4: DonCesarGrinder (269.02).
Seat 5: MadLifeGrinder (221.06).
Seat 6: LloydXmas (215.63).
Player VegetablesArentYummy has small blind (1)
Player IlxxxlI has big blind (2)
Player IlxxxlI received card: [6s]
Player IlxxxlI received card: [10h]
Player IbetUmuck folds
Player DonCesarGrinder folds
Player MadLifeGrinder folds
Player LloydXmas raises (4.50)
Player VegetablesArentYummy folds
Player IlxxxlI folds
Uncalled bet (2.50) returned to LloydXmas
Player LloydXmas mucks cards
------ Summary ------
Pot: 5. Rake 0
Player VegetablesArentYummy does not show cards.Bets: 1. Collects: 0. Loses: 1.
Player IlxxxlI does not show cards.Bets: 2. Collects: 0. Loses: 2.
Player IbetUmuck does not show cards.Bets: 0. Collects: 0. Wins: 0.
Player DonCesarGrinder does not show cards.Bets: 0. Collects: 0. Wins: 0.
Player MadLifeGrinder does not show cards.Bets: 0. Collects: 0. Wins: 0.
*Player LloydXmas mucks (does not show cards). Bets: 2. Collects: 5. Wins: 3.
Game ended at: 2016/11/29 14:27:39

Game started
Game ID: 787005738 0.50/1 (PRR) Kraken - 16 (Hold'em)
Seat 5 is the button
Seat 2: MadLifeGrinder (108.35).
Seat 3: Sephiroth1 (157.32).
Seat 4: Beep_Beep (123.01).
Seat 5: IlxxxlI (40).
Seat 6: gust (40).
Player gust has small blind (0.50)
Player MadLifeGrinder has big blind (1)
Player IlxxxlI received card: [Ah]
Player IlxxxlI received card: [As]
Player Sephiroth1 folds
Player Beep_Beep folds
Player IlxxxlI raises (3)
Player gust folds
Player MadLifeGrinder folds
Uncalled bet (2) returned to IlxxxlI
Player IlxxxlI mucks cards
------ Summary ------
Pot: 2.50. Rake 0
Player MadLifeGrinder does not show cards.Bets: 1. Collects: 0. Loses: 1.
Player Sephiroth1 does not show cards.Bets: 0. Collects: 0. Wins: 0.
Player Beep_Beep does not show cards.Bets: 0. Collects: 0. Wins: 0.
*Player IlxxxlI mucks (does not show cards). Bets: 1. Collects: 2.50. Wins: 1.50.
Player gust does not show cards.Bets: 0.50. Collects: 0. Loses: 0.50.
Game ended at: 2016/11/29 14:27:39

Game started
Game ID: 787005653 0.50/1 (PRR) Karkadann - 3 (Hold'em)
Seat 4 is the button
Seat 1: zboiii (121.12).
Seat 2: ElvenEyes (158.30).
Seat 3: StephCurry (100).
Seat 4: gust (40).
Seat 5: pineapplesand (49.46).
Seat 7: IlxxxlI (43.50).
Seat 8: dankmann (162.01).
Seat 9: VegetablesArentYummy (264.67).
Player pineapplesand has small blind (0.50)
Player IlxxxlI has big blind (1)
Player IlxxxlI received card: [10h]
Player IlxxxlI received card: [Qd]
Player dankmann folds
Player VegetablesArentYummy folds
Player zboiii folds
Player ElvenEyes folds
Player StephCurry folds
Player gust raises (2)
Player pineapplesand folds
Player IlxxxlI calls (1)
*** FLOP ***: [6s 3s 8h]
Player IlxxxlI checks
Player gust bets (2.14)
Player IlxxxlI folds
Uncalled bet (2.14) returned to gust
Player gust mucks cards
------ Summary ------
Pot: 4.28. Rake 0.16. JP fee 0.06
Board: [6s 3s 8h]
Player zboiii does not show cards.Bets: 0. Collects: 0. Wins: 0.
Player ElvenEyes does not show cards.Bets: 0. Collects: 0. Wins: 0.
Player StephCurry does not show cards.Bets: 0. Collects: 0. Wins: 0.
*Player gust mucks (does not show cards). Bets: 2. Collects: 4.28. Wins: 2.28.
Player pineapplesand does not show cards.Bets: 0.50. Collects: 0. Loses: 0.50.
Player IlxxxlI does not show cards.Bets: 2. Collects: 0. Loses: 2.
Player dankmann does not show cards.Bets: 0. Collects: 0. Wins: 0.
Player VegetablesArentYummy does not show cards.Bets: 0. Collects: 0. Wins: 0.
Game ended at: 2016/11/29 14:28:2

Game started
Game ID: 787005581 0.25/0.50 (PRR) Gorgons - 15 (Hold'em)
Seat 5 is the button
Seat 1: WeakAndWeary (53.08).
Seat 2: IampokerKidd (106.51).
Seat 3: imger8 (40.75).
Seat 4: IlxxxlI (21.50).
Seat 5: foreseen (52.70).
Seat 6: BiGFck (13.43).
Player BiGFck has small blind (0.25)
Player WeakAndWeary has big blind (0.50)
Player IlxxxlI received card: [3h]
Player IlxxxlI received card: [7h]
Player IampokerKidd folds
Player imger8 raises (1.50)
Player IlxxxlI folds
Player foreseen folds
Player BiGFck folds
Player WeakAndWeary folds
Uncalled bet (1) returned to imger8
Player imger8 mucks cards
------ Summary ------
Pot: 1.25. Rake 0
Player WeakAndWeary does not show cards.Bets: 0.50. Collects: 0. Loses: 0.50.
Player IampokerKidd does not show cards.Bets: 0. Collects: 0. Wins: 0.
*Player imger8 mucks (does not show cards). Bets: 0.50. Collects: 1.25. Wins: 0.75.
Player IlxxxlI does not show cards.Bets: 0. Collects: 0. Wins: 0.
Player foreseen does not show cards.Bets: 0. Collects: 0. Wins: 0.
Player BiGFck does not show cards.Bets: 0.25. Collects: 0. Loses: 0.25.
Game ended at: 2016/11/29 14:27:31

Game started
Game ID: 787005572 1/2 (PRR) Lakhey (Hold'em)
Seat 5 is the button
Seat 1: VegetablesArentYummy (231.20).
Seat 2: IlxxxlI (80).
Seat 3: IbetUmuck (866.90).
Seat 4: DonCesarGrinder (269.02).
Seat 5: MadLifeGrinder (221.06).
Seat 6: LloydXmas (216.63).
Player LloydXmas has small blind (1)
Player VegetablesArentYummy has big blind (2)
Player IlxxxlI received card: [Qc]
Player IlxxxlI received card: [10h]
Player IlxxxlI folds
Player IbetUmuck folds
Player DonCesarGrinder folds
Player MadLifeGrinder folds
Player LloydXmas folds
Uncalled bet (1) returned to VegetablesArentYummy
Player VegetablesArentYummy mucks cards
------ Summary ------
Pot: 2. Rake 0
*Player VegetablesArentYummy mucks (does not show cards). Bets: 1. Collects: 2. Wins: 1.
Player IlxxxlI does not show cards.Bets: 0. Collects: 0. Wins: 0.
Player IbetUmuck does not show cards.Bets: 0. Collects: 0. Wins: 0.
Player DonCesarGrinder does not show cards.Bets: 0. Collects: 0. Wins: 0.
Player MadLifeGrinder does not show cards.Bets: 0. Collects: 0. Wins: 0.
Player LloydXmas does not show cards.Bets: 1. Collects: 0. Loses: 1.
Game ended at: 2016/11/29 14:27:2

Game started
Game ID: 787005539 0.50/1 (PRR) Kraken - 23 (Hold'em)
Seat 5 is the button
Seat 1: WeakAndWeary (100.40).
Seat 2: gust (46).
Seat 3: LloydXmas (130.29).
Seat 4: Sephiroth1 (100).
Seat 5: ElvenEyes (121.03).
Seat 6: IlxxxlI (43.90).
Player IlxxxlI has small blind (0.50)
Player WeakAndWeary has big blind (1)
Player IlxxxlI received card: [2d]
Player IlxxxlI received card: [10s]
Player gust folds
Player LloydXmas folds
Player Sephiroth1 folds
Player ElvenEyes raises (3)
Player IlxxxlI folds
Player WeakAndWeary calls (2)
*** FLOP ***: [Qd Ac 5d]
Player WeakAndWeary checks
Player ElvenEyes checks
*** TURN ***: [Qd Ac 5d] [As]
Player WeakAndWeary checks
Player ElvenEyes bets (5)
Player WeakAndWeary folds
Uncalled bet (5) returned to ElvenEyes
Player ElvenEyes mucks cards
------ Summary ------
Pot: 6.18. Rake 0.22. JP fee 0.10
Board: [Qd Ac 5d As]
Player WeakAndWeary does not show cards.Bets: 3. Collects: 0. Loses: 3.
Player gust does not show cards.Bets: 0. Collects: 0. Wins: 0.
Player LloydXmas does not show cards.Bets: 0. Collects: 0. Wins: 0.
Player Sephiroth1 does not show cards.Bets: 0. Collects: 0. Wins: 0.
*Player ElvenEyes mucks (does not show cards). Bets: 3. Collects: 6.18. Wins: 3.18.
Player IlxxxlI does not show cards.Bets: 0.50. Collects: 0. Loses: 0.50.
Game ended at: 2016/11/29 14:27:43

Game started
Game ID: 787005502 0.50/1 (PRR) Kraken - 16 (Hold'em)
Seat 4 is the button
Seat 2: MadLifeGrinder (108.35).
Seat 3: Sephiroth1 (157.32).
Seat 4: Beep_Beep (121.51).
Seat 5: IlxxxlI (40).
Seat 6: gust (40).
Player IlxxxlI has small blind (0.50)
Player gust has big blind (1)
Player IlxxxlI received card: [Qd]
Player IlxxxlI received card: [3c]
Player MadLifeGrinder folds
Player Sephiroth1 folds
Player Beep_Beep raises (3)
Player IlxxxlI folds
Player gust folds
Uncalled bet (2) returned to Beep_Beep
Player Beep_Beep mucks cards
------ Summary ------
Pot: 2.50. Rake 0
Player MadLifeGrinder does not show cards.Bets: 0. Collects: 0. Wins: 0.
Player Sephiroth1 does not show cards.Bets: 0. Collects: 0. Wins: 0.
*Player Beep_Beep mucks (does not show cards). Bets: 1. Collects: 2.50. Wins: 1.50.
Player IlxxxlI does not show cards.Bets: 0.50. Collects: 0. Loses: 0.50.
Player gust does not show cards.Bets: 1. Collects: 0. Loses: 1.
Game ended at: 2016/11/29 14:26:58

Game started
Game ID: 787005258 0.25/0.50 (PRR) Gorgons - 8 (Hold'em)
Seat 3 is the button
Seat 3: foreseen (66.64).
Seat 4: IlxxxlI (22.57).
Seat 5: Beep_Beep (100.82).
Seat 6: Jui Kuen (61.37).
Player IlxxxlI has small blind (0.25)
Player Beep_Beep has big blind (0.50)
Player Jui Kuen straddle (1)
Player IlxxxlI received card: [Kd]
Player IlxxxlI received card: [10h]
Player foreseen raises (3)
Player IlxxxlI folds
Player Beep_Beep folds
Player Jui Kuen folds
Uncalled bet (2) returned to foreseen
Player foreseen mucks cards
------ Summary ------
Pot: 2.75. Rake 0
*Player foreseen mucks (does not show cards). Bets: 1. Collects: 2.75. Wins: 1.75.
Player IlxxxlI does not show cards.Bets: 0.25. Collects: 0. Loses: 0.25.
Player Beep_Beep does not show cards.Bets: 0.50. Collects: 0. Loses: 0.50.
Player Jui Kuen does not show cards.Bets: 1. Collects: 0. Loses: 1.
Game ended at: 2016/11/29 14:26:27

Game started
Game ID: 787005238 0.25/0.50 (PRR) Gorgons - 15 (Hold'em)
Seat 4 is the button
Seat 1: WeakAndWeary (53.08).
Seat 2: IampokerKidd (106.51).
Seat 3: imger8 (40).
Seat 4: IlxxxlI (21.50).
Seat 5: foreseen (52.95).
Seat 6: BiGFck (13.93).
Player foreseen has small blind (0.25)
Player BiGFck has big blind (0.50)
Player IlxxxlI received card: [2d]
Player IlxxxlI received card: [4h]
Player WeakAndWeary folds
Player IampokerKidd folds
Player imger8 raises (1.50)
Player IlxxxlI folds
Player foreseen folds
Player BiGFck folds
Uncalled bet (1) returned to imger8
Player imger8 mucks cards
------ Summary ------
Pot: 1.25. Rake 0
Player WeakAndWeary does not show cards.Bets: 0. Collects: 0. Wins: 0.
Player IampokerKidd does not show cards.Bets: 0. Collects: 0. Wins: 0.
*Player imger8 mucks (does not show cards). Bets: 0.50. Collects: 1.25. Wins: 0.75.
Player IlxxxlI does not show cards.Bets: 0. Collects: 0. Wins: 0.
Player foreseen does not show cards.Bets: 0.25. Collects: 0. Loses: 0.25.
Player BiGFck does not show cards.Bets: 0.50. Collects: 0. Loses: 0.50.
Game ended at: 2016/11/29 14:26:40

Game started
Game ID: 787005190 0.50/1 (PRR) Kraken (Hold'em)
Seat 6 is the button
Seat 1: WeakAndWeary (204.41).
Seat 2: MadLifeGrinder (100).
Seat 3: Sephiroth1 (146.13).
Seat 4: IlxxxlI (42.23).
Seat 5: gust (40).
Seat 6: ElvenEyes (114.11).
Player WeakAndWeary has small blind (0.50)
Player MadLifeGrinder has big blind (1)
Player IlxxxlI received card: [Js]
Player IlxxxlI received card: [3s]
Player Sephiroth1 folds
Player IlxxxlI folds
Player gust folds
Player ElvenEyes folds
Player WeakAndWeary raises (2.50)
Player MadLifeGrinder calls (2)
*** FLOP ***: [4c Kd Qh]
Player WeakAndWeary checks
Player MadLifeGrinder checks
*** TURN ***: [4c Kd Qh] [3c]
Player WeakAndWeary checks
Player MadLifeGrinder bets (3.80)
Player WeakAndWeary calls (3.80)
*** RIVER ***: [4c Kd Qh 3c] [3d]
Player WeakAndWeary checks
Player MadLifeGrinder bets (10)
Player WeakAndWeary calls (10)
Player WeakAndWeary mucks cards
------ Summary ------
Pot: 31.92. Rake 1.44. JP fee 0.24
Board: [4c Kd Qh 3c 3d]
Player WeakAndWeary mucks (does not show cards). Bets: 16.80. Collects: 0. Loses: 16.80.
*Player MadLifeGrinder shows: Two pairs. Ks and 3s [Ks 8d]. Bets: 16.80. Collects: 31.92. Wins: 15.12.
Player Sephiroth1 does not show cards.Bets: 0. Collects: 0. Wins: 0.
Player IlxxxlI does not show cards.Bets: 0. Collects: 0. Wins: 0.
Player gust does not show cards.Bets: 0. Collects: 0. Wins: 0.
Player ElvenEyes does not show cards.Bets: 0. Collects: 0. Wins: 0.
Game ended at: 2016/11/29 14:27:30

Game started
Game ID: 787005155 0.50/1 (PRR) Kraken - 16 (Hold'em)
Seat 3 is the button
Seat 2: MadLifeGrinder (108.35).
Seat 3: Sephiroth1 (118.32).
Seat 4: Beep_Beep (122.01).
Seat 5: IlxxxlI (41.50).
Seat 6: gust (40).
Player Beep_Beep has small blind (0.50)
Player IlxxxlI has big blind (1)
Player IlxxxlI received card: [9c]
Player IlxxxlI received card: [6c]
Player gust folds
Player MadLifeGrinder folds
Player Sephiroth1 raises (3)
Player Beep_Beep folds
Player IlxxxlI calls (2)
*** FLOP ***: [7c 10c 3d]
Player IlxxxlI checks
Player Sephiroth1 bets (4.12)
Player IlxxxlI raises (10)
Player Sephiroth1 allin (111.20)
Player IlxxxlI allin (28.50)
Uncalled bet (76.82) returned to Sephiroth1
*** TURN ***: [7c 10c 3d] [Jh]
*** RIVER ***: [7c 10c 3d Jh] [3c]
------ Summary ------
Pot: 80.50. Rake 2.76. JP fee 0.24
Board: [7c 10c 3d Jh 3c]
Player MadLifeGrinder does not show cards.Bets: 0. Collects: 0. Wins: 0.
*Player Sephiroth1 shows: Full House (J/3) [Jd Js]. Bets: 41.50. Collects: 80.50. Wins: 39.
Player Beep_Beep does not show cards.Bets: 0.50. Collects: 0. Loses: 0.50.
Player IlxxxlI shows: Flush, 10 high [9c 6c]. Bets: 41.50. Collects: 0. Loses: 41.50.
Player gust does not show cards.Bets: 0. Collects: 0. Wins: 0.
Game ended at: 2016/11/29 14:26:27

Game started
Game ID: 787005049 0.50/1 (PRR) Karkadann - 3 (Hold'em)
Seat 3 is the button
Seat 1: zboiii (121.12).
Seat 2: ElvenEyes (148.86).
Seat 3: StephCurry (104.18).
Seat 4: gust (40.50).
Seat 5: pineapplesand (50.46).
Seat 7: IlxxxlI (43.50).
Seat 8: dankmann (162.01).
Seat 9: VegetablesArentYummy (264.67).
Player gust has small blind (0.50)
Player pineapplesand has big blind (1)
Player IlxxxlI received card: [Qd]
Player IlxxxlI received card: [10h]
Player IlxxxlI folds
Player dankmann folds
Player VegetablesArentYummy folds
Player zboiii folds
Player ElvenEyes raises (2.58)
Player StephCurry raises (8.90)
Player gust folds
Player pineapplesand folds
Player ElvenEyes calls (6.32)
*** FLOP ***: [Js Qh 2d]
Player ElvenEyes checks
Player StephCurry checks
*** TURN ***: [Js Qh 2d] [8c]
Player ElvenEyes checks
Player StephCurry checks
*** RIVER ***: [Js Qh 2d 8c] [5c]
Player ElvenEyes checks
Player StephCurry checks
Player StephCurry mucks cards
------ Summary ------
Pot: 18.34. Rake 0.72. JP fee 0.24
Board: [Js Qh 2d 8c 5c]
Player zboiii does not show cards.Bets: 0. Collects: 0. Wins: 0.
*Player ElvenEyes shows: One pair of Js [Kd Jd]. Bets: 8.90. Collects: 18.34. Wins: 9.44.
Player StephCurry mucks (does not show cards). Bets: 8.90. Collects: 0. Loses: 8.90.
Player gust does not show cards.Bets: 0.50. Collects: 0. Loses: 0.50.
Player pineapplesand does not show cards.Bets: 1. Collects: 0. Loses: 1.
Player IlxxxlI does not show cards.Bets: 0. Collects: 0. Wins: 0.
Player dankmann does not show cards.Bets: 0. Collects: 0. Wins: 0.
Player VegetablesArentYummy does not show cards.Bets: 0. Collects: 0. Wins: 0.
Game ended at: 2016/11/29 14:26:45

Game started
Game ID: 787005047 0.50/1 (PRR) Kraken - 16 (Hold'em)
Seat 2 is the button
Seat 2: MadLifeGrinder (108.35).
Seat 3: Sephiroth1 (118.82).
Seat 4: Beep_Beep (121.51).
Seat 5: IlxxxlI (41.50).
Seat 6: gust (40).
Player Sephiroth1 has small blind (0.50)
Player Beep_Beep has big blind (1)
Player IlxxxlI received card: [9d]
Player IlxxxlI received card: [Ac]
Player IlxxxlI folds
Player gust folds
Player MadLifeGrinder folds
Player Sephiroth1 folds
Uncalled bet (0.50) returned to Beep_Beep
Player Beep_Beep mucks cards
------ Summary ------
Pot: 1. Rake 0
Player MadLifeGrinder does not show cards.Bets: 0. Collects: 0. Wins: 0.
Player Sephiroth1 does not show cards.Bets: 0.50. Collects: 0. Loses: 0.50.
*Player Beep_Beep mucks (does not show cards). Bets: 0.50. Collects: 1. Wins: 0.50.
Player IlxxxlI does not show cards.Bets: 0. Collects: 0. Wins: 0.
Player gust does not show cards.Bets: 0. Collects: 0. Wins: 0.
Game ended at: 2016/11/29 14:25:37

Game started
Game ID: 787005025 0.25/0.50 (PRR) Gorgons - 15 (Hold'em)
Seat 3 is the button
Seat 1: WeakAndWeary (53.08).
Seat 2: IampokerKidd (106.51).
Seat 3: imger8 (40).
Seat 4: IlxxxlI (21.75).
Seat 5: foreseen (52.70).
Seat 6: BiGFck (13.93).
Player IlxxxlI has small blind (0.25)
Player foreseen has big blind (0.50)
Player IlxxxlI received card: [10d]
Player IlxxxlI received card: [4c]
Player BiGFck folds
Player WeakAndWeary folds
Player IampokerKidd folds
Player imger8 folds
Player IlxxxlI folds
Uncalled bet (0.25) returned to foreseen
Player foreseen mucks cards
------ Summary ------
Pot: 0.50. Rake 0
Player WeakAndWeary does not show cards.Bets: 0. Collects: 0. Wins: 0.
Player IampokerKidd does not show cards.Bets: 0. Collects: 0. Wins: 0.
Player imger8 does not show cards.Bets: 0. Collects: 0. Wins: 0.
Player IlxxxlI does not show cards.Bets: 0.25. Collects: 0. Loses: 0.25.
*Player foreseen mucks (does not show cards). Bets: 0.25. Collects: 0.50. Wins: 0.25.
Player BiGFck does not show cards.Bets: 0. Collects: 0. Wins: 0.
Game ended at: 2016/11/29 14:25:50

Game started
Game ID: 787004994 0.50/1 (PRR) Kraken - 23 (Hold'em)
Seat 4 is the button
Seat 1: WeakAndWeary (100.40).
Seat 2: gust (46).
Seat 3: LloydXmas (130.29).
Seat 4: Sephiroth1 (100).
Seat 5: ElvenEyes (122.03).
Seat 6: IlxxxlI (43).
Player ElvenEyes has small blind (0.50)
Player IlxxxlI has big blind (1)
Player IlxxxlI received card: [9h]
Player IlxxxlI received card: [Js]
Player WeakAndWeary folds
Player gust folds
Player LloydXmas folds
Player Sephiroth1 folds
Player ElvenEyes calls (0.50)
Player IlxxxlI checks
*** FLOP ***: [Ac Ad 2h]
Player ElvenEyes checks
Player IlxxxlI bets (1)
Player ElvenEyes folds
Uncalled bet (1) returned to IlxxxlI
Player IlxxxlI mucks cards
------ Summary ------
Pot: 1.90. Rake 0.08. JP fee 0.02
Board: [Ac Ad 2h]
Player WeakAndWeary does not show cards.Bets: 0. Collects: 0. Wins: 0.
Player gust does not show cards.Bets: 0. Collects: 0. Wins: 0.
Player LloydXmas does not show cards.Bets: 0. Collects: 0. Wins: 0.
Player Sephiroth1 does not show cards.Bets: 0. Collects: 0. Wins: 0.
Player ElvenEyes does not show cards.Bets: 1. Collects: 0. Loses: 1.
*Player IlxxxlI mucks (does not show cards). Bets: 1. Collects: 1.90. Wins: 0.90.
Game ended at: 2016/11/29 14:26:32

Game started
Game ID: 787004970 1/2 (PRR) Longana (Short) - 2 (Hold'em)
Seat 1 is the button
Seat 1: actionjax24 (92.51).
Seat 3: VegetablesArentYummy (133.53).
Seat 4: gust (80).
Seat 5: thimk (67.02).
Seat 6: IlxxxlI (40).
Seat 7: pineapplesand (42).
Seat 8: StephCurry (109.50).
Seat 9: hotshothotgg (71.19).
Player VegetablesArentYummy has small blind (1)
Player gust has big blind (2)
Player IlxxxlI received card: [10c]
Player IlxxxlI received card: [Ks]
Player thimk calls (2)
Player IlxxxlI folds
Player pineapplesand folds
Player StephCurry folds
Player hotshothotgg calls (2)
Player actionjax24 calls (2)
Player VegetablesArentYummy folds
Player gust checks
*** FLOP ***: [4h 9c 2h]
Player gust checks
Player thimk checks
Player hotshothotgg checks
Player actionjax24 bets (6)
Player gust folds
Player thimk folds
Player hotshothotgg calls (6)
*** TURN ***: [4h 9c 2h] [2d]
Player hotshothotgg checks
Player actionjax24 bets (11)
Player hotshothotgg folds
Uncalled bet (11) returned to actionjax24
Player actionjax24 mucks cards
------ Summary ------
Pot: 19.95. Rake 0.81. JP fee 0.24
Board: [4h 9c 2h 2d]
*Player actionjax24 mucks (does not show cards). Bets: 8. Collects: 19.95. Wins: 11.95.
Player VegetablesArentYummy does not show cards.Bets: 1. Collects: 0. Loses: 1.
Player gust does not show cards.Bets: 2. Collects: 0. Loses: 2.
Player thimk does not show cards.Bets: 2. Collects: 0. Loses: 2.
Player IlxxxlI does not show cards.Bets: 0. Collects: 0. Wins: 0.
Player pineapplesand does not show cards.Bets: 0. Collects: 0. Wins: 0.
Player StephCurry does not show cards.Bets: 0. Collects: 0. Wins: 0.
Player hotshothotgg does not show cards.Bets: 8. Collects: 0. Loses: 8.
Game ended at: 2016/11/29 14:27:7

Game started
Game ID: 787004839 0.50/1 (PRR) Kraken - 23 (Hold'em)
Seat 3 is the button
Seat 1: WeakAndWeary (100.40).
Seat 2: gust (46).
Seat 3: LloydXmas (130.29).
Seat 4: Sephiroth1 (100).
Seat 5: ElvenEyes (123.03).
Seat 6: IlxxxlI (41.50).
Player Sephiroth1 has small blind (0.50)
Player ElvenEyes has big blind (1)
Player IlxxxlI received card: [Qh]
Player IlxxxlI received card: [Jh]
Player IlxxxlI raises (3.50)
Player WeakAndWeary folds
Player gust folds
Player LloydXmas folds
Player Sephiroth1 folds
Player ElvenEyes folds
Uncalled bet (2.50) returned to IlxxxlI
Player IlxxxlI mucks cards
------ Summary ------
Pot: 2.50. Rake 0
Player WeakAndWeary does not show cards.Bets: 0. Collects: 0. Wins: 0.
Player gust does not show cards.Bets: 0. Collects: 0. Wins: 0.
Player LloydXmas does not show cards.Bets: 0. Collects: 0. Wins: 0.
Player Sephiroth1 does not show cards.Bets: 0.50. Collects: 0. Loses: 0.50.
Player ElvenEyes does not show cards.Bets: 1. Collects: 0. Loses: 1.
*Player IlxxxlI mucks (does not show cards). Bets: 1. Collects: 2.50. Wins: 1.50.
Game ended at: 2016/11/29 14:25:15

Game started
Game ID: 787004756 1/2 (PRR) Lakhey (Hold'em)
Seat 4 is the button
Seat 1: VegetablesArentYummy (231.20).
Seat 2: IlxxxlI (80).
Seat 3: IbetUmuck (866.90).
Seat 4: DonCesarGrinder (269.02).
Seat 5: MadLifeGrinder (200).
Seat 6: LloydXmas (240.03).
Player MadLifeGrinder has small blind (1)
Player LloydXmas has big blind (2)
Player IlxxxlI received card: [3s]
Player IlxxxlI received card: [4s]
Player VegetablesArentYummy folds
Player IlxxxlI folds
Player IbetUmuck folds
Player DonCesarGrinder folds
Player MadLifeGrinder raises (5)
Player LloydXmas calls (4)
*** FLOP ***: [4h Kd 5s]
Player MadLifeGrinder bets (5.70)
Player LloydXmas raises (17.40)
Player MadLifeGrinder calls (11.70)
*** TURN ***: [4h Kd 5s] [6s]
Player MadLifeGrinder checks
Player LloydXmas checks
*** RIVER ***: [4h Kd 5s 6s] [Qc]
Player MadLifeGrinder bets (22.23)
Player LloydXmas folds
Uncalled bet (22.23) returned to MadLifeGrinder
Player MadLifeGrinder mucks cards
------ Summary ------
Pot: 44.46. Rake 2.10. JP fee 0.24
Board: [4h Kd 5s 6s Qc]
Player VegetablesArentYummy does not show cards.Bets: 0. Collects: 0. Wins: 0.
Player IlxxxlI does not show cards.Bets: 0. Collects: 0. Wins: 0.
Player IbetUmuck does not show cards.Bets: 0. Collects: 0. Wins: 0.
Player DonCesarGrinder does not show cards.Bets: 0. Collects: 0. Wins: 0.
*Player MadLifeGrinder mucks (does not show cards). Bets: 23.40. Collects: 44.46. Wins: 21.06.
Player LloydXmas does not show cards.Bets: 23.40. Collects: 0. Loses: 23.40.
Game ended at: 2016/11/29 14:26:38

Game started
Game ID: 787004753 0.50/1 (PRR) Kraken - 16 (Hold'em)
Seat 6 is the button
Seat 2: MadLifeGrinder (107.35).
Seat 3: Sephiroth1 (119.82).
Seat 4: Beep_Beep (121.51).
Seat 5: IlxxxlI (41.50).
Seat 6: gust (40).
Player MadLifeGrinder has small blind (0.50)
Player Sephiroth1 has big blind (1)
Player IlxxxlI received card: [3c]
Player IlxxxlI received card: [Jh]
Player Beep_Beep folds
Player IlxxxlI folds
Player gust folds
Player MadLifeGrinder raises (2.50)
Player Sephiroth1 folds
Uncalled bet (2) returned to MadLifeGrinder
Player MadLifeGrinder mucks cards
------ Summary ------
Pot: 2. Rake 0
*Player MadLifeGrinder mucks (does not show cards). Bets: 1. Collects: 2. Wins: 1.
Player Sephiroth1 does not show cards.Bets: 1. Collects: 0. Loses: 1.
Player Beep_Beep does not show cards.Bets: 0. Collects: 0. Wins: 0.
Player IlxxxlI does not show cards.Bets: 0. Collects: 0. Wins: 0.
Player gust does not show cards.Bets: 0. Collects: 0. Wins: 0.
Game ended at: 2016/11/29 14:25:23

Game started
Game ID: 787004740 0.25/0.50 (PRR) Gorgons - 8 (Hold'em)
Seat 6 is the button
Seat 3: foreseen (66.89).
Seat 4: IlxxxlI (20.15).
Seat 5: Beep_Beep (100.82).
Seat 6: Jui Kuen (63.79).
Player foreseen has small blind (0.25)
Player IlxxxlI has big blind (0.50)
Player IlxxxlI received card: [Js]
Player IlxxxlI received card: [Ks]
Player Beep_Beep folds
Player Jui Kuen raises (1)
Player foreseen folds
Player IlxxxlI calls (0.50)
*** FLOP ***: [Qd 6h Qs]
Player IlxxxlI checks
Player Jui Kuen bets (1.42)
Player IlxxxlI raises (3.50)
Player Jui Kuen folds
Uncalled bet (2.08) returned to IlxxxlI
Player IlxxxlI mucks cards
------ Summary ------
Pot: 4.84. Rake 0.17. JP fee 0.08
Board: [Qd 6h Qs]
Player foreseen does not show cards.Bets: 0.25. Collects: 0. Loses: 0.25.
*Player IlxxxlI mucks (does not show cards). Bets: 2.42. Collects: 4.84. Wins: 2.42.
Player Beep_Beep does not show cards.Bets: 0. Collects: 0. Wins: 0.
Player Jui Kuen does not show cards.Bets: 2.42. Collects: 0. Loses: 2.42.
Game ended at: 2016/11/29 14:25:54

Game started
Game ID: 787004652 0.50/1 (PRR) Kraken - 23 (Hold'em)
Seat 2 is the button
Seat 1: WeakAndWeary (100.40).
Seat 2: gust (46).
Seat 3: LloydXmas (130.79).
Seat 4: Sephiroth1 (100).
Seat 5: ElvenEyes (121.53).
Seat 6: IlxxxlI (41.50).
Player LloydXmas has small blind (0.50)
Player Sephiroth1 has big blind (1)
Player IlxxxlI received card: [7c]
Player IlxxxlI received card: [Jd]
Player ElvenEyes raises (2)
Player IlxxxlI folds
Player WeakAndWeary folds
Player gust folds
Player LloydXmas folds
Player Sephiroth1 folds
Uncalled bet (1) returned to ElvenEyes
Player ElvenEyes mucks cards
------ Summary ------
Pot: 2.50. Rake 0
Player WeakAndWeary does not show cards.Bets: 0. Collects: 0. Wins: 0.
Player gust does not show cards.Bets: 0. Collects: 0. Wins: 0.
Player LloydXmas does not show cards.Bets: 0.50. Collects: 0. Loses: 0.50.
Player Sephiroth1 does not show cards.Bets: 1. Collects: 0. Loses: 1.
*Player ElvenEyes mucks (does not show cards). Bets: 1. Collects: 2.50. Wins: 1.50.
Player IlxxxlI does not show cards.Bets: 0. Collects: 0. Wins: 0.
Game ended at: 2016/11/29 14:24:53

Game started
Game ID: 787004553 0.25/0.50 (PRR) Gorgons - 8 (Hold'em)
Seat 5 is the button
Seat 2: Parcker (89.09).
Seat 3: foreseen (67.39).
Seat 4: IlxxxlI (20.15).
Seat 5: Beep_Beep (100.82).
Seat 6: Jui Kuen (63.29).
Player Jui Kuen has small blind (0.25)
Player Parcker sitting out
Player foreseen has big blind (0.50)
Player IlxxxlI received card: [3h]
Player IlxxxlI received card: [6h]
Player IlxxxlI folds
Player Beep_Beep folds
Player Jui Kuen raises (1.25)
Player foreseen folds
Uncalled bet (1) returned to Jui Kuen
Player Jui Kuen mucks cards
------ Summary ------
Pot: 1. Rake 0
Player Parcker does not show cards.Bets: 0. Collects: 0. Wins: 0.
Player foreseen does not show cards.Bets: 0.50. Collects: 0. Loses: 0.50.
Player IlxxxlI does not show cards.Bets: 0. Collects: 0. Wins: 0.
Player Beep_Beep does not show cards.Bets: 0. Collects: 0. Wins: 0.
*Player Jui Kuen mucks (does not show cards). Bets: 0.50. Collects: 1. Wins: 0.50.
Game ended at: 2016/11/29 14:24:41

Game started
Game ID: 787004481 0.50/1 (PRR) Karkadann - 3 (Hold'em)
Seat 2 is the button
Seat 1: zboiii (121.12).
Seat 2: ElvenEyes (144.36).
Seat 3: StephCurry (104.68).
Seat 4: gust (41.50).
Seat 5: pineapplesand (50.46).
Seat 7: IlxxxlI (43.50).
Seat 8: dankmann (165.01).
Seat 9: VegetablesArentYummy (264.67).
Player StephCurry has small blind (0.50)
Player gust has big blind (1)
Player IlxxxlI received card: [7c]
Player IlxxxlI received card: [9s]
Player pineapplesand folds
Player IlxxxlI folds
Player dankmann raises (3)
Player VegetablesArentYummy folds
Player zboiii folds
Player ElvenEyes raises (8)
Player StephCurry folds
Player gust folds
Player dankmann folds
Uncalled bet (5) returned to ElvenEyes
Player ElvenEyes mucks cards
------ Summary ------
Pot: 7.50. Rake 0
Player zboiii does not show cards.Bets: 0. Collects: 0. Wins: 0.
*Player ElvenEyes mucks (does not show cards). Bets: 3. Collects: 7.50. Wins: 4.50.
Player StephCurry does not show cards.Bets: 0.50. Collects: 0. Loses: 0.50.
Player gust does not show cards.Bets: 1. Collects: 0. Loses: 1.
Player pineapplesand does not show cards.Bets: 0. Collects: 0. Wins: 0.
Player IlxxxlI does not show cards.Bets: 0. Collects: 0. Wins: 0.
Player dankmann does not show cards.Bets: 3. Collects: 0. Loses: 3.
Player VegetablesArentYummy does not show cards.Bets: 0. Collects: 0. Wins: 0.
Game ended at: 2016/11/29 14:25:24

Game started
Game ID: 787004456 0.50/1 (PRR) Kraken - 16 (Hold'em)
Seat 5 is the button
Seat 1: GagaPoker (100).
Seat 2: MadLifeGrinder (108.35).
Seat 3: Sephiroth1 (119.82).
Seat 4: Beep_Beep (121.51).
Seat 5: IlxxxlI (40).
Seat 6: gust (40).
Player gust has small blind (0.50)
Player GagaPoker sitting out
Player MadLifeGrinder has big blind (1)
Player IlxxxlI received card: [As]
Player IlxxxlI received card: [Jh]
Player Sephiroth1 folds
Player Beep_Beep folds
Player IlxxxlI raises (3)
Player gust folds
Player MadLifeGrinder folds
Uncalled bet (2) returned to IlxxxlI
Player IlxxxlI mucks cards
------ Summary ------
Pot: 2.50. Rake 0
Player GagaPoker does not show cards.Bets: 0. Collects: 0. Wins: 0.
Player MadLifeGrinder does not show cards.Bets: 1. Collects: 0. Loses: 1.
Player Sephiroth1 does not show cards.Bets: 0. Collects: 0. Wins: 0.
Player Beep_Beep does not show cards.Bets: 0. Collects: 0. Wins: 0.
*Player IlxxxlI mucks (does not show cards). Bets: 1. Collects: 2.50. Wins: 1.50.
Player gust does not show cards.Bets: 0.50. Collects: 0. Loses: 0.50.
Game ended at: 2016/11/29 14:24:42

Game started
Game ID: 787004361 0.25/0.50 (PRR) Gorgons - 15 (Hold'em)
Seat 2 is the button
Seat 1: WeakAndWeary (53.08).
Seat 2: IampokerKidd (106.51).
Seat 3: imger8 (43).
Seat 4: IlxxxlI (22.25).
Seat 5: foreseen (52.70).
Seat 6: BiGFck (10.75).
Player imger8 has small blind (0.25)
Player IlxxxlI has big blind (0.50)
Player IlxxxlI received card: [7c]
Player IlxxxlI received card: [10h]
Player foreseen folds
Player BiGFck raises (1)
Player WeakAndWeary folds
Player IampokerKidd folds
Player imger8 calls (0.75)
Player IlxxxlI folds
*** FLOP ***: [5c Ks 4d]
Player imger8 checks
Player BiGFck checks
*** TURN ***: [5c Ks 4d] [5d]
Player imger8 bets (2)
Player BiGFck calls (2)
*** RIVER ***: [5c Ks 4d 5d] [8d]
Player imger8 checks
Player BiGFck bets (2.06)
Player imger8 folds
Uncalled bet (2.06) returned to BiGFck
Player BiGFck mucks cards
------ Summary ------
Pot: 6.18. Rake 0.22. JP fee 0.10
Board: [5c Ks 4d 5d 8d]
Player WeakAndWeary does not show cards.Bets: 0. Collects: 0. Wins: 0.
Player IampokerKidd does not show cards.Bets: 0. Collects: 0. Wins: 0.
Player imger8 does not show cards.Bets: 3. Collects: 0. Loses: 3.
Player IlxxxlI does not show cards.Bets: 0.50. Collects: 0. Loses: 0.50.
Player foreseen does not show cards.Bets: 0. Collects: 0. Wins: 0.
*Player BiGFck mucks (does not show cards). Bets: 3. Collects: 6.18. Wins: 3.18.
Game ended at: 2016/11/29 14:25:20

Game started
Game ID: 787004204 1/2 (PRR) Lakhey (Hold'em)
Seat 3 is the button
Seat 1: VegetablesArentYummy (231.20).
Seat 2: IlxxxlI (80).
Seat 3: IbetUmuck (872.65).
Seat 4: DonCesarGrinder (261.27).
Seat 5: MadLifeGrinder (200).
Seat 6: LloydXmas (240.03).
Player DonCesarGrinder has small blind (1)
Player MadLifeGrinder has big blind (2)
Player IlxxxlI received card: [7d]
Player IlxxxlI received card: [Qc]
Player LloydXmas folds
Player VegetablesArentYummy folds
Player IlxxxlI folds
Player IbetUmuck raises (5.75)
Player DonCesarGrinder raises (17.33)
Player MadLifeGrinder folds
Player IbetUmuck folds
Uncalled bet (12.58) returned to DonCesarGrinder
Player DonCesarGrinder mucks cards
------ Summary ------
Pot: 13.50. Rake 0
Player VegetablesArentYummy does not show cards.Bets: 0. Collects: 0. Wins: 0.
Player IlxxxlI does not show cards.Bets: 0. Collects: 0. Wins: 0.
Player IbetUmuck does not show cards.Bets: 5.75. Collects: 0. Loses: 5.75.
*Player DonCesarGrinder mucks (does not show cards). Bets: 5.75. Collects: 13.50. Wins: 7.75.
Player MadLifeGrinder does not show cards.Bets: 2. Collects: 0. Loses: 2.
Player LloydXmas does not show cards.Bets: 0. Collects: 0. Wins: 0.
Game ended at: 2016/11/29 14:24:43

Game started
Game ID: 787004186 0.50/1 (PRR) Kraken (Hold'em)
Seat 5 is the button
Seat 1: WeakAndWeary (183.86).
Seat 2: MadLifeGrinder (100).
Seat 3: Sephiroth1 (146.13).
Seat 4: IlxxxlI (42.23).
Seat 5: gust (40).
Seat 6: ElvenEyes (114.61).
Player ElvenEyes has small blind (0.50)
Player WeakAndWeary has big blind (1)
Player IlxxxlI received card: [5h]
Player IlxxxlI received card: [4d]
Player MadLifeGrinder folds
Player Sephiroth1 folds
Player IlxxxlI folds
Player gust raises (2)
Player ElvenEyes folds
Player WeakAndWeary calls (1)
*** FLOP ***: [Qd 3d 2s]
Player WeakAndWeary checks
Player gust bets (2.14)
Player WeakAndWeary calls (2.14)
*** TURN ***: [Qd 3d 2s] [As]
Player WeakAndWeary checks
Player gust bets (5.56)
Player WeakAndWeary calls (5.56)
*** RIVER ***: [Qd 3d 2s As] [6h]
Player WeakAndWeary checks
Player gust bets (12.60)
Player WeakAndWeary calls (12.60)
------ Summary ------
Pot: 42.85. Rake 2.01. JP fee 0.24
Board: [Qd 3d 2s As 6h]
*Player WeakAndWeary shows: One pair of As [Ac 9h]. Bets: 22.30. Collects: 42.85. Wins: 20.55.
Player MadLifeGrinder does not show cards.Bets: 0. Collects: 0. Wins: 0.
Player Sephiroth1 does not show cards.Bets: 0. Collects: 0. Wins: 0.
Player IlxxxlI does not show cards.Bets: 0. Collects: 0. Wins: 0.
Player gust shows: High card A [Ks 10c]. Bets: 22.30. Collects: 0. Loses: 22.30.
Player ElvenEyes does not show cards.Bets: 0.50. Collects: 0. Loses: 0.50.
Game ended at: 2016/11/29 14:25:41

Game started
Game ID: 787004176 0.50/1 (PRR) Karkadann - 3 (Hold'em)
Seat 1 is the button
Seat 1: zboiii (121.12).
Seat 2: ElvenEyes (144.86).
Seat 3: StephCurry (104.18).
Seat 4: gust (41.50).
Seat 5: pineapplesand (50.46).
Seat 7: IlxxxlI (43.50).
Seat 8: dankmann (165.01).
Seat 9: VegetablesArentYummy (264.67).
Player ElvenEyes has small blind (0.50)
Player StephCurry has big blind (1)
Player IlxxxlI received card: [Kh]
Player IlxxxlI received card: [6c]
Player gust folds
Player pineapplesand folds
Player IlxxxlI folds
Player dankmann folds
Player VegetablesArentYummy folds
Player zboiii folds
Player ElvenEyes folds
Uncalled bet (0.50) returned to StephCurry
Player StephCurry mucks cards
------ Summary ------
Pot: 1. Rake 0
Player zboiii does not show cards.Bets: 0. Collects: 0. Wins: 0.
Player ElvenEyes does not show cards.Bets: 0.50. Collects: 0. Loses: 0.50.
*Player StephCurry mucks (does not show cards). Bets: 0.50. Collects: 1. Wins: 0.50.
Player gust does not show cards.Bets: 0. Collects: 0. Wins: 0.
Player pineapplesand does not show cards.Bets: 0. Collects: 0. Wins: 0.
Player IlxxxlI does not show cards.Bets: 0. Collects: 0. Wins: 0.
Player dankmann does not show cards.Bets: 0. Collects: 0. Wins: 0.
Player VegetablesArentYummy does not show cards.Bets: 0. Collects: 0. Wins: 0.
Game ended at: 2016/11/29 14:24:6

Game started
Game ID: 787004138 1/2 (PRR) Longana (Short) - 2 (Hold'em)
Seat 9 is the button
Seat 1: actionjax24 (106.51).
Seat 2: BiGFck (83.35).
Seat 3: VegetablesArentYummy (120.93).
Seat 4: gust (80).
Seat 5: thimk (67.02).
Seat 6: IlxxxlI (40).
Seat 7: pineapplesand (42).
Seat 8: StephCurry (109.50).
Seat 9: hotshothotgg (71.19).
Player actionjax24 has small blind (1)
Player BiGFck sitting out
Player VegetablesArentYummy has big blind (2)
Player IlxxxlI received card: [Ac]
Player IlxxxlI received card: [2h]
Player gust folds
Player thimk folds
Player IlxxxlI folds
Player pineapplesand folds
Player StephCurry folds
Player hotshothotgg folds
Player actionjax24 raises (4)
Player VegetablesArentYummy raises (12)
Player actionjax24 calls (9)
*** FLOP ***: [4s 3d 4d]
Player actionjax24 checks
Player VegetablesArentYummy bets (13.30)
Player actionjax24 folds
Uncalled bet (13.30) returned to VegetablesArentYummy
Player VegetablesArentYummy mucks cards
------ Summary ------
Pot: 26.60. Rake 1.16. JP fee 0.24
Board: [4s 3d 4d]
Player actionjax24 does not show cards.Bets: 14. Collects: 0. Loses: 14.
Player BiGFck does not show cards.Bets: 0. Collects: 0. Wins: 0.
*Player VegetablesArentYummy mucks (does not show cards). Bets: 14. Collects: 26.60. Wins: 12.60.
Player gust does not show cards.Bets: 0. Collects: 0. Wins: 0.
Player thimk does not show cards.Bets: 0. Collects: 0. Wins: 0.
Player IlxxxlI does not show cards.Bets: 0. Collects: 0. Wins: 0.
Player pineapplesand does not show cards.Bets: 0. Collects: 0. Wins: 0.
Player StephCurry does not show cards.Bets: 0. Collects: 0. Wins: 0.
Player hotshothotgg does not show cards.Bets: 0. Collects: 0. Wins: 0.
Game ended at: 2016/11/29 14:25:13

Game started
Game ID: 787004135 0.25/0.50 (PRR) Gorgons - 8 (Hold'em)
Seat 4 is the button
Seat 2: Parcker (89.09).
Seat 3: foreseen (67.39).
Seat 4: IlxxxlI (20.15).
Seat 5: Beep_Beep (101.07).
Seat 6: Jui Kuen (63.04).
Player Beep_Beep has small blind (0.25)
Player Jui Kuen has big blind (0.50)
Player IlxxxlI received card: [2d]
Player IlxxxlI received card: [9h]
Player Parcker folds
Player foreseen folds
Player IlxxxlI folds
Player Beep_Beep folds
Uncalled bet (0.25) returned to Jui Kuen
Player Jui Kuen mucks cards
------ Summary ------
Pot: 0.50. Rake 0
Player Parcker does not show cards.Bets: 0. Collects: 0. Wins: 0.
Player foreseen does not show cards.Bets: 0. Collects: 0. Wins: 0.
Player IlxxxlI does not show cards.Bets: 0. Collects: 0. Wins: 0.
Player Beep_Beep does not show cards.Bets: 0.25. Collects: 0. Loses: 0.25.
*Player Jui Kuen mucks (does not show cards). Bets: 0.25. Collects: 0.50. Wins: 0.25.
Game ended at: 2016/11/29 14:24:15

Game started
Game ID: 787004023 0.50/1 (PRR) Kraken - 23 (Hold'em)
Seat 1 is the button
Seat 1: WeakAndWeary (100.40).
Seat 2: gust (46.50).
Seat 3: LloydXmas (131.79).
Seat 4: Sephiroth1 (104.20).
Seat 5: ElvenEyes (115.95).
Seat 6: IlxxxlI (41.50).
Player gust has small blind (0.50)
Player LloydXmas has big blind (1)
Player IlxxxlI received card: [Kc]
Player IlxxxlI received card: [7s]
Player Sephiroth1 raises (2)
Player ElvenEyes calls (2)
Player IlxxxlI folds
Player WeakAndWeary folds
Player gust folds
Player LloydXmas folds
*** FLOP ***: [2d 8h 10c]
Player Sephiroth1 checks
Player ElvenEyes bets (2.61)
Player Sephiroth1 calls (2.61)
*** TURN ***: [2d 8h 10c] [8d]
Player Sephiroth1 checks
Player ElvenEyes checks
*** RIVER ***: [2d 8h 10c 8d] [6c]
Player Sephiroth1 checks
Player ElvenEyes bets (21)
Player Sephiroth1 folds
Uncalled bet (21) returned to ElvenEyes
Player ElvenEyes mucks cards
------ Summary ------
Pot: 10.19. Rake 0.37. JP fee 0.16
Board: [2d 8h 10c 8d 6c]
Player WeakAndWeary does not show cards.Bets: 0. Collects: 0. Wins: 0.
Player gust does not show cards.Bets: 0.50. Collects: 0. Loses: 0.50.
Player LloydXmas does not show cards.Bets: 1. Collects: 0. Loses: 1.
Player Sephiroth1 does not show cards.Bets: 4.61. Collects: 0. Loses: 4.61.
*Player ElvenEyes mucks (does not show cards). Bets: 4.61. Collects: 10.19. Wins: 5.58.
Player IlxxxlI does not show cards.Bets: 0. Collects: 0. Wins: 0.
Game ended at: 2016/11/29 14:24:29

Game started
Game ID: 787003937 0.50/1 (PRR) Karkadann - 3 (Hold'em)
Seat 9 is the button
Seat 1: zboiii (120.12).
Seat 2: ElvenEyes (145.86).
Seat 3: StephCurry (104.18).
Seat 4: gust (41.50).
Seat 5: pineapplesand (50.46).
Seat 7: IlxxxlI (43.50).
Seat 8: dankmann (165.01).
Seat 9: VegetablesArentYummy (264.67).
Player zboiii has small blind (0.50)
Player ElvenEyes has big blind (1)
Player IlxxxlI received card: [3h]
Player IlxxxlI received card: [10h]
Player StephCurry folds
Player gust folds
Player pineapplesand folds
Player IlxxxlI folds
Player dankmann folds
Player VegetablesArentYummy folds
Player zboiii raises (2.50)
Player ElvenEyes folds
Uncalled bet (2) returned to zboiii
Player zboiii mucks cards
------ Summary ------
Pot: 2. Rake 0
*Player zboiii mucks (does not show cards). Bets: 1. Collects: 2. Wins: 1.
Player ElvenEyes does not show cards.Bets: 1. Collects: 0. Loses: 1.
Player StephCurry does not show cards.Bets: 0. Collects: 0. Wins: 0.
Player gust does not show cards.Bets: 0. Collects: 0. Wins: 0.
Player pineapplesand does not show cards.Bets: 0. Collects: 0. Wins: 0.
Player IlxxxlI does not show cards.Bets: 0. Collects: 0. Wins: 0.
Player dankmann does not show cards.Bets: 0. Collects: 0. Wins: 0.
Player VegetablesArentYummy does not show cards.Bets: 0. Collects: 0. Wins: 0.
Game ended at: 2016/11/29 14:23:22

Game started
Game ID: 787003934 0.25/0.50 (PRR) Gorgons - 8 (Hold'em)
Seat 3 is the button
Seat 2: Parcker (88.34).
Seat 3: foreseen (67.39).
Seat 4: IlxxxlI (20.40).
Seat 5: Beep_Beep (101.57).
Seat 6: Jui Kuen (63.04).
Player IlxxxlI has small blind (0.25)
Player Beep_Beep has big blind (0.50)
Player IlxxxlI received card: [8h]
Player IlxxxlI received card: [3c]
Player Jui Kuen folds
Player Parcker raises (1.25)
Player foreseen folds
Player IlxxxlI folds
Player Beep_Beep folds
Uncalled bet (0.75) returned to Parcker
Player Parcker mucks cards
------ Summary ------
Pot: 1.25. Rake 0
*Player Parcker mucks (does not show cards). Bets: 0.50. Collects: 1.25. Wins: 0.75.
Player foreseen does not show cards.Bets: 0. Collects: 0. Wins: 0.
Player IlxxxlI does not show cards.Bets: 0.25. Collects: 0. Loses: 0.25.
Player Beep_Beep does not show cards.Bets: 0.50. Collects: 0. Loses: 0.50.
Player Jui Kuen does not show cards.Bets: 0. Collects: 0. Wins: 0.
Game ended at: 2016/11/29 14:23:17

Game started
Game ID: 787003914 0.50/1 (PRR) Kraken (Hold'em)
Seat 4 is the button
Seat 1: WeakAndWeary (183.86).
Seat 2: MadLifeGrinder (100).
Seat 3: Sephiroth1 (146.13).
Seat 4: IlxxxlI (42.23).
Seat 5: gust (40).
Seat 6: ElvenEyes (114.11).
Player gust has small blind (0.50)
Player ElvenEyes has big blind (1)
Player IlxxxlI received card: [7h]
Player IlxxxlI received card: [Qd]
Player WeakAndWeary folds
Player MadLifeGrinder folds
Player Sephiroth1 folds
Player IlxxxlI folds
Player gust folds
Uncalled bet (0.50) returned to ElvenEyes
Player ElvenEyes mucks cards
------ Summary ------
Pot: 1. Rake 0
Player WeakAndWeary does not show cards.Bets: 0. Collects: 0. Wins: 0.
Player MadLifeGrinder does not show cards.Bets: 0. Collects: 0. Wins: 0.
Player Sephiroth1 does not show cards.Bets: 0. Collects: 0. Wins: 0.
Player IlxxxlI does not show cards.Bets: 0. Collects: 0. Wins: 0.
Player gust does not show cards.Bets: 0.50. Collects: 0. Loses: 0.50.
*Player ElvenEyes mucks (does not show cards). Bets: 0.50. Collects: 1. Wins: 0.50.
Game ended at: 2016/11/29 14:23:23

Game started
Game ID: 787003907 0.25/0.50 (PRR) Gorgons - 10 (Hold'em)
Seat 1 is the button
Seat 1: WeakAndWeary (50).
Seat 2: foreseen (226.15).
Seat 3: IampokerKidd (65.12).
Seat 4: Beep_Beep (50).
Seat 5: IlxxxlI (26.73).
Seat 6: xROCKETMANx (63.54).
Player foreseen has small blind (0.25)
Player IampokerKidd has big blind (0.50)
Player IlxxxlI received card: [8h]
Player IlxxxlI received card: [2h]
Player Beep_Beep folds
Player IlxxxlI folds
Player xROCKETMANx raises (1.50)
Player WeakAndWeary folds
Player foreseen folds
Player IampokerKidd calls (1)
*** FLOP ***: [Qc 4c 10d]
Player IampokerKidd checks
Player xROCKETMANx bets (2.06)
Player IampokerKidd calls (2.06)
*** TURN ***: [Qc 4c 10d] [7s]
Player IampokerKidd checks
Player xROCKETMANx bets (4.67)
Player IampokerKidd calls (4.67)
*** RIVER ***: [Qc 4c 10d 7s] [8c]
Player IampokerKidd checks
Player xROCKETMANx checks
Player IampokerKidd mucks cards
------ Summary ------
Pot: 15.88. Rake 0.59. JP fee 0.24
Board: [Qc 4c 10d 7s 8c]
Player WeakAndWeary does not show cards.Bets: 0. Collects: 0. Wins: 0.
Player foreseen does not show cards.Bets: 0.25. Collects: 0. Loses: 0.25.
Player IampokerKidd mucks (does not show cards). Bets: 8.23. Collects: 0. Loses: 8.23.
Player Beep_Beep does not show cards.Bets: 0. Collects: 0. Wins: 0.
Player IlxxxlI does not show cards.Bets: 0. Collects: 0. Wins: 0.
*Player xROCKETMANx shows: One pair of Qs [Qs Jh]. Bets: 8.23. Collects: 15.88. Wins: 7.65.
Game ended at: 2016/11/29 14:24:34

Game started
Game ID: 787003900 0.25/0.50 (PRR) Gorgons - 15 (Hold'em)
Seat 1 is the button
Seat 1: WeakAndWeary (51.70).
Seat 2: IampokerKidd (107.51).
Seat 3: imger8 (43.50).
Seat 4: IlxxxlI (22.25).
Seat 5: foreseen (52.70).
Seat 6: BiGFck (10.75).
Player IampokerKidd has small blind (0.25)
Player imger8 has big blind (0.50)
Player IlxxxlI received card: [4c]
Player IlxxxlI received card: [7d]
Player IlxxxlI folds
Player foreseen folds
Player BiGFck folds
Player WeakAndWeary raises (1)
Player IampokerKidd calls (0.75)
Player imger8 folds
*** FLOP ***: [6d 3d 8c]
Player IampokerKidd checks
Player WeakAndWeary bets (1.79)
Player IampokerKidd folds
Uncalled bet (1.79) returned to WeakAndWeary
Player WeakAndWeary mucks cards
------ Summary ------
Pot: 2.38. Rake 0.08. JP fee 0.04
Board: [6d 3d 8c]
*Player WeakAndWeary mucks (does not show cards). Bets: 1. Collects: 2.38. Wins: 1.38.
Player IampokerKidd does not show cards.Bets: 1. Collects: 0. Loses: 1.
Player imger8 does not show cards.Bets: 0.50. Collects: 0. Loses: 0.50.
Player IlxxxlI does not show cards.Bets: 0. Collects: 0. Wins: 0.
Player foreseen does not show cards.Bets: 0. Collects: 0. Wins: 0.
Player BiGFck does not show cards.Bets: 0. Collects: 0. Wins: 0.
Game ended at: 2016/11/29 14:23:48

Game started
Game ID: 787003823 0.50/1 (PRR) Kraken - 16 (Hold'em)
Seat 4 is the button
Seat 1: GagaPoker (100).
Seat 2: MadLifeGrinder (108.35).
Seat 3: Sephiroth1 (111).
Seat 4: Beep_Beep (121.51).
Seat 5: IlxxxlI (40).
Seat 6: gust (40).
Player IlxxxlI has small blind (0.50)
Player gust has big blind (1)
Player IlxxxlI received card: [Jh]
Player IlxxxlI received card: [Kh]
Player GagaPoker folds
Player MadLifeGrinder folds
Player Sephiroth1 raises (2)
Player Beep_Beep folds
Player IlxxxlI raises (4.66)
Player gust folds
Player Sephiroth1 calls (3.16)
*** FLOP ***: [3d 3c 8h]
Player IlxxxlI bets (3.58)
Player Sephiroth1 calls (3.58)
*** TURN ***: [3d 3c 8h] [10s]
Player IlxxxlI checks
Player Sephiroth1 checks
*** RIVER ***: [3d 3c 8h 10s] [4d]
Player IlxxxlI checks
Player Sephiroth1 checks
Player IlxxxlI mucks cards
------ Summary ------
Pot: 17.56. Rake 0.68. JP fee 0.24
Board: [3d 3c 8h 10s 4d]
Player GagaPoker does not show cards.Bets: 0. Collects: 0. Wins: 0.
Player MadLifeGrinder does not show cards.Bets: 0. Collects: 0. Wins: 0.
*Player Sephiroth1 shows: Two pairs. 7s and 3s [7h 7d]. Bets: 8.74. Collects: 17.56. Wins: 8.82.
Player Beep_Beep does not show cards.Bets: 0. Collects: 0. Wins: 0.
Player IlxxxlI mucks (does not show: [Jh Kh]). Bets: 8.74. Collects: 0. Loses: 8.74.
Player gust does not show cards.Bets: 1. Collects: 0. Loses: 1.
Game ended at: 2016/11/29 14:24:0

Game started
Game ID: 787003791 0.50/1 (PRR) Kraken - 23 (Hold'em)
Seat 6 is the button
Seat 1: WeakAndWeary (100.90).
Seat 2: gust (47.50).
Seat 3: LloydXmas (131.79).
Seat 4: Sephiroth1 (104.20).
Seat 5: ElvenEyes (115.95).
Seat 6: IlxxxlI (40).
Player WeakAndWeary has small blind (0.50)
Player gust has big blind (1)
Player IlxxxlI received card: [10c]
Player IlxxxlI received card: [Qc]
Player LloydXmas folds
Player Sephiroth1 folds
Player ElvenEyes folds
Player IlxxxlI raises (3)
Player WeakAndWeary folds
Player gust folds
Uncalled bet (2) returned to IlxxxlI
Player IlxxxlI mucks cards
------ Summary ------
Pot: 2.50. Rake 0
Player WeakAndWeary does not show cards.Bets: 0.50. Collects: 0. Loses: 0.50.
Player gust does not show cards.Bets: 1. Collects: 0. Loses: 1.
Player LloydXmas does not show cards.Bets: 0. Collects: 0. Wins: 0.
Player Sephiroth1 does not show cards.Bets: 0. Collects: 0. Wins: 0.
Player ElvenEyes does not show cards.Bets: 0. Collects: 0. Wins: 0.
*Player IlxxxlI mucks (does not show cards). Bets: 1. Collects: 2.50. Wins: 1.50.
Game ended at: 2016/11/29 14:23:3

Game started
Game ID: 787003771 0.25/0.50 (PRR) Gorgons - 8 (Hold'em)
Seat 2 is the button
Seat 2: Parcker (88.34).
Seat 3: foreseen (67.64).
Seat 4: IlxxxlI (20.90).
Seat 5: Beep_Beep (100.82).
Seat 6: Jui Kuen (63.04).
Player foreseen has small blind (0.25)
Player IlxxxlI has big blind (0.50)
Player IlxxxlI received card: [Jh]
Player IlxxxlI received card: [Qs]
Player Beep_Beep raises (1.50)
Player Jui Kuen folds
Player Parcker folds
Player foreseen folds
Player IlxxxlI folds
Uncalled bet (1) returned to Beep_Beep
Player Beep_Beep mucks cards
------ Summary ------
Pot: 1.25. Rake 0
Player Parcker does not show cards.Bets: 0. Collects: 0. Wins: 0.
Player foreseen does not show cards.Bets: 0.25. Collects: 0. Loses: 0.25.
Player IlxxxlI does not show cards.Bets: 0.50. Collects: 0. Loses: 0.50.
*Player Beep_Beep mucks (does not show cards). Bets: 0.50. Collects: 1.25. Wins: 0.75.
Player Jui Kuen does not show cards.Bets: 0. Collects: 0. Wins: 0.
Game ended at: 2016/11/29 14:22:49

Game started
Game ID: 787003705 1/2 (PRR) Lakhey (Hold'em)
Seat 2 is the button
Seat 1: VegetablesArentYummy (231.20).
Seat 2: IlxxxlI (81.55).
Seat 3: IbetUmuck (873.65).
Seat 4: DonCesarGrinder (249.14).
Seat 5: MadLifeGrinder (200).
Seat 6: LloydXmas (240.03).
Player IbetUmuck has small blind (1)
Player DonCesarGrinder has big blind (2)
Player IlxxxlI received card: [9h]
Player IlxxxlI received card: [Qs]
Player MadLifeGrinder folds
Player LloydXmas folds
Player VegetablesArentYummy folds
Player IlxxxlI raises (6)
Player IbetUmuck folds
Player DonCesarGrinder calls (4)
*** FLOP ***: [Jh 5s 2h]
Player DonCesarGrinder checks
Player IlxxxlI bets (6.42)
Player DonCesarGrinder raises (17.26)
Player IlxxxlI folds
Uncalled bet (10.84) returned to DonCesarGrinder
Player DonCesarGrinder mucks cards
------ Summary ------
Pot: 24.55. Rake 1.05. JP fee 0.24
Board: [Jh 5s 2h]
Player VegetablesArentYummy does not show cards.Bets: 0. Collects: 0. Wins: 0.
Player IlxxxlI does not show cards.Bets: 12.42. Collects: 0. Loses: 12.42.
Player IbetUmuck does not show cards.Bets: 1. Collects: 0. Loses: 1.
*Player DonCesarGrinder mucks (does not show cards). Bets: 12.42. Collects: 24.55. Wins: 12.13.
Player MadLifeGrinder does not show cards.Bets: 0. Collects: 0. Wins: 0.
Player LloydXmas does not show cards.Bets: 0. Collects: 0. Wins: 0.
Game ended at: 2016/11/29 14:23:27

Game started
Game ID: 787003641 0.50/1 (PRR) Kraken - 16 (Hold'em)
Seat 3 is the button
Seat 1: GagaPoker (100).
Seat 2: MadLifeGrinder (106.85).
Seat 3: Sephiroth1 (111).
Seat 4: Beep_Beep (122.01).
Seat 5: IlxxxlI (40).
Player Beep_Beep has small blind (0.50)
Player IlxxxlI has big blind (1)
Player IlxxxlI received card: [10s]
Player IlxxxlI received card: [4c]
Player GagaPoker folds
Player MadLifeGrinder raises (2.50)
Player Sephiroth1 folds
Player Beep_Beep folds
Player IlxxxlI folds
Uncalled bet (1.50) returned to MadLifeGrinder
Player MadLifeGrinder mucks cards
------ Summary ------
Pot: 2.50. Rake 0
Player GagaPoker does not show cards.Bets: 0. Collects: 0. Wins: 0.
*Player MadLifeGrinder mucks (does not show cards). Bets: 1. Collects: 2.50. Wins: 1.50.
Player Sephiroth1 does not show cards.Bets: 0. Collects: 0. Wins: 0.
Player Beep_Beep does not show cards.Bets: 0.50. Collects: 0. Loses: 0.50.
Player IlxxxlI does not show cards.Bets: 1. Collects: 0. Loses: 1.
Game ended at: 2016/11/29 14:22:34

Game started
Game ID: 787003598 0.50/1 (PRR) Karkadann - 3 (Hold'em)
Seat 8 is the button
Seat 1: zboiii (121.12).
Seat 2: ElvenEyes (145.86).
Seat 3: StephCurry (104.18).
Seat 4: gust (40).
Seat 5: pineapplesand (50.46).
Seat 7: IlxxxlI (43.50).
Seat 8: dankmann (165.01).
Seat 9: VegetablesArentYummy (265.17).
Player VegetablesArentYummy has small blind (0.50)
Player zboiii has big blind (1)
Player IlxxxlI received card: [3d]
Player IlxxxlI received card: [4h]
Player ElvenEyes folds
Player StephCurry folds
Player gust raises (2)
Player pineapplesand folds
Player IlxxxlI folds
Player dankmann folds
Player VegetablesArentYummy folds
Player zboiii folds
Uncalled bet (1) returned to gust
Player gust mucks cards
------ Summary ------
Pot: 2.50. Rake 0
Player zboiii does not show cards.Bets: 1. Collects: 0. Loses: 1.
Player ElvenEyes does not show cards.Bets: 0. Collects: 0. Wins: 0.
Player StephCurry does not show cards.Bets: 0. Collects: 0. Wins: 0.
*Player gust mucks (does not show cards). Bets: 1. Collects: 2.50. Wins: 1.50.
Player pineapplesand does not show cards.Bets: 0. Collects: 0. Wins: 0.
Player IlxxxlI does not show cards.Bets: 0. Collects: 0. Wins: 0.
Player dankmann does not show cards.Bets: 0. Collects: 0. Wins: 0.
Player VegetablesArentYummy does not show cards.Bets: 0.50. Collects: 0. Loses: 0.50.
Game ended at: 2016/11/29 14:22:50

Game started
Game ID: 787003595 0.50/1 (PRR) Kraken (Hold'em)
Seat 3 is the button
Seat 1: WeakAndWeary (183.86).
Seat 2: MadLifeGrinder (100).
Seat 3: Sephiroth1 (144.63).
Seat 4: IlxxxlI (42.73).
Seat 5: gust (40.08).
Seat 6: ElvenEyes (114.11).
Player IlxxxlI has small blind (0.50)
Player gust has big blind (1)
Player IlxxxlI received card: [4d]
Player IlxxxlI received card: [Kh]
Player ElvenEyes folds
Player WeakAndWeary folds
Player MadLifeGrinder folds
Player Sephiroth1 raises (3)
Player IlxxxlI folds
Player gust folds
Uncalled bet (2) returned to Sephiroth1
Player Sephiroth1 mucks cards
------ Summary ------
Pot: 2.50. Rake 0
Player WeakAndWeary does not show cards.Bets: 0. Collects: 0. Wins: 0.
Player MadLifeGrinder does not show cards.Bets: 0. Collects: 0. Wins: 0.
*Player Sephiroth1 mucks (does not show cards). Bets: 1. Collects: 2.50. Wins: 1.50.
Player IlxxxlI does not show cards.Bets: 0.50. Collects: 0. Loses: 0.50.
Player gust does not show cards.Bets: 1. Collects: 0. Loses: 1.
Player ElvenEyes does not show cards.Bets: 0. Collects: 0. Wins: 0.
Game ended at: 2016/11/29 14:22:47

Game started
Game ID: 787003460 0.25/0.50 (PRR) Gorgons - 8 (Hold'em)
Seat 6 is the button
Seat 2: Parcker (86.84).
Seat 3: foreseen (68.14).
Seat 4: IlxxxlI (20.90).
Seat 5: Beep_Beep (100.82).
Seat 6: Jui Kuen (64.04).
Player Parcker has small blind (0.25)
Player foreseen has big blind (0.50)
Player IlxxxlI received card: [5d]
Player IlxxxlI received card: [Js]
Player IlxxxlI folds
Player Beep_Beep folds
Player Jui Kuen raises (1)
Player Parcker raises (3.79)
Player foreseen folds
Player Jui Kuen folds
Uncalled bet (3.04) returned to Parcker
Player Parcker mucks cards
------ Summary ------
Pot: 2.50. Rake 0
*Player Parcker mucks (does not show cards). Bets: 1. Collects: 2.50. Wins: 1.50.
Player foreseen does not show cards.Bets: 0.50. Collects: 0. Loses: 0.50.
Player IlxxxlI does not show cards.Bets: 0. Collects: 0. Wins: 0.
Player Beep_Beep does not show cards.Bets: 0. Collects: 0. Wins: 0.
Player Jui Kuen does not show cards.Bets: 1. Collects: 0. Loses: 1.
Game ended at: 2016/11/29 14:22:25

Game started
Game ID: 787003436 1/2 (PRR) Lakhey (Hold'em)
Seat 1 is the button
Seat 1: VegetablesArentYummy (231.20).
Seat 2: IlxxxlI (82.55).
Seat 3: IbetUmuck (875.65).
Seat 4: DonCesarGrinder (249.14).
Seat 5: MadLifeGrinder (203).
Seat 6: LloydXmas (232.03).
Player IlxxxlI has small blind (1)
Player IbetUmuck has big blind (2)
Player IlxxxlI received card: [3h]
Player IlxxxlI received card: [9d]
Player DonCesarGrinder folds
Player MadLifeGrinder raises (5)
Player LloydXmas raises (18)
Player VegetablesArentYummy folds
Player IlxxxlI folds
Player IbetUmuck folds
Player MadLifeGrinder folds
Uncalled bet (13) returned to LloydXmas
Player LloydXmas mucks cards
------ Summary ------
Pot: 13. Rake 0
Player VegetablesArentYummy does not show cards.Bets: 0. Collects: 0. Wins: 0.
Player IlxxxlI does not show cards.Bets: 1. Collects: 0. Loses: 1.
Player IbetUmuck does not show cards.Bets: 2. Collects: 0. Loses: 2.
Player DonCesarGrinder does not show cards.Bets: 0. Collects: 0. Wins: 0.
Player MadLifeGrinder does not show cards.Bets: 5. Collects: 0. Loses: 5.
*Player LloydXmas mucks (does not show cards). Bets: 5. Collects: 13. Wins: 8.
Game ended at: 2016/11/29 14:22:17

Game started
Game ID: 787003427 0.50/1 (PRR) Kraken - 16 (Hold'em)
Seat 2 is the button
Seat 1: GagaPoker (100).
Seat 2: MadLifeGrinder (106.85).
Seat 3: Sephiroth1 (110).
Seat 4: Beep_Beep (123.01).
Seat 5: IlxxxlI (40).
Player Sephiroth1 has small blind (0.50)
Player Beep_Beep has big blind (1)
Player IlxxxlI received card: [Qs]
Player IlxxxlI received card: [8s]
Player IlxxxlI folds
Player GagaPoker folds
Player MadLifeGrinder folds
Player Sephiroth1 raises (2.50)
Player Beep_Beep folds
Uncalled bet (2) returned to Sephiroth1
Player Sephiroth1 mucks cards
------ Summary ------
Pot: 2. Rake 0
Player GagaPoker does not show cards.Bets: 0. Collects: 0. Wins: 0.
Player MadLifeGrinder does not show cards.Bets: 0. Collects: 0. Wins: 0.
*Player Sephiroth1 mucks (does not show cards). Bets: 1. Collects: 2. Wins: 1.
Player Beep_Beep does not show cards.Bets: 1. Collects: 0. Loses: 1.
Player IlxxxlI does not show cards.Bets: 0. Collects: 0. Wins: 0.
Game ended at: 2016/11/29 14:22:7

Game started
Game ID: 787003406 0.50/1 (PRR) Kraken - 23 (Hold'em)
Seat 5 is the button
Seat 1: WeakAndWeary (101.90).
Seat 2: gust (47.50).
Seat 3: LloydXmas (131.79).
Seat 4: Sephiroth1 (102.70).
Seat 5: ElvenEyes (115.95).
Seat 6: IlxxxlI (40).
Player IlxxxlI has small blind (0.50)
Player WeakAndWeary has big blind (1)
Player IlxxxlI received card: [9c]
Player IlxxxlI received card: [8s]
Player gust folds
Player LloydXmas folds
Player Sephiroth1 raises (2)
Player ElvenEyes folds
Player IlxxxlI folds
Player WeakAndWeary folds
Uncalled bet (1) returned to Sephiroth1
Player Sephiroth1 mucks cards
------ Summary ------
Pot: 2.50. Rake 0
Player WeakAndWeary does not show cards.Bets: 1. Collects: 0. Loses: 1.
Player gust does not show cards.Bets: 0. Collects: 0. Wins: 0.
Player LloydXmas does not show cards.Bets: 0. Collects: 0. Wins: 0.
*Player Sephiroth1 mucks (does not show cards). Bets: 1. Collects: 2.50. Wins: 1.50.
Player ElvenEyes does not show cards.Bets: 0. Collects: 0. Wins: 0.
Player IlxxxlI does not show cards.Bets: 0.50. Collects: 0. Loses: 0.50.
Game ended at: 2016/11/29 14:22:28

Game started
Game ID: 787003389 1/2 (PRR) Longana (Short) - 2 (Hold'em)
Seat 8 is the button
Seat 1: actionjax24 (117.51).
Seat 2: BiGFck (83.35).
Seat 3: VegetablesArentYummy (120.93).
Seat 4: gust (80).
Seat 5: thimk (52.37).
Seat 6: IlxxxlI (40).
Seat 7: pineapplesand (42).
Seat 8: StephCurry (109.50).
Seat 9: hotshothotgg (72.19).
Player hotshothotgg has small blind (1)
Player actionjax24 has big blind (2)
Player IlxxxlI received card: [10h]
Player IlxxxlI received card: [Kc]
Player BiGFck folds
Player VegetablesArentYummy folds
Player gust raises (4)
Player thimk calls (4)
Player IlxxxlI folds
Player pineapplesand folds
Player StephCurry folds
Player hotshothotgg folds
Player actionjax24 calls (2)
*** FLOP ***: [4c 10s 9s]
Player actionjax24 checks
Player gust checks
Player thimk checks
*** TURN ***: [4c 10s 9s] [8c]
Player actionjax24 bets (7)
Player gust folds
Player thimk calls (7)
*** RIVER ***: [4c 10s 9s 8c] [4s]
Player actionjax24 checks
Player thimk bets (17.10)
Player actionjax24 folds
Uncalled bet (17.10) returned to thimk
Player thimk is timed out.
Player thimk mucks cards
------ Summary ------
Pot: 25.65. Rake 1.11. JP fee 0.24
Board: [4c 10s 9s 8c 4s]
Player actionjax24 does not show cards.Bets: 11. Collects: 0. Loses: 11.
Player BiGFck does not show cards.Bets: 0. Collects: 0. Wins: 0.
Player VegetablesArentYummy does not show cards.Bets: 0. Collects: 0. Wins: 0.
Player gust does not show cards.Bets: 4. Collects: 0. Loses: 4.
*Player thimk mucks (does not show cards). Bets: 11. Collects: 25.65. Wins: 14.65.
Player IlxxxlI does not show cards.Bets: 0. Collects: 0. Wins: 0.
Player pineapplesand does not show cards.Bets: 0. Collects: 0. Wins: 0.
Player StephCurry does not show cards.Bets: 0. Collects: 0. Wins: 0.
Player hotshothotgg does not show cards.Bets: 1. Collects: 0. Loses: 1.
Game ended at: 2016/11/29 14:23:17

Game started
Game ID: 787003360 0.25/0.50 (PRR) Gorgons - 10 (Hold'em)
Seat 6 is the button
Seat 1: WeakAndWeary (50).
Seat 2: foreseen (226.65).
Seat 3: IampokerKidd (69).
Seat 4: Beep_Beep (50).
Seat 5: IlxxxlI (22.52).
Seat 6: xROCKETMANx (63.54).
Player WeakAndWeary has small blind (0.25)
Player foreseen has big blind (0.50)
Player IlxxxlI received card: [Qc]
Player IlxxxlI received card: [Ah]
Player IampokerKidd raises (1.50)
Player Beep_Beep folds
Player IlxxxlI calls (1.50)
Player xROCKETMANx folds
Player WeakAndWeary folds
Player foreseen folds
*** FLOP ***: [Kc Jc Ac]
Player IampokerKidd bets (2.38)
Player IlxxxlI calls (2.38)
*** TURN ***: [Kc Jc Ac] [8h]
Player IampokerKidd checks
Player IlxxxlI bets (4.04)
Player IampokerKidd folds
Uncalled bet (4.04) returned to IlxxxlI
Player IlxxxlI mucks cards
------ Summary ------
Pot: 8.09. Rake 0.28. JP fee 0.14
Board: [Kc Jc Ac 8h]
Player WeakAndWeary does not show cards.Bets: 0.25. Collects: 0. Loses: 0.25.
Player foreseen does not show cards.Bets: 0.50. Collects: 0. Loses: 0.50.
Player IampokerKidd does not show cards.Bets: 3.88. Collects: 0. Loses: 3.88.
Player Beep_Beep does not show cards.Bets: 0. Collects: 0. Wins: 0.
*Player IlxxxlI mucks (does not show cards). Bets: 3.88. Collects: 8.09. Wins: 4.21.
Player xROCKETMANx does not show cards.Bets: 0. Collects: 0. Wins: 0.
Game ended at: 2016/11/29 14:22:46

Game started
Game ID: 787003361 0.25/0.50 (PRR) Gorgons - 15 (Hold'em)
Seat 6 is the button
Seat 1: WeakAndWeary (51.95).
Seat 2: IampokerKidd (99.27).
Seat 3: imger8 (52.39).
Seat 4: IlxxxlI (22.25).
Seat 5: foreseen (52.70).
Seat 6: BiGFck (10.75).
Player WeakAndWeary has small blind (0.25)
Player IampokerKidd has big blind (0.50)
Player IlxxxlI received card: [3h]
Player IlxxxlI received card: [5d]
Player imger8 raises (1.50)
Player IlxxxlI folds
Player foreseen folds
Player BiGFck folds
Player WeakAndWeary folds
Player IampokerKidd raises (4)
Player imger8 calls (3)
*** FLOP ***: [9c As Kh]
Player IampokerKidd bets (4.39)
Player imger8 calls (4.39)
*** TURN ***: [9c As Kh] [8c]
Player IampokerKidd bets (14)
Player imger8 folds
Uncalled bet (14) returned to IampokerKidd
Player IampokerKidd mucks cards
------ Summary ------
Pot: 17.13. Rake 0.66. JP fee 0.24
Board: [9c As Kh 8c]
Player WeakAndWeary does not show cards.Bets: 0.25. Collects: 0. Loses: 0.25.
*Player IampokerKidd mucks (does not show cards). Bets: 8.89. Collects: 17.13. Wins: 8.24.
Player imger8 does not show cards.Bets: 8.89. Collects: 0. Loses: 8.89.
Player IlxxxlI does not show cards.Bets: 0. Collects: 0. Wins: 0.
Player foreseen does not show cards.Bets: 0. Collects: 0. Wins: 0.
Player BiGFck does not show cards.Bets: 0. Collects: 0. Wins: 0.
Game ended at: 2016/11/29 14:22:45

Game started
Game ID: 787003283 0.50/1 (PRR) Karkadann - 3 (Hold'em)
Seat 7 is the button
Seat 1: zboiii (124.12).
Seat 2: ElvenEyes (145.86).
Seat 3: StephCurry (104.18).
Seat 4: gust (40).
Seat 5: pineapplesand (45.96).
Seat 7: IlxxxlI (43.50).
Seat 8: dankmann (165.51).
Seat 9: VegetablesArentYummy (266.17).
Player dankmann has small blind (0.50)
Player VegetablesArentYummy has big blind (1)
Player IlxxxlI received card: [4h]
Player IlxxxlI received card: [6c]
Player zboiii raises (3)
Player ElvenEyes folds
Player StephCurry folds
Player gust folds
Player pineapplesand raises (9)
Player IlxxxlI folds
Player dankmann folds
Player VegetablesArentYummy folds
Player zboiii folds
Uncalled bet (6) returned to pineapplesand
Player pineapplesand mucks cards
------ Summary ------
Pot: 7.50. Rake 0
Player zboiii does not show cards.Bets: 3. Collects: 0. Loses: 3.
Player ElvenEyes does not show cards.Bets: 0. Collects: 0. Wins: 0.
Player StephCurry does not show cards.Bets: 0. Collects: 0. Wins: 0.
Player gust does not show cards.Bets: 0. Collects: 0. Wins: 0.
*Player pineapplesand mucks (does not show cards). Bets: 3. Collects: 7.50. Wins: 4.50.
Player IlxxxlI does not show cards.Bets: 0. Collects: 0. Wins: 0.
Player dankmann does not show cards.Bets: 0.50. Collects: 0. Loses: 0.50.
Player VegetablesArentYummy does not show cards.Bets: 1. Collects: 0. Loses: 1.
Game ended at: 2016/11/29 14:22:1

Game started
Game ID: 787003198 0.25/0.50 (PRR) Gorgons - 8 (Hold'em)
Seat 5 is the button
Seat 2: Parcker (86.59).
Seat 3: foreseen (68.14).
Seat 4: IlxxxlI (20.90).
Seat 5: Beep_Beep (100.82).
Seat 6: Jui Kuen (64.29).
Player Jui Kuen has small blind (0.25)
Player Parcker has big blind (0.50)
Player IlxxxlI received card: [8s]
Player IlxxxlI received card: [3c]
Player foreseen folds
Player IlxxxlI folds
Player Beep_Beep folds
Player Jui Kuen folds
Uncalled bet (0.25) returned to Parcker
Player Parcker mucks cards
------ Summary ------
Pot: 0.50. Rake 0
*Player Parcker mucks (does not show cards). Bets: 0.25. Collects: 0.50. Wins: 0.25.
Player foreseen does not show cards.Bets: 0. Collects: 0. Wins: 0.
Player IlxxxlI does not show cards.Bets: 0. Collects: 0. Wins: 0.
Player Beep_Beep does not show cards.Bets: 0. Collects: 0. Wins: 0.
Player Jui Kuen does not show cards.Bets: 0.25. Collects: 0. Loses: 0.25.
Game ended at: 2016/11/29 14:21:45

Game started
Game ID: 787003180 0.25/0.50 (PRR) Gorgons - 15 (Hold'em)
Seat 5 is the button
Seat 1: WeakAndWeary (51.70).
Seat 2: IampokerKidd (99.27).
Seat 3: imger8 (52.39).
Seat 4: IlxxxlI (22.25).
Seat 5: foreseen (52.70).
Seat 6: BiGFck (11).
Player BiGFck has small blind (0.25)
Player WeakAndWeary has big blind (0.50)
Player IlxxxlI received card: [2c]
Player IlxxxlI received card: [6h]
Player IampokerKidd folds
Player imger8 folds
Player IlxxxlI folds
Player foreseen folds
Player BiGFck folds
Uncalled bet (0.25) returned to WeakAndWeary
Player WeakAndWeary mucks cards
------ Summary ------
Pot: 0.50. Rake 0
*Player WeakAndWeary mucks (does not show cards). Bets: 0.25. Collects: 0.50. Wins: 0.25.
Player IampokerKidd does not show cards.Bets: 0. Collects: 0. Wins: 0.
Player imger8 does not show cards.Bets: 0. Collects: 0. Wins: 0.
Player IlxxxlI does not show cards.Bets: 0. Collects: 0. Wins: 0.
Player foreseen does not show cards.Bets: 0. Collects: 0. Wins: 0.
Player BiGFck does not show cards.Bets: 0.25. Collects: 0. Loses: 0.25.
Game ended at: 2016/11/29 14:21:29

Game started
Game ID: 787003161 0.50/1 (PRR) Kraken - 16 (Hold'em)
Seat 1 is the button
Seat 1: GagaPoker (100).
Seat 2: MadLifeGrinder (107.35).
Seat 3: Sephiroth1 (111).
Seat 4: Beep_Beep (121.51).
Seat 5: IlxxxlI (40).
Player MadLifeGrinder has small blind (0.50)
Player Sephiroth1 has big blind (1)
Player IlxxxlI received card: [4d]
Player IlxxxlI received card: [6c]
Player Beep_Beep raises (3)
Player IlxxxlI folds
Player GagaPoker folds
Player MadLifeGrinder folds
Player Sephiroth1 folds
Uncalled bet (2) returned to Beep_Beep
Player Beep_Beep mucks cards
------ Summary ------
Pot: 2.50. Rake 0
Player GagaPoker does not show cards.Bets: 0. Collects: 0. Wins: 0.
Player MadLifeGrinder does not show cards.Bets: 0.50. Collects: 0. Loses: 0.50.
Player Sephiroth1 does not show cards.Bets: 1. Collects: 0. Loses: 1.
*Player Beep_Beep mucks (does not show cards). Bets: 1. Collects: 2.50. Wins: 1.50.
Player IlxxxlI does not show cards.Bets: 0. Collects: 0. Wins: 0.
Game ended at: 2016/11/29 14:21:40

Game started
Game ID: 787003155 0.50/1 (PRR) Kraken (Hold'em)
Seat 2 is the button
Seat 1: WeakAndWeary (183.86).
Seat 2: MadLifeGrinder (101.78).
Seat 3: Sephiroth1 (145.13).
Seat 4: IlxxxlI (40).
Seat 5: gust (40.08).
Seat 6: ElvenEyes (114.11).
Player Sephiroth1 has small blind (0.50)
Player IlxxxlI has big blind (1)
Player IlxxxlI received card: [8c]
Player IlxxxlI received card: [Ad]
Player gust folds
Player ElvenEyes folds
Player WeakAndWeary folds
Player MadLifeGrinder raises (2.50)
Player Sephiroth1 folds
Player IlxxxlI calls (1.50)
*** FLOP ***: [8h 6s Jd]
Player IlxxxlI checks
Player MadLifeGrinder checks
*** TURN ***: [8h 6s Jd] [5c]
Player IlxxxlI bets (3)
Player MadLifeGrinder folds
Uncalled bet (3) returned to IlxxxlI
Player IlxxxlI mucks cards
------ Summary ------
Pot: 5.23. Rake 0.19. JP fee 0.08
Board: [8h 6s Jd 5c]
Player WeakAndWeary does not show cards.Bets: 0. Collects: 0. Wins: 0.
Player MadLifeGrinder does not show cards.Bets: 2.50. Collects: 0. Loses: 2.50.
Player Sephiroth1 does not show cards.Bets: 0.50. Collects: 0. Loses: 0.50.
*Player IlxxxlI mucks (does not show cards). Bets: 2.50. Collects: 5.23. Wins: 2.73.
Player gust does not show cards.Bets: 0. Collects: 0. Wins: 0.
Player ElvenEyes does not show cards.Bets: 0. Collects: 0. Wins: 0.
Game ended at: 2016/11/29 14:22:0

Game started
Game ID: 787003109 0.50/1 (PRR) Kraken - 23 (Hold'em)
Seat 4 is the button
Seat 1: WeakAndWeary (101.90).
Seat 2: gust (47.50).
Seat 3: LloydXmas (130.29).
Seat 4: Sephiroth1 (102.70).
Seat 5: ElvenEyes (116.45).
Seat 6: IlxxxlI (40).
Player ElvenEyes has small blind (0.50)
Player IlxxxlI has big blind (1)
Player IlxxxlI received card: [Qd]
Player IlxxxlI received card: [10c]
Player WeakAndWeary folds
Player gust folds
Player LloydXmas raises (2.88)
Player Sephiroth1 folds
Player ElvenEyes folds
Player IlxxxlI folds
Uncalled bet (1.88) returned to LloydXmas
Player LloydXmas mucks cards
------ Summary ------
Pot: 2.50. Rake 0
Player WeakAndWeary does not show cards.Bets: 0. Collects: 0. Wins: 0.
Player gust does not show cards.Bets: 0. Collects: 0. Wins: 0.
*Player LloydXmas mucks (does not show cards). Bets: 1. Collects: 2.50. Wins: 1.50.
Player Sephiroth1 does not show cards.Bets: 0. Collects: 0. Wins: 0.
Player ElvenEyes does not show cards.Bets: 0.50. Collects: 0. Loses: 0.50.
Player IlxxxlI does not show cards.Bets: 1. Collects: 0. Loses: 1.
Game ended at: 2016/11/29 14:21:37

Game started
Game ID: 787003066 0.50/1 (PRR) Karkadann - 3 (Hold'em)
Seat 5 is the button
Seat 1: zboiii (124.12).
Seat 2: ElvenEyes (145.86).
Seat 3: StephCurry (104.18).
Seat 4: gust (40).
Seat 5: pineapplesand (45.96).
Seat 7: IlxxxlI (44).
Seat 8: dankmann (165.01).
Seat 9: VegetablesArentYummy (266.17).
Player IlxxxlI has small blind (0.50)
Player dankmann has big blind (1)
Player IlxxxlI received card: [2c]
Player IlxxxlI received card: [9s]
Player VegetablesArentYummy folds
Player zboiii folds
Player ElvenEyes folds
Player StephCurry folds
Player gust folds
Player pineapplesand folds
Player IlxxxlI folds
Uncalled bet (0.50) returned to dankmann
Player dankmann mucks cards
------ Summary ------
Pot: 1. Rake 0
Player zboiii does not show cards.Bets: 0. Collects: 0. Wins: 0.
Player ElvenEyes does not show cards.Bets: 0. Collects: 0. Wins: 0.
Player StephCurry does not show cards.Bets: 0. Collects: 0. Wins: 0.
Player gust does not show cards.Bets: 0. Collects: 0. Wins: 0.
Player pineapplesand does not show cards.Bets: 0. Collects: 0. Wins: 0.
Player IlxxxlI does not show cards.Bets: 0.50. Collects: 0. Loses: 0.50.
*Player dankmann mucks (does not show cards). Bets: 0.50. Collects: 1. Wins: 0.50.
Player VegetablesArentYummy does not show cards.Bets: 0. Collects: 0. Wins: 0.
Game ended at: 2016/11/29 14:21:18

Game started
Game ID: 787003032 0.50/1 (PRR) Kraken - 16 (Hold'em)
Seat 5 is the button
Seat 1: GagaPoker (100.34).
Seat 2: MadLifeGrinder (106.85).
Seat 3: Sephiroth1 (111).
Seat 4: Beep_Beep (121.51).
Seat 5: IlxxxlI (40).
Player GagaPoker has small blind (0.50)
Player MadLifeGrinder has big blind (1)
Player IlxxxlI received card: [4s]
Player IlxxxlI received card: [9c]
Player Sephiroth1 folds
Player Beep_Beep folds
Player IlxxxlI folds
Player GagaPoker folds
Uncalled bet (0.50) returned to MadLifeGrinder
Player MadLifeGrinder mucks cards
------ Summary ------
Pot: 1. Rake 0
Player GagaPoker does not show cards.Bets: 0.50. Collects: 0. Loses: 0.50.
*Player MadLifeGrinder mucks (does not show cards). Bets: 0.50. Collects: 1. Wins: 0.50.
Player Sephiroth1 does not show cards.Bets: 0. Collects: 0. Wins: 0.
Player Beep_Beep does not show cards.Bets: 0. Collects: 0. Wins: 0.
Player IlxxxlI does not show cards.Bets: 0. Collects: 0. Wins: 0.
Game ended at: 2016/11/29 14:20:57

Game started
Game ID: 787003000 0.25/0.50 (PRR) Gorgons - 8 (Hold'em)
Seat 4 is the button
Seat 3: foreseen (67.39).
Seat 4: IlxxxlI (20.90).
Seat 5: Beep_Beep (101.07).
Seat 6: Jui Kuen (64.79).
Player Beep_Beep has small blind (0.25)
Player Jui Kuen has big blind (0.50)
Player IlxxxlI received card: [6c]
Player IlxxxlI received card: [9h]
Player foreseen raises (1.25)
Player IlxxxlI folds
Player Beep_Beep folds
Player Jui Kuen folds
Uncalled bet (0.75) returned to foreseen
Player foreseen mucks cards
------ Summary ------
Pot: 1.25. Rake 0
*Player foreseen mucks (does not show cards). Bets: 0.50. Collects: 1.25. Wins: 0.75.
Player IlxxxlI does not show cards.Bets: 0. Collects: 0. Wins: 0.
Player Beep_Beep does not show cards.Bets: 0.25. Collects: 0. Loses: 0.25.
Player Jui Kuen does not show cards.Bets: 0.50. Collects: 0. Loses: 0.50.
Game ended at: 2016/11/29 14:21:4

Game started
Game ID: 787002935 0.50/1 (PRR) Kraken (Hold'em)
Seat 1 is the button
Seat 1: WeakAndWeary (183.86).
Seat 2: MadLifeGrinder (102.28).
Seat 3: Sephiroth1 (146.13).
Seat 4: IlxxxlI (40).
Seat 5: gust (40.08).
Seat 6: ElvenEyes (112.61).
Player MadLifeGrinder has small blind (0.50)
Player Sephiroth1 has big blind (1)
Player IlxxxlI received card: [8s]
Player IlxxxlI received card: [Jc]
Player IlxxxlI folds
Player gust folds
Player ElvenEyes raises (2.58)
Player WeakAndWeary folds
Player MadLifeGrinder folds
Player Sephiroth1 folds
Uncalled bet (1.58) returned to ElvenEyes
Player ElvenEyes mucks cards
------ Summary ------
Pot: 2.50. Rake 0
Player WeakAndWeary does not show cards.Bets: 0. Collects: 0. Wins: 0.
Player MadLifeGrinder does not show cards.Bets: 0.50. Collects: 0. Loses: 0.50.
Player Sephiroth1 does not show cards.Bets: 1. Collects: 0. Loses: 1.
Player IlxxxlI does not show cards.Bets: 0. Collects: 0. Wins: 0.
Player gust does not show cards.Bets: 0. Collects: 0. Wins: 0.
*Player ElvenEyes mucks (does not show cards). Bets: 1. Collects: 2.50. Wins: 1.50.
Game ended at: 2016/11/29 14:20:57

Game started
Game ID: 787002836 1/2 (PRR) Longana (Short) - 2 (Hold'em)
Seat 7 is the button
Seat 1: actionjax24 (117.51).
Seat 2: BiGFck (83.35).
Seat 3: VegetablesArentYummy (135.10).
Seat 4: gust (80).
Seat 5: thimk (52.37).
Seat 6: IlxxxlI (40).
Seat 7: pineapplesand (42).
Seat 8: StephCurry (110.50).
Seat 9: hotshothotgg (58.48).
Player StephCurry has small blind (1)
Player hotshothotgg has big blind (2)
Player IlxxxlI received card: [Qc]
Player IlxxxlI received card: [5s]
Player actionjax24 folds
Player BiGFck folds
Player VegetablesArentYummy raises (5)
Player gust folds
Player thimk folds
Player IlxxxlI folds
Player pineapplesand folds
Player StephCurry folds
Player hotshothotgg calls (3)
*** FLOP ***: [Kh Jc 4s]
Player hotshothotgg bets (3.48)
Player VegetablesArentYummy calls (3.48)
*** TURN ***: [Kh Jc 4s] [7h]
Player hotshothotgg checks
Player VegetablesArentYummy checks
*** RIVER ***: [Kh Jc 4s 7h] [10s]
Player hotshothotgg bets (5.69)
Player VegetablesArentYummy calls (5.69)
Player VegetablesArentYummy mucks cards
------ Summary ------
Pot: 27.88. Rake 1.22. JP fee 0.24
Board: [Kh Jc 4s 7h 10s]
Player actionjax24 does not show cards.Bets: 0. Collects: 0. Wins: 0.
Player BiGFck does not show cards.Bets: 0. Collects: 0. Wins: 0.
Player VegetablesArentYummy mucks (does not show cards). Bets: 14.17. Collects: 0. Loses: 14.17.
Player gust does not show cards.Bets: 0. Collects: 0. Wins: 0.
Player thimk does not show cards.Bets: 0. Collects: 0. Wins: 0.
Player IlxxxlI does not show cards.Bets: 0. Collects: 0. Wins: 0.
Player pineapplesand does not show cards.Bets: 0. Collects: 0. Wins: 0.
Player StephCurry does not show cards.Bets: 1. Collects: 0. Loses: 1.
*Player hotshothotgg shows: Two pairs. Ks and 10s [Kd 10d]. Bets: 14.17. Collects: 27.88. Wins: 13.71.
Game ended at: 2016/11/29 14:21:32

Game started
Game ID: 787002835 0.25/0.50 (PRR) Gorgons - 15 (Hold'em)
Seat 4 is the button
Seat 1: WeakAndWeary (53.20).
Seat 2: IampokerKidd (99.27).
Seat 3: imger8 (52.39).
Seat 4: IlxxxlI (20).
Seat 5: foreseen (52.95).
Seat 6: BiGFck (11.50).
Player foreseen has small blind (0.25)
Player BiGFck has big blind (0.50)
Player IlxxxlI received card: [Qh]
Player IlxxxlI received card: [Qd]
Player WeakAndWeary raises (1.50)
Player IampokerKidd folds
Player imger8 folds
Player IlxxxlI raises (3.64)
Player foreseen folds
Player BiGFck folds
Player WeakAndWeary folds
Uncalled bet (2.14) returned to IlxxxlI
Player IlxxxlI mucks cards
------ Summary ------
Pot: 3.75. Rake 0
Player WeakAndWeary does not show cards.Bets: 1.50. Collects: 0. Loses: 1.50.
Player IampokerKidd does not show cards.Bets: 0. Collects: 0. Wins: 0.
Player imger8 does not show cards.Bets: 0. Collects: 0. Wins: 0.
*Player IlxxxlI mucks (does not show cards). Bets: 1.50. Collects: 3.75. Wins: 2.25.
Player foreseen does not show cards.Bets: 0.25. Collects: 0. Loses: 0.25.
Player BiGFck does not show cards.Bets: 0.50. Collects: 0. Loses: 0.50.
Game ended at: 2016/11/29 14:21:1

Game started
Game ID: 787002824 0.50/1 (PRR) Kraken - 23 (Hold'em)
Seat 3 is the button
Seat 1: WeakAndWeary (101.90).
Seat 2: gust (47.50).
Seat 3: LloydXmas (130.29).
Seat 4: Sephiroth1 (100).
Seat 5: ElvenEyes (119.45).
Seat 6: IlxxxlI (40).
Player Sephiroth1 has small blind (0.50)
Player ElvenEyes has big blind (1)
Player IlxxxlI received card: [9h]
Player IlxxxlI received card: [Jd]
Player IlxxxlI folds
Player WeakAndWeary folds
Player gust folds
Player LloydXmas folds
Player Sephiroth1 raises (2.50)
Player ElvenEyes calls (2)
*** FLOP ***: [6d 2h 2c]
Player Sephiroth1 bets (3.80)
Player ElvenEyes folds
Uncalled bet (3.80) returned to Sephiroth1
Player Sephiroth1 mucks cards
------ Summary ------
Pot: 5.70. Rake 0.20. JP fee 0.10
Board: [6d 2h 2c]
Player WeakAndWeary does not show cards.Bets: 0. Collects: 0. Wins: 0.
Player gust does not show cards.Bets: 0. Collects: 0. Wins: 0.
Player LloydXmas does not show cards.Bets: 0. Collects: 0. Wins: 0.
*Player Sephiroth1 mucks (does not show cards). Bets: 3. Collects: 5.70. Wins: 2.70.
Player ElvenEyes does not show cards.Bets: 3. Collects: 0. Loses: 3.
Player IlxxxlI does not show cards.Bets: 0. Collects: 0. Wins: 0.
Game ended at: 2016/11/29 14:20:51

Game started
Game ID: 787002791 0.50/1 (PRR) Karkadann - 3 (Hold'em)
Seat 4 is the button
Seat 1: zboiii (124.12).
Seat 2: ElvenEyes (145.86).
Seat 3: StephCurry (104.18).
Seat 4: gust (40).
Seat 5: pineapplesand (46.46).
Seat 7: IlxxxlI (41.50).
Seat 8: dankmann (165.01).
Seat 9: VegetablesArentYummy (266.17).
Player pineapplesand has small blind (0.50)
Player IlxxxlI has big blind (1)
Player IlxxxlI received card: [Jc]
Player IlxxxlI received card: [Js]
Player dankmann folds
Player VegetablesArentYummy folds
Player zboiii folds
Player ElvenEyes folds
Player StephCurry folds
Player gust raises (2)
Player pineapplesand folds
Player IlxxxlI raises (4.16)
Player gust folds
Uncalled bet (3.16) returned to IlxxxlI
Player IlxxxlI mucks cards
------ Summary ------
Pot: 4.50. Rake 0
Player zboiii does not show cards.Bets: 0. Collects: 0. Wins: 0.
Player ElvenEyes does not show cards.Bets: 0. Collects: 0. Wins: 0.
Player StephCurry does not show cards.Bets: 0. Collects: 0. Wins: 0.
Player gust does not show cards.Bets: 2. Collects: 0. Loses: 2.
Player pineapplesand does not show cards.Bets: 0.50. Collects: 0. Loses: 0.50.
*Player IlxxxlI mucks (does not show cards). Bets: 2. Collects: 4.50. Wins: 2.50.
Player dankmann does not show cards.Bets: 0. Collects: 0. Wins: 0.
Player VegetablesArentYummy does not show cards.Bets: 0. Collects: 0. Wins: 0.
Game ended at: 2016/11/29 14:20:43

Game started
Game ID: 787002652 1/2 (PRR) Lakhey (Hold'em)
Seat 6 is the button
Seat 1: VegetablesArentYummy (264.23).
Seat 2: IlxxxlI (84.55).
Seat 3: IbetUmuck (875.65).
Seat 4: DonCesarGrinder (249.14).
Seat 5: MadLifeGrinder (203).
Seat 6: LloydXmas (200).
Player VegetablesArentYummy has small blind (1)
Player IlxxxlI has big blind (2)
Player IlxxxlI received card: [3h]
Player IlxxxlI received card: [8c]
Player IbetUmuck folds
Player DonCesarGrinder folds
Player MadLifeGrinder folds
Player LloydXmas raises (4)
Player VegetablesArentYummy raises (17)
Player IlxxxlI folds
Player LloydXmas calls (14)
*** FLOP ***: [3c 8d 6s]
Player VegetablesArentYummy bets (15.03)
Player LloydXmas calls (15.03)
*** TURN ***: [3c 8d 6s] [9d]
Player VegetablesArentYummy checks
Player LloydXmas checks
*** RIVER ***: [3c 8d 6s 9d] [Jc]
Player VegetablesArentYummy checks
Player LloydXmas checks
Player VegetablesArentYummy mucks cards
------ Summary ------
Pot: 65.06. Rake 2.76. JP fee 0.24
Board: [3c 8d 6s 9d Jc]
Player VegetablesArentYummy mucks (does not show cards). Bets: 33.03. Collects: 0. Loses: 33.03.
Player IlxxxlI does not show cards.Bets: 2. Collects: 0. Loses: 2.
Player IbetUmuck does not show cards.Bets: 0. Collects: 0. Wins: 0.
Player DonCesarGrinder does not show cards.Bets: 0. Collects: 0. Wins: 0.
Player MadLifeGrinder does not show cards.Bets: 0. Collects: 0. Wins: 0.
*Player LloydXmas shows: One pair of 9s [10s 9s]. Bets: 33.03. Collects: 65.06. Wins: 32.03.
Game ended at: 2016/11/29 14:21:40

Game started
Game ID: 787002647 0.50/1 (PRR) Karkadann - 3 (Hold'em)
Seat 3 is the button
Seat 1: zboiii (122.62).
Seat 2: ElvenEyes (145.86).
Seat 3: StephCurry (104.18).
Seat 4: gust (40).
Seat 5: pineapplesand (47.46).
Seat 7: IlxxxlI (41.50).
Seat 8: dankmann (165.01).
Seat 9: VegetablesArentYummy (266.17).
Player gust has small blind (0.50)
Player pineapplesand has big blind (1)
Player IlxxxlI received card: [9c]
Player IlxxxlI received card: [6s]
Player IlxxxlI folds
Player dankmann folds
Player VegetablesArentYummy folds
Player zboiii raises (3)
Player ElvenEyes folds
Player StephCurry folds
Player gust folds
Player pineapplesand folds
Uncalled bet (2) returned to zboiii
Player zboiii mucks cards
------ Summary ------
Pot: 2.50. Rake 0
*Player zboiii mucks (does not show cards). Bets: 1. Collects: 2.50. Wins: 1.50.
Player ElvenEyes does not show cards.Bets: 0. Collects: 0. Wins: 0.
Player StephCurry does not show cards.Bets: 0. Collects: 0. Wins: 0.
Player gust does not show cards.Bets: 0.50. Collects: 0. Loses: 0.50.
Player pineapplesand does not show cards.Bets: 1. Collects: 0. Loses: 1.
Player IlxxxlI does not show cards.Bets: 0. Collects: 0. Wins: 0.
Player dankmann does not show cards.Bets: 0. Collects: 0. Wins: 0.
Player VegetablesArentYummy does not show cards.Bets: 0. Collects: 0. Wins: 0.
Game ended at: 2016/11/29 14:20:5

Game started
Game ID: 787002625 0.25/0.50 (PRR) Gorgons - 10 (Hold'em)
Seat 5 is the button
Seat 1: WeakAndWeary (50).
Seat 2: foreseen (226.65).
Seat 3: IampokerKidd (69).
Seat 4: Beep_Beep (50).
Seat 5: IlxxxlI (20).
Seat 6: xROCKETMANx (63.79).
Player xROCKETMANx has small blind (0.25)
Player WeakAndWeary has big blind (0.50)
Player IlxxxlI received card: [10s]
Player IlxxxlI received card: [Qs]
Player foreseen folds
Player IampokerKidd folds
Player Beep_Beep folds
Player IlxxxlI raises (1.50)
Player xROCKETMANx folds
Player WeakAndWeary calls (1)
*** FLOP ***: [2s 2h 3d]
Player WeakAndWeary checks
Player IlxxxlI bets (1.03)
Player WeakAndWeary calls (1.03)
*** TURN ***: [2s 2h 3d] [7c]
Player WeakAndWeary checks
Player IlxxxlI checks
*** RIVER ***: [2s 2h 3d 7c] [Jc]
Player WeakAndWeary checks
Player IlxxxlI checks
Player WeakAndWeary mucks cards
------ Summary ------
Pot: 5.05. Rake 0.18. JP fee 0.08
Board: [2s 2h 3d 7c Jc]
Player WeakAndWeary mucks (does not show cards). Bets: 2.53. Collects: 0. Loses: 2.53.
Player foreseen does not show cards.Bets: 0. Collects: 0. Wins: 0.
Player IampokerKidd does not show cards.Bets: 0. Collects: 0. Wins: 0.
Player Beep_Beep does not show cards.Bets: 0. Collects: 0. Wins: 0.
*Player IlxxxlI shows: One pair of 2s [10s Qs]. Bets: 2.53. Collects: 5.05. Wins: 2.52.
Player xROCKETMANx does not show cards.Bets: 0.25. Collects: 0. Loses: 0.25.
Game ended at: 2016/11/29 14:21:30

Game started
Game ID: 787002564 0.25/0.50 (PRR) Gorgons - 15 (Hold'em)
Seat 3 is the button
Seat 1: WeakAndWeary (53.20).
Seat 2: IampokerKidd (99.27).
Seat 3: imger8 (51.64).
Seat 4: IlxxxlI (20.25).
Seat 5: foreseen (53.45).
Seat 6: BiGFck (11.50).
Player IlxxxlI has small blind (0.25)
Player foreseen has big blind (0.50)
Player IlxxxlI received card: [4c]
Player IlxxxlI received card: [9d]
Player BiGFck folds
Player WeakAndWeary folds
Player IampokerKidd folds
Player imger8 raises (1.50)
Player IlxxxlI folds
Player foreseen folds
Uncalled bet (1) returned to imger8
Player imger8 mucks cards
------ Summary ------
Pot: 1.25. Rake 0
Player WeakAndWeary does not show cards.Bets: 0. Collects: 0. Wins: 0.
Player IampokerKidd does not show cards.Bets: 0. Collects: 0. Wins: 0.
*Player imger8 mucks (does not show cards). Bets: 0.50. Collects: 1.25. Wins: 0.75.
Player IlxxxlI does not show cards.Bets: 0.25. Collects: 0. Loses: 0.25.
Player foreseen does not show cards.Bets: 0.50. Collects: 0. Loses: 0.50.
Player BiGFck does not show cards.Bets: 0. Collects: 0. Wins: 0.
Game ended at: 2016/11/29 14:20:11

Game started
Game ID: 787002385 1/2 (PRR) Lakhey (Hold'em)
Seat 5 is the button
Seat 1: VegetablesArentYummy (266.23).
Seat 2: IlxxxlI (84.55).
Seat 3: IbetUmuck (875.65).
Seat 4: DonCesarGrinder (246.14).
Seat 5: MadLifeGrinder (203).
Seat 6: LloydXmas (200).
Player LloydXmas has small blind (1)
Player VegetablesArentYummy has big blind (2)
Player IlxxxlI received card: [Qh]
Player IlxxxlI received card: [6s]
Player IlxxxlI folds
Player IbetUmuck folds
Player DonCesarGrinder raises (5)
Player MadLifeGrinder folds
Player LloydXmas folds
Player VegetablesArentYummy folds
Uncalled bet (3) returned to DonCesarGrinder
Player DonCesarGrinder mucks cards
------ Summary ------
Pot: 5. Rake 0
Player VegetablesArentYummy does not show cards.Bets: 2. Collects: 0. Loses: 2.
Player IlxxxlI does not show cards.Bets: 0. Collects: 0. Wins: 0.
Player IbetUmuck does not show cards.Bets: 0. Collects: 0. Wins: 0.
*Player DonCesarGrinder mucks (does not show cards). Bets: 2. Collects: 5. Wins: 3.
Player MadLifeGrinder does not show cards.Bets: 0. Collects: 0. Wins: 0.
Player LloydXmas does not show cards.Bets: 1. Collects: 0. Loses: 1.
Game ended at: 2016/11/29 14:19:46

Game started
Game ID: 787002383 0.25/0.50 (PRR) Gorgons - 8 (Hold'em)
Seat 3 is the button
Seat 3: foreseen (67.39).
Seat 4: IlxxxlI (20).
Seat 5: Beep_Beep (102.07).
Seat 6: Jui Kuen (64.79).
Player IlxxxlI has small blind (0.25)
Player Beep_Beep has big blind (0.50)
Player IlxxxlI received card: [6c]
Player IlxxxlI received card: [9c]
Player Jui Kuen folds
Player foreseen folds
Player IlxxxlI calls (0.25)
Player Beep_Beep checks
*** FLOP ***: [Qc 10d Ad]
Player IlxxxlI bets (0.50)
Player Beep_Beep calls (0.50)
*** TURN ***: [Qc 10d Ad] [8d]
Player IlxxxlI checks
Player Beep_Beep checks
*** RIVER ***: [Qc 10d Ad 8d] [7s]
Player IlxxxlI bets (1.33)
Player Beep_Beep folds
Uncalled bet (1.33) returned to IlxxxlI
Player IlxxxlI mucks cards
------ Summary ------
Pot: 1.90. Rake 0.08. JP fee 0.02
Board: [Qc 10d Ad 8d 7s]
Player foreseen does not show cards.Bets: 0. Collects: 0. Wins: 0.
*Player IlxxxlI mucks (does not show cards). Bets: 1. Collects: 1.90. Wins: 0.90.
Player Beep_Beep does not show cards.Bets: 1. Collects: 0. Loses: 1.
Player Jui Kuen does not show cards.Bets: 0. Collects: 0. Wins: 0.
Game ended at: 2016/11/29 14:20:34

Game started
Game ID: 787002368 1/2 (PRR) Longana (Short) - 2 (Hold'em)
Seat 6 is the button
Seat 1: actionjax24 (117.51).
Seat 2: BiGFck (83.35).
Seat 3: VegetablesArentYummy (135.10).
Seat 4: gust (80).
Seat 5: thimk (52.37).
Seat 6: IlxxxlI (40).
Seat 7: pineapplesand (40).
Seat 8: StephCurry (112.50).
Seat 9: hotshothotgg (58.48).
Player pineapplesand has small blind (1)
Player StephCurry has big blind (2)
Player IlxxxlI received card: [Kd]
Player IlxxxlI received card: [3c]
Player hotshothotgg folds
Player actionjax24 folds
Player BiGFck folds
Player VegetablesArentYummy folds
Player gust folds
Player thimk folds
Player IlxxxlI folds
Player pineapplesand allin (39)
Player StephCurry folds
Uncalled bet (38) returned to pineapplesand
Player pineapplesand mucks cards
------ Summary ------
Pot: 4. Rake 0
Player actionjax24 does not show cards.Bets: 0. Collects: 0. Wins: 0.
Player BiGFck does not show cards.Bets: 0. Collects: 0. Wins: 0.
Player VegetablesArentYummy does not show cards.Bets: 0. Collects: 0. Wins: 0.
Player gust does not show cards.Bets: 0. Collects: 0. Wins: 0.
Player thimk does not show cards.Bets: 0. Collects: 0. Wins: 0.
Player IlxxxlI does not show cards.Bets: 0. Collects: 0. Wins: 0.
*Player pineapplesand mucks (does not show cards). Bets: 2. Collects: 4. Wins: 2.
Player StephCurry does not show cards.Bets: 2. Collects: 0. Loses: 2.
Player hotshothotgg does not show cards.Bets: 0. Collects: 0. Wins: 0.
Game ended at: 2016/11/29 14:20:12

Game started
Game ID: 787002341 0.50/1 (PRR) Kraken (Hold'em)
Seat 6 is the button
Seat 1: WeakAndWeary (184.36).
Seat 2: MadLifeGrinder (100).
Seat 3: Sephiroth1 (146.13).
Seat 4: IlxxxlI (40).
Seat 5: gust (42.08).
Seat 6: ElvenEyes (112.61).
Player WeakAndWeary has small blind (0.50)
Player MadLifeGrinder has big blind (1)
Player IlxxxlI received card: [10s]
Player IlxxxlI received card: [2h]
Player Sephiroth1 folds
Player IlxxxlI folds
Player gust raises (2)
Player ElvenEyes folds
Player WeakAndWeary folds
Player MadLifeGrinder calls (1)
*** FLOP ***: [Qs 4s 7s]
Player MadLifeGrinder checks
Player gust checks
*** TURN ***: [Qs 4s 7s] [Ks]
Player MadLifeGrinder bets (3)
Player gust folds
Uncalled bet (3) returned to MadLifeGrinder
Player MadLifeGrinder mucks cards
------ Summary ------
Pot: 4.28. Rake 0.16. JP fee 0.06
Board: [Qs 4s 7s Ks]
Player WeakAndWeary does not show cards.Bets: 0.50. Collects: 0. Loses: 0.50.
*Player MadLifeGrinder mucks (does not show cards). Bets: 2. Collects: 4.28. Wins: 2.28.
Player Sephiroth1 does not show cards.Bets: 0. Collects: 0. Wins: 0.
Player IlxxxlI does not show cards.Bets: 0. Collects: 0. Wins: 0.
Player gust does not show cards.Bets: 2. Collects: 0. Loses: 2.
Player ElvenEyes does not show cards.Bets: 0. Collects: 0. Wins: 0.
Game ended at: 2016/11/29 14:20:24

Game started
Game ID: 787002327 0.50/1 (PRR) Kraken - 23 (Hold'em)
Seat 2 is the button
Seat 1: WeakAndWeary (101.90).
Seat 2: gust (47.50).
Seat 3: LloydXmas (123.73).
Seat 4: Sephiroth1 (100).
Seat 5: ElvenEyes (119.45).
Seat 6: IlxxxlI (40).
Player LloydXmas has small blind (0.50)
Player Sephiroth1 has big blind (1)
Player IlxxxlI received card: [4d]
Player IlxxxlI received card: [Js]
Player ElvenEyes folds
Player IlxxxlI folds
Player WeakAndWeary folds
Player gust folds
Player LloydXmas raises (2.50)
Player Sephiroth1 calls (2)
*** FLOP ***: [9d 7h 4c]
Player LloydXmas bets (4.28)
Player Sephiroth1 calls (4.28)
*** TURN ***: [9d 7h 4c] [Kh]
Player LloydXmas bets (10.38)
Player Sephiroth1 folds
Uncalled bet (10.38) returned to LloydXmas
Player LloydXmas mucks cards
------ Summary ------
Pot: 13.84. Rake 0.48. JP fee 0.24
Board: [9d 7h 4c Kh]
Player WeakAndWeary does not show cards.Bets: 0. Collects: 0. Wins: 0.
Player gust does not show cards.Bets: 0. Collects: 0. Wins: 0.
*Player LloydXmas mucks (does not show cards). Bets: 7.28. Collects: 13.84. Wins: 6.56.
Player Sephiroth1 does not show cards.Bets: 7.28. Collects: 0. Loses: 7.28.
Player ElvenEyes does not show cards.Bets: 0. Collects: 0. Wins: 0.
Player IlxxxlI does not show cards.Bets: 0. Collects: 0. Wins: 0.
Game ended at: 2016/11/29 14:20:9

Game started
Game ID: 787002322 0.25/0.50 (PRR) Gorgons - 15 (Hold'em)
Seat 2 is the button
Seat 1: WeakAndWeary (53.20).
Seat 2: IampokerKidd (99.27).
Seat 3: imger8 (51.89).
Seat 4: IlxxxlI (20.75).
Seat 5: foreseen (52.70).
Seat 6: BiGFck (11.50).
Player imger8 has small blind (0.25)
Player IlxxxlI has big blind (0.50)
Player IlxxxlI received card: [9d]
Player IlxxxlI received card: [8c]
Player foreseen raises (1.25)
Player BiGFck folds
Player WeakAndWeary folds
Player IampokerKidd folds
Player imger8 folds
Player IlxxxlI folds
Uncalled bet (0.75) returned to foreseen
Player foreseen mucks cards
------ Summary ------
Pot: 1.25. Rake 0
Player WeakAndWeary does not show cards.Bets: 0. Collects: 0. Wins: 0.
Player IampokerKidd does not show cards.Bets: 0. Collects: 0. Wins: 0.
Player imger8 does not show cards.Bets: 0.25. Collects: 0. Loses: 0.25.
Player IlxxxlI does not show cards.Bets: 0.50. Collects: 0. Loses: 0.50.
*Player foreseen mucks (does not show cards). Bets: 0.50. Collects: 1.25. Wins: 0.75.
Player BiGFck does not show cards.Bets: 0. Collects: 0. Wins: 0.
Game ended at: 2016/11/29 14:19:32

Game started
Game ID: 787002303 0.50/1 (PRR) Karkadann - 3 (Hold'em)
Seat 2 is the button
Seat 1: zboiii (122.62).
Seat 2: ElvenEyes (145.86).
Seat 3: StephCurry (103.18).
Seat 4: gust (40).
Seat 5: pineapplesand (47.46).
Seat 7: IlxxxlI (41.50).
Seat 8: dankmann (165.01).
Seat 9: VegetablesArentYummy (266.17).
Player StephCurry has small blind (0.50)
Player gust has big blind (1)
Player IlxxxlI received card: [3d]
Player IlxxxlI received card: [3c]
Player pineapplesand folds
Player IlxxxlI folds
Player dankmann folds
Player VegetablesArentYummy folds
Player zboiii folds
Player ElvenEyes folds
Player StephCurry raises (2.50)
Player gust folds
Uncalled bet (2) returned to StephCurry
Player StephCurry mucks cards
------ Summary ------
Pot: 2. Rake 0
Player zboiii does not show cards.Bets: 0. Collects: 0. Wins: 0.
Player ElvenEyes does not show cards.Bets: 0. Collects: 0. Wins: 0.
*Player StephCurry mucks (does not show cards). Bets: 1. Collects: 2. Wins: 1.
Player gust does not show cards.Bets: 1. Collects: 0. Loses: 1.
Player pineapplesand does not show cards.Bets: 0. Collects: 0. Wins: 0.
Player IlxxxlI does not show cards.Bets: 0. Collects: 0. Wins: 0.
Player dankmann does not show cards.Bets: 0. Collects: 0. Wins: 0.
Player VegetablesArentYummy does not show cards.Bets: 0. Collects: 0. Wins: 0.
Game ended at: 2016/11/29 14:19:45

Game started
Game ID: 787002257 0.50/1 (PRR) Kraken - 16 (Hold'em)
Seat 4 is the button
Seat 1: GagaPoker (106.43).
Seat 2: MadLifeGrinder (106.85).
Seat 3: Sephiroth1 (111).
Seat 4: Beep_Beep (115.55).
Seat 5: IlxxxlI (40).
Player IlxxxlI has small blind (0.50)
Player GagaPoker has big blind (1)
Player IlxxxlI received card: [10h]
Player IlxxxlI received card: [7s]
Player MadLifeGrinder folds
Player Sephiroth1 folds
Player Beep_Beep raises (3)
Player IlxxxlI folds
Player GagaPoker calls (2)
*** FLOP ***: [Qh 8s 2h]
Player GagaPoker checks
Player Beep_Beep checks
*** TURN ***: [Qh 8s 2h] [5h]
Player GagaPoker bets (3.09)
Player Beep_Beep calls (3.09)
*** RIVER ***: [Qh 8s 2h 5h] [Ac]
Player GagaPoker checks
Player Beep_Beep bets (9)
Player GagaPoker folds
Uncalled bet (9) returned to Beep_Beep
Player Beep_Beep mucks cards
------ Summary ------
Pot: 12.05. Rake 0.43. JP fee 0.20
Board: [Qh 8s 2h 5h Ac]
Player GagaPoker does not show cards.Bets: 6.09. Collects: 0. Loses: 6.09.
Player MadLifeGrinder does not show cards.Bets: 0. Collects: 0. Wins: 0.
Player Sephiroth1 does not show cards.Bets: 0. Collects: 0. Wins: 0.
*Player Beep_Beep mucks (does not show cards). Bets: 6.09. Collects: 12.05. Wins: 5.96.
Player IlxxxlI does not show cards.Bets: 0.50. Collects: 0. Loses: 0.50.
Game ended at: 2016/11/29 14:20:38

Game started
Game ID: 787002211 0.25/0.50 (PRR) Gorgons - 10 (Hold'em)
Seat 4 is the button
Seat 1: WeakAndWeary (50).
Seat 2: foreseen (226.65).
Seat 3: IampokerKidd (69).
Seat 4: Beep_Beep (51.14).
Seat 5: IlxxxlI (20).
Seat 6: xROCKETMANx (62.20).
Player IlxxxlI has small blind (0.25)
Player xROCKETMANx has big blind (0.50)
Player IlxxxlI received card: [Qs]
Player IlxxxlI received card: [10d]
Player WeakAndWeary folds
Player foreseen folds
Player IampokerKidd folds
Player Beep_Beep raises (1.50)
Player IlxxxlI folds
Player xROCKETMANx calls (1)
*** FLOP ***: [3s 5d 2h]
Player xROCKETMANx bets (2.06)
Player Beep_Beep folds
Uncalled bet (2.06) returned to xROCKETMANx
Player xROCKETMANx mucks cards
------ Summary ------
Pot: 3.09. Rake 0.12. JP fee 0.04
Board: [3s 5d 2h]
Player WeakAndWeary does not show cards.Bets: 0. Collects: 0. Wins: 0.
Player foreseen does not show cards.Bets: 0. Collects: 0. Wins: 0.
Player IampokerKidd does not show cards.Bets: 0. Collects: 0. Wins: 0.
Player Beep_Beep does not show cards.Bets: 1.50. Collects: 0. Loses: 1.50.
Player IlxxxlI does not show cards.Bets: 0.25. Collects: 0. Loses: 0.25.
*Player xROCKETMANx mucks (does not show cards). Bets: 1.50. Collects: 3.09. Wins: 1.59.
Game ended at: 2016/11/29 14:19:42

Game started
Game ID: 787002180 0.50/1 (PRR) Kraken - 23 (Hold'em)
Seat 1 is the button
Seat 1: WeakAndWeary (101.90).
Seat 2: gust (48).
Seat 3: LloydXmas (123.23).
Seat 4: Sephiroth1 (100).
Seat 5: ElvenEyes (119.45).
Seat 6: IlxxxlI (40).
Player gust has small blind (0.50)
Player LloydXmas has big blind (1)
Player IlxxxlI received card: [10d]
Player IlxxxlI received card: [8h]
Player Sephiroth1 folds
Player ElvenEyes folds
Player IlxxxlI folds
Player WeakAndWeary folds
Player gust folds
Uncalled bet (0.50) returned to LloydXmas
Player LloydXmas mucks cards
------ Summary ------
Pot: 1. Rake 0
Player WeakAndWeary does not show cards.Bets: 0. Collects: 0. Wins: 0.
Player gust does not show cards.Bets: 0.50. Collects: 0. Loses: 0.50.
*Player LloydXmas mucks (does not show cards). Bets: 0.50. Collects: 1. Wins: 0.50.
Player Sephiroth1 does not show cards.Bets: 0. Collects: 0. Wins: 0.
Player ElvenEyes does not show cards.Bets: 0. Collects: 0. Wins: 0.
Player IlxxxlI does not show cards.Bets: 0. Collects: 0. Wins: 0.
Game ended at: 2016/11/29 14:19:1

Game started
Game ID: 787002143 0.50/1 (PRR) Kraken - 16 (Hold'em)
Seat 3 is the button
Seat 1: GagaPoker (106.43).
Seat 2: MadLifeGrinder (106.85).
Seat 3: Sephiroth1 (109.50).
Seat 4: Beep_Beep (116.05).
Seat 5: IlxxxlI (40).
Player Beep_Beep has small blind (0.50)
Player IlxxxlI has big blind (1)
Player IlxxxlI received card: [3c]
Player IlxxxlI received card: [5s]
Player GagaPoker folds
Player MadLifeGrinder folds
Player Sephiroth1 raises (3)
Player Beep_Beep folds
Player IlxxxlI folds
Uncalled bet (2) returned to Sephiroth1
Player Sephiroth1 mucks cards
------ Summary ------
Pot: 2.50. Rake 0
Player GagaPoker does not show cards.Bets: 0. Collects: 0. Wins: 0.
Player MadLifeGrinder does not show cards.Bets: 0. Collects: 0. Wins: 0.
*Player Sephiroth1 mucks (does not show cards). Bets: 1. Collects: 2.50. Wins: 1.50.
Player Beep_Beep does not show cards.Bets: 0.50. Collects: 0. Loses: 0.50.
Player IlxxxlI does not show cards.Bets: 1. Collects: 0. Loses: 1.
Game ended at: 2016/11/29 14:18:50

Game started
Game ID: 787002122 1/2 (PRR) Lakhey (Hold'em)
Seat 4 is the button
Seat 1: VegetablesArentYummy (266.23).
Seat 2: IlxxxlI (84.55).
Seat 3: IbetUmuck (881.40).
Seat 4: DonCesarGrinder (237.39).
Seat 5: MadLifeGrinder (204).
Seat 6: LloydXmas (200).
Player MadLifeGrinder has small blind (1)
Player LloydXmas has big blind (2)
Player IlxxxlI received card: [2h]
Player IlxxxlI received card: [3d]
Player VegetablesArentYummy folds
Player IlxxxlI folds
Player IbetUmuck raises (5.75)
Player DonCesarGrinder raises (15.33)
Player MadLifeGrinder folds
Player LloydXmas folds
Player IbetUmuck folds
Uncalled bet (9.58) returned to DonCesarGrinder
Player DonCesarGrinder mucks cards
------ Summary ------
Pot: 14.50. Rake 0
Player VegetablesArentYummy does not show cards.Bets: 0. Collects: 0. Wins: 0.
Player IlxxxlI does not show cards.Bets: 0. Collects: 0. Wins: 0.
Player IbetUmuck does not show cards.Bets: 5.75. Collects: 0. Loses: 5.75.
*Player DonCesarGrinder mucks (does not show cards). Bets: 5.75. Collects: 14.50. Wins: 8.75.
Player MadLifeGrinder does not show cards.Bets: 1. Collects: 0. Loses: 1.
Player LloydXmas does not show cards.Bets: 2. Collects: 0. Loses: 2.
Game ended at: 2016/11/29 14:19:10

Game started
Game ID: 787002091 0.50/1 (PRR) Kraken (Hold'em)
Seat 5 is the button
Seat 1: WeakAndWeary (181.36).
Seat 2: MadLifeGrinder (100).
Seat 3: Sephiroth1 (146.13).
Seat 4: IlxxxlI (40).
Seat 5: gust (42.08).
Seat 6: ElvenEyes (115.61).
Player ElvenEyes has small blind (0.50)
Player WeakAndWeary has big blind (1)
Player IlxxxlI received card: [10c]
Player IlxxxlI received card: [9h]
Player MadLifeGrinder folds
Player Sephiroth1 folds
Player IlxxxlI folds
Player gust folds
Player ElvenEyes raises (2.50)
Player WeakAndWeary raises (9)
Player ElvenEyes folds
Uncalled bet (7) returned to WeakAndWeary
Player WeakAndWeary mucks cards
------ Summary ------
Pot: 6. Rake 0
*Player WeakAndWeary mucks (does not show cards). Bets: 3. Collects: 6. Wins: 3.
Player MadLifeGrinder does not show cards.Bets: 0. Collects: 0. Wins: 0.
Player Sephiroth1 does not show cards.Bets: 0. Collects: 0. Wins: 0.
Player IlxxxlI does not show cards.Bets: 0. Collects: 0. Wins: 0.
Player gust does not show cards.Bets: 0. Collects: 0. Wins: 0.
Player ElvenEyes does not show cards.Bets: 3. Collects: 0. Loses: 3.
Game ended at: 2016/11/29 14:19:3

Game started
Game ID: 787001974 0.50/1 (PRR) Kraken - 23 (Hold'em)
Seat 6 is the button
Seat 1: WeakAndWeary (100.90).
Seat 2: gust (49).
Seat 3: LloydXmas (123.23).
Seat 4: Sephiroth1 (100).
Seat 5: ElvenEyes (119.45).
Seat 6: IlxxxlI (40).
Player WeakAndWeary has small blind (0.50)
Player gust has big blind (1)
Player IlxxxlI received card: [9s]
Player IlxxxlI received card: [4s]
Player LloydXmas folds
Player Sephiroth1 folds
Player ElvenEyes folds
Player IlxxxlI folds
Player WeakAndWeary raises (2.50)
Player gust folds
Uncalled bet (2) returned to WeakAndWeary
Player WeakAndWeary mucks cards
------ Summary ------
Pot: 2. Rake 0
*Player WeakAndWeary mucks (does not show cards). Bets: 1. Collects: 2. Wins: 1.
Player gust does not show cards.Bets: 1. Collects: 0. Loses: 1.
Player LloydXmas does not show cards.Bets: 0. Collects: 0. Wins: 0.
Player Sephiroth1 does not show cards.Bets: 0. Collects: 0. Wins: 0.
Player ElvenEyes does not show cards.Bets: 0. Collects: 0. Wins: 0.
Player IlxxxlI does not show cards.Bets: 0. Collects: 0. Wins: 0.
Game ended at: 2016/11/29 14:18:37

Game started
Game ID: 787001958 0.50/1 (PRR) Kraken (Hold'em)
Seat 4 is the button
Seat 1: WeakAndWeary (181.36).
Seat 2: MadLifeGrinder (100).
Seat 3: Sephiroth1 (146.13).
Seat 4: IlxxxlI (40).
Seat 5: gust (42.58).
Seat 6: ElvenEyes (115.11).
Player gust has small blind (0.50)
Player ElvenEyes has big blind (1)
Player IlxxxlI received card: [7s]
Player IlxxxlI received card: [10h]
Player WeakAndWeary folds
Player MadLifeGrinder folds
Player Sephiroth1 folds
Player IlxxxlI folds
Player gust folds
Uncalled bet (0.50) returned to ElvenEyes
Player ElvenEyes mucks cards
------ Summary ------
Pot: 1. Rake 0
Player WeakAndWeary does not show cards.Bets: 0. Collects: 0. Wins: 0.
Player MadLifeGrinder does not show cards.Bets: 0. Collects: 0. Wins: 0.
Player Sephiroth1 does not show cards.Bets: 0. Collects: 0. Wins: 0.
Player IlxxxlI does not show cards.Bets: 0. Collects: 0. Wins: 0.
Player gust does not show cards.Bets: 0.50. Collects: 0. Loses: 0.50.
*Player ElvenEyes mucks (does not show cards). Bets: 0.50. Collects: 1. Wins: 0.50.
Game ended at: 2016/11/29 14:18:27

Game started
Game ID: 787001943 1/2 (PRR) Lakhey (Hold'em)
Seat 3 is the button
Seat 1: VegetablesArentYummy (266.23).
Seat 2: IlxxxlI (84.55).
Seat 3: IbetUmuck (881.40).
Seat 4: DonCesarGrinder (238.39).
Seat 5: MadLifeGrinder (203).
Player DonCesarGrinder has small blind (1)
Player MadLifeGrinder has big blind (2)
Player IlxxxlI received card: [5d]
Player IlxxxlI received card: [Kc]
Player VegetablesArentYummy folds
Player IlxxxlI folds
Player IbetUmuck folds
Player DonCesarGrinder folds
Uncalled bet (1) returned to MadLifeGrinder
Player MadLifeGrinder mucks cards
------ Summary ------
Pot: 2. Rake 0
Player VegetablesArentYummy does not show cards.Bets: 0. Collects: 0. Wins: 0.
Player IlxxxlI does not show cards.Bets: 0. Collects: 0. Wins: 0.
Player IbetUmuck does not show cards.Bets: 0. Collects: 0. Wins: 0.
Player DonCesarGrinder does not show cards.Bets: 1. Collects: 0. Loses: 1.
*Player MadLifeGrinder mucks (does not show cards). Bets: 1. Collects: 2. Wins: 1.
Game ended at: 2016/11/29 14:18:31

Game started
Game ID: 787001940 0.50/1 (PRR) Karkadann - 3 (Hold'em)
Seat 1 is the button
Seat 1: zboiii (125.62).
Seat 2: ElvenEyes (146.36).
Seat 3: StephCurry (100).
Seat 4: gust (40).
Seat 5: pineapplesand (47.46).
Seat 7: IlxxxlI (41.50).
Seat 8: dankmann (165.01).
Seat 9: VegetablesArentYummy (266.17).
Player ElvenEyes has small blind (0.50)
Player StephCurry has big blind (1)
Player IlxxxlI received card: [3c]
Player IlxxxlI received card: [Jh]
Player gust folds
Player pineapplesand folds
Player IlxxxlI folds
Player dankmann folds
Player VegetablesArentYummy folds
Player zboiii raises (3)
Player ElvenEyes folds
Player StephCurry calls (2)
*** FLOP ***: [8s 6h Jd]
Player StephCurry checks
Player zboiii checks
*** TURN ***: [8s 6h Jd] [9c]
Player StephCurry bets (4.12)
Player zboiii folds
Uncalled bet (4.12) returned to StephCurry
Player StephCurry mucks cards
------ Summary ------
Pot: 6.18. Rake 0.22. JP fee 0.10
Board: [8s 6h Jd 9c]
Player zboiii does not show cards.Bets: 3. Collects: 0. Loses: 3.
Player ElvenEyes does not show cards.Bets: 0.50. Collects: 0. Loses: 0.50.
*Player StephCurry mucks (does not show cards). Bets: 3. Collects: 6.18. Wins: 3.18.
Player gust does not show cards.Bets: 0. Collects: 0. Wins: 0.
Player pineapplesand does not show cards.Bets: 0. Collects: 0. Wins: 0.
Player IlxxxlI does not show cards.Bets: 0. Collects: 0. Wins: 0.
Player dankmann does not show cards.Bets: 0. Collects: 0. Wins: 0.
Player VegetablesArentYummy does not show cards.Bets: 0. Collects: 0. Wins: 0.
Game ended at: 2016/11/29 14:18:57

Game started
Game ID: 787001890 0.50/1 (PRR) Kraken - 16 (Hold'em)
Seat 2 is the button
Seat 1: GagaPoker (106.43).
Seat 2: MadLifeGrinder (109.35).
Seat 3: Sephiroth1 (106).
Seat 4: Beep_Beep (117.05).
Seat 5: IlxxxlI (40).
Player Sephiroth1 has small blind (0.50)
Player Beep_Beep has big blind (1)
Player IlxxxlI received card: [2c]
Player IlxxxlI received card: [7h]
Player IlxxxlI folds
Player GagaPoker folds
Player MadLifeGrinder raises (2.50)
Player Sephiroth1 raises (8)
Player Beep_Beep folds
Player MadLifeGrinder folds
Uncalled bet (6) returned to Sephiroth1
Player Sephiroth1 mucks cards
------ Summary ------
Pot: 6. Rake 0
Player GagaPoker does not show cards.Bets: 0. Collects: 0. Wins: 0.
Player MadLifeGrinder does not show cards.Bets: 2.50. Collects: 0. Loses: 2.50.
*Player Sephiroth1 mucks (does not show cards). Bets: 2.50. Collects: 6. Wins: 3.50.
Player Beep_Beep does not show cards.Bets: 1. Collects: 0. Loses: 1.
Player IlxxxlI does not show cards.Bets: 0. Collects: 0. Wins: 0.
Game ended at: 2016/11/29 14:18:34

Game started
Game ID: 787001849 0.25/0.50 (PRR) Gorgons - 10 (Hold'em)
Seat 3 is the button
Seat 1: WeakAndWeary (50).
Seat 2: foreseen (226.65).
Seat 3: IampokerKidd (69).
Seat 4: Beep_Beep (52.64).
Seat 5: IlxxxlI (20).
Seat 6: xROCKETMANx (60.37).
Player Beep_Beep has small blind (0.25)
Player IlxxxlI has big blind (0.50)
Player IlxxxlI received card: [Ks]
Player IlxxxlI received card: [3h]
Player xROCKETMANx raises (1.50)
Player WeakAndWeary folds
Player foreseen folds
Player IampokerKidd folds
Player Beep_Beep calls (1.25)
Player IlxxxlI folds
*** FLOP ***: [8s 2s 3s]
Player Beep_Beep checks
Player xROCKETMANx bets (2.22)
Player Beep_Beep folds
Uncalled bet (2.22) returned to xROCKETMANx
Player xROCKETMANx mucks cards
------ Summary ------
Pot: 3.33. Rake 0.13. JP fee 0.04
Board: [8s 2s 3s]
Player WeakAndWeary does not show cards.Bets: 0. Collects: 0. Wins: 0.
Player foreseen does not show cards.Bets: 0. Collects: 0. Wins: 0.
Player IampokerKidd does not show cards.Bets: 0. Collects: 0. Wins: 0.
Player Beep_Beep does not show cards.Bets: 1.50. Collects: 0. Loses: 1.50.
Player IlxxxlI does not show cards.Bets: 0.50. Collects: 0. Loses: 0.50.
*Player xROCKETMANx mucks (does not show cards). Bets: 1.50. Collects: 3.33. Wins: 1.83.
Game ended at: 2016/11/29 14:18:43

Game started
Game ID: 787001796 1/2 (PRR) Lakhey (Hold'em)
Seat 2 is the button
Seat 1: VegetablesArentYummy (263.23).
Seat 2: IlxxxlI (84.55).
Seat 3: IbetUmuck (882.40).
Seat 4: DonCesarGrinder (240.39).
Seat 5: MadLifeGrinder (203).
Player IbetUmuck has small blind (1)
Player DonCesarGrinder has big blind (2)
Player IlxxxlI received card: [9s]
Player IlxxxlI received card: [Qc]
Player MadLifeGrinder folds
Player VegetablesArentYummy raises (5)
Player IlxxxlI folds
Player IbetUmuck folds
Player DonCesarGrinder folds
Uncalled bet (3) returned to VegetablesArentYummy
Player VegetablesArentYummy mucks cards
------ Summary ------
Pot: 5. Rake 0
*Player VegetablesArentYummy mucks (does not show cards). Bets: 2. Collects: 5. Wins: 3.
Player IlxxxlI does not show cards.Bets: 0. Collects: 0. Wins: 0.
Player IbetUmuck does not show cards.Bets: 1. Collects: 0. Loses: 1.
Player DonCesarGrinder does not show cards.Bets: 2. Collects: 0. Loses: 2.
Player MadLifeGrinder does not show cards.Bets: 0. Collects: 0. Wins: 0.
Game ended at: 2016/11/29 14:18:5

Game started
Game ID: 787001795 0.50/1 (PRR) Kraken - 16 (Hold'em)
Seat 1 is the button
Seat 1: GagaPoker (106.43).
Seat 2: MadLifeGrinder (109.85).
Seat 3: Sephiroth1 (105.50).
Seat 4: Beep_Beep (117.05).
Seat 5: IlxxxlI (40).
Player MadLifeGrinder has small blind (0.50)
Player Sephiroth1 has big blind (1)
Player IlxxxlI received card: [8s]
Player IlxxxlI received card: [Jc]
Player Beep_Beep folds
Player IlxxxlI folds
Player GagaPoker folds
Player MadLifeGrinder folds
Uncalled bet (0.50) returned to Sephiroth1
Player Sephiroth1 mucks cards
------ Summary ------
Pot: 1. Rake 0
Player GagaPoker does not show cards.Bets: 0. Collects: 0. Wins: 0.
Player MadLifeGrinder does not show cards.Bets: 0.50. Collects: 0. Loses: 0.50.
*Player Sephiroth1 mucks (does not show cards). Bets: 0.50. Collects: 1. Wins: 0.50.
Player Beep_Beep does not show cards.Bets: 0. Collects: 0. Wins: 0.
Player IlxxxlI does not show cards.Bets: 0. Collects: 0. Wins: 0.
Game ended at: 2016/11/29 14:17:56

Game started
Game ID: 787001738 0.25/0.50 (PRR) Gorgons - 15 (Hold'em)
Seat 1 is the button
Seat 1: WeakAndWeary (52.06).
Seat 2: IampokerKidd (99.52).
Seat 3: imger8 (52.89).
Seat 4: IlxxxlI (20.75).
Seat 5: foreseen (52.70).
Seat 6: BiGFck (11.50).
Player IampokerKidd has small blind (0.25)
Player imger8 has big blind (0.50)
Player IlxxxlI received card: [9d]
Player IlxxxlI received card: [7h]
Player IlxxxlI folds
Player foreseen folds
Player BiGFck folds
Player WeakAndWeary raises (1)
Player IampokerKidd folds
Player imger8 calls (0.50)
*** FLOP ***: [2s 3c Qd]
Player imger8 checks
Player WeakAndWeary checks
*** TURN ***: [2s 3c Qd] [Ah]
Player imger8 checks
Player WeakAndWeary checks
*** RIVER ***: [2s 3c Qd Ah] [6h]
Player imger8 checks
Player WeakAndWeary bets (1.61)
Player imger8 folds
Uncalled bet (1.61) returned to WeakAndWeary
Player WeakAndWeary mucks cards
------ Summary ------
Pot: 2.14. Rake 0.09. JP fee 0.02
Board: [2s 3c Qd Ah 6h]
*Player WeakAndWeary mucks (does not show cards). Bets: 1. Collects: 2.14. Wins: 1.14.
Player IampokerKidd does not show cards.Bets: 0.25. Collects: 0. Loses: 0.25.
Player imger8 does not show cards.Bets: 1. Collects: 0. Loses: 1.
Player IlxxxlI does not show cards.Bets: 0. Collects: 0. Wins: 0.
Player foreseen does not show cards.Bets: 0. Collects: 0. Wins: 0.
Player BiGFck does not show cards.Bets: 0. Collects: 0. Wins: 0.
Game ended at: 2016/11/29 14:19:0

Game started
Game ID: 787001704 0.50/1 (PRR) Karkadann - 3 (Hold'em)
Seat 9 is the button
Seat 1: zboiii (126.12).
Seat 2: ElvenEyes (147.36).
Seat 3: StephCurry (100).
Seat 4: gust (40).
Seat 5: pineapplesand (47.46).
Seat 7: IlxxxlI (40).
Seat 8: dankmann (165.01).
Seat 9: VegetablesArentYummy (266.17).
Player zboiii has small blind (0.50)
Player ElvenEyes has big blind (1)
Player IlxxxlI received card: [Jh]
Player IlxxxlI received card: [Kd]
Player StephCurry folds
Player gust folds
Player pineapplesand folds
Player IlxxxlI raises (3.50)
Player dankmann folds
Player VegetablesArentYummy folds
Player zboiii folds
Player ElvenEyes folds
Uncalled bet (2.50) returned to IlxxxlI
Player IlxxxlI mucks cards
------ Summary ------
Pot: 2.50. Rake 0
Player zboiii does not show cards.Bets: 0.50. Collects: 0. Loses: 0.50.
Player ElvenEyes does not show cards.Bets: 1. Collects: 0. Loses: 1.
Player StephCurry does not show cards.Bets: 0. Collects: 0. Wins: 0.
Player gust does not show cards.Bets: 0. Collects: 0. Wins: 0.
Player pineapplesand does not show cards.Bets: 0. Collects: 0. Wins: 0.
*Player IlxxxlI mucks (does not show cards). Bets: 1. Collects: 2.50. Wins: 1.50.
Player dankmann does not show cards.Bets: 0. Collects: 0. Wins: 0.
Player VegetablesArentYummy does not show cards.Bets: 0. Collects: 0. Wins: 0.
Game ended at: 2016/11/29 14:18:3

Game started
Game ID: 787001693 1/2 (PRR) Lakhey (Hold'em)
Seat 1 is the button
Seat 1: VegetablesArentYummy (263.23).
Seat 2: IlxxxlI (85.55).
Seat 3: IbetUmuck (884.40).
Seat 4: DonCesarGrinder (240.39).
Seat 5: MadLifeGrinder (200).
Player IlxxxlI has small blind (1)
Player IbetUmuck has big blind (2)
Player IlxxxlI received card: [Jc]
Player IlxxxlI received card: [4c]
Player DonCesarGrinder folds
Player MadLifeGrinder raises (5)
Player VegetablesArentYummy folds
Player IlxxxlI folds
Player IbetUmuck folds
Uncalled bet (3) returned to MadLifeGrinder
Player MadLifeGrinder mucks cards
------ Summary ------
Pot: 5. Rake 0
Player VegetablesArentYummy does not show cards.Bets: 0. Collects: 0. Wins: 0.
Player IlxxxlI does not show cards.Bets: 1. Collects: 0. Loses: 1.
Player IbetUmuck does not show cards.Bets: 2. Collects: 0. Loses: 2.
Player DonCesarGrinder does not show cards.Bets: 0. Collects: 0. Wins: 0.
*Player MadLifeGrinder mucks (does not show cards). Bets: 2. Collects: 5. Wins: 3.
Game ended at: 2016/11/29 14:17:45

Game started
Game ID: 787001648 0.50/1 (PRR) Kraken (Hold'em)
Seat 3 is the button
Seat 1: WeakAndWeary (181.36).
Seat 2: MadLifeGrinder (100).
Seat 3: Sephiroth1 (146.13).
Seat 4: IlxxxlI (40.50).
Seat 5: gust (43.58).
Seat 6: ElvenEyes (113.61).
Player IlxxxlI has small blind (0.50)
Player gust has big blind (1)
Player IlxxxlI received card: [10d]
Player IlxxxlI received card: [Ac]
Player ElvenEyes raises (2)
Player WeakAndWeary folds
Player MadLifeGrinder folds
Player Sephiroth1 folds
Player IlxxxlI folds
Player gust folds
Uncalled bet (1) returned to ElvenEyes
Player ElvenEyes mucks cards
------ Summary ------
Pot: 2.50. Rake 0
Player WeakAndWeary does not show cards.Bets: 0. Collects: 0. Wins: 0.
Player MadLifeGrinder does not show cards.Bets: 0. Collects: 0. Wins: 0.
Player Sephiroth1 does not show cards.Bets: 0. Collects: 0. Wins: 0.
Player IlxxxlI does not show cards.Bets: 0.50. Collects: 0. Loses: 0.50.
Player gust does not show cards.Bets: 1. Collects: 0. Loses: 1.
*Player ElvenEyes mucks (does not show cards). Bets: 1. Collects: 2.50. Wins: 1.50.
Game ended at: 2016/11/29 14:18:7

Game started
Game ID: 787001608 1/2 (PRR) Lakhey (Hold'em)
Seat 5 is the button
Seat 1: VegetablesArentYummy (264.23).
Seat 2: IlxxxlI (84.55).
Seat 3: IbetUmuck (884.40).
Seat 4: DonCesarGrinder (240.39).
Seat 5: MadLifeGrinder (200).
Player VegetablesArentYummy has small blind (1)
Player IlxxxlI has big blind (2)
Player IlxxxlI received card: [9c]
Player IlxxxlI received card: [3h]
Player IbetUmuck folds
Player DonCesarGrinder folds
Player MadLifeGrinder folds
Player VegetablesArentYummy folds
Uncalled bet (1) returned to IlxxxlI
Player IlxxxlI mucks cards
------ Summary ------
Pot: 2. Rake 0
Player VegetablesArentYummy does not show cards.Bets: 1. Collects: 0. Loses: 1.
*Player IlxxxlI mucks (does not show cards). Bets: 1. Collects: 2. Wins: 1.
Player IbetUmuck does not show cards.Bets: 0. Collects: 0. Wins: 0.
Player DonCesarGrinder does not show cards.Bets: 0. Collects: 0. Wins: 0.
Player MadLifeGrinder does not show cards.Bets: 0. Collects: 0. Wins: 0.
Game ended at: 2016/11/29 14:17:28

Game started
Game ID: 787001583 0.50/1 (PRR) Kraken - 23 (Hold'em)
Seat 5 is the button
Seat 1: WeakAndWeary (100).
Seat 3: LloydXmas (123.23).
Seat 4: Sephiroth1 (100).
Seat 5: ElvenEyes (119.45).
Seat 6: IlxxxlI (40).
Player IlxxxlI has small blind (0.50)
Player WeakAndWeary has big blind (1)
Player IlxxxlI received card: [Ks]
Player IlxxxlI received card: [3s]
Player LloydXmas folds
Player Sephiroth1 folds
Player ElvenEyes folds
Player IlxxxlI calls (0.50)
Player WeakAndWeary checks
*** FLOP ***: [10c 8h 9d]
Player IlxxxlI checks
Player WeakAndWeary bets (1.27)
Player IlxxxlI folds
Uncalled bet (1.27) returned to WeakAndWeary
Player WeakAndWeary mucks cards
------ Summary ------
Pot: 1.90. Rake 0.08. JP fee 0.02
Board: [10c 8h 9d]
*Player WeakAndWeary mucks (does not show cards). Bets: 1. Collects: 1.90. Wins: 0.90.
Player LloydXmas does not show cards.Bets: 0. Collects: 0. Wins: 0.
Player Sephiroth1 does not show cards.Bets: 0. Collects: 0. Wins: 0.
Player ElvenEyes does not show cards.Bets: 0. Collects: 0. Wins: 0.
Player IlxxxlI does not show cards.Bets: 1. Collects: 0. Loses: 1.
Game ended at: 2016/11/29 14:18:9

Game started
Game ID: 787001568 0.50/1 (PRR) Kraken - 16 (Hold'em)
Seat 5 is the button
Seat 1: GagaPoker (106.93).
Seat 2: MadLifeGrinder (110.85).
Seat 3: Sephiroth1 (105.50).
Seat 4: Beep_Beep (115.55).
Seat 5: IlxxxlI (40).
Player GagaPoker has small blind (0.50)
Player MadLifeGrinder has big blind (1)
Player IlxxxlI received card: [10h]
Player IlxxxlI received card: [7d]
Player Sephiroth1 folds
Player Beep_Beep raises (3)
Player IlxxxlI folds
Player GagaPoker folds
Player MadLifeGrinder folds
Uncalled bet (2) returned to Beep_Beep
Player Beep_Beep mucks cards
------ Summary ------
Pot: 2.50. Rake 0
Player GagaPoker does not show cards.Bets: 0.50. Collects: 0. Loses: 0.50.
Player MadLifeGrinder does not show cards.Bets: 1. Collects: 0. Loses: 1.
Player Sephiroth1 does not show cards.Bets: 0. Collects: 0. Wins: 0.
*Player Beep_Beep mucks (does not show cards). Bets: 1. Collects: 2.50. Wins: 1.50.
Player IlxxxlI does not show cards.Bets: 0. Collects: 0. Wins: 0.
Game ended at: 2016/11/29 14:17:44

Game started
Game ID: 787001569 0.25/0.50 (PRR) Gorgons - 8 (Hold'em)
Seat 6 is the button
Seat 3: foreseen (54.50).
Seat 4: IlxxxlI (20).
Seat 5: Beep_Beep (102.07).
Seat 6: Jui Kuen (64.79).
Player foreseen has small blind (0.25)
Player IlxxxlI has big blind (0.50)
Player IlxxxlI received card: [10s]
Player IlxxxlI received card: [Js]
Player Beep_Beep folds
Player Jui Kuen folds
Player foreseen raises (1.39)
Player IlxxxlI calls (1.14)
*** FLOP ***: [5h 7h Jd]
Player foreseen bets (1.64)
Player IlxxxlI raises (4)
Player foreseen calls (2.36)
*** TURN ***: [5h 7h Jd] [As]
Player foreseen checks
Player IlxxxlI checks
*** RIVER ***: [5h 7h Jd As] [6d]
Player foreseen bets (8.68)
Player IlxxxlI calls (8.68)
Player IlxxxlI mucks cards
------ Summary ------
Pot: 27.21. Rake 1.19. JP fee 0.24
Board: [5h 7h Jd As 6d]
*Player foreseen shows: Two pairs. As and 7s [7d Ah]. Bets: 14.32. Collects: 27.21. Wins: 12.89.
Player IlxxxlI mucks (does not show: [10s Js]). Bets: 14.32. Collects: 0. Loses: 14.32.
Player Beep_Beep does not show cards.Bets: 0. Collects: 0. Wins: 0.
Player Jui Kuen does not show cards.Bets: 0. Collects: 0. Wins: 0.
Game ended at: 2016/11/29 14:19:6

Game started
Game ID: 787001510 1/2 (PRR) Longana (Short) - 2 (Hold'em)
Seat 5 is the button
Seat 1: actionjax24 (117.51).
Seat 2: BiGFck (83.35).
Seat 3: VegetablesArentYummy (129.65).
Seat 4: gust (80).
Seat 5: thimk (52.37).
Seat 6: IlxxxlI (40).
Seat 7: pineapplesand (40).
Seat 8: StephCurry (112.50).
Seat 9: hotshothotgg (58.48).
Player IlxxxlI has small blind (1)
Player pineapplesand has big blind (2)
Player IlxxxlI received card: [8c]
Player IlxxxlI received card: [Ks]
Player StephCurry folds
Player hotshothotgg folds
Player actionjax24 folds
Player BiGFck folds
Player VegetablesArentYummy raises (5)
Player gust folds
Player thimk folds
Player IlxxxlI folds
Player pineapplesand calls (3)
*** FLOP ***: [2s 6c 4d]
Player pineapplesand checks
Player VegetablesArentYummy checks
*** TURN ***: [2s 6c 4d] [4s]
Player pineapplesand checks
Player VegetablesArentYummy bets (5.22)
Player pineapplesand folds
Uncalled bet (5.22) returned to VegetablesArentYummy
Player VegetablesArentYummy mucks cards
------ Summary ------
Pot: 10.45. Rake 0.37. JP fee 0.18
Board: [2s 6c 4d 4s]
Player actionjax24 does not show cards.Bets: 0. Collects: 0. Wins: 0.
Player BiGFck does not show cards.Bets: 0. Collects: 0. Wins: 0.
*Player VegetablesArentYummy mucks (does not show cards). Bets: 5. Collects: 10.45. Wins: 5.45.
Player gust does not show cards.Bets: 0. Collects: 0. Wins: 0.
Player thimk does not show cards.Bets: 0. Collects: 0. Wins: 0.
Player IlxxxlI does not show cards.Bets: 1. Collects: 0. Loses: 1.
Player pineapplesand does not show cards.Bets: 5. Collects: 0. Loses: 5.
Player StephCurry does not show cards.Bets: 0. Collects: 0. Wins: 0.
Player hotshothotgg does not show cards.Bets: 0. Collects: 0. Wins: 0.
Game ended at: 2016/11/29 14:19:7

Game started
Game ID: 787001465 0.50/1 (PRR) Kraken (Hold'em)
Seat 2 is the button
Seat 1: WeakAndWeary (181.36).
Seat 2: MadLifeGrinder (100).
Seat 3: Sephiroth1 (146.63).
Seat 4: IlxxxlI (40).
Seat 6: ElvenEyes (113.61).
Player Sephiroth1 has small blind (0.50)
Player IlxxxlI has big blind (1)
Player IlxxxlI received card: [5c]
Player IlxxxlI received card: [6h]
Player ElvenEyes folds
Player WeakAndWeary folds
Player MadLifeGrinder folds
Player Sephiroth1 folds
Uncalled bet (0.50) returned to IlxxxlI
Player IlxxxlI mucks cards
------ Summary ------
Pot: 1. Rake 0
Player WeakAndWeary does not show cards.Bets: 0. Collects: 0. Wins: 0.
Player MadLifeGrinder does not show cards.Bets: 0. Collects: 0. Wins: 0.
Player Sephiroth1 does not show cards.Bets: 0.50. Collects: 0. Loses: 0.50.
*Player IlxxxlI mucks (does not show cards). Bets: 0.50. Collects: 1. Wins: 0.50.
Player ElvenEyes does not show cards.Bets: 0. Collects: 0. Wins: 0.
Game ended at: 2016/11/29 14:17:22

Game started
Game ID: 787001457 0.25/0.50 (PRR) Gorgons - 15 (Hold'em)
Seat 6 is the button
Seat 1: WeakAndWeary (52.31).
Seat 2: IampokerKidd (99.27).
Seat 3: imger8 (52.89).
Seat 4: IlxxxlI (20.75).
Seat 5: foreseen (52.70).
Seat 6: BiGFck (11.50).
Player WeakAndWeary has small blind (0.25)
Player IampokerKidd has big blind (0.50)
Player IlxxxlI received card: [4c]
Player IlxxxlI received card: [2c]
Player imger8 folds
Player IlxxxlI folds
Player foreseen folds
Player BiGFck folds
Player WeakAndWeary folds
Uncalled bet (0.25) returned to IampokerKidd
Player IampokerKidd mucks cards
------ Summary ------
Pot: 0.50. Rake 0
Player WeakAndWeary does not show cards.Bets: 0.25. Collects: 0. Loses: 0.25.
*Player IampokerKidd mucks (does not show cards). Bets: 0.25. Collects: 0.50. Wins: 0.25.
Player imger8 does not show cards.Bets: 0. Collects: 0. Wins: 0.
Player IlxxxlI does not show cards.Bets: 0. Collects: 0. Wins: 0.
Player foreseen does not show cards.Bets: 0. Collects: 0. Wins: 0.
Player BiGFck does not show cards.Bets: 0. Collects: 0. Wins: 0.
Game ended at: 2016/11/29 14:17:35

Game started
Game ID: 787001419 0.50/1 (PRR) Kraken - 16 (Hold'em)
Seat 4 is the button
Seat 1: GagaPoker (107.93).
Seat 2: MadLifeGrinder (110.85).
Seat 3: Sephiroth1 (105.50).
Seat 4: Beep_Beep (114.05).
Seat 5: IlxxxlI (40).
Player IlxxxlI has small blind (0.50)
Player GagaPoker has big blind (1)
Player IlxxxlI received card: [8h]
Player IlxxxlI received card: [10s]
Player MadLifeGrinder folds
Player Sephiroth1 folds
Player Beep_Beep raises (3)
Player IlxxxlI folds
Player GagaPoker folds
Uncalled bet (2) returned to Beep_Beep
Player Beep_Beep mucks cards
------ Summary ------
Pot: 2.50. Rake 0
Player GagaPoker does not show cards.Bets: 1. Collects: 0. Loses: 1.
Player MadLifeGrinder does not show cards.Bets: 0. Collects: 0. Wins: 0.
Player Sephiroth1 does not show cards.Bets: 0. Collects: 0. Wins: 0.
*Player Beep_Beep mucks (does not show cards). Bets: 1. Collects: 2.50. Wins: 1.50.
Player IlxxxlI does not show cards.Bets: 0.50. Collects: 0. Loses: 0.50.
Game ended at: 2016/11/29 14:17:11

Game started
Game ID: 787001210 0.50/1 (PRR) Kraken - 16 (Hold'em)
Seat 3 is the button
Seat 1: GagaPoker (107.93).
Seat 2: MadLifeGrinder (110.85).
Seat 3: Sephiroth1 (105.50).
Seat 4: Beep_Beep (113.05).
Seat 5: IlxxxlI (40).
Player Beep_Beep has small blind (0.50)
Player IlxxxlI has big blind (1)
Player IlxxxlI received card: [10s]
Player IlxxxlI received card: [4c]
Player GagaPoker folds
Player MadLifeGrinder folds
Player Sephiroth1 folds
Player Beep_Beep raises (2.50)
Player IlxxxlI folds
Uncalled bet (2) returned to Beep_Beep
Player Beep_Beep mucks cards
------ Summary ------
Pot: 2. Rake 0
Player GagaPoker does not show cards.Bets: 0. Collects: 0. Wins: 0.
Player MadLifeGrinder does not show cards.Bets: 0. Collects: 0. Wins: 0.
Player Sephiroth1 does not show cards.Bets: 0. Collects: 0. Wins: 0.
*Player Beep_Beep mucks (does not show cards). Bets: 1. Collects: 2. Wins: 1.
Player IlxxxlI does not show cards.Bets: 1. Collects: 0. Loses: 1.
Game ended at: 2016/11/29 14:16:47

Game started
Game ID: 787001184 0.25/0.50 (PRR) Gorgons - 15 (Hold'em)
Seat 5 is the button
Seat 1: WeakAndWeary (52.81).
Seat 2: IampokerKidd (99.27).
Seat 3: imger8 (52.89).
Seat 4: IlxxxlI (20).
Seat 5: foreseen (52.70).
Seat 6: BiGFck (11.75).
Player BiGFck has small blind (0.25)
Player WeakAndWeary has big blind (0.50)
Player IlxxxlI received card: [Ks]
Player IlxxxlI received card: [Jh]
Player IampokerKidd folds
Player imger8 folds
Player IlxxxlI raises (1.20)
Player foreseen folds
Player BiGFck folds
Player WeakAndWeary folds
Uncalled bet (0.70) returned to IlxxxlI
Player IlxxxlI mucks cards
------ Summary ------
Pot: 1.25. Rake 0
Player WeakAndWeary does not show cards.Bets: 0.50. Collects: 0. Loses: 0.50.
Player IampokerKidd does not show cards.Bets: 0. Collects: 0. Wins: 0.
Player imger8 does not show cards.Bets: 0. Collects: 0. Wins: 0.
*Player IlxxxlI mucks (does not show cards). Bets: 0.50. Collects: 1.25. Wins: 0.75.
Player foreseen does not show cards.Bets: 0. Collects: 0. Wins: 0.
Player BiGFck does not show cards.Bets: 0.25. Collects: 0. Loses: 0.25.
Game ended at: 2016/11/29 14:16:53

Game started
Game ID: 787001013 0.50/1 (PRR) Karkadann - 3 (Hold'em)
Seat 8 is the button
Seat 1: zboiii (123.84).
Seat 2: ElvenEyes (147.36).
Seat 3: StephCurry (100).
Seat 4: gust (40).
Seat 5: pineapplesand (47.46).
Seat 7: IlxxxlI (40).
Seat 8: dankmann (165.01).
Seat 9: VegetablesArentYummy (266.67).
Player VegetablesArentYummy has small blind (0.50)
Player zboiii has big blind (1)
Player IlxxxlI received card: [2d]
Player IlxxxlI received card: [7d]
Player ElvenEyes folds
Player StephCurry folds
Player gust raises (2)
Player pineapplesand folds
Player IlxxxlI folds
Player dankmann folds
Player VegetablesArentYummy folds
Player zboiii calls (1)
*** FLOP ***: [Qd 8d 9s]
Player zboiii checks
Player gust checks
*** TURN ***: [Qd 8d 9s] [5h]
Player zboiii checks
Player gust checks
*** RIVER ***: [Qd 8d 9s 5h] [2s]
Player zboiii checks
Player gust checks
Player gust mucks cards
------ Summary ------
Pot: 4.28. Rake 0.16. JP fee 0.06
Board: [Qd 8d 9s 5h 2s]
*Player zboiii shows: One pair of 5s [5d 4s]. Bets: 2. Collects: 4.28. Wins: 2.28.
Player ElvenEyes does not show cards.Bets: 0. Collects: 0. Wins: 0.
Player StephCurry does not show cards.Bets: 0. Collects: 0. Wins: 0.
Player gust mucks (does not show cards). Bets: 2. Collects: 0. Loses: 2.
Player pineapplesand does not show cards.Bets: 0. Collects: 0. Wins: 0.
Player IlxxxlI does not show cards.Bets: 0. Collects: 0. Wins: 0.
Player dankmann does not show cards.Bets: 0. Collects: 0. Wins: 0.
Player VegetablesArentYummy does not show cards.Bets: 0.50. Collects: 0. Loses: 0.50.
Game ended at: 2016/11/29 14:17:29

Game started
Game ID: 787000969 1/2 (PRR) Longana (Short) - 2 (Hold'em)
Seat 4 is the button
Seat 1: actionjax24 (117.51).
Seat 2: BiGFck (26.45).
Seat 3: VegetablesArentYummy (129.65).
Seat 4: gust (80).
Seat 5: thimk (53.37).
Seat 6: IlxxxlI (46).
Seat 8: StephCurry (118.50).
Seat 9: hotshothotgg (58.48).
Player thimk has small blind (1)
Player IlxxxlI has big blind (2)
Player IlxxxlI received card: [As]
Player IlxxxlI received card: [Ac]
Player StephCurry raises (6)
Player hotshothotgg folds
Player actionjax24 folds
Player BiGFck allin (26.45)
Player VegetablesArentYummy folds
Player gust calls (26.45)
Player thimk folds
Player IlxxxlI allin (44)
Player StephCurry folds
Player gust calls (19.55)
*** FLOP ***: [7d 7c Jc]
*** TURN ***: [7d 7c Jc] [8s]
*** RIVER ***: [7d 7c Jc 8s] [6d]
------ Summary ------
Pot: 122.45. Rake 2.76. JP fee 0.24
Board: [7d 7c Jc 8s 6d]
Player actionjax24 does not show cards.Bets: 0. Collects: 0. Wins: 0.
*Player BiGFck shows: Full House (6/7) [6c 6s]. Bets: 26.45. Collects: 83.35. Wins: 56.90.
Player VegetablesArentYummy does not show cards.Bets: 0. Collects: 0. Wins: 0.
Player gust shows: Two pairs. Ks and 7s [Kh Kd]. Bets: 46. Collects: 0. Loses: 46.
Player thimk does not show cards.Bets: 1. Collects: 0. Loses: 1.
*Player IlxxxlI shows: Two pairs. As and 7s [As Ac]. Bets: 46. Collects: 39.10. Loses: 6.90.
Player StephCurry does not show cards.Bets: 6. Collects: 0. Loses: 6.
Player hotshothotgg does not show cards.Bets: 0. Collects: 0. Wins: 0.
Game ended at: 2016/11/29 14:17:2

Game started
Game ID: 787000900 1/2 (PRR) Lakhey (Hold'em)
Seat 4 is the button
Seat 1: VegetablesArentYummy (239.30).
Seat 2: IlxxxlI (84.55).
Seat 3: IbetUmuck (884.40).
Seat 4: DonCesarGrinder (240.39).
Seat 5: MadLifeGrinder (218.48).
Player MadLifeGrinder has small blind (1)
Player VegetablesArentYummy has big blind (2)
Player IlxxxlI received card: [9c]
Player IlxxxlI received card: [5s]
Player IlxxxlI folds
Player IbetUmuck folds
Player DonCesarGrinder folds
Player MadLifeGrinder raises (5)
Player VegetablesArentYummy calls (4)
*** FLOP ***: [3d Kh Jc]
Player MadLifeGrinder bets (5.70)
Player VegetablesArentYummy calls (5.70)
*** TURN ***: [3d Kh Jc] [Qd]
Player MadLifeGrinder bets (16)
Player VegetablesArentYummy calls (16)
*** RIVER ***: [3d Kh Jc Qd] [9s]
Player MadLifeGrinder checks
Player VegetablesArentYummy bets (40.08)
Player MadLifeGrinder folds
Uncalled bet (40.08) returned to VegetablesArentYummy
Player VegetablesArentYummy mucks cards
------ Summary ------
Pot: 52.63. Rake 2.53. JP fee 0.24
Board: [3d Kh Jc Qd 9s]
*Player VegetablesArentYummy mucks (does not show cards). Bets: 27.70. Collects: 52.63. Wins: 24.93.
Player IlxxxlI does not show cards.Bets: 0. Collects: 0. Wins: 0.
Player IbetUmuck does not show cards.Bets: 0. Collects: 0. Wins: 0.
Player DonCesarGrinder does not show cards.Bets: 0. Collects: 0. Wins: 0.
Player MadLifeGrinder does not show cards.Bets: 27.70. Collects: 0. Loses: 27.70.
Game ended at: 2016/11/29 14:17:17

Game started
Game ID: 787000887 0.25/0.50 (PRR) Gorgons - 15 (Hold'em)
Seat 4 is the button
Seat 1: WeakAndWeary (52.81).
Seat 2: IampokerKidd (99.27).
Seat 3: imger8 (52.89).
Seat 4: IlxxxlI (20).
Seat 5: foreseen (52.95).
Seat 6: BiGFck (11.50).
Player foreseen has small blind (0.25)
Player BiGFck has big blind (0.50)
Player IlxxxlI received card: [6c]
Player IlxxxlI received card: [7d]
Player WeakAndWeary folds
Player IampokerKidd folds
Player imger8 folds
Player IlxxxlI folds
Player foreseen folds
Uncalled bet (0.25) returned to BiGFck
Player BiGFck mucks cards
------ Summary ------
Pot: 0.50. Rake 0
Player WeakAndWeary does not show cards.Bets: 0. Collects: 0. Wins: 0.
Player IampokerKidd does not show cards.Bets: 0. Collects: 0. Wins: 0.
Player imger8 does not show cards.Bets: 0. Collects: 0. Wins: 0.
Player IlxxxlI does not show cards.Bets: 0. Collects: 0. Wins: 0.
Player foreseen does not show cards.Bets: 0.25. Collects: 0. Loses: 0.25.
*Player BiGFck mucks (does not show cards). Bets: 0.25. Collects: 0.50. Wins: 0.25.
Game ended at: 2016/11/29 14:16:13

Game started
Game ID: 787000847 0.50/1 (PRR) Kraken - 23 (Hold'em)
Seat 4 is the button
Seat 1: WeakAndWeary (115.79).
Seat 3: LloydXmas (101.55).
Seat 4: Sephiroth1 (100).
Seat 5: ElvenEyes (119.95).
Seat 6: IlxxxlI (40.64).
Player ElvenEyes has small blind (0.50)
Player IlxxxlI has big blind (1)
Player IlxxxlI received card: [10c]
Player IlxxxlI received card: [Qd]
Player WeakAndWeary raises (3)
Player LloydXmas raises (10.50)
Player Sephiroth1 folds
Player ElvenEyes folds
Player IlxxxlI folds
Player WeakAndWeary calls (7.50)
*** FLOP ***: [8s 2d 6d]
Player WeakAndWeary checks
Player LloydXmas bets (12)
Player WeakAndWeary calls (12)
*** TURN ***: [8s 2d 6d] [6c]
Player WeakAndWeary checks
Player LloydXmas bets (32)
Player WeakAndWeary folds
Uncalled bet (32) returned to LloydXmas
Player LloydXmas mucks cards
------ Summary ------
Pot: 44.18. Rake 2.08. JP fee 0.24
Board: [8s 2d 6d 6c]
Player WeakAndWeary does not show cards.Bets: 22.50. Collects: 0. Loses: 22.50.
*Player LloydXmas mucks (does not show cards). Bets: 22.50. Collects: 44.18. Wins: 21.68.
Player Sephiroth1 does not show cards.Bets: 0. Collects: 0. Wins: 0.
Player ElvenEyes does not show cards.Bets: 0.50. Collects: 0. Loses: 0.50.
Player IlxxxlI does not show cards.Bets: 1. Collects: 0. Loses: 1.
Game ended at: 2016/11/29 14:17:13

Game started
Game ID: 787000763 1/2 (PRR) Longana (Short) - 2 (Hold'em)
Seat 3 is the button
Seat 1: actionjax24 (117.51).
Seat 2: BiGFck (26.45).
Seat 3: VegetablesArentYummy (129.65).
Seat 4: gust (80).
Seat 5: thimk (55.37).
Seat 6: IlxxxlI (46).
Seat 8: StephCurry (115.50).
Seat 9: hotshothotgg (58.48).
Player gust has small blind (1)
Player thimk has big blind (2)
Player IlxxxlI received card: [3s]
Player IlxxxlI received card: [2h]
Player IlxxxlI folds
Player StephCurry raises (6)
Player hotshothotgg folds
Player actionjax24 folds
Player BiGFck folds
Player VegetablesArentYummy folds
Player gust folds
Player thimk folds
Uncalled bet (4) returned to StephCurry
Player StephCurry mucks cards
------ Summary ------
Pot: 5. Rake 0
Player actionjax24 does not show cards.Bets: 0. Collects: 0. Wins: 0.
Player BiGFck does not show cards.Bets: 0. Collects: 0. Wins: 0.
Player VegetablesArentYummy does not show cards.Bets: 0. Collects: 0. Wins: 0.
Player gust does not show cards.Bets: 1. Collects: 0. Loses: 1.
Player thimk does not show cards.Bets: 2. Collects: 0. Loses: 2.
Player IlxxxlI does not show cards.Bets: 0. Collects: 0. Wins: 0.
*Player StephCurry mucks (does not show cards). Bets: 2. Collects: 5. Wins: 3.
Player hotshothotgg does not show cards.Bets: 0. Collects: 0. Wins: 0.
Game ended at: 2016/11/29 14:15:42

Game started
Game ID: 787000707 1/2 (PRR) Lakhey (Hold'em)
Seat 3 is the button
Seat 1: VegetablesArentYummy (236.30).
Seat 2: IlxxxlI (84.55).
Seat 3: IbetUmuck (884.40).
Seat 4: DonCesarGrinder (241.39).
Seat 5: MadLifeGrinder (220.48).
Player DonCesarGrinder has small blind (1)
Player MadLifeGrinder has big blind (2)
Player IlxxxlI received card: [Jh]
Player IlxxxlI received card: [Ks]
Player VegetablesArentYummy raises (5)
Player IlxxxlI folds
Player IbetUmuck folds
Player DonCesarGrinder folds
Player MadLifeGrinder folds
Uncalled bet (3) returned to VegetablesArentYummy
Player VegetablesArentYummy mucks cards
------ Summary ------
Pot: 5. Rake 0
*Player VegetablesArentYummy mucks (does not show cards). Bets: 2. Collects: 5. Wins: 3.
Player IlxxxlI does not show cards.Bets: 0. Collects: 0. Wins: 0.
Player IbetUmuck does not show cards.Bets: 0. Collects: 0. Wins: 0.
Player DonCesarGrinder does not show cards.Bets: 1. Collects: 0. Loses: 1.
Player MadLifeGrinder does not show cards.Bets: 2. Collects: 0. Loses: 2.
Game ended at: 2016/11/29 14:15:33

Game started
Game ID: 787000620 0.25/0.50 (PRR) Gorgons - 15 (Hold'em)
Seat 3 is the button
Seat 1: WeakAndWeary (52.81).
Seat 2: IampokerKidd (99.27).
Seat 3: imger8 (52.14).
Seat 4: IlxxxlI (20.25).
Seat 5: foreseen (53.45).
Seat 6: BiGFck (11.50).
Player IlxxxlI has small blind (0.25)
Player foreseen has big blind (0.50)
Player IlxxxlI received card: [Kd]
Player IlxxxlI received card: [3h]
Player BiGFck folds
Player WeakAndWeary folds
Player IampokerKidd folds
Player imger8 raises (1.50)
Player IlxxxlI folds
Player foreseen folds
Uncalled bet (1) returned to imger8
Player imger8 mucks cards
------ Summary ------
Pot: 1.25. Rake 0
Player WeakAndWeary does not show cards.Bets: 0. Collects: 0. Wins: 0.
Player IampokerKidd does not show cards.Bets: 0. Collects: 0. Wins: 0.
*Player imger8 mucks (does not show cards). Bets: 0.50. Collects: 1.25. Wins: 0.75.
Player IlxxxlI does not show cards.Bets: 0.25. Collects: 0. Loses: 0.25.
Player foreseen does not show cards.Bets: 0.50. Collects: 0. Loses: 0.50.
Player BiGFck does not show cards.Bets: 0. Collects: 0. Wins: 0.
Game ended at: 2016/11/29 14:15:30

Game started
Game ID: 787000545 0.50/1 (PRR) Kraken - 17 (Hold'em)
Seat 5 is the button
Seat 2: Sephiroth1 (103.61).
Seat 5: IlxxxlI (40).
Player IlxxxlI has small blind (0.50)
Player Sephiroth1 has big blind (1)
Player IlxxxlI received card: [2d]
Player IlxxxlI received card: [Jd]
Player IlxxxlI calls (0.50)
Player Sephiroth1 checks
*** FLOP ***: [3h 5s Qs]
Player Sephiroth1 checks
Player IlxxxlI bets (1)
Player Sephiroth1 calls (1)
*** TURN ***: [3h 5s Qs] [10d]
Player Sephiroth1 checks
Player IlxxxlI checks
*** RIVER ***: [3h 5s Qs 10d] [2c]
Player Sephiroth1 checks
Player IlxxxlI checks
Player IlxxxlI mucks cards
------ Summary ------
Pot: 3.80. Rake 0.16. JP fee 0.04
Board: [3h 5s Qs 10d 2c]
*Player Sephiroth1 shows: One pair of 3s [3s 9h]. Bets: 2. Collects: 3.80. Wins: 1.80.
Player IlxxxlI mucks (does not show: [2d Jd]). Bets: 2. Collects: 0. Loses: 2.
Game ended at: 2016/11/29 14:15:21

Game started
Game ID: 787000492 0.50/1 (PRR) Kraken - 23 (Hold'em)
Seat 3 is the button
Seat 1: WeakAndWeary (115.79).
Seat 2: gust (49).
Seat 3: LloydXmas (101.55).
Seat 4: Sephiroth1 (100).
Seat 5: ElvenEyes (119.45).
Seat 6: IlxxxlI (40.64).
Player Sephiroth1 has small blind (0.50)
Player ElvenEyes has big blind (1)
Player IlxxxlI received card: [3s]
Player IlxxxlI received card: [6s]
Player IlxxxlI folds
Player WeakAndWeary folds
Player gust is timed out.
Player gust folds
Player LloydXmas folds
Player Sephiroth1 folds
Uncalled bet (0.50) returned to ElvenEyes
Player ElvenEyes mucks cards
------ Summary ------
Pot: 1. Rake 0
Player WeakAndWeary does not show cards.Bets: 0. Collects: 0. Wins: 0.
Player gust does not show cards.Bets: 0. Collects: 0. Wins: 0.
Player LloydXmas does not show cards.Bets: 0. Collects: 0. Wins: 0.
Player Sephiroth1 does not show cards.Bets: 0.50. Collects: 0. Loses: 0.50.
*Player ElvenEyes mucks (does not show cards). Bets: 0.50. Collects: 1. Wins: 0.50.
Player IlxxxlI does not show cards.Bets: 0. Collects: 0. Wins: 0.
Game ended at: 2016/11/29 14:15:26

Game started
Game ID: 787000477 1/2 (PRR) Lakhey (Hold'em)
Seat 2 is the button
Seat 1: VegetablesArentYummy (236.30).
Seat 2: IlxxxlI (80).
Seat 3: IbetUmuck (885.40).
Seat 4: DonCesarGrinder (245.39).
Seat 5: MadLifeGrinder (220.48).
Player IbetUmuck has small blind (1)
Player DonCesarGrinder has big blind (2)
Player IlxxxlI received card: [4h]
Player IlxxxlI received card: [Ac]
Player MadLifeGrinder folds
Player VegetablesArentYummy folds
Player IlxxxlI raises (4)
Player IbetUmuck folds
Player DonCesarGrinder calls (2)
*** FLOP ***: [7c 7h 4d]
Player DonCesarGrinder checks
Player IlxxxlI bets (4.45)
Player DonCesarGrinder folds
Uncalled bet (4.45) returned to IlxxxlI
Player IlxxxlI mucks cards
------ Summary ------
Pot: 8.55. Rake 0.31. JP fee 0.14
Board: [7c 7h 4d]
Player VegetablesArentYummy does not show cards.Bets: 0. Collects: 0. Wins: 0.
*Player IlxxxlI mucks (does not show cards). Bets: 4. Collects: 8.55. Wins: 4.55.
Player IbetUmuck does not show cards.Bets: 1. Collects: 0. Loses: 1.
Player DonCesarGrinder does not show cards.Bets: 4. Collects: 0. Loses: 4.
Player MadLifeGrinder does not show cards.Bets: 0. Collects: 0. Wins: 0.
Game ended at: 2016/11/29 14:15:5

Game started
Game ID: 787000461 0.50/1 (PRR) Kraken - 17 (Hold'em)
Seat 2 is the button
Seat 2: Sephiroth1 (102.61).
Seat 5: IlxxxlI (40).
Player Sephiroth1 has small blind (0.50)
Player IlxxxlI has big blind (1)
Player IlxxxlI received card: [2c]
Player IlxxxlI received card: [8d]
Player Sephiroth1 raises (2.50)
Player IlxxxlI folds
Uncalled bet (2) returned to Sephiroth1
Player Sephiroth1 mucks cards
------ Summary ------
Pot: 2. Rake 0
*Player Sephiroth1 mucks (does not show cards). Bets: 1. Collects: 2. Wins: 1.
Player IlxxxlI does not show cards.Bets: 1. Collects: 0. Loses: 1.
Game ended at: 2016/11/29 14:14:39

Game started
Game ID: 787000431 1/2 (PRR) Longana (Short) - 2 (Hold'em)
Seat 2 is the button
Seat 1: actionjax24 (117.51).
Seat 2: BiGFck (23.45).
Seat 3: VegetablesArentYummy (130.65).
Seat 4: gust (80).
Seat 5: thimk (55.37).
Seat 6: IlxxxlI (46).
Seat 8: StephCurry (115.50).
Seat 9: hotshothotgg (58.48).
Player VegetablesArentYummy has small blind (1)
Player gust has big blind (2)
Player IlxxxlI received card: [10c]
Player IlxxxlI received card: [7c]
Player thimk folds
Player IlxxxlI folds
Player StephCurry folds
Player hotshothotgg folds
Player actionjax24 folds
Player BiGFck raises (22)
Player VegetablesArentYummy folds
Player gust folds
Uncalled bet (20) returned to BiGFck
Player BiGFck mucks cards
------ Summary ------
Pot: 5. Rake 0
Player actionjax24 does not show cards.Bets: 0. Collects: 0. Wins: 0.
*Player BiGFck mucks (does not show cards). Bets: 2. Collects: 5. Wins: 3.
Player VegetablesArentYummy does not show cards.Bets: 1. Collects: 0. Loses: 1.
Player gust does not show cards.Bets: 2. Collects: 0. Loses: 2.
Player thimk does not show cards.Bets: 0. Collects: 0. Wins: 0.
Player IlxxxlI does not show cards.Bets: 0. Collects: 0. Wins: 0.
Player StephCurry does not show cards.Bets: 0. Collects: 0. Wins: 0.
Player hotshothotgg does not show cards.Bets: 0. Collects: 0. Wins: 0.
Game ended at: 2016/11/29 14:15:11

Game started
Game ID: 787000425 0.25/0.50 (PRR) Gorgons - 15 (Hold'em)
Seat 2 is the button
Seat 1: WeakAndWeary (52.81).
Seat 2: IampokerKidd (99.27).
Seat 3: imger8 (52.39).
Seat 4: IlxxxlI (20).
Seat 5: foreseen (53.45).
Seat 6: BiGFck (11.50).
Player imger8 has small blind (0.25)
Player IlxxxlI has big blind (0.50)
Player IlxxxlI received card: [4c]
Player IlxxxlI received card: [Kd]
Player foreseen folds
Player BiGFck folds
Player WeakAndWeary folds
Player IampokerKidd folds
Player imger8 folds
Uncalled bet (0.25) returned to IlxxxlI
Player IlxxxlI mucks cards
------ Summary ------
Pot: 0.50. Rake 0
Player WeakAndWeary does not show cards.Bets: 0. Collects: 0. Wins: 0.
Player IampokerKidd does not show cards.Bets: 0. Collects: 0. Wins: 0.
Player imger8 does not show cards.Bets: 0.25. Collects: 0. Loses: 0.25.
*Player IlxxxlI mucks (does not show cards). Bets: 0.25. Collects: 0.50. Wins: 0.25.
Player foreseen does not show cards.Bets: 0. Collects: 0. Wins: 0.
Player BiGFck does not show cards.Bets: 0. Collects: 0. Wins: 0.
Game ended at: 2016/11/29 14:14:51

Game started
Game ID: 787000206 0.50/1 (PRR) Karkadann - 3 (Hold'em)
Seat 7 is the button
Seat 1: zboiii (123.84).
Seat 2: ElvenEyes (147.36).
Seat 3: StephCurry (100).
Seat 4: gust (40).
Seat 5: pineapplesand (47.46).
Seat 7: IlxxxlI (40).
Seat 8: dankmann (165.24).
Seat 9: VegetablesArentYummy (267.67).
Player dankmann has small blind (0.50)
Player VegetablesArentYummy has big blind (1)
Player IlxxxlI received card: [9c]
Player IlxxxlI received card: [7d]
Player zboiii folds
Player ElvenEyes folds
Player StephCurry folds
Player gust raises (2)
Player pineapplesand folds
Player IlxxxlI folds
Player dankmann raises (6.50)
Player VegetablesArentYummy folds
Player gust calls (5)
*** FLOP ***: [3d 10c Jh]
Player dankmann checks
Player gust checks
*** TURN ***: [3d 10c Jh] [6h]
Player dankmann bets (7.12)
Player gust calls (7.12)
*** RIVER ***: [3d 10c Jh 6h] [4h]
Player dankmann checks
Player gust checks
------ Summary ------
Pot: 27.78. Rake 1.22. JP fee 0.24
Board: [3d 10c Jh 6h 4h]
Player zboiii does not show cards.Bets: 0. Collects: 0. Wins: 0.
Player ElvenEyes does not show cards.Bets: 0. Collects: 0. Wins: 0.
Player StephCurry does not show cards.Bets: 0. Collects: 0. Wins: 0.
*Player gust shows: High card A [Ac Ks]. Bets: 14.12. Collects: 13.89. Loses: 0.23.
Player pineapplesand does not show cards.Bets: 0. Collects: 0. Wins: 0.
Player IlxxxlI does not show cards.Bets: 0. Collects: 0. Wins: 0.
*Player dankmann shows: High card A [As Kd]. Bets: 14.12. Collects: 13.89. Loses: 0.23.
Player VegetablesArentYummy does not show cards.Bets: 1. Collects: 0. Loses: 1.
Game ended at: 2016/11/29 14:15:46

Game started
Game ID: 787000116 0.25/0.50 (PRR) Gorgons - 15 (Hold'em)
Seat 1 is the button
Seat 1: WeakAndWeary (52.81).
Seat 2: IampokerKidd (99.52).
Seat 3: imger8 (52.14).
Seat 4: IlxxxlI (20).
Seat 5: foreseen (53.45).
Seat 6: BiGFck (11.50).
Player IampokerKidd has small blind (0.25)
Player imger8 has big blind (0.50)
Player IlxxxlI received card: [Jh]
Player IlxxxlI received card: [7d]
Player IlxxxlI folds
Player foreseen folds
Player BiGFck folds
Player WeakAndWeary folds
Player IampokerKidd folds
Uncalled bet (0.25) returned to imger8
Player imger8 mucks cards
------ Summary ------
Pot: 0.50. Rake 0
Player WeakAndWeary does not show cards.Bets: 0. Collects: 0. Wins: 0.
Player IampokerKidd does not show cards.Bets: 0.25. Collects: 0. Loses: 0.25.
*Player imger8 mucks (does not show cards). Bets: 0.25. Collects: 0.50. Wins: 0.25.
Player IlxxxlI does not show cards.Bets: 0. Collects: 0. Wins: 0.
Player foreseen does not show cards.Bets: 0. Collects: 0. Wins: 0.
Player BiGFck does not show cards.Bets: 0. Collects: 0. Wins: 0.
Game ended at: 2016/11/29 14:14:23

Game started
Game ID: 787000013 1/2 (PRR) Longana (Short) - 2 (Hold'em)
Seat 1 is the button
Seat 1: actionjax24 (111.06).
Seat 2: BiGFck (24.45).
Seat 3: VegetablesArentYummy (132.65).
Seat 4: gust (80).
Seat 5: thimk (55.37).
Seat 6: IlxxxlI (46).
Seat 8: StephCurry (115.50).
Seat 9: hotshothotgg (58.48).
Player BiGFck has small blind (1)
Player VegetablesArentYummy has big blind (2)
Player IlxxxlI received card: [As]
Player IlxxxlI received card: [4d]
Player gust raises (4)
Player thimk folds
Player IlxxxlI folds
Player StephCurry folds
Player hotshothotgg folds
Player actionjax24 calls (4)
Player BiGFck folds
Player VegetablesArentYummy folds
*** FLOP ***: [10s 10h Kc]
Player gust checks
Player actionjax24 checks
*** TURN ***: [10s 10h Kc] [Kh]
Player gust checks
Player actionjax24 bets (5)
Player gust folds
Uncalled bet (5) returned to actionjax24
Player actionjax24 mucks cards
------ Summary ------
Pot: 10.45. Rake 0.37. JP fee 0.18
Board: [10s 10h Kc Kh]
*Player actionjax24 mucks (does not show cards). Bets: 4. Collects: 10.45. Wins: 6.45.
Player BiGFck does not show cards.Bets: 1. Collects: 0. Loses: 1.
Player VegetablesArentYummy does not show cards.Bets: 2. Collects: 0. Loses: 2.
Player gust does not show cards.Bets: 4. Collects: 0. Loses: 4.
Player thimk does not show cards.Bets: 0. Collects: 0. Wins: 0.
Player IlxxxlI does not show cards.Bets: 0. Collects: 0. Wins: 0.
Player StephCurry does not show cards.Bets: 0. Collects: 0. Wins: 0.
Player hotshothotgg does not show cards.Bets: 0. Collects: 0. Wins: 0.
Game ended at: 2016/11/29 14:14:25

Game started
Game ID: 786999894 0.50/1 (PRR) Karkadann - 3 (Hold'em)
Seat 5 is the button
Seat 1: zboiii (123.84).
Seat 2: ElvenEyes (149.36).
Seat 3: StephCurry (100).
Seat 4: gust (40).
Seat 5: pineapplesand (47.46).
Seat 7: IlxxxlI (40).
Seat 8: dankmann (162.74).
Seat 9: VegetablesArentYummy (267.67).
Player IlxxxlI has small blind (0.50)
Player dankmann has big blind (1)
Player IlxxxlI received card: [9c]
Player IlxxxlI received card: [Qc]
Player VegetablesArentYummy folds
Player zboiii folds
Player ElvenEyes raises (2)
Player StephCurry folds
Player gust folds
Player pineapplesand folds
Player IlxxxlI folds
Player dankmann raises (6)
Player ElvenEyes folds
Uncalled bet (5) returned to dankmann
Player dankmann mucks cards
------ Summary ------
Pot: 4.50. Rake 0
Player zboiii does not show cards.Bets: 0. Collects: 0. Wins: 0.
Player ElvenEyes does not show cards.Bets: 2. Collects: 0. Loses: 2.
Player StephCurry does not show cards.Bets: 0. Collects: 0. Wins: 0.
Player gust does not show cards.Bets: 0. Collects: 0. Wins: 0.
Player pineapplesand does not show cards.Bets: 0. Collects: 0. Wins: 0.
Player IlxxxlI does not show cards.Bets: 0.50. Collects: 0. Loses: 0.50.
*Player dankmann mucks (does not show cards). Bets: 2. Collects: 4.50. Wins: 2.50.
Player VegetablesArentYummy does not show cards.Bets: 0. Collects: 0. Wins: 0.
Game ended at: 2016/11/29 14:13:48

Game started
Game ID: 786999815 1/2 (PRR) Lakhey (Hold'em)
Seat 1 is the button
Seat 1: VegetablesArentYummy (236.30).
Seat 2: IlxxxlI (80).
Seat 3: IbetUmuck (881.80).
Seat 4: DonCesarGrinder (245.39).
Seat 5: MadLifeGrinder (220.48).
Seat 6: Ka1zeN (205).
Player IlxxxlI has small blind (1)
Player IbetUmuck has big blind (2)
Player IlxxxlI received card: [8d]
Player IlxxxlI received card: [9s]
Player DonCesarGrinder folds
Player MadLifeGrinder folds
Player Ka1zeN folds
Player VegetablesArentYummy folds
Player IlxxxlI calls (1)
Player IbetUmuck checks
*** FLOP ***: [7d 5c Js]
Player IlxxxlI bets (2)
Player IbetUmuck calls (2)
*** TURN ***: [7d 5c Js] [4h]
Player IlxxxlI checks
Player IbetUmuck bets (5.70)
Player IlxxxlI folds
Uncalled bet (5.70) returned to IbetUmuck
Player IbetUmuck mucks cards
------ Summary ------
Pot: 7.60. Rake 0.28. JP fee 0.12
Board: [7d 5c Js 4h]
Player VegetablesArentYummy does not show cards.Bets: 0. Collects: 0. Wins: 0.
Player IlxxxlI does not show cards.Bets: 4. Collects: 0. Loses: 4.
*Player IbetUmuck mucks (does not show cards). Bets: 4. Collects: 7.60. Wins: 3.60.
Player DonCesarGrinder does not show cards.Bets: 0. Collects: 0. Wins: 0.
Player MadLifeGrinder does not show cards.Bets: 0. Collects: 0. Wins: 0.
Player Ka1zeN does not show cards.Bets: 0. Collects: 0. Wins: 0.
Game ended at: 2016/11/29 14:14:31

Game started
Game ID: 786999785 1/2 (PRR) Longana (Short) - 2 (Hold'em)
Seat 9 is the button
Seat 1: actionjax24 (112.06).
Seat 2: BiGFck (26.45).
Seat 3: VegetablesArentYummy (132.65).
Seat 4: gust (80).
Seat 5: thimk (55.37).
Seat 6: IlxxxlI (43).
Seat 8: StephCurry (115.50).
Seat 9: hotshothotgg (58.48).
Player actionjax24 has small blind (1)
Player BiGFck has big blind (2)
Player IlxxxlI received card: [Kc]
Player IlxxxlI received card: [Kd]
Player VegetablesArentYummy folds
Player gust folds
Player thimk folds
Player IlxxxlI raises (7)
Player StephCurry folds
Player hotshothotgg folds
Player actionjax24 folds
Player BiGFck folds
Uncalled bet (5) returned to IlxxxlI
Player IlxxxlI mucks cards
------ Summary ------
Pot: 5. Rake 0
Player actionjax24 does not show cards.Bets: 1. Collects: 0. Loses: 1.
Player BiGFck does not show cards.Bets: 2. Collects: 0. Loses: 2.
Player VegetablesArentYummy does not show cards.Bets: 0. Collects: 0. Wins: 0.
Player gust does not show cards.Bets: 0. Collects: 0. Wins: 0.
Player thimk does not show cards.Bets: 0. Collects: 0. Wins: 0.
*Player IlxxxlI mucks (does not show cards). Bets: 2. Collects: 5. Wins: 3.
Player StephCurry does not show cards.Bets: 0. Collects: 0. Wins: 0.
Player hotshothotgg does not show cards.Bets: 0. Collects: 0. Wins: 0.
Game ended at: 2016/11/29 14:13:20

Game started
Game ID: 786999700 0.25/0.50 (PRR) Gorgons - 15 (Hold'em)
Seat 6 is the button
Seat 1: WeakAndWeary (53.06).
Seat 2: IampokerKidd (100.02).
Seat 3: imger8 (48.59).
Seat 4: IlxxxlI (20).
Seat 5: foreseen (56.60).
Seat 6: BiGFck (11.50).
Player WeakAndWeary has small blind (0.25)
Player IampokerKidd has big blind (0.50)
Player IlxxxlI received card: [9d]
Player IlxxxlI received card: [Jh]
Player imger8 raises (1.50)
Player IlxxxlI folds
Player foreseen raises (3.15)
Player BiGFck folds
Player WeakAndWeary folds
Player IampokerKidd folds
Player imger8 calls (1.65)
*** FLOP ***: [Qh Kc 3s]
Player imger8 bets (4.50)
Player foreseen folds
Uncalled bet (4.50) returned to imger8
Player imger8 mucks cards
------ Summary ------
Pot: 6.70. Rake 0.25. JP fee 0.10
Board: [Qh Kc 3s]
Player WeakAndWeary does not show cards.Bets: 0.25. Collects: 0. Loses: 0.25.
Player IampokerKidd does not show cards.Bets: 0.50. Collects: 0. Loses: 0.50.
*Player imger8 mucks (does not show cards). Bets: 3.15. Collects: 6.70. Wins: 3.55.
Player IlxxxlI does not show cards.Bets: 0. Collects: 0. Wins: 0.
Player foreseen does not show cards.Bets: 3.15. Collects: 0. Loses: 3.15.
Player BiGFck does not show cards.Bets: 0. Collects: 0. Wins: 0.
Game ended at: 2016/11/29 14:13:36

Game started
Game ID: 786999591 0.50/1 (PRR) Kraken - 23 (Hold'em)
Seat 2 is the button
Seat 1: WeakAndWeary (107.90).
Seat 2: gust (49).
Seat 3: LloydXmas (102.05).
Seat 4: Sephiroth1 (100).
Seat 5: ElvenEyes (119.45).
Seat 6: IlxxxlI (42.64).
Player LloydXmas has small blind (0.50)
Player Sephiroth1 has big blind (1)
Player IlxxxlI received card: [7c]
Player IlxxxlI received card: [Ac]
Player ElvenEyes folds
Player IlxxxlI raises (2)
Player WeakAndWeary calls (2)
Player gust folds
Player LloydXmas folds
Player Sephiroth1 calls (1)
*** FLOP ***: [5s 2d Js]
Player Sephiroth1 checks
Player IlxxxlI checks
Player WeakAndWeary checks
*** TURN ***: [5s 2d Js] [9h]
Player Sephiroth1 is timed out.
Player Sephiroth1 checks
Player IlxxxlI checks
Player WeakAndWeary checks
*** RIVER ***: [5s 2d Js 9h] [10s]
Player Sephiroth1 bets (4.12)
Player IlxxxlI folds
Player WeakAndWeary calls (4.12)
------ Summary ------
Pot: 14.01. Rake 0.49. JP fee 0.24
Board: [5s 2d Js 9h 10s]
*Player WeakAndWeary shows: Three Of Kind of 9s [9c 9d]. Bets: 6.12. Collects: 14.01. Wins: 7.89.
Player gust does not show cards.Bets: 0. Collects: 0. Wins: 0.
Player LloydXmas does not show cards.Bets: 0.50. Collects: 0. Loses: 0.50.
Player Sephiroth1 shows: Two pairs. Js and 10s [Jd 10c]. Bets: 6.12. Collects: 0. Loses: 6.12.
Player ElvenEyes does not show cards.Bets: 0. Collects: 0. Wins: 0.
Player IlxxxlI does not show cards.Bets: 2. Collects: 0. Loses: 2.
Game ended at: 2016/11/29 14:14:30

Game started
Game ID: 786999524 1/2 (PRR) Longana (Short) - 2 (Hold'em)
Seat 8 is the button
Seat 1: actionjax24 (114.06).
Seat 2: BiGFck (26.45).
Seat 3: VegetablesArentYummy (132.65).
Seat 4: gust (80).
Seat 5: thimk (55.37).
Seat 6: IlxxxlI (40).
Seat 8: StephCurry (115.50).
Seat 9: hotshothotgg (59.48).
Player hotshothotgg has small blind (1)
Player actionjax24 has big blind (2)
Player IlxxxlI received card: [Ah]
Player IlxxxlI received card: [Qh]
Player BiGFck folds
Player VegetablesArentYummy folds
Player gust folds
Player thimk folds
Player IlxxxlI raises (4.80)
Player StephCurry folds
Player hotshothotgg folds
Player actionjax24 folds
Uncalled bet (2.80) returned to IlxxxlI
Player IlxxxlI mucks cards
------ Summary ------
Pot: 5. Rake 0
Player actionjax24 does not show cards.Bets: 2. Collects: 0. Loses: 2.
Player BiGFck does not show cards.Bets: 0. Collects: 0. Wins: 0.
Player VegetablesArentYummy does not show cards.Bets: 0. Collects: 0. Wins: 0.
Player gust does not show cards.Bets: 0. Collects: 0. Wins: 0.
Player thimk does not show cards.Bets: 0. Collects: 0. Wins: 0.
*Player IlxxxlI mucks (does not show cards). Bets: 2. Collects: 5. Wins: 3.
Player StephCurry does not show cards.Bets: 0. Collects: 0. Wins: 0.
Player hotshothotgg does not show cards.Bets: 1. Collects: 0. Loses: 1.
Game ended at: 2016/11/29 14:12:44

Game started
Game ID: 786999525 1/2 (PRR) Lakhey (Hold'em)
Seat 6 is the button
Seat 1: VegetablesArentYummy (237.30).
Seat 2: IlxxxlI (80).
Seat 3: IbetUmuck (887.55).
Seat 4: DonCesarGrinder (245.39).
Seat 5: MadLifeGrinder (211.73).
Seat 6: Ka1zeN (205).
Player VegetablesArentYummy has small blind (1)
Player IlxxxlI has big blind (2)
Player IlxxxlI received card: [10s]
Player IlxxxlI received card: [Qs]
Player IbetUmuck raises (5.75)
Player DonCesarGrinder folds
Player MadLifeGrinder raises (17)
Player Ka1zeN folds
Player VegetablesArentYummy folds
Player IlxxxlI folds
Player IbetUmuck folds
Uncalled bet (11.25) returned to MadLifeGrinder
Player MadLifeGrinder mucks cards
------ Summary ------
Pot: 14.50. Rake 0
Player VegetablesArentYummy does not show cards.Bets: 1. Collects: 0. Loses: 1.
Player IlxxxlI does not show cards.Bets: 2. Collects: 0. Loses: 2.
Player IbetUmuck does not show cards.Bets: 5.75. Collects: 0. Loses: 5.75.
Player DonCesarGrinder does not show cards.Bets: 0. Collects: 0. Wins: 0.
*Player MadLifeGrinder mucks (does not show cards). Bets: 5.75. Collects: 14.50. Wins: 8.75.
Player Ka1zeN does not show cards.Bets: 0. Collects: 0. Wins: 0.
Game ended at: 2016/11/29 14:12:47

Game started
Game ID: 786999416 0.25/0.50 (PRR) Gorgons - 15 (Hold'em)
Seat 5 is the button
Seat 1: WeakAndWeary (53.56).
Seat 2: IampokerKidd (100.02).
Seat 3: imger8 (47.84).
Seat 4: IlxxxlI (20).
Seat 5: foreseen (56.60).
Seat 6: BiGFck (11.75).
Player BiGFck has small blind (0.25)
Player WeakAndWeary has big blind (0.50)
Player IlxxxlI received card: [6h]
Player IlxxxlI received card: [4s]
Player IampokerKidd folds
Player imger8 raises (1.50)
Player IlxxxlI folds
Player foreseen folds
Player BiGFck folds
Player WeakAndWeary folds
Uncalled bet (1) returned to imger8
Player imger8 mucks cards
------ Summary ------
Pot: 1.25. Rake 0
Player WeakAndWeary does not show cards.Bets: 0.50. Collects: 0. Loses: 0.50.
Player IampokerKidd does not show cards.Bets: 0. Collects: 0. Wins: 0.
*Player imger8 mucks (does not show cards). Bets: 0.50. Collects: 1.25. Wins: 0.75.
Player IlxxxlI does not show cards.Bets: 0. Collects: 0. Wins: 0.
Player foreseen does not show cards.Bets: 0. Collects: 0. Wins: 0.
Player BiGFck does not show cards.Bets: 0.25. Collects: 0. Loses: 0.25.
Game ended at: 2016/11/29 14:12:29

Game started
Game ID: 786999391 0.50/1 (PRR) Karkadann - 3 (Hold'em)
Seat 4 is the button
Seat 1: zboiii (123.84).
Seat 2: ElvenEyes (101.86).
Seat 3: StephCurry (100).
Seat 4: gust (40).
Seat 5: pineapplesand (47.96).
Seat 6: tyty2 (50).
Seat 7: IlxxxlI (40).
Seat 8: dankmann (162.74).
Seat 9: VegetablesArentYummy (267.67).
Player pineapplesand has small blind (0.50)
Player tyty2 has big blind (1)
Player IlxxxlI received card: [8d]
Player IlxxxlI received card: [Js]
Player IlxxxlI folds
Player dankmann folds
Player VegetablesArentYummy folds
Player zboiii folds
Player ElvenEyes raises (2)
Player StephCurry folds
Player gust folds
Player pineapplesand folds
Player tyty2 calls (1)
*** FLOP ***: [6d 5h 9s]
Player tyty2 checks
Player ElvenEyes bets (2.14)
Player tyty2 raises (12.84)
Player ElvenEyes allin (97.72)
Player tyty2 allin (35.16)
Uncalled bet (51.86) returned to ElvenEyes
*** TURN ***: [6d 5h 9s] [Ah]
*** RIVER ***: [6d 5h 9s Ah] [4s]
------ Summary ------
Pot: 97.50. Rake 2.76. JP fee 0.24
Board: [6d 5h 9s Ah 4s]
Player zboiii does not show cards.Bets: 0. Collects: 0. Wins: 0.
*Player ElvenEyes shows: One pair of Qs [Qc Qh]. Bets: 50. Collects: 97.50. Wins: 47.50.
Player StephCurry does not show cards.Bets: 0. Collects: 0. Wins: 0.
Player gust does not show cards.Bets: 0. Collects: 0. Wins: 0.
Player pineapplesand does not show cards.Bets: 0.50. Collects: 0. Loses: 0.50.
Player tyty2 shows: One pair of 9s [9h 2c]. Bets: 50. Collects: 0. Loses: 50.
Player IlxxxlI does not show cards.Bets: 0. Collects: 0. Wins: 0.
Player dankmann does not show cards.Bets: 0. Collects: 0. Wins: 0.
Player VegetablesArentYummy does not show cards.Bets: 0. Collects: 0. Wins: 0.
Game ended at: 2016/11/29 14:12:58

Game started
Game ID: 786999260 1/2 (PRR) Longana (Short) - 2 (Hold'em)
Seat 6 is the button
Seat 1: actionjax24 (116.06).
Seat 2: BiGFck (26.45).
Seat 3: VegetablesArentYummy (132.65).
Seat 4: gust (80).
Seat 5: thimk (55.37).
Seat 6: IlxxxlI (40).
Seat 8: StephCurry (116.50).
Seat 9: hotshothotgg (38.73).
Player StephCurry has small blind (1)
Player hotshothotgg has big blind (2)
Player IlxxxlI received card: [10s]
Player IlxxxlI received card: [3c]
Player actionjax24 calls (2)
Player BiGFck folds
Player VegetablesArentYummy folds
Player gust folds
Player thimk folds
Player IlxxxlI folds
Player StephCurry folds
Player hotshothotgg checks
*** FLOP ***: [2d 2s 7d]
Player hotshothotgg bets (2)
Player actionjax24 folds
Uncalled bet (2) returned to hotshothotgg
Player hotshothotgg mucks cards
------ Summary ------
Pot: 4.75. Rake 0.17. JP fee 0.08
Board: [2d 2s 7d]
Player actionjax24 does not show cards.Bets: 2. Collects: 0. Loses: 2.
Player BiGFck does not show cards.Bets: 0. Collects: 0. Wins: 0.
Player VegetablesArentYummy does not show cards.Bets: 0. Collects: 0. Wins: 0.
Player gust does not show cards.Bets: 0. Collects: 0. Wins: 0.
Player thimk does not show cards.Bets: 0. Collects: 0. Wins: 0.
Player IlxxxlI does not show cards.Bets: 0. Collects: 0. Wins: 0.
Player StephCurry does not show cards.Bets: 1. Collects: 0. Loses: 1.
*Player hotshothotgg mucks (does not show cards). Bets: 2. Collects: 4.75. Wins: 2.75.
Game ended at: 2016/11/29 14:12:2

Game started
Game ID: 786999223 0.50/1 (PRR) Kraken - 23 (Hold'em)
Seat 1 is the button
Seat 1: WeakAndWeary (107.90).
Seat 2: gust (49.50).
Seat 3: LloydXmas (104.45).
Seat 4: Sephiroth1 (100).
Seat 5: ElvenEyes (119.45).
Seat 6: IlxxxlI (40).
Player gust has small blind (0.50)
Player LloydXmas has big blind (1)
Player IlxxxlI received card: [7h]
Player IlxxxlI received card: [Ah]
Player Sephiroth1 folds
Player ElvenEyes folds
Player IlxxxlI raises (2.40)
Player WeakAndWeary folds
Player gust folds
Player LloydXmas calls (1.40)
*** FLOP ***: [9s 6c 9d]
Player LloydXmas checks
Player IlxxxlI bets (1.68)
Player LloydXmas folds
Uncalled bet (1.68) returned to IlxxxlI
Player IlxxxlI mucks cards
------ Summary ------
Pot: 5.04. Rake 0.18. JP fee 0.08
Board: [9s 6c 9d]
Player WeakAndWeary does not show cards.Bets: 0. Collects: 0. Wins: 0.
Player gust does not show cards.Bets: 0.50. Collects: 0. Loses: 0.50.
Player LloydXmas does not show cards.Bets: 2.40. Collects: 0. Loses: 2.40.
Player Sephiroth1 does not show cards.Bets: 0. Collects: 0. Wins: 0.
Player ElvenEyes does not show cards.Bets: 0. Collects: 0. Wins: 0.
*Player IlxxxlI mucks (does not show cards). Bets: 2.40. Collects: 5.04. Wins: 2.64.
Game ended at: 2016/11/29 14:12:12

Game started
Game ID: 786999144 0.25/0.50 (PRR) Gorgons - 15 (Hold'em)
Seat 4 is the button
Seat 1: WeakAndWeary (53.56).
Seat 2: IampokerKidd (100.02).
Seat 3: imger8 (47.84).
Seat 4: IlxxxlI (20).
Seat 5: foreseen (56.10).
Seat 6: BiGFck (12.25).
Player foreseen has small blind (0.25)
Player BiGFck has big blind (0.50)
Player IlxxxlI received card: [5h]
Player IlxxxlI received card: [2d]
Player WeakAndWeary folds
Player IampokerKidd folds
Player imger8 folds
Player IlxxxlI folds
Player foreseen raises (1.39)
Player BiGFck folds
Uncalled bet (1.14) returned to foreseen
Player foreseen mucks cards
------ Summary ------
Pot: 1. Rake 0
Player WeakAndWeary does not show cards.Bets: 0. Collects: 0. Wins: 0.
Player IampokerKidd does not show cards.Bets: 0. Collects: 0. Wins: 0.
Player imger8 does not show cards.Bets: 0. Collects: 0. Wins: 0.
Player IlxxxlI does not show cards.Bets: 0. Collects: 0. Wins: 0.
*Player foreseen mucks (does not show cards). Bets: 0.50. Collects: 1. Wins: 0.50.
Player BiGFck does not show cards.Bets: 0.50. Collects: 0. Loses: 0.50.
Game ended at: 2016/11/29 14:11:45

Game started
Game ID: 786999003 0.50/1 (PRR) Kraken - 23 (Hold'em)
Seat 6 is the button
Seat 1: WeakAndWeary (108.40).
Seat 2: gust (49).
Seat 3: LloydXmas (104.45).
Seat 4: Sephiroth1 (100).
Seat 5: ElvenEyes (119.45).
Seat 6: IlxxxlI (40).
Player WeakAndWeary has small blind (0.50)
Player gust has big blind (1)
Player IlxxxlI received card: [9d]
Player IlxxxlI received card: [3d]
Player LloydXmas folds
Player Sephiroth1 folds
Player ElvenEyes folds
Player IlxxxlI folds
Player WeakAndWeary folds
Uncalled bet (0.50) returned to gust
Player gust mucks cards
------ Summary ------
Pot: 1. Rake 0
Player WeakAndWeary does not show cards.Bets: 0.50. Collects: 0. Loses: 0.50.
*Player gust mucks (does not show cards). Bets: 0.50. Collects: 1. Wins: 0.50.
Player LloydXmas does not show cards.Bets: 0. Collects: 0. Wins: 0.
Player Sephiroth1 does not show cards.Bets: 0. Collects: 0. Wins: 0.
Player ElvenEyes does not show cards.Bets: 0. Collects: 0. Wins: 0.
Player IlxxxlI does not show cards.Bets: 0. Collects: 0. Wins: 0.
Game ended at: 2016/11/29 14:11:19

Game started
Game ID: 786998884 0.25/0.50 (PRR) Gorgons - 15 (Hold'em)
Seat 3 is the button
Seat 1: WeakAndWeary (52.81).
Seat 2: IampokerKidd (100.02).
Seat 3: imger8 (47.84).
Seat 4: IlxxxlI (20).
Seat 5: foreseen (56.60).
Seat 6: BiGFck (12.25).
Player IlxxxlI has small blind (0.25)
Player foreseen has big blind (0.50)
Player IlxxxlI received card: [Qs]
Player IlxxxlI received card: [5c]
Player BiGFck folds
Player WeakAndWeary raises (1.50)
Player IampokerKidd folds
Player imger8 folds
Player IlxxxlI folds
Player foreseen folds
Uncalled bet (1) returned to WeakAndWeary
Player WeakAndWeary mucks cards
------ Summary ------
Pot: 1.25. Rake 0
*Player WeakAndWeary mucks (does not show cards). Bets: 0.50. Collects: 1.25. Wins: 0.75.
Player IampokerKidd does not show cards.Bets: 0. Collects: 0. Wins: 0.
Player imger8 does not show cards.Bets: 0. Collects: 0. Wins: 0.
Player IlxxxlI does not show cards.Bets: 0.25. Collects: 0. Loses: 0.25.
Player foreseen does not show cards.Bets: 0.50. Collects: 0. Loses: 0.50.
Player BiGFck does not show cards.Bets: 0. Collects: 0. Wins: 0.
Game ended at: 2016/11/29 14:11:10

Game started
Game ID: 786998770 1/2 (PRR) Longana (Short) - 2 (Hold'em)
Seat 4 is the button
Seat 1: actionjax24 (109.71).
Seat 2: BiGFck (26.45).
Seat 3: VegetablesArentYummy (132.65).
Seat 4: gust (80).
Seat 5: thimk (56.37).
Seat 6: IlxxxlI (40).
Seat 7: dbrinker (498.41).
Seat 9: hotshothotgg (38.73).
Player thimk has small blind (1)
Player IlxxxlI has big blind (2)
Player IlxxxlI received card: [10c]
Player IlxxxlI received card: [Jd]
Player dbrinker folds
Player hotshothotgg folds
Player actionjax24 raises (6)
Player BiGFck folds
Player VegetablesArentYummy folds
Player gust folds
Player thimk folds
Player IlxxxlI calls (4)
*** FLOP ***: [Qs 2c Ac]
Player IlxxxlI checks
Player actionjax24 bets (7)
Player IlxxxlI folds
Uncalled bet (7) returned to actionjax24
Player actionjax24 mucks cards
------ Summary ------
Pot: 12.35. Rake 0.45. JP fee 0.20
Board: [Qs 2c Ac]
*Player actionjax24 mucks (does not show cards). Bets: 6. Collects: 12.35. Wins: 6.35.
Player BiGFck does not show cards.Bets: 0. Collects: 0. Wins: 0.
Player VegetablesArentYummy does not show cards.Bets: 0. Collects: 0. Wins: 0.
Player gust does not show cards.Bets: 0. Collects: 0. Wins: 0.
Player thimk does not show cards.Bets: 1. Collects: 0. Loses: 1.
Player IlxxxlI does not show cards.Bets: 6. Collects: 0. Loses: 6.
Player dbrinker does not show cards.Bets: 0. Collects: 0. Wins: 0.
Player hotshothotgg does not show cards.Bets: 0. Collects: 0. Wins: 0.
Game ended at: 2016/11/29 14:10:52

Game started
Game ID: 786998619 0.50/1 (PRR) Karkadann - 3 (Hold'em)
Seat 3 is the button
Seat 1: zboiii (123.84).
Seat 2: ElvenEyes (101.86).
Seat 3: StephCurry (100).
Seat 4: gust (42).
Seat 5: pineapplesand (40).
Seat 7: IlxxxlI (40).
Seat 8: dankmann (162.74).
Seat 9: VegetablesArentYummy (267.67).
Player gust has small blind (0.50)
Player pineapplesand has big blind (1)
Player IlxxxlI received card: [9h]
Player IlxxxlI received card: [8c]
Player IlxxxlI folds
Player dankmann folds
Player VegetablesArentYummy folds
Player zboiii folds
Player ElvenEyes folds
Player StephCurry folds
Player gust raises (1.50)
Player pineapplesand calls (1)
*** FLOP ***: [4s 7c 5d]
Player gust checks
Player pineapplesand bets (1.90)
Player gust calls (1.90)
*** TURN ***: [4s 7c 5d] [6h]
Player gust bets (4.94)
Player pineapplesand calls (4.94)
*** RIVER ***: [4s 7c 5d 6h] [Kc]
Player gust checks
Player pineapplesand bets (11.20)
Player gust folds
Uncalled bet (11.20) returned to pineapplesand
Player pineapplesand mucks cards
------ Summary ------
Pot: 16.80. Rake 0.64. JP fee 0.24
Board: [4s 7c 5d 6h Kc]
Player zboiii does not show cards.Bets: 0. Collects: 0. Wins: 0.
Player ElvenEyes does not show cards.Bets: 0. Collects: 0. Wins: 0.
Player StephCurry does not show cards.Bets: 0. Collects: 0. Wins: 0.
Player gust does not show cards.Bets: 8.84. Collects: 0. Loses: 8.84.
*Player pineapplesand mucks (does not show cards). Bets: 8.84. Collects: 16.80. Wins: 7.96.
Player IlxxxlI does not show cards.Bets: 0. Collects: 0. Wins: 0.
Player dankmann does not show cards.Bets: 0. Collects: 0. Wins: 0.
Player VegetablesArentYummy does not show cards.Bets: 0. Collects: 0. Wins: 0.
Game ended at: 2016/11/29 14:11:43

Game started
Game ID: 786998517 0.25/0.50 (PRR) Gorgons - 15 (Hold'em)
Seat 2 is the button
Seat 1: WeakAndWeary (54.31).
Seat 2: IampokerKidd (97.77).
Seat 3: imger8 (48.09).
Seat 4: IlxxxlI (20).
Seat 5: foreseen (56.60).
Seat 6: BiGFck (12.25).
Player imger8 has small blind (0.25)
Player IlxxxlI has big blind (0.50)
Player IlxxxlI received card: [2c]
Player IlxxxlI received card: [6s]
Player foreseen folds
Player BiGFck folds
Player WeakAndWeary raises (1.50)
Player IampokerKidd raises (5)
Player imger8 folds
Player IlxxxlI folds
Player WeakAndWeary folds
Uncalled bet (3.50) returned to IampokerKidd
Player IampokerKidd mucks cards
------ Summary ------
Pot: 3.75. Rake 0
Player WeakAndWeary does not show cards.Bets: 1.50. Collects: 0. Loses: 1.50.
*Player IampokerKidd mucks (does not show cards). Bets: 1.50. Collects: 3.75. Wins: 2.25.
Player imger8 does not show cards.Bets: 0.25. Collects: 0. Loses: 0.25.
Player IlxxxlI does not show cards.Bets: 0.50. Collects: 0. Loses: 0.50.
Player foreseen does not show cards.Bets: 0. Collects: 0. Wins: 0.
Player BiGFck does not show cards.Bets: 0. Collects: 0. Wins: 0.
Game ended at: 2016/11/29 14:10:32

Game started
Game ID: 786998452 0.50/1 (PRR) Karkadann - 3 (Hold'em)
Seat 2 is the button
Seat 1: zboiii (123.84).
Seat 2: ElvenEyes (101.86).
Seat 3: StephCurry (100).
Seat 4: gust (41.50).
Seat 7: IlxxxlI (40).
Seat 8: dankmann (162.74).
Seat 9: VegetablesArentYummy (267.67).
Player StephCurry has small blind (0.50)
Player gust has big blind (1)
Player IlxxxlI received card: [8d]
Player IlxxxlI received card: [Jc]
Player IlxxxlI folds
Player dankmann folds
Player VegetablesArentYummy folds
Player zboiii folds
Player ElvenEyes folds
Player StephCurry folds
Uncalled bet (0.50) returned to gust
Player gust mucks cards
------ Summary ------
Pot: 1. Rake 0
Player zboiii does not show cards.Bets: 0. Collects: 0. Wins: 0.
Player ElvenEyes does not show cards.Bets: 0. Collects: 0. Wins: 0.
Player StephCurry does not show cards.Bets: 0.50. Collects: 0. Loses: 0.50.
*Player gust mucks (does not show cards). Bets: 0.50. Collects: 1. Wins: 0.50.
Player IlxxxlI does not show cards.Bets: 0. Collects: 0. Wins: 0.
Player dankmann does not show cards.Bets: 0. Collects: 0. Wins: 0.
Player VegetablesArentYummy does not show cards.Bets: 0. Collects: 0. Wins: 0.
Game ended at: 2016/11/29 14:9:53

Game started
Game ID: 786998211 0.50/1 (PRR) Kraken - 23 (Hold'em)
Seat 5 is the button
Seat 1: WeakAndWeary (101.50).
Seat 2: gust (49).
Seat 3: LloydXmas (104.45).
Seat 4: Sephiroth1 (100).
Seat 5: ElvenEyes (119.45).
Seat 6: IlxxxlI (40).
Player IlxxxlI has small blind (0.50)
Player WeakAndWeary has big blind (1)
Player IlxxxlI received card: [10h]
Player IlxxxlI received card: [Qc]
Player gust folds
Player LloydXmas folds
Player Sephiroth1 folds
Player ElvenEyes folds
Player IlxxxlI raises (2)
Player WeakAndWeary calls (1.50)
*** FLOP ***: [9c 2c 5h]
Player IlxxxlI bets (3.16)
Player WeakAndWeary calls (3.16)
*** TURN ***: [9c 2c 5h] [3s]
Player IlxxxlI bets (2)
Player WeakAndWeary calls (2)
*** RIVER ***: [9c 2c 5h 3s] [4c]
Player IlxxxlI checks
Player WeakAndWeary bets (21.84)
Player IlxxxlI folds
Uncalled bet (21.84) returned to WeakAndWeary
Player WeakAndWeary mucks cards
------ Summary ------
Pot: 14.56. Rake 0.52. JP fee 0.24
Board: [9c 2c 5h 3s 4c]
*Player WeakAndWeary mucks (does not show cards). Bets: 7.66. Collects: 14.56. Wins: 6.90.
Player gust does not show cards.Bets: 0. Collects: 0. Wins: 0.
Player LloydXmas does not show cards.Bets: 0. Collects: 0. Wins: 0.
Player Sephiroth1 does not show cards.Bets: 0. Collects: 0. Wins: 0.
Player ElvenEyes does not show cards.Bets: 0. Collects: 0. Wins: 0.
Player IlxxxlI does not show cards.Bets: 7.66. Collects: 0. Loses: 7.66.
Game ended at: 2016/11/29 14:10:49

Game started
Game ID: 786997980 0.50/1 (PRR) Karkadann - 3 (Hold'em)
Seat 1 is the button
Seat 1: zboiii (103.71).
Seat 2: ElvenEyes (102.36).
Seat 3: StephCurry (112.28).
Seat 7: IlxxxlI (40.04).
Seat 8: dankmann (162.74).
Seat 9: VegetablesArentYummy (267.67).
Player ElvenEyes has small blind (0.50)
Player StephCurry has big blind (1)
Player IlxxxlI received card: [2h]
Player IlxxxlI received card: [Ah]
Player IlxxxlI raises (2)
Player dankmann folds
Player VegetablesArentYummy folds
Player zboiii raises (8)
Player ElvenEyes folds
Player StephCurry calls (7)
Player IlxxxlI folds
*** FLOP ***: [5c Qd 10d]
Player StephCurry checks
Player zboiii bets (11.72)
Player StephCurry calls (11.72)
*** TURN ***: [5c Qd 10d] [Ac]
Player StephCurry checks
Player zboiii checks
*** RIVER ***: [5c Qd 10d Ac] [4d]
Player StephCurry checks
Player zboiii checks
Player StephCurry mucks cards
------ Summary ------
Pot: 39.85. Rake 1.85. JP fee 0.24
Board: [5c Qd 10d Ac 4d]
*Player zboiii shows: One pair of As [Ad Kc]. Bets: 19.72. Collects: 39.85. Wins: 20.13.
Player ElvenEyes does not show cards.Bets: 0.50. Collects: 0. Loses: 0.50.
Player StephCurry mucks (does not show cards). Bets: 19.72. Collects: 0. Loses: 19.72.
Player IlxxxlI does not show cards.Bets: 2. Collects: 0. Loses: 2.
Player dankmann does not show cards.Bets: 0. Collects: 0. Wins: 0.
Player VegetablesArentYummy does not show cards.Bets: 0. Collects: 0. Wins: 0.
Game ended at: 2016/11/29 14:9:26

Game started
Game ID: 786997959 0.50/1 (PRR) Kraken - 23 (Hold'em)
Seat 4 is the button
Seat 1: WeakAndWeary (100).
Seat 2: gust (49).
Seat 3: LloydXmas (104.45).
Seat 4: Sephiroth1 (100).
Seat 5: ElvenEyes (119.95).
Seat 6: IlxxxlI (40).
Player ElvenEyes has small blind (0.50)
Player IlxxxlI has big blind (1)
Player IlxxxlI received card: [Qd]
Player IlxxxlI received card: [2c]
Player WeakAndWeary raises (3)
Player gust folds
Player LloydXmas folds
Player Sephiroth1 folds
Player ElvenEyes folds
Player IlxxxlI folds
Uncalled bet (2) returned to WeakAndWeary
Player WeakAndWeary mucks cards
------ Summary ------
Pot: 2.50. Rake 0
*Player WeakAndWeary mucks (does not show cards). Bets: 1. Collects: 2.50. Wins: 1.50.
Player gust does not show cards.Bets: 0. Collects: 0. Wins: 0.
Player LloydXmas does not show cards.Bets: 0. Collects: 0. Wins: 0.
Player Sephiroth1 does not show cards.Bets: 0. Collects: 0. Wins: 0.
Player ElvenEyes does not show cards.Bets: 0.50. Collects: 0. Loses: 0.50.
Player IlxxxlI does not show cards.Bets: 1. Collects: 0. Loses: 1.
Game ended at: 2016/11/29 14:8:52

Game started
Game ID: 786997792 0.50/1 (PRR) Karkadann - 3 (Hold'em)
Seat 9 is the button
Seat 1: zboiii (104.21).
Seat 2: ElvenEyes (103.36).
Seat 3: StephCurry (112.28).
Seat 7: IlxxxlI (40.04).
Seat 8: dankmann (161.24).
Seat 9: VegetablesArentYummy (267.67).
Player zboiii has small blind (0.50)
Player ElvenEyes has big blind (1)
Player IlxxxlI received card: [4d]
Player IlxxxlI received card: [6c]
Player StephCurry folds
Player IlxxxlI folds
Player dankmann raises (3)
Player VegetablesArentYummy folds
Player zboiii folds
Player ElvenEyes folds
Uncalled bet (2) returned to dankmann
Player dankmann mucks cards
------ Summary ------
Pot: 2.50. Rake 0
Player zboiii does not show cards.Bets: 0.50. Collects: 0. Loses: 0.50.
Player ElvenEyes does not show cards.Bets: 1. Collects: 0. Loses: 1.
Player StephCurry does not show cards.Bets: 0. Collects: 0. Wins: 0.
Player IlxxxlI does not show cards.Bets: 0. Collects: 0. Wins: 0.
*Player dankmann mucks (does not show cards). Bets: 1. Collects: 2.50. Wins: 1.50.
Player VegetablesArentYummy does not show cards.Bets: 0. Collects: 0. Wins: 0.
Game ended at: 2016/11/29 14:8:20

Game started
Game ID: 786997254 0.50/1 (PRR) Karkadann - 3 (Hold'em)
Seat 8 is the button
Seat 1: zboiii (100).
Seat 2: ElvenEyes (107.50).
Seat 3: StephCurry (112.28).
Seat 7: IlxxxlI (40.04).
Seat 8: dankmann (161.24).
Seat 9: VegetablesArentYummy (268.17).
Player VegetablesArentYummy has small blind (0.50)
Player zboiii has big blind (1)
Player IlxxxlI received card: [7h]
Player IlxxxlI received card: [9h]
Player ElvenEyes raises (2)
Player StephCurry folds
Player IlxxxlI folds
Player dankmann folds
Player VegetablesArentYummy folds
Player zboiii calls (1)
*** FLOP ***: [7d 8d Jc]
Player zboiii checks
Player ElvenEyes bets (2.14)
Player zboiii calls (2.14)
*** TURN ***: [7d 8d Jc] [8s]
Player zboiii checks
Player ElvenEyes checks
*** RIVER ***: [7d 8d Jc 8s] [5c]
Player zboiii bets (6)
Player ElvenEyes folds
Uncalled bet (6) returned to zboiii
Player zboiii mucks cards
------ Summary ------
Pot: 8.35. Rake 0.29. JP fee 0.14
Board: [7d 8d Jc 8s 5c]
*Player zboiii mucks (does not show cards). Bets: 4.14. Collects: 8.35. Wins: 4.21.
Player ElvenEyes does not show cards.Bets: 4.14. Collects: 0. Loses: 4.14.
Player StephCurry does not show cards.Bets: 0. Collects: 0. Wins: 0.
Player IlxxxlI does not show cards.Bets: 0. Collects: 0. Wins: 0.
Player dankmann does not show cards.Bets: 0. Collects: 0. Wins: 0.
Player VegetablesArentYummy does not show cards.Bets: 0.50. Collects: 0. Loses: 0.50.
Game ended at: 2016/11/29 14:7:51

Game started
Game ID: 786997081 0.50/1 (PRR) Karkadann - 3 (Hold'em)
Seat 7 is the button
Seat 2: ElvenEyes (107.50).
Seat 3: StephCurry (112.28).
Seat 7: IlxxxlI (42.04).
Seat 8: dankmann (161.74).
Seat 9: VegetablesArentYummy (265.67).
Player dankmann has small blind (0.50)
Player VegetablesArentYummy has big blind (1)
Player IlxxxlI received card: [5c]
Player IlxxxlI received card: [Ah]
Player ElvenEyes folds
Player StephCurry folds
Player IlxxxlI raises (2)
Player dankmann folds
Player VegetablesArentYummy raises (5)
Player IlxxxlI folds
Uncalled bet (4) returned to VegetablesArentYummy
Player VegetablesArentYummy mucks cards
------ Summary ------
Pot: 4.50. Rake 0
Player ElvenEyes does not show cards.Bets: 0. Collects: 0. Wins: 0.
Player StephCurry does not show cards.Bets: 0. Collects: 0. Wins: 0.
Player IlxxxlI does not show cards.Bets: 2. Collects: 0. Loses: 2.
Player dankmann does not show cards.Bets: 0.50. Collects: 0. Loses: 0.50.
*Player VegetablesArentYummy mucks (does not show cards). Bets: 2. Collects: 4.50. Wins: 2.50.
Game ended at: 2016/11/29 14:6:36

Game started
Game ID: 786996722 0.50/1 (PRR) Karkadann - 3 (Hold'em)
Seat 3 is the button
Seat 2: ElvenEyes (107.50).
Seat 3: StephCurry (112.28).
Seat 7: IlxxxlI (40).
Seat 8: dankmann (164).
Player IlxxxlI has small blind (0.50)
Player dankmann has big blind (1)
Player IlxxxlI received card: [8d]
Player IlxxxlI received card: [7s]
Player ElvenEyes folds
Player StephCurry folds
Player IlxxxlI calls (0.50)
Player dankmann checks
*** FLOP ***: [10s 10c 2c]
Player IlxxxlI bets (1.26)
Player dankmann calls (1.26)
*** TURN ***: [10s 10c 2c] [9s]
Player IlxxxlI bets (2)
Player dankmann folds
Uncalled bet (2) returned to IlxxxlI
Player IlxxxlI mucks cards
------ Summary ------
Pot: 4.30. Rake 0.16. JP fee 0.06
Board: [10s 10c 2c 9s]
Player ElvenEyes does not show cards.Bets: 0. Collects: 0. Wins: 0.
Player StephCurry does not show cards.Bets: 0. Collects: 0. Wins: 0.
*Player IlxxxlI mucks (does not show cards). Bets: 2.26. Collects: 4.30. Wins: 2.04.
Player dankmann does not show cards.Bets: 2.26. Collects: 0. Loses: 2.26.
Game ended at: 2016/11/29 14:6:12

Game started
Game ID: 786996494 0.50/1 (PRR) Karkadann - 3 (Hold'em)
Seat 2 is the button
Seat 2: ElvenEyes (107.50).
Seat 3: StephCurry (112.78).
Seat 7: IlxxxlI (40).
Seat 8: dankmann (162.50).
Player StephCurry has small blind (0.50)
Player IlxxxlI has big blind (1)
Player IlxxxlI received card: [2h]
Player IlxxxlI received card: [9h]
Player dankmann raises (3)
Player ElvenEyes folds
Player StephCurry folds
Player IlxxxlI folds
Uncalled bet (2) returned to dankmann
Player dankmann mucks cards
------ Summary ------
Pot: 2.50. Rake 0
Player ElvenEyes does not show cards.Bets: 0. Collects: 0. Wins: 0.
Player StephCurry does not show cards.Bets: 0.50. Collects: 0. Loses: 0.50.
Player IlxxxlI does not show cards.Bets: 1. Collects: 0. Loses: 1.
*Player dankmann mucks (does not show cards). Bets: 1. Collects: 2.50. Wins: 1.50.
Game ended at: 2016/11/29 14:5:22

Game started
Game ID: 786992765 0.50/1 (PRR) Kraken - 20 (Hold'em)
Seat 3 is the button
Seat 1: IlxxxlI (40).
Seat 3: AironVega (101).
Seat 4: WeakAndWeary (114.88).
Seat 5: bunnyfox2t (100).
Seat 6: quant_theo (140.36).
Player WeakAndWeary has small blind (0.50)
Player bunnyfox2t has big blind (1)
Player IlxxxlI received card: [8h]
Player IlxxxlI received card: [3h]
Player quant_theo folds
Player IlxxxlI folds
Player AironVega raises (2)
Player WeakAndWeary raises (9.50)
Player bunnyfox2t folds
Player AironVega folds
Uncalled bet (8) returned to WeakAndWeary
Player WeakAndWeary mucks cards
------ Summary ------
Pot: 5. Rake 0
Player IlxxxlI does not show cards.Bets: 0. Collects: 0. Wins: 0.
Player AironVega does not show cards.Bets: 2. Collects: 0. Loses: 2.
*Player WeakAndWeary mucks (does not show cards). Bets: 2. Collects: 5. Wins: 3.
Player bunnyfox2t does not show cards.Bets: 1. Collects: 0. Loses: 1.
Player quant_theo does not show cards.Bets: 0. Collects: 0. Wins: 0.
Game ended at: 2016/11/29 13:55:42

Game started
Game ID: 786992523 0.50/1 (PRR) Kraken - 20 (Hold'em)
Seat 1 is the button
Seat 1: IlxxxlI (40).
Seat 3: AironVega (100).
Seat 4: WeakAndWeary (115.88).
Seat 5: bunnyfox2t (100).
Seat 6: quant_theo (140.36).
Player AironVega has small blind (0.50)
Player WeakAndWeary has big blind (1)
Player IlxxxlI received card: [7d]
Player IlxxxlI received card: [4s]
Player bunnyfox2t folds
Player quant_theo folds
Player IlxxxlI folds
Player AironVega raises (2.50)
Player WeakAndWeary folds
Uncalled bet (2) returned to AironVega
Player AironVega mucks cards
------ Summary ------
Pot: 2. Rake 0
Player IlxxxlI does not show cards.Bets: 0. Collects: 0. Wins: 0.
*Player AironVega mucks (does not show cards). Bets: 1. Collects: 2. Wins: 1.
Player WeakAndWeary does not show cards.Bets: 1. Collects: 0. Loses: 1.
Player bunnyfox2t does not show cards.Bets: 0. Collects: 0. Wins: 0.
Player quant_theo does not show cards.Bets: 0. Collects: 0. Wins: 0.
Game ended at: 2016/11/29 13:55:7

Game started
Game ID: 786991925 0.50/1 (PRR) Karkadann - 4 (Hold'em)
Seat 2 is the button
Seat 2: StephCurry (194.18).
Seat 3: dankmann (100).
Seat 4: MadLifeGrinder (101.55).
Seat 5: MaxWoof (116.24).
Seat 6: Pla2Par (27.57).
Seat 7: IlxxxlI (40).
Seat 8: VegetablesArentYummy (126.65).
Seat 9: zboiii (135.15).
Player dankmann has small blind (0.50)
Player MadLifeGrinder sitting out
Player MaxWoof has big blind (1)
Player IlxxxlI received card: [7d]
Player IlxxxlI received card: [3d]
Player Pla2Par folds
Player IlxxxlI folds
Player VegetablesArentYummy folds
Player zboiii folds
Player StephCurry raises (2)
Player dankmann folds
Player MaxWoof folds
Uncalled bet (1) returned to StephCurry
Player StephCurry mucks cards
------ Summary ------
Pot: 2.50. Rake 0
*Player StephCurry mucks (does not show cards). Bets: 1. Collects: 2.50. Wins: 1.50.
Player dankmann does not show cards.Bets: 0.50. Collects: 0. Loses: 0.50.
Player MadLifeGrinder does not show cards.Bets: 0. Collects: 0. Wins: 0.
Player MaxWoof does not show cards.Bets: 1. Collects: 0. Loses: 1.
Player Pla2Par does not show cards.Bets: 0. Collects: 0. Wins: 0.
Player IlxxxlI does not show cards.Bets: 0. Collects: 0. Wins: 0.
Player VegetablesArentYummy does not show cards.Bets: 0. Collects: 0. Wins: 0.
Player zboiii does not show cards.Bets: 0. Collects: 0. Wins: 0.
Game ended at: 2016/11/29 13:53:43

Game started
Game ID: 786991607 0.50/1 (PRR) Karkadann - 4 (Hold'em)
Seat 9 is the button
Seat 2: StephCurry (194.68).
Seat 3: dankmann (100).
Seat 4: MadLifeGrinder (101.55).
Seat 5: MaxWoof (116.24).
Seat 6: Pla2Par (27.57).
Seat 7: IlxxxlI (40).
Seat 8: VegetablesArentYummy (126.65).
Seat 9: zboiii (133.65).
Player StephCurry has small blind (0.50)
Player dankmann has big blind (1)
Player IlxxxlI received card: [Jh]
Player IlxxxlI received card: [6c]
Player MadLifeGrinder folds
Player MaxWoof folds
Player Pla2Par folds
Player IlxxxlI folds
Player VegetablesArentYummy folds
Player zboiii raises (3)
Player StephCurry folds
Player dankmann folds
Uncalled bet (2) returned to zboiii
Player zboiii mucks cards
------ Summary ------
Pot: 2.50. Rake 0
Player StephCurry does not show cards.Bets: 0.50. Collects: 0. Loses: 0.50.
Player dankmann does not show cards.Bets: 1. Collects: 0. Loses: 1.
Player MadLifeGrinder does not show cards.Bets: 0. Collects: 0. Wins: 0.
Player MaxWoof does not show cards.Bets: 0. Collects: 0. Wins: 0.
Player Pla2Par does not show cards.Bets: 0. Collects: 0. Wins: 0.
Player IlxxxlI does not show cards.Bets: 0. Collects: 0. Wins: 0.
Player VegetablesArentYummy does not show cards.Bets: 0. Collects: 0. Wins: 0.
*Player zboiii mucks (does not show cards). Bets: 1. Collects: 2.50. Wins: 1.50.
Game ended at: 2016/11/29 13:53:16

Game started
Game ID: 786991509 0.50/1 (PRR) Kraken - 20 (Hold'em)
Seat 6 is the button
Seat 1: IlxxxlI (40).
Seat 2: MadLifeGrinder (123.45).
Seat 3: AironVega (100).
Seat 4: WeakAndWeary (115.88).
Seat 5: bunnyfox2t (100).
Seat 6: quant_theo (102.36).
Player IlxxxlI has small blind (0.50)
Player MadLifeGrinder has big blind (1)
Player IlxxxlI received card: [10h]
Player IlxxxlI received card: [As]
Player AironVega folds
Player WeakAndWeary folds
Player bunnyfox2t folds
Player quant_theo raises (3)
Player IlxxxlI raises (4.50)
Player MadLifeGrinder folds
Player quant_theo calls (2)
*** FLOP ***: [10c 7h Kh]
Player IlxxxlI checks
Player quant_theo bets (6)
Player IlxxxlI calls (6)
*** TURN ***: [10c 7h Kh] [2s]
Player IlxxxlI checks
Player quant_theo bets (10)
Player IlxxxlI calls (10)
*** RIVER ***: [10c 7h Kh 2s] [7d]
Player IlxxxlI checks
Player quant_theo bets (19)
Player IlxxxlI allin (19)
------ Summary ------
Pot: 78. Rake 2.76. JP fee 0.24
Board: [10c 7h Kh 2s 7d]
Player IlxxxlI shows: Two pairs. 10s and 7s [10h As]. Bets: 40. Collects: 0. Loses: 40.
Player MadLifeGrinder does not show cards.Bets: 1. Collects: 0. Loses: 1.
Player AironVega does not show cards.Bets: 0. Collects: 0. Wins: 0.
Player WeakAndWeary does not show cards.Bets: 0. Collects: 0. Wins: 0.
Player bunnyfox2t does not show cards.Bets: 0. Collects: 0. Wins: 0.
*Player quant_theo shows: Full House (7/2) [7c 2d]. Bets: 40. Collects: 78. Wins: 38.
Game ended at: 2016/11/29 13:54:30

Game started
Game ID: 786991320 0.25/0.50 (PRR) Gorgons (Short) (Hold'em)
Seat 1 is the button
Seat 1: Ball Crusher (120.76).
Seat 2: Jui Kuen (38.64).
Seat 3: PokerBrat1127 (17.08).
Seat 4: Hakuna_Matata777 (47.74).
Seat 5: IlxxxlI (10).
Seat 6: anabeliangrape (25.75).
Player Jui Kuen has small blind (0.25)
Player PokerBrat1127 has big blind (0.50)
Player IlxxxlI received card: [8d]
Player IlxxxlI received card: [Kc]
Player Hakuna_Matata777 folds
Player IlxxxlI folds
Player anabeliangrape raises (1.50)
Player Ball Crusher calls (1.50)
Player Jui Kuen folds
Player PokerBrat1127 calls (1)
*** FLOP ***: [Ks 5s 7h]
Player PokerBrat1127 checks
Player anabeliangrape bets (2.26)
Player Ball Crusher raises (6.78)
Player PokerBrat1127 folds
Player anabeliangrape calls (4.52)
*** TURN ***: [Ks 5s 7h] [8c]
Player anabeliangrape checks
Player Ball Crusher checks
*** RIVER ***: [Ks 5s 7h 8c] [5d]
Player anabeliangrape checks
Player Ball Crusher checks
------ Summary ------
Pot: 17.40. Rake 0.67. JP fee 0.24
Board: [Ks 5s 7h 8c 5d]
*Player Ball Crusher shows: Two pairs. 7s and 5s [7s 6s]. Bets: 8.28. Collects: 8.70. Wins: 0.42.
Player Jui Kuen does not show cards.Bets: 0.25. Collects: 0. Loses: 0.25.
Player PokerBrat1127 does not show cards.Bets: 1.50. Collects: 0. Loses: 1.50.
Player Hakuna_Matata777 does not show cards.Bets: 0. Collects: 0. Wins: 0.
Player IlxxxlI does not show cards.Bets: 0. Collects: 0. Wins: 0.
*Player anabeliangrape shows: Two pairs. 7s and 5s [Jc 7d]. Bets: 8.28. Collects: 8.70. Wins: 0.42.
Game ended at: 2016/11/29 13:54:0

Game started
Game ID: 786991266 0.50/1 (PRR) Kraken - 20 (Hold'em)
Seat 5 is the button
Seat 1: IlxxxlI (40).
Seat 2: MadLifeGrinder (123.45).
Seat 3: AironVega (100).
Seat 4: WeakAndWeary (114.38).
Seat 5: bunnyfox2t (100).
Seat 6: quant_theo (102.86).
Player quant_theo has small blind (0.50)
Player IlxxxlI has big blind (1)
Player IlxxxlI received card: [Qd]
Player IlxxxlI received card: [2d]
Player MadLifeGrinder folds
Player AironVega folds
Player WeakAndWeary raises (3)
Player bunnyfox2t folds
Player quant_theo folds
Player IlxxxlI folds
Uncalled bet (2) returned to WeakAndWeary
Player WeakAndWeary mucks cards
------ Summary ------
Pot: 2.50. Rake 0
Player IlxxxlI does not show cards.Bets: 1. Collects: 0. Loses: 1.
Player MadLifeGrinder does not show cards.Bets: 0. Collects: 0. Wins: 0.
Player AironVega does not show cards.Bets: 0. Collects: 0. Wins: 0.
*Player WeakAndWeary mucks (does not show cards). Bets: 1. Collects: 2.50. Wins: 1.50.
Player bunnyfox2t does not show cards.Bets: 0. Collects: 0. Wins: 0.
Player quant_theo does not show cards.Bets: 0.50. Collects: 0. Loses: 0.50.
Game ended at: 2016/11/29 13:52:24

Game started
Game ID: 786991255 0.25/0.50 (PRR) Gorgons - 12 (Hold'em)
Seat 6 is the button
Seat 1: BHawk12 (64.75).
Seat 2: WeakAndWeary (93.95).
Seat 3: IampokerKidd (97.25).
Seat 4: IlxxxlI (25.17).
Seat 5: vagabond00 (43.24).
Seat 6: foreseen (56.12).
Player BHawk12 has small blind (0.25)
Player WeakAndWeary has big blind (0.50)
Player IlxxxlI received card: [6d]
Player IlxxxlI received card: [8h]
Player IampokerKidd folds
Player IlxxxlI folds
Player vagabond00 folds
Player foreseen raises (1.25)
Player BHawk12 folds
Player WeakAndWeary folds
Uncalled bet (0.75) returned to foreseen
Player foreseen mucks cards
------ Summary ------
Pot: 1.25. Rake 0
Player BHawk12 does not show cards.Bets: 0.25. Collects: 0. Loses: 0.25.
Player WeakAndWeary does not show cards.Bets: 0.50. Collects: 0. Loses: 0.50.
Player IampokerKidd does not show cards.Bets: 0. Collects: 0. Wins: 0.
Player IlxxxlI does not show cards.Bets: 0. Collects: 0. Wins: 0.
Player vagabond00 does not show cards.Bets: 0. Collects: 0. Wins: 0.
*Player foreseen mucks (does not show cards). Bets: 0.50. Collects: 1.25. Wins: 0.75.
Game ended at: 2016/11/29 13:52:27

Game started
Game ID: 786991053 0.25/0.50 (PRR) Gorgons (Short) (Hold'em)
Seat 6 is the button
Seat 1: Ball Crusher (121.01).
Seat 2: Jui Kuen (39.14).
Seat 3: PokerBrat1127 (17.08).
Seat 4: Hakuna_Matata777 (47.74).
Seat 5: IlxxxlI (10).
Seat 6: anabeliangrape (25).
Player Ball Crusher has small blind (0.25)
Player Jui Kuen has big blind (0.50)
Player IlxxxlI received card: [7d]
Player IlxxxlI received card: [4c]
Player PokerBrat1127 folds
Player Hakuna_Matata777 folds
Player IlxxxlI folds
Player anabeliangrape raises (1.50)
Player Ball Crusher folds
Player Jui Kuen folds
Uncalled bet (1) returned to anabeliangrape
Player anabeliangrape mucks cards
------ Summary ------
Pot: 1.25. Rake 0
Player Ball Crusher does not show cards.Bets: 0.25. Collects: 0. Loses: 0.25.
Player Jui Kuen does not show cards.Bets: 0.50. Collects: 0. Loses: 0.50.
Player PokerBrat1127 does not show cards.Bets: 0. Collects: 0. Wins: 0.
Player Hakuna_Matata777 does not show cards.Bets: 0. Collects: 0. Wins: 0.
Player IlxxxlI does not show cards.Bets: 0. Collects: 0. Wins: 0.
*Player anabeliangrape mucks (does not show cards). Bets: 0.50. Collects: 1.25. Wins: 0.75.
Game ended at: 2016/11/29 13:52:1

Game started
Game ID: 786990711 0.25/0.50 (PRR) Gorgons - 12 (Hold'em)
Seat 5 is the button
Seat 1: BHawk12 (65.25).
Seat 2: WeakAndWeary (93.95).
Seat 3: IampokerKidd (97.25).
Seat 4: IlxxxlI (25.17).
Seat 5: vagabond00 (45.75).
Seat 6: foreseen (53.38).
Player foreseen has small blind (0.25)
Player BHawk12 has big blind (0.50)
Player IlxxxlI received card: [Qd]
Player IlxxxlI received card: [3h]
Player WeakAndWeary folds
Player IampokerKidd folds
Player IlxxxlI folds
Player vagabond00 calls (0.50)
Player foreseen raises (2.26)
Player BHawk12 folds
Player vagabond00 calls (2.01)
*** FLOP ***: [5d Kd 2h]
Player foreseen bets (1.73)
Player vagabond00 folds
Uncalled bet (1.73) returned to foreseen
Player foreseen mucks cards
------ Summary ------
Pot: 5.25. Rake 0.19. JP fee 0.08
Board: [5d Kd 2h]
Player BHawk12 does not show cards.Bets: 0.50. Collects: 0. Loses: 0.50.
Player WeakAndWeary does not show cards.Bets: 0. Collects: 0. Wins: 0.
Player IampokerKidd does not show cards.Bets: 0. Collects: 0. Wins: 0.
Player IlxxxlI does not show cards.Bets: 0. Collects: 0. Wins: 0.
Player vagabond00 does not show cards.Bets: 2.51. Collects: 0. Loses: 2.51.
*Player foreseen mucks (does not show cards). Bets: 2.51. Collects: 5.25. Wins: 2.74.
Game ended at: 2016/11/29 13:51:52

Game started
Game ID: 786990710 0.25/0.50 (PRR) Gorgons - 7 (Hold'em)
Seat 5 is the button
Seat 1: flyshark01 (86.45).
Seat 2: xROCKETMANx (41.16).
Seat 3: IlxxxlI (20).
Seat 4: fishinwithbobbo (14.36).
Seat 5: Beep_Beep (81.64).
Seat 6: foreseen (75.43).
Player foreseen has small blind (0.25)
Player flyshark01 has big blind (0.50)
Player IlxxxlI received card: [6s]
Player IlxxxlI received card: [7h]
Player xROCKETMANx folds
Player IlxxxlI folds
Player fishinwithbobbo folds
Player Beep_Beep folds
Player foreseen calls (0.25)
Player flyshark01 checks
*** FLOP ***: [3h 7c Ks]
Player foreseen bets (0.50)
Player flyshark01 calls (0.50)
*** TURN ***: [3h 7c Ks] [2c]
Player foreseen checks
Player flyshark01 bets (1.27)
Player foreseen folds
Uncalled bet (1.27) returned to flyshark01
Player flyshark01 mucks cards
------ Summary ------
Pot: 1.90. Rake 0.08. JP fee 0.02
Board: [3h 7c Ks 2c]
*Player flyshark01 mucks (does not show cards). Bets: 1. Collects: 1.90. Wins: 0.90.
Player xROCKETMANx does not show cards.Bets: 0. Collects: 0. Wins: 0.
Player IlxxxlI does not show cards.Bets: 0. Collects: 0. Wins: 0.
Player fishinwithbobbo does not show cards.Bets: 0. Collects: 0. Wins: 0.
Player Beep_Beep does not show cards.Bets: 0. Collects: 0. Wins: 0.
Player foreseen does not show cards.Bets: 1. Collects: 0. Loses: 1.
Game ended at: 2016/11/29 13:52:30

Game started
Game ID: 786990662 0.50/1 (PRR) Kraken - 13 (Hold'em)
Seat 5 is the button
Seat 1: CrimZnole (142.48).
Seat 2: bunnyfox2t (101.50).
Seat 3: IlxxxlI (40).
Seat 4: AironVega (109.64).
Seat 5: flyshark01 (107.21).
Seat 6: Doubletwentyone (102.52).
Player Doubletwentyone has small blind (0.50)
Player CrimZnole has big blind (1)
Player IlxxxlI received card: [Kc]
Player IlxxxlI received card: [2h]
Player bunnyfox2t folds
Player IlxxxlI folds
Player AironVega raises (2.50)
Player flyshark01 folds
Player Doubletwentyone folds
Player CrimZnole calls (1.50)
*** FLOP ***: [9d 8s 2s]
Player CrimZnole checks
Player AironVega bets (1.73)
Player CrimZnole calls (1.73)
*** TURN ***: [9d 8s 2s] [9s]
Player CrimZnole checks
Player AironVega checks
*** RIVER ***: [9d 8s 2s 9s] [Qc]
Player CrimZnole bets (6.20)
Player AironVega folds
Uncalled bet (6.20) returned to CrimZnole
Player CrimZnole mucks cards
------ Summary ------
Pot: 8.52. Rake 0.30. JP fee 0.14
Board: [9d 8s 2s 9s Qc]
*Player CrimZnole mucks (does not show cards). Bets: 4.23. Collects: 8.52. Wins: 4.29.
Player bunnyfox2t does not show cards.Bets: 0. Collects: 0. Wins: 0.
Player IlxxxlI does not show cards.Bets: 0. Collects: 0. Wins: 0.
Player AironVega does not show cards.Bets: 4.23. Collects: 0. Loses: 4.23.
Player flyshark01 does not show cards.Bets: 0. Collects: 0. Wins: 0.
Player Doubletwentyone does not show cards.Bets: 0.50. Collects: 0. Loses: 0.50.
Game ended at: 2016/11/29 13:52:40

Game started
Game ID: 786990542 0.50/1 (PRR) Karkadann - 4 (Hold'em)
Seat 8 is the button
Seat 1: AironVega (101.50).
Seat 2: StephCurry (195.68).
Seat 4: MadLifeGrinder (110.88).
Seat 5: MaxWoof (116.24).
Seat 6: Pla2Par (27.57).
Seat 7: IlxxxlI (40).
Seat 8: VegetablesArentYummy (152.97).
Seat 9: zboiii (100).
Player zboiii has small blind (0.50)
Player AironVega sitting out
Player StephCurry has big blind (1)
Player IlxxxlI received card: [9h]
Player IlxxxlI received card: [10d]
Player MadLifeGrinder raises (3)
Player MaxWoof folds
Player Pla2Par folds
Player IlxxxlI folds
Player VegetablesArentYummy calls (3)
Player zboiii calls (2.50)
Player StephCurry folds
*** FLOP ***: [5h 4c 2d]
Player zboiii checks
Player MadLifeGrinder bets (6.33)
Player VegetablesArentYummy calls (6.33)
Player zboiii raises (23.32)
Player MadLifeGrinder folds
Player VegetablesArentYummy calls (16.99)
*** TURN ***: [5h 4c 2d] [10s]
Player zboiii bets (30.12)
Player VegetablesArentYummy folds
Uncalled bet (30.12) returned to zboiii
Player zboiii mucks cards
------ Summary ------
Pot: 59.97. Rake 2.76. JP fee 0.24
Board: [5h 4c 2d 10s]
Player AironVega does not show cards.Bets: 0. Collects: 0. Wins: 0.
Player StephCurry does not show cards.Bets: 1. Collects: 0. Loses: 1.
Player MadLifeGrinder does not show cards.Bets: 9.33. Collects: 0. Loses: 9.33.
Player MaxWoof does not show cards.Bets: 0. Collects: 0. Wins: 0.
Player Pla2Par does not show cards.Bets: 0. Collects: 0. Wins: 0.
Player IlxxxlI does not show cards.Bets: 0. Collects: 0. Wins: 0.
Player VegetablesArentYummy does not show cards.Bets: 26.32. Collects: 0. Loses: 26.32.
*Player zboiii mucks (does not show cards). Bets: 26.32. Collects: 59.97. Wins: 33.65.
Game ended at: 2016/11/29 13:52:37

Game started
Game ID: 786990481 0.50/1 (PRR) Kraken - 13 (Hold'em)
Seat 4 is the button
Seat 1: CrimZnole (142.48).
Seat 2: bunnyfox2t (101.50).
Seat 3: IlxxxlI (40).
Seat 4: AironVega (109.64).
Seat 5: flyshark01 (106.21).
Seat 6: Doubletwentyone (103.52).
Player flyshark01 has small blind (0.50)
Player Doubletwentyone has big blind (1)
Player IlxxxlI received card: [9d]
Player IlxxxlI received card: [8s]
Player CrimZnole folds
Player bunnyfox2t folds
Player IlxxxlI folds
Player AironVega folds
Player flyshark01 raises (2.50)
Player Doubletwentyone folds
Uncalled bet (2) returned to flyshark01
Player flyshark01 mucks cards
------ Summary ------
Pot: 2. Rake 0
Player CrimZnole does not show cards.Bets: 0. Collects: 0. Wins: 0.
Player bunnyfox2t does not show cards.Bets: 0. Collects: 0. Wins: 0.
Player IlxxxlI does not show cards.Bets: 0. Collects: 0. Wins: 0.
Player AironVega does not show cards.Bets: 0. Collects: 0. Wins: 0.
*Player flyshark01 mucks (does not show cards). Bets: 1. Collects: 2. Wins: 1.
Player Doubletwentyone does not show cards.Bets: 1. Collects: 0. Loses: 1.
Game ended at: 2016/11/29 13:50:39

Game started
Game ID: 786990467 0.25/0.50 (PRR) Gorgons (Short) (Hold'em)
Seat 5 is the button
Seat 1: Ball Crusher (117.50).
Seat 2: Jui Kuen (39.14).
Seat 3: PokerBrat1127 (17.08).
Seat 4: Hakuna_Matata777 (47.74).
Seat 5: IlxxxlI (10).
Seat 6: anabeliangrape (25).
Player anabeliangrape has small blind (0.25)
Player Ball Crusher has big blind (0.50)
Player IlxxxlI received card: [5c]
Player IlxxxlI received card: [Kc]
Player Jui Kuen folds
Player PokerBrat1127 folds
Player Hakuna_Matata777 folds
Player IlxxxlI folds
Player anabeliangrape raises (1.75)
Player Ball Crusher calls (1.50)
*** FLOP ***: [As Qd 2d]
Player anabeliangrape bets (1.90)
Player Ball Crusher calls (1.90)
*** TURN ***: [As Qd 2d] [Qh]
Player anabeliangrape checks
Player Ball Crusher bets (2.47)
Player anabeliangrape folds
Uncalled bet (2.47) returned to Ball Crusher
Player Ball Crusher mucks cards
------ Summary ------
Pot: 7.41. Rake 0.27. JP fee 0.12
Board: [As Qd 2d Qh]
*Player Ball Crusher mucks (does not show cards). Bets: 3.90. Collects: 7.41. Wins: 3.51.
Player Jui Kuen does not show cards.Bets: 0. Collects: 0. Wins: 0.
Player PokerBrat1127 does not show cards.Bets: 0. Collects: 0. Wins: 0.
Player Hakuna_Matata777 does not show cards.Bets: 0. Collects: 0. Wins: 0.
Player IlxxxlI does not show cards.Bets: 0. Collects: 0. Wins: 0.
Player anabeliangrape does not show cards.Bets: 3.90. Collects: 0. Loses: 3.90.
Game ended at: 2016/11/29 13:51:28

Game started
Game ID: 786990330 0.25/0.50 (PRR) Gorgons - 7 (Hold'em)
Seat 4 is the button
Seat 1: flyshark01 (86.45).
Seat 2: xROCKETMANx (41.16).
Seat 3: IlxxxlI (20).
Seat 4: fishinwithbobbo (13.61).
Seat 5: Beep_Beep (81.89).
Seat 6: foreseen (75.93).
Player Beep_Beep has small blind (0.25)
Player foreseen has big blind (0.50)
Player IlxxxlI received card: [Kc]
Player IlxxxlI received card: [10h]
Player flyshark01 folds
Player xROCKETMANx folds
Player IlxxxlI folds
Player fishinwithbobbo raises (1.50)
Player Beep_Beep folds
Player foreseen folds
Uncalled bet (1) returned to fishinwithbobbo
Player fishinwithbobbo mucks cards
------ Summary ------
Pot: 1.25. Rake 0
Player flyshark01 does not show cards.Bets: 0. Collects: 0. Wins: 0.
Player xROCKETMANx does not show cards.Bets: 0. Collects: 0. Wins: 0.
Player IlxxxlI does not show cards.Bets: 0. Collects: 0. Wins: 0.
*Player fishinwithbobbo mucks (does not show cards). Bets: 0.50. Collects: 1.25. Wins: 0.75.
Player Beep_Beep does not show cards.Bets: 0.25. Collects: 0. Loses: 0.25.
Player foreseen does not show cards.Bets: 0.50. Collects: 0. Loses: 0.50.
Game ended at: 2016/11/29 13:50:46

Game started
Game ID: 786990156 0.25/0.50 (PRR) Gorgons - 7 (Hold'em)
Seat 3 is the button
Seat 1: flyshark01 (86.45).
Seat 2: xROCKETMANx (41.16).
Seat 3: IlxxxlI (20).
Seat 4: fishinwithbobbo (13.86).
Seat 5: Beep_Beep (81.64).
Seat 6: foreseen (75.93).
Player fishinwithbobbo has small blind (0.25)
Player Beep_Beep has big blind (0.50)
Player IlxxxlI received card: [4s]
Player IlxxxlI received card: [9h]
Player foreseen folds
Player flyshark01 folds
Player xROCKETMANx folds
Player IlxxxlI folds
Player fishinwithbobbo folds
Uncalled bet (0.25) returned to Beep_Beep
Player Beep_Beep mucks cards
------ Summary ------
Pot: 0.50. Rake 0
Player flyshark01 does not show cards.Bets: 0. Collects: 0. Wins: 0.
Player xROCKETMANx does not show cards.Bets: 0. Collects: 0. Wins: 0.
Player IlxxxlI does not show cards.Bets: 0. Collects: 0. Wins: 0.
Player fishinwithbobbo does not show cards.Bets: 0.25. Collects: 0. Loses: 0.25.
*Player Beep_Beep mucks (does not show cards). Bets: 0.25. Collects: 0.50. Wins: 0.25.
Player foreseen does not show cards.Bets: 0. Collects: 0. Wins: 0.
Game ended at: 2016/11/29 13:49:57

Game started
Game ID: 786990121 0.50/1 (PRR) Kraken - 13 (Hold'em)
Seat 3 is the button
Seat 1: CrimZnole (144.88).
Seat 2: bunnyfox2t (101.50).
Seat 3: IlxxxlI (40).
Seat 4: AironVega (110.14).
Seat 5: flyshark01 (103.31).
Seat 6: Doubletwentyone (103.52).
Player AironVega has small blind (0.50)
Player flyshark01 has big blind (1)
Player IlxxxlI received card: [Kd]
Player IlxxxlI received card: [4c]
Player Doubletwentyone folds
Player CrimZnole raises (2.40)
Player bunnyfox2t folds
Player IlxxxlI folds
Player AironVega folds
Player flyshark01 raises (8.50)
Player CrimZnole folds
Uncalled bet (7.10) returned to flyshark01
Player flyshark01 mucks cards
------ Summary ------
Pot: 5.30. Rake 0
Player CrimZnole does not show cards.Bets: 2.40. Collects: 0. Loses: 2.40.
Player bunnyfox2t does not show cards.Bets: 0. Collects: 0. Wins: 0.
Player IlxxxlI does not show cards.Bets: 0. Collects: 0. Wins: 0.
Player AironVega does not show cards.Bets: 0.50. Collects: 0. Loses: 0.50.
*Player flyshark01 mucks (does not show cards). Bets: 2.40. Collects: 5.30. Wins: 2.90.
Player Doubletwentyone does not show cards.Bets: 0. Collects: 0. Wins: 0.
Game ended at: 2016/11/29 13:50:15

Game started
Game ID: 786989991 0.25/0.50 (PRR) Gorgons - 12 (Hold'em)
Seat 4 is the button
Seat 1: BHawk12 (65.25).
Seat 2: WeakAndWeary (93.95).
Seat 3: IampokerKidd (97.25).
Seat 4: IlxxxlI (25.17).
Seat 5: vagabond00 (49.50).
Seat 6: foreseen (50).
Player vagabond00 has small blind (0.25)
Player foreseen has big blind (0.50)
Player IlxxxlI received card: [5h]
Player IlxxxlI received card: [7c]
Player BHawk12 folds
Player WeakAndWeary folds
Player IampokerKidd folds
Player IlxxxlI folds
Player vagabond00 calls (0.25)
Player foreseen raises (1.75)
Player vagabond00 calls (1.75)
*** FLOP ***: [8h 8s Ks]
Player vagabond00 bets (1.50)
Player foreseen calls (1.50)
*** TURN ***: [8h 8s Ks] [Jd]
Player vagabond00 checks
Player foreseen checks
*** RIVER ***: [8h 8s Ks Jd] [4s]
Player vagabond00 checks
Player foreseen bets (5.78)
Player vagabond00 folds
Uncalled bet (5.78) returned to foreseen
Player foreseen mucks cards
------ Summary ------
Pot: 7.13. Rake 0.25. JP fee 0.12
Board: [8h 8s Ks Jd 4s]
Player BHawk12 does not show cards.Bets: 0. Collects: 0. Wins: 0.
Player WeakAndWeary does not show cards.Bets: 0. Collects: 0. Wins: 0.
Player IampokerKidd does not show cards.Bets: 0. Collects: 0. Wins: 0.
Player IlxxxlI does not show cards.Bets: 0. Collects: 0. Wins: 0.
Player vagabond00 does not show cards.Bets: 3.75. Collects: 0. Loses: 3.75.
*Player foreseen mucks (does not show cards). Bets: 3.75. Collects: 7.13. Wins: 3.38.
Game ended at: 2016/11/29 13:50:46

Game started
Game ID: 786989829 0.25/0.50 (PRR) Gorgons - 7 (Hold'em)
Seat 2 is the button
Seat 1: flyshark01 (86.45).
Seat 2: xROCKETMANx (41.92).
Seat 3: IlxxxlI (20).
Seat 4: fishinwithbobbo (14.36).
Seat 5: Beep_Beep (81.64).
Seat 6: foreseen (75.93).
Player IlxxxlI has small blind (0.25)
Player fishinwithbobbo has big blind (0.50)
Player IlxxxlI received card: [Kh]
Player IlxxxlI received card: [Ad]
Player Beep_Beep folds
Player foreseen folds
Player flyshark01 folds
Player xROCKETMANx raises (1.50)
Player IlxxxlI raises (3.55)
Player fishinwithbobbo folds
Player xROCKETMANx allin (40.42)
Player IlxxxlI allin (16.20)
Uncalled bet (21.92) returned to xROCKETMANx
*** FLOP ***: [9h Qs 4s]
*** TURN ***: [9h Qs 4s] [As]
*** RIVER ***: [9h Qs 4s As] [4c]
------ Summary ------
Pot: 38.48. Rake 1.78. JP fee 0.24
Board: [9h Qs 4s As 4c]
Player flyshark01 does not show cards.Bets: 0. Collects: 0. Wins: 0.
*Player xROCKETMANx shows: Two pairs. As and 4s [Ks Ac]. Bets: 20. Collects: 19.24. Loses: 0.76.
*Player IlxxxlI shows: Two pairs. As and 4s [Kh Ad]. Bets: 20. Collects: 19.24. Loses: 0.76.
Player fishinwithbobbo does not show cards.Bets: 0.50. Collects: 0. Loses: 0.50.
Player Beep_Beep does not show cards.Bets: 0. Collects: 0. Wins: 0.
Player foreseen does not show cards.Bets: 0. Collects: 0. Wins: 0.
Game ended at: 2016/11/29 13:49:34

Game started
Game ID: 786989800 0.25/0.50 (PRR) Gorgons (Short) (Hold'em)
Seat 4 is the button
Seat 1: Ball Crusher (117.50).
Seat 2: Jui Kuen (39.14).
Seat 3: PokerBrat1127 (17.08).
Seat 4: Hakuna_Matata777 (25).
Seat 5: IlxxxlI (10).
Seat 6: anabeliangrape (25).
Player IlxxxlI has small blind (0.25)
Player anabeliangrape has big blind (0.50)
Player IlxxxlI received card: [10h]
Player IlxxxlI received card: [5c]
Player Ball Crusher folds
Player Jui Kuen folds
Player PokerBrat1127 folds
Player Hakuna_Matata777 raises (1)
Player IlxxxlI folds
Player anabeliangrape raises (1.50)
Player Hakuna_Matata777 calls (1)
*** FLOP ***: [Ah Qc 10c]
Player anabeliangrape bets (2.02)
Player Hakuna_Matata777 raises (7.50)
Player anabeliangrape calls (5.48)
*** TURN ***: [Ah Qc 10c] [4c]
Player anabeliangrape checks
Player Hakuna_Matata777 bets (6.09)
Player anabeliangrape calls (6.09)
*** RIVER ***: [Ah Qc 10c 4c] [6d]
Player anabeliangrape checks
Player Hakuna_Matata777 allin (9.41)
Player anabeliangrape allin (9.41)
------ Summary ------
Pot: 47.74. Rake 2.27. JP fee 0.24
Board: [Ah Qc 10c 4c 6d]
Player Ball Crusher does not show cards.Bets: 0. Collects: 0. Wins: 0.
Player Jui Kuen does not show cards.Bets: 0. Collects: 0. Wins: 0.
Player PokerBrat1127 does not show cards.Bets: 0. Collects: 0. Wins: 0.
*Player Hakuna_Matata777 shows: Two pairs. As and 10s [Ac 10d]. Bets: 25. Collects: 47.74. Wins: 22.74.
Player IlxxxlI does not show cards.Bets: 0.25. Collects: 0. Loses: 0.25.
Player anabeliangrape shows: One pair of As [8h As]. Bets: 25. Collects: 0. Loses: 25.
Game ended at: 2016/11/29 13:50:11

Game started
Game ID: 786989675 0.50/1 (PRR) Kraken - 13 (Hold'em)
Seat 2 is the button
Seat 1: CrimZnole (144.88).
Seat 2: bunnyfox2t (100).
Seat 3: IlxxxlI (40).
Seat 4: AironVega (111.14).
Seat 5: flyshark01 (103.31).
Seat 6: Doubletwentyone (103.52).
Player IlxxxlI has small blind (0.50)
Player AironVega has big blind (1)
Player IlxxxlI received card: [9c]
Player IlxxxlI received card: [3s]
Player flyshark01 folds
Player Doubletwentyone folds
Player CrimZnole folds
Player bunnyfox2t raises (2.20)
Player IlxxxlI folds
Player AironVega folds
Uncalled bet (1.20) returned to bunnyfox2t
Player bunnyfox2t mucks cards
------ Summary ------
Pot: 2.50. Rake 0
Player CrimZnole does not show cards.Bets: 0. Collects: 0. Wins: 0.
*Player bunnyfox2t mucks (does not show cards). Bets: 1. Collects: 2.50. Wins: 1.50.
Player IlxxxlI does not show cards.Bets: 0.50. Collects: 0. Loses: 0.50.
Player AironVega does not show cards.Bets: 1. Collects: 0. Loses: 1.
Player flyshark01 does not show cards.Bets: 0. Collects: 0. Wins: 0.
Player Doubletwentyone does not show cards.Bets: 0. Collects: 0. Wins: 0.
Game ended at: 2016/11/29 13:49:30

Game started
Game ID: 786989670 0.50/1 (PRR) Karkadann - 4 (Hold'em)
Seat 7 is the button
Seat 1: AironVega (101.50).
Seat 2: StephCurry (195.68).
Seat 4: MadLifeGrinder (110.88).
Seat 5: MaxWoof (116.24).
Seat 6: Pla2Par (26.19).
Seat 7: IlxxxlI (40).
Seat 8: VegetablesArentYummy (153.47).
Seat 9: zboiii (100).
Player VegetablesArentYummy has small blind (0.50)
Player zboiii has big blind (1)
Player IlxxxlI received card: [3s]
Player IlxxxlI received card: [4h]
Player AironVega folds
Player StephCurry folds
Player MadLifeGrinder folds
Player MaxWoof folds
Player Pla2Par calls (1)
Player IlxxxlI folds
Player VegetablesArentYummy folds
Player zboiii checks
*** FLOP ***: [4d Kh 5d]
Player zboiii checks
Player Pla2Par checks
*** TURN ***: [4d Kh 5d] [10h]
Player zboiii checks
Player Pla2Par checks
*** RIVER ***: [4d Kh 5d 10h] [Kd]
Player zboiii checks
Player Pla2Par checks
Player zboiii mucks cards
------ Summary ------
Pot: 2.38. Rake 0.08. JP fee 0.04
Board: [4d Kh 5d 10h Kd]
Player AironVega does not show cards.Bets: 0. Collects: 0. Wins: 0.
Player StephCurry does not show cards.Bets: 0. Collects: 0. Wins: 0.
Player MadLifeGrinder does not show cards.Bets: 0. Collects: 0. Wins: 0.
Player MaxWoof does not show cards.Bets: 0. Collects: 0. Wins: 0.
*Player Pla2Par shows: Two pairs. Ks and 10s [Qs 10d]. Bets: 1. Collects: 2.38. Wins: 1.38.
Player IlxxxlI does not show cards.Bets: 0. Collects: 0. Wins: 0.
Player VegetablesArentYummy does not show cards.Bets: 0.50. Collects: 0. Loses: 0.50.
Player zboiii mucks (does not show cards). Bets: 1. Collects: 0. Loses: 1.
Game ended at: 2016/11/29 13:50:21

Game started
Game ID: 786989490 0.25/0.50 (PRR) Gorgons - 7 (Hold'em)
Seat 1 is the button
Seat 1: flyshark01 (86.45).
Seat 2: xROCKETMANx (40.57).
Seat 3: IlxxxlI (20.45).
Seat 4: fishinwithbobbo (14.36).
Seat 5: Beep_Beep (81.64).
Seat 6: foreseen (75.93).
Player xROCKETMANx has small blind (0.25)
Player IlxxxlI has big blind (0.50)
Player IlxxxlI received card: [2s]
Player IlxxxlI received card: [5s]
Player fishinwithbobbo folds
Player Beep_Beep folds
Player foreseen folds
Player flyshark01 folds
Player xROCKETMANx raises (1.25)
Player IlxxxlI calls (1)
*** FLOP ***: [Jd Kd Qh]
Player xROCKETMANx bets (1.90)
Player IlxxxlI folds
Uncalled bet (1.90) returned to xROCKETMANx
Player xROCKETMANx mucks cards
------ Summary ------
Pot: 2.85. Rake 0.11. JP fee 0.04
Board: [Jd Kd Qh]
Player flyshark01 does not show cards.Bets: 0. Collects: 0. Wins: 0.
*Player xROCKETMANx mucks (does not show cards). Bets: 1.50. Collects: 2.85. Wins: 1.35.
Player IlxxxlI does not show cards.Bets: 1.50. Collects: 0. Loses: 1.50.
Player fishinwithbobbo does not show cards.Bets: 0. Collects: 0. Wins: 0.
Player Beep_Beep does not show cards.Bets: 0. Collects: 0. Wins: 0.
Player foreseen does not show cards.Bets: 0. Collects: 0. Wins: 0.
Game ended at: 2016/11/29 13:48:52

Game started
Game ID: 786989336 0.50/1 (PRR) Karkadann - 4 (Hold'em)
Seat 6 is the button
Seat 1: AironVega (101.50).
Seat 2: StephCurry (195.68).
Seat 4: MadLifeGrinder (110.88).
Seat 5: MaxWoof (116.24).
Seat 6: Pla2Par (26.19).
Seat 7: IlxxxlI (40).
Seat 8: VegetablesArentYummy (152.97).
Player IlxxxlI has small blind (0.50)
Player VegetablesArentYummy has big blind (1)
Player IlxxxlI received card: [8c]
Player IlxxxlI received card: [5h]
Player AironVega folds
Player StephCurry folds
Player MadLifeGrinder folds
Player MaxWoof folds
Player Pla2Par folds
Player IlxxxlI folds
Uncalled bet (0.50) returned to VegetablesArentYummy
Player VegetablesArentYummy mucks cards
------ Summary ------
Pot: 1. Rake 0
Player AironVega does not show cards.Bets: 0. Collects: 0. Wins: 0.
Player StephCurry does not show cards.Bets: 0. Collects: 0. Wins: 0.
Player MadLifeGrinder does not show cards.Bets: 0. Collects: 0. Wins: 0.
Player MaxWoof does not show cards.Bets: 0. Collects: 0. Wins: 0.
Player Pla2Par does not show cards.Bets: 0. Collects: 0. Wins: 0.
Player IlxxxlI does not show cards.Bets: 0.50. Collects: 0. Loses: 0.50.
*Player VegetablesArentYummy mucks (does not show cards). Bets: 0.50. Collects: 1. Wins: 0.50.
Game ended at: 2016/11/29 13:48:35

Game started
Game ID: 786989255 0.25/0.50 (PRR) Gorgons - 7 (Hold'em)
Seat 6 is the button
Seat 1: flyshark01 (85.95).
Seat 2: xROCKETMANx (41.07).
Seat 3: IlxxxlI (20.45).
Seat 4: fishinwithbobbo (14.36).
Seat 5: Beep_Beep (81.64).
Seat 6: foreseen (75.93).
Player flyshark01 has small blind (0.25)
Player xROCKETMANx has big blind (0.50)
Player IlxxxlI received card: [4d]
Player IlxxxlI received card: [9s]
Player IlxxxlI folds
Player fishinwithbobbo folds
Player Beep_Beep folds
Player foreseen folds
Player flyshark01 raises (1.25)
Player xROCKETMANx folds
Uncalled bet (1) returned to flyshark01
Player flyshark01 mucks cards
------ Summary ------
Pot: 1. Rake 0
*Player flyshark01 mucks (does not show cards). Bets: 0.50. Collects: 1. Wins: 0.50.
Player xROCKETMANx does not show cards.Bets: 0.50. Collects: 0. Loses: 0.50.
Player IlxxxlI does not show cards.Bets: 0. Collects: 0. Wins: 0.
Player fishinwithbobbo does not show cards.Bets: 0. Collects: 0. Wins: 0.
Player Beep_Beep does not show cards.Bets: 0. Collects: 0. Wins: 0.
Player foreseen does not show cards.Bets: 0. Collects: 0. Wins: 0.
Game ended at: 2016/11/29 13:48:11

Game started
Game ID: 786989231 0.25/0.50 (PRR) Gorgons (Short) (Hold'em)
Seat 3 is the button
Seat 1: Ball Crusher (110.71).
Seat 2: Jui Kuen (39.14).
Seat 3: PokerBrat1127 (17.08).
Seat 4: Hakuna_Matata777 (25).
Seat 5: IlxxxlI (10).
Seat 6: anabeliangrape (26.50).
Player Hakuna_Matata777 has small blind (0.25)
Player IlxxxlI has big blind (0.50)
Player IlxxxlI received card: [10c]
Player IlxxxlI received card: [5s]
Player anabeliangrape raises (1.50)
Player Ball Crusher calls (1.50)
Player Jui Kuen folds
Player PokerBrat1127 folds
Player Hakuna_Matata777 folds
Player IlxxxlI folds
*** FLOP ***: [2c 7d 10h]
Player anabeliangrape checks
Player Ball Crusher bets (1.78)
Player anabeliangrape calls (1.78)
*** TURN ***: [2c 7d 10h] [9c]
Player anabeliangrape checks
Player Ball Crusher bets (3.47)
Player anabeliangrape calls (3.47)
*** RIVER ***: [2c 7d 10h 9c] [7h]
Player anabeliangrape checks
Player Ball Crusher checks
Player anabeliangrape mucks cards
------ Summary ------
Pot: 13.54. Rake 0.49. JP fee 0.22
Board: [2c 7d 10h 9c 7h]
*Player Ball Crusher shows: Two pairs. 7s and 5s [5d 5c]. Bets: 6.75. Collects: 13.54. Wins: 6.79.
Player Jui Kuen does not show cards.Bets: 0. Collects: 0. Wins: 0.
Player PokerBrat1127 does not show cards.Bets: 0. Collects: 0. Wins: 0.
Player Hakuna_Matata777 does not show cards.Bets: 0.25. Collects: 0. Loses: 0.25.
Player IlxxxlI does not show cards.Bets: 0.50. Collects: 0. Loses: 0.50.
Player anabeliangrape mucks (does not show cards). Bets: 6.75. Collects: 0. Loses: 6.75.
Game ended at: 2016/11/29 13:48:47

Game started
Game ID: 786989140 0.25/0.50 (PRR) Gorgons - 12 (Hold'em)
Seat 3 is the button
Seat 1: BHawk12 (66.75).
Seat 2: WeakAndWeary (93.95).
Seat 3: IampokerKidd (97.25).
Seat 4: IlxxxlI (23.34).
Seat 5: vagabond00 (50).
Seat 6: foreseen (50).
Player IlxxxlI has small blind (0.25)
Player vagabond00 has big blind (0.50)
Player IlxxxlI received card: [8h]
Player IlxxxlI received card: [8c]
Player foreseen folds
Player BHawk12 raises (1.50)
Player WeakAndWeary folds
Player IampokerKidd folds
Player IlxxxlI calls (1.25)
Player vagabond00 folds
*** FLOP ***: [8d Kh 2h]
Player IlxxxlI checks
Player BHawk12 checks
*** TURN ***: [8d Kh 2h] [5d]
Player IlxxxlI bets (5.50)
Player BHawk12 folds
Uncalled bet (5.50) returned to IlxxxlI
Player IlxxxlI mucks cards
------ Summary ------
Pot: 3.33. Rake 0.13. JP fee 0.04
Board: [8d Kh 2h 5d]
Player BHawk12 does not show cards.Bets: 1.50. Collects: 0. Loses: 1.50.
Player WeakAndWeary does not show cards.Bets: 0. Collects: 0. Wins: 0.
Player IampokerKidd does not show cards.Bets: 0. Collects: 0. Wins: 0.
*Player IlxxxlI mucks (does not show cards). Bets: 1.50. Collects: 3.33. Wins: 1.83.
Player vagabond00 does not show cards.Bets: 0.50. Collects: 0. Loses: 0.50.
Player foreseen does not show cards.Bets: 0. Collects: 0. Wins: 0.
Game ended at: 2016/11/29 13:49:14

Game started
Game ID: 786989095 0.25/0.50 (PRR) Gorgons - 2 (Hold'em)
Seat 1 is the button
Seat 1: BHawk12 (55.74).
Seat 2: vagabond00 (19.50).
Seat 3: flyshark01 (99.67).
Seat 4: Doubletwentyone (50).
Seat 5: IlxxxlI (20.50).
Seat 6: foreseen (57.41).
Player vagabond00 has small blind (0.25)
Player flyshark01 has big blind (0.50)
Player IlxxxlI received card: [4s]
Player IlxxxlI received card: [3d]
Player Doubletwentyone folds
Player IlxxxlI folds
Player foreseen raises (1.25)
Player BHawk12 folds
Player vagabond00 folds
Player flyshark01 folds
Uncalled bet (0.75) returned to foreseen
Player foreseen mucks cards
------ Summary ------
Pot: 1.25. Rake 0
Player BHawk12 does not show cards.Bets: 0. Collects: 0. Wins: 0.
Player vagabond00 does not show cards.Bets: 0.25. Collects: 0. Loses: 0.25.
Player flyshark01 does not show cards.Bets: 0.50. Collects: 0. Loses: 0.50.
Player Doubletwentyone does not show cards.Bets: 0. Collects: 0. Wins: 0.
Player IlxxxlI does not show cards.Bets: 0. Collects: 0. Wins: 0.
*Player foreseen mucks (does not show cards). Bets: 0.50. Collects: 1.25. Wins: 0.75.
Game ended at: 2016/11/29 13:48:20

Game started
Game ID: 786988979 0.50/1 (PRR) Kraken - 13 (Hold'em)
Seat 1 is the button
Seat 1: CrimZnole (150.23).
Seat 2: bunnyfox2t (100).
Seat 3: IlxxxlI (40).
Seat 4: AironVega (104.90).
Seat 5: flyshark01 (103.31).
Seat 6: Doubletwentyone (103.52).
Player bunnyfox2t has small blind (0.50)
Player IlxxxlI has big blind (1)
Player IlxxxlI received card: [5s]
Player IlxxxlI received card: [9s]
Player AironVega raises (3)
Player flyshark01 folds
Player Doubletwentyone folds
Player CrimZnole calls (3)
Player bunnyfox2t folds
Player IlxxxlI folds
*** FLOP ***: [7d 9c Qd]
Player AironVega bets (2.35)
Player CrimZnole calls (2.35)
*** TURN ***: [7d 9c Qd] [10c]
Player AironVega bets (8.69)
Player CrimZnole folds
Uncalled bet (8.69) returned to AironVega
Player AironVega mucks cards
------ Summary ------
Pot: 11.59. Rake 0.41. JP fee 0.20
Board: [7d 9c Qd 10c]
Player CrimZnole does not show cards.Bets: 5.35. Collects: 0. Loses: 5.35.
Player bunnyfox2t does not show cards.Bets: 0.50. Collects: 0. Loses: 0.50.
Player IlxxxlI does not show cards.Bets: 1. Collects: 0. Loses: 1.
*Player AironVega mucks (does not show cards). Bets: 5.35. Collects: 11.59. Wins: 6.24.
Player flyshark01 does not show cards.Bets: 0. Collects: 0. Wins: 0.
Player Doubletwentyone does not show cards.Bets: 0. Collects: 0. Wins: 0.
Game ended at: 2016/11/29 13:48:35

Game started
Game ID: 786988966 0.50/1 (PRR) Karkadann - 4 (Hold'em)
Seat 5 is the button
Seat 1: AironVega (100).
Seat 2: StephCurry (195.68).
Seat 4: MadLifeGrinder (110.88).
Seat 5: MaxWoof (116.24).
Seat 6: Pla2Par (26.69).
Seat 7: IlxxxlI (40).
Seat 8: VegetablesArentYummy (152.97).
Player Pla2Par has small blind (0.50)
Player IlxxxlI has big blind (1)
Player IlxxxlI received card: [Jd]
Player IlxxxlI received card: [3d]
Player VegetablesArentYummy folds
Player AironVega raises (3)
Player StephCurry folds
Player MadLifeGrinder folds
Player MaxWoof folds
Player Pla2Par folds
Player IlxxxlI folds
Uncalled bet (2) returned to AironVega
Player AironVega mucks cards
------ Summary ------
Pot: 2.50. Rake 0
*Player AironVega mucks (does not show cards). Bets: 1. Collects: 2.50. Wins: 1.50.
Player StephCurry does not show cards.Bets: 0. Collects: 0. Wins: 0.
Player MadLifeGrinder does not show cards.Bets: 0. Collects: 0. Wins: 0.
Player MaxWoof does not show cards.Bets: 0. Collects: 0. Wins: 0.
Player Pla2Par does not show cards.Bets: 0.50. Collects: 0. Loses: 0.50.
Player IlxxxlI does not show cards.Bets: 1. Collects: 0. Loses: 1.
Player VegetablesArentYummy does not show cards.Bets: 0. Collects: 0. Wins: 0.
Game ended at: 2016/11/29 13:47:55

Game started
Game ID: 786988560 0.25/0.50 (PRR) Gorgons - 12 (Hold'em)
Seat 2 is the button
Seat 1: BHawk12 (66.75).
Seat 2: WeakAndWeary (96.56).
Seat 3: IampokerKidd (97.50).
Seat 4: IlxxxlI (20.75).
Seat 6: foreseen (50).
Player IampokerKidd has small blind (0.25)
Player IlxxxlI has big blind (0.50)
Player IlxxxlI received card: [6d]
Player IlxxxlI received card: [Kd]
Player foreseen folds
Player BHawk12 folds
Player WeakAndWeary raises (1)
Player IampokerKidd folds
Player IlxxxlI calls (0.50)
*** FLOP ***: [8h 10c 5d]
Player IlxxxlI checks
Player WeakAndWeary bets (1.61)
Player IlxxxlI raises (4)
Player WeakAndWeary folds
Uncalled bet (2.39) returned to IlxxxlI
Player IlxxxlI mucks cards
------ Summary ------
Pot: 5.20. Rake 0.19. JP fee 0.08
Board: [8h 10c 5d]
Player BHawk12 does not show cards.Bets: 0. Collects: 0. Wins: 0.
Player WeakAndWeary does not show cards.Bets: 2.61. Collects: 0. Loses: 2.61.
Player IampokerKidd does not show cards.Bets: 0.25. Collects: 0. Loses: 0.25.
*Player IlxxxlI mucks (does not show cards). Bets: 2.61. Collects: 5.20. Wins: 2.59.
Player foreseen does not show cards.Bets: 0. Collects: 0. Wins: 0.
Game ended at: 2016/11/29 13:47:29

Game started
Game ID: 786988490 0.25/0.50 (PRR) Gorgons (Short) (Hold'em)
Seat 2 is the button
Seat 1: Ball Crusher (119.21).
Seat 2: Jui Kuen (39.14).
Seat 3: PokerBrat1127 (8.95).
Seat 4: Hakuna_Matata777 (25).
Seat 5: IlxxxlI (10).
Seat 6: anabeliangrape (26.50).
Player PokerBrat1127 has small blind (0.25)
Player Hakuna_Matata777 has big blind (0.50)
Player IlxxxlI received card: [8s]
Player IlxxxlI received card: [2s]
Player IlxxxlI folds
Player anabeliangrape folds
Player Ball Crusher raises (1.50)
Player Jui Kuen folds
Player PokerBrat1127 calls (1.25)
Player Hakuna_Matata777 folds
*** FLOP ***: [2h 6s 8d]
Player PokerBrat1127 bets (1.50)
Player Ball Crusher calls (1.50)
*** TURN ***: [2h 6s 8d] [6c]
Player PokerBrat1127 bets (2.50)
Player Ball Crusher calls (2.50)
*** RIVER ***: [2h 6s 8d 6c] [4c]
Player PokerBrat1127 bets (3)
Player Ball Crusher calls (3)
Player Ball Crusher mucks cards
------ Summary ------
Pot: 16.63. Rake 0.63. JP fee 0.24
Board: [2h 6s 8d 6c 4c]
Player Ball Crusher mucks (does not show cards). Bets: 8.50. Collects: 0. Loses: 8.50.
Player Jui Kuen does not show cards.Bets: 0. Collects: 0. Wins: 0.
*Player PokerBrat1127 shows: Two pairs. 8s and 6s [8c Qc]. Bets: 8.50. Collects: 16.63. Wins: 8.13.
Player Hakuna_Matata777 does not show cards.Bets: 0.50. Collects: 0. Loses: 0.50.
Player IlxxxlI does not show cards.Bets: 0. Collects: 0. Wins: 0.
Player anabeliangrape does not show cards.Bets: 0. Collects: 0. Wins: 0.
Game ended at: 2016/11/29 13:47:41

Game started
Game ID: 786988346 1/2 (PRR) Lakhey (Short) (Hold'em)
Seat 4 is the button
Seat 3: VegetablesArentYummy (218.53).
Seat 4: IlxxxlI (43).
Seat 5: AironVega (101).
Player AironVega has small blind (1)
Player VegetablesArentYummy sitting out
Player IlxxxlI has big blind (2)
Player IlxxxlI received card: [Ac]
Player IlxxxlI received card: [3c]
Player AironVega raises (5)
Player IlxxxlI allin (41)
Player AironVega folds
Uncalled bet (37) returned to IlxxxlI
Player IlxxxlI mucks cards
------ Summary ------
Pot: 12. Rake 0
Player VegetablesArentYummy does not show cards.Bets: 0. Collects: 0. Wins: 0.
*Player IlxxxlI mucks (does not show cards). Bets: 6. Collects: 12. Wins: 6.
Player AironVega does not show cards.Bets: 6. Collects: 0. Loses: 6.
Game ended at: 2016/11/29 13:46:18

Game started
Game ID: 786988316 0.50/1 (PRR) Kraken - 8 (Hold'em)
Seat 1 is the button
Seat 1: MadLifeGrinder (123.71).
Seat 2: bunnyfox2t (100).
Seat 3: AironVega (100).
Seat 4: rook_ (135.41).
Seat 5: IlxxxlI (61.87).
Seat 6: ThxBro (24.84).
Player bunnyfox2t has small blind (0.50)
Player AironVega has big blind (1)
Player IlxxxlI received card: [7c]
Player IlxxxlI received card: [5d]
Player rook_ raises (3)
Player IlxxxlI folds
Player ThxBro folds
Player MadLifeGrinder folds
Player bunnyfox2t raises (9.50)
Player AironVega folds
Player rook_ folds
Uncalled bet (7) returned to bunnyfox2t
Player bunnyfox2t mucks cards
------ Summary ------
Pot: 7. Rake 0
Player MadLifeGrinder does not show cards.Bets: 0. Collects: 0. Wins: 0.
*Player bunnyfox2t mucks (does not show cards). Bets: 3. Collects: 7. Wins: 4.
Player AironVega does not show cards.Bets: 1. Collects: 0. Loses: 1.
Player rook_ does not show cards.Bets: 3. Collects: 0. Loses: 3.
Player IlxxxlI does not show cards.Bets: 0. Collects: 0. Wins: 0.
Player ThxBro does not show cards.Bets: 0. Collects: 0. Wins: 0.
Game ended at: 2016/11/29 13:46:39

Game started
Game ID: 786988289 0.25/0.50 (PRR) Gorgons - 2 (Hold'em)
Seat 6 is the button
Seat 1: BHawk12 (49.50).
Seat 2: vagabond00 (20).
Seat 3: flyshark01 (99.67).
Seat 4: Doubletwentyone (51.49).
Seat 5: IlxxxlI (20.50).
Seat 6: foreseen (57.41).
Player BHawk12 has small blind (0.25)
Player vagabond00 has big blind (0.50)
Player IlxxxlI received card: [8d]
Player IlxxxlI received card: [2c]
Player flyshark01 folds
Player Doubletwentyone raises (1.50)
Player IlxxxlI folds
Player foreseen folds
Player BHawk12 calls (1.25)
Player vagabond00 folds
*** FLOP ***: [2h 6s 3h]
Player BHawk12 checks
Player Doubletwentyone bets (1.66)
Player BHawk12 calls (1.66)
*** TURN ***: [2h 6s 3h] [6d]
Player BHawk12 checks
Player Doubletwentyone checks
*** RIVER ***: [2h 6s 3h 6d] [6h]
Player BHawk12 bets (3.24)
Player Doubletwentyone calls (3.24)
Player Doubletwentyone mucks cards
------ Summary ------
Pot: 12.64. Rake 0.44. JP fee 0.22
Board: [2h 6s 3h 6d 6h]
*Player BHawk12 shows: Full House (6/3) [3d 5d]. Bets: 6.40. Collects: 12.64. Wins: 6.24.
Player vagabond00 does not show cards.Bets: 0.50. Collects: 0. Loses: 0.50.
Player flyshark01 does not show cards.Bets: 0. Collects: 0. Wins: 0.
Player Doubletwentyone mucks (does not show cards). Bets: 6.40. Collects: 0. Loses: 6.40.
Player IlxxxlI does not show cards.Bets: 0. Collects: 0. Wins: 0.
Player foreseen does not show cards.Bets: 0. Collects: 0. Wins: 0.
Game ended at: 2016/11/29 13:47:21

Game started
Game ID: 786988248 0.25/0.50 (PRR) Gorgons - 7 (Hold'em)
Seat 5 is the button
Seat 1: flyshark01 (86.45).
Seat 2: xROCKETMANx (41.07).
Seat 3: IlxxxlI (20.45).
Seat 4: fishinwithbobbo (21.36).
Seat 5: Beep_Beep (95.64).
Seat 6: foreseen (56.20).
Player foreseen has small blind (0.25)
Player flyshark01 has big blind (0.50)
Player IlxxxlI received card: [2h]
Player IlxxxlI received card: [6d]
Player xROCKETMANx folds
Player IlxxxlI folds
Player fishinwithbobbo raises (1.50)
Player Beep_Beep calls (1.50)
Player foreseen raises (6.75)
Player flyshark01 folds
Player fishinwithbobbo calls (5.50)
Player Beep_Beep calls (5.50)
*** FLOP ***: [Kc 2d 7c]
Player foreseen checks
Player fishinwithbobbo checks
Player Beep_Beep bets (7)
Player foreseen calls (7)
Player fishinwithbobbo folds
*** TURN ***: [Kc 2d 7c] [3h]
Player foreseen checks
Player Beep_Beep checks
*** RIVER ***: [Kc 2d 7c 3h] [3s]
Player foreseen allin (42.20)
Player Beep_Beep folds
Uncalled bet (42.20) returned to foreseen
Player foreseen mucks cards
------ Summary ------
Pot: 33.73. Rake 1.53. JP fee 0.24
Board: [Kc 2d 7c 3h 3s]
Player flyshark01 does not show cards.Bets: 0.50. Collects: 0. Loses: 0.50.
Player xROCKETMANx does not show cards.Bets: 0. Collects: 0. Wins: 0.
Player IlxxxlI does not show cards.Bets: 0. Collects: 0. Wins: 0.
Player fishinwithbobbo does not show cards.Bets: 7. Collects: 0. Loses: 7.
Player Beep_Beep does not show cards.Bets: 14. Collects: 0. Loses: 14.
*Player foreseen mucks (does not show cards). Bets: 14. Collects: 33.73. Wins: 19.73.
Game ended at: 2016/11/29 13:47:46

Game started
Game ID: 786988184 0.25/0.50 (PRR) Gorgons (Short) (Hold'em)
Seat 1 is the button
Seat 1: Ball Crusher (119.21).
Seat 2: Jui Kuen (39.39).
Seat 3: PokerBrat1127 (9.45).
Seat 5: IlxxxlI (10).
Seat 6: anabeliangrape (25.75).
Player Jui Kuen has small blind (0.25)
Player PokerBrat1127 has big blind (0.50)
Player IlxxxlI received card: [9d]
Player IlxxxlI received card: [6d]
Player IlxxxlI folds
Player anabeliangrape raises (1.50)
Player Ball Crusher folds
Player Jui Kuen folds
Player PokerBrat1127 folds
Uncalled bet (1) returned to anabeliangrape
Player anabeliangrape mucks cards
------ Summary ------
Pot: 1.25. Rake 0
Player Ball Crusher does not show cards.Bets: 0. Collects: 0. Wins: 0.
Player Jui Kuen does not show cards.Bets: 0.25. Collects: 0. Loses: 0.25.
Player PokerBrat1127 does not show cards.Bets: 0.50. Collects: 0. Loses: 0.50.
Player IlxxxlI does not show cards.Bets: 0. Collects: 0. Wins: 0.
*Player anabeliangrape mucks (does not show cards). Bets: 0.50. Collects: 1.25. Wins: 0.75.
Game ended at: 2016/11/29 13:46:6

Game started
Game ID: 786988185 0.25/0.50 (PRR) Gorgons - 12 (Hold'em)
Seat 1 is the button
Seat 1: BHawk12 (66.75).
Seat 2: WeakAndWeary (96.06).
Seat 3: IampokerKidd (98).
Seat 4: IlxxxlI (20.75).
Seat 5: vagabond00 (50).
Seat 6: foreseen (50).
Player WeakAndWeary has small blind (0.25)
Player IampokerKidd has big blind (0.50)
Player vagabond00 is timed out.
Player vagabond00 wait BB
Player IlxxxlI received card: [8s]
Player IlxxxlI received card: [Qs]
Player IlxxxlI folds
Player foreseen folds
Player BHawk12 folds
Player WeakAndWeary raises (1.25)
Player IampokerKidd folds
Uncalled bet (1) returned to WeakAndWeary
Player WeakAndWeary mucks cards
------ Summary ------
Pot: 1. Rake 0
Player BHawk12 does not show cards.Bets: 0. Collects: 0. Wins: 0.
*Player WeakAndWeary mucks (does not show cards). Bets: 0.50. Collects: 1. Wins: 0.50.
Player IampokerKidd does not show cards.Bets: 0.50. Collects: 0. Loses: 0.50.
Player IlxxxlI does not show cards.Bets: 0. Collects: 0. Wins: 0.
Player vagabond00 does not show cards.Bets: 0. Collects: 0. Wins: 0.
Player foreseen does not show cards.Bets: 0. Collects: 0. Wins: 0.
Game ended at: 2016/11/29 13:46:15

Game started
Game ID: 786988049 1/2 (PRR) Lakhey (Short) (Hold'em)
Seat 3 is the button
Seat 3: VegetablesArentYummy (215.53).
Seat 4: IlxxxlI (44).
Seat 5: AironVega (103).
Player IlxxxlI has small blind (1)
Player AironVega has big blind (2)
Player IlxxxlI received card: [Jd]
Player IlxxxlI received card: [8d]
Player VegetablesArentYummy raises (5)
Player IlxxxlI folds
Player AironVega folds
Uncalled bet (3) returned to VegetablesArentYummy
Player VegetablesArentYummy mucks cards
------ Summary ------
Pot: 5. Rake 0
*Player VegetablesArentYummy mucks (does not show cards). Bets: 2. Collects: 5. Wins: 3.
Player IlxxxlI does not show cards.Bets: 1. Collects: 0. Loses: 1.
Player AironVega does not show cards.Bets: 2. Collects: 0. Loses: 2.
Game ended at: 2016/11/29 13:45:50

Game started
Game ID: 786988004 0.25/0.50 (PRR) Gorgons - 2 (Hold'em)
Seat 5 is the button
Seat 1: BHawk12 (50).
Seat 3: flyshark01 (99.67).
Seat 4: Doubletwentyone (51.49).
Seat 5: IlxxxlI (20.50).
Seat 6: foreseen (56.91).
Player foreseen has small blind (0.25)
Player BHawk12 has big blind (0.50)
Player IlxxxlI received card: [Ks]
Player IlxxxlI received card: [6h]
Player flyshark01 folds
Player Doubletwentyone folds
Player IlxxxlI folds
Player foreseen raises (1.39)
Player BHawk12 folds
Uncalled bet (1.14) returned to foreseen
Player foreseen mucks cards
------ Summary ------
Pot: 1. Rake 0
Player BHawk12 does not show cards.Bets: 0.50. Collects: 0. Loses: 0.50.
Player flyshark01 does not show cards.Bets: 0. Collects: 0. Wins: 0.
Player Doubletwentyone does not show cards.Bets: 0. Collects: 0. Wins: 0.
Player IlxxxlI does not show cards.Bets: 0. Collects: 0. Wins: 0.
*Player foreseen mucks (does not show cards). Bets: 0.50. Collects: 1. Wins: 0.50.
Game ended at: 2016/11/29 13:45:43

Game started
Game ID: 786987978 0.50/1 (PRR) Kraken - 13 (Hold'em)
Seat 6 is the button
Seat 1: CrimZnole (135.60).
Seat 2: bunnyfox2t (100).
Seat 3: IlxxxlI (40).
Seat 4: AironVega (104.90).
Seat 5: flyshark01 (103.31).
Seat 6: Doubletwentyone (118.72).
Player CrimZnole has small blind (0.50)
Player bunnyfox2t has big blind (1)
Player IlxxxlI received card: [7h]
Player IlxxxlI received card: [4c]
Player IlxxxlI folds
Player AironVega folds
Player flyshark01 folds
Player Doubletwentyone raises (2.50)
Player CrimZnole raises (6.40)
Player bunnyfox2t folds
Player Doubletwentyone calls (4.40)
*** FLOP ***: [Qc 8h 2c]
Player CrimZnole bets (8.30)
Player Doubletwentyone calls (8.30)
*** TURN ***: [Qc 8h 2c] [Kd]
Player CrimZnole bets (18.90)
Player Doubletwentyone folds
Uncalled bet (18.90) returned to CrimZnole
Player CrimZnole mucks cards
------ Summary ------
Pot: 29.83. Rake 1.33. JP fee 0.24
Board: [Qc 8h 2c Kd]
*Player CrimZnole mucks (does not show cards). Bets: 15.20. Collects: 29.83. Wins: 14.63.
Player bunnyfox2t does not show cards.Bets: 1. Collects: 0. Loses: 1.
Player IlxxxlI does not show cards.Bets: 0. Collects: 0. Wins: 0.
Player AironVega does not show cards.Bets: 0. Collects: 0. Wins: 0.
Player flyshark01 does not show cards.Bets: 0. Collects: 0. Wins: 0.
Player Doubletwentyone does not show cards.Bets: 15.20. Collects: 0. Loses: 15.20.
Game ended at: 2016/11/29 13:47:7

Game started
Game ID: 786987908 1/2 (PRR) Lakhey (Short) (Hold'em)
Seat 5 is the button
Seat 3: VegetablesArentYummy (216.53).
Seat 4: IlxxxlI (43).
Seat 5: AironVega (103).
Player VegetablesArentYummy has small blind (1)
Player IlxxxlI has big blind (2)
Player IlxxxlI received card: [6c]
Player IlxxxlI received card: [2c]
Player AironVega folds
Player VegetablesArentYummy folds
Uncalled bet (1) returned to IlxxxlI
Player IlxxxlI mucks cards
------ Summary ------
Pot: 2. Rake 0
Player VegetablesArentYummy does not show cards.Bets: 1. Collects: 0. Loses: 1.
*Player IlxxxlI mucks (does not show cards). Bets: 1. Collects: 2. Wins: 1.
Player AironVega does not show cards.Bets: 0. Collects: 0. Wins: 0.
Game ended at: 2016/11/29 13:45:14

Game started
Game ID: 786987890 0.25/0.50 (PRR) Gorgons - 7 (Hold'em)
Seat 4 is the button
Seat 1: flyshark01 (86.45).
Seat 2: xROCKETMANx (41.07).
Seat 3: IlxxxlI (20.45).
Seat 4: fishinwithbobbo (21.36).
Seat 5: Beep_Beep (95.89).
Seat 6: foreseen (55.95).
Player Beep_Beep has small blind (0.25)
Player foreseen has big blind (0.50)
Player IlxxxlI received card: [8c]
Player IlxxxlI received card: [10d]
Player flyshark01 folds
Player xROCKETMANx folds
Player IlxxxlI folds
Player fishinwithbobbo folds
Player Beep_Beep folds
Uncalled bet (0.25) returned to foreseen
Player foreseen mucks cards
------ Summary ------
Pot: 0.50. Rake 0
Player flyshark01 does not show cards.Bets: 0. Collects: 0. Wins: 0.
Player xROCKETMANx does not show cards.Bets: 0. Collects: 0. Wins: 0.
Player IlxxxlI does not show cards.Bets: 0. Collects: 0. Wins: 0.
Player fishinwithbobbo does not show cards.Bets: 0. Collects: 0. Wins: 0.
Player Beep_Beep does not show cards.Bets: 0.25. Collects: 0. Loses: 0.25.
*Player foreseen mucks (does not show cards). Bets: 0.25. Collects: 0.50. Wins: 0.25.
Game ended at: 2016/11/29 13:45:37

Game started
Game ID: 786987821 0.25/0.50 (PRR) Gorgons - 2 (Hold'em)
Seat 4 is the button
Seat 1: BHawk12 (50).
Seat 3: flyshark01 (99.67).
Seat 4: Doubletwentyone (51.49).
Seat 5: IlxxxlI (20).
Seat 6: foreseen (57.41).
Player IlxxxlI has small blind (0.25)
Player foreseen has big blind (0.50)
Player IlxxxlI received card: [Qd]
Player IlxxxlI received card: [Kc]
Player BHawk12 folds
Player flyshark01 folds
Player Doubletwentyone folds
Player IlxxxlI raises (1)
Player foreseen folds
Uncalled bet (0.75) returned to IlxxxlI
Player IlxxxlI mucks cards
------ Summary ------
Pot: 1. Rake 0
Player BHawk12 does not show cards.Bets: 0. Collects: 0. Wins: 0.
Player flyshark01 does not show cards.Bets: 0. Collects: 0. Wins: 0.
Player Doubletwentyone does not show cards.Bets: 0. Collects: 0. Wins: 0.
*Player IlxxxlI mucks (does not show cards). Bets: 0.50. Collects: 1. Wins: 0.50.
Player foreseen does not show cards.Bets: 0.50. Collects: 0. Loses: 0.50.
Game ended at: 2016/11/29 13:45:10

Game started
Game ID: 786987801 0.50/1 (PRR) Kraken - 13 (Hold'em)
Seat 5 is the button
Seat 1: CrimZnole (135.10).
Seat 2: bunnyfox2t (100).
Seat 3: IlxxxlI (40).
Seat 4: AironVega (104.90).
Seat 5: flyshark01 (103.31).
Seat 6: Doubletwentyone (119.22).
Player Doubletwentyone has small blind (0.50)
Player CrimZnole has big blind (1)
Player IlxxxlI received card: [7h]
Player IlxxxlI received card: [9h]
Player bunnyfox2t folds
Player IlxxxlI folds
Player AironVega folds
Player flyshark01 folds
Player Doubletwentyone folds
Uncalled bet (0.50) returned to CrimZnole
Player CrimZnole mucks cards
------ Summary ------
Pot: 1. Rake 0
*Player CrimZnole mucks (does not show cards). Bets: 0.50. Collects: 1. Wins: 0.50.
Player bunnyfox2t does not show cards.Bets: 0. Collects: 0. Wins: 0.
Player IlxxxlI does not show cards.Bets: 0. Collects: 0. Wins: 0.
Player AironVega does not show cards.Bets: 0. Collects: 0. Wins: 0.
Player flyshark01 does not show cards.Bets: 0. Collects: 0. Wins: 0.
Player Doubletwentyone does not show cards.Bets: 0.50. Collects: 0. Loses: 0.50.
Game ended at: 2016/11/29 13:45:6

Game started
Game ID: 786987709 1/2 (PRR) Lakhey (Short) (Hold'em)
Seat 4 is the button
Seat 3: VegetablesArentYummy (218.53).
Seat 4: IlxxxlI (40).
Seat 5: AironVega (104).
Player AironVega has small blind (1)
Player VegetablesArentYummy has big blind (2)
Player IlxxxlI received card: [8d]
Player IlxxxlI received card: [8c]
Player IlxxxlI raises (6)
Player AironVega folds
Player VegetablesArentYummy folds
Uncalled bet (4) returned to IlxxxlI
Player IlxxxlI mucks cards
------ Summary ------
Pot: 5. Rake 0
Player VegetablesArentYummy does not show cards.Bets: 2. Collects: 0. Loses: 2.
*Player IlxxxlI mucks (does not show cards). Bets: 2. Collects: 5. Wins: 3.
Player AironVega does not show cards.Bets: 1. Collects: 0. Loses: 1.
Game ended at: 2016/11/29 13:44:57

Game started
Game ID: 786987647 1/2 (PRR) Lakhey (Short) (Hold'em)
Seat 3 is the button
Seat 3: VegetablesArentYummy (218.53).
Seat 4: IlxxxlI (40).
Seat 5: AironVega (103).
Player IlxxxlI has small blind (1)
Player AironVega has big blind (2)
Player IlxxxlI received card: [8h]
Player IlxxxlI received card: [5s]
Player VegetablesArentYummy folds
Player IlxxxlI folds
Uncalled bet (1) returned to AironVega
Player AironVega mucks cards
------ Summary ------
Pot: 2. Rake 0
Player VegetablesArentYummy does not show cards.Bets: 0. Collects: 0. Wins: 0.
Player IlxxxlI does not show cards.Bets: 1. Collects: 0. Loses: 1.
*Player AironVega mucks (does not show cards). Bets: 1. Collects: 2. Wins: 1.
Game ended at: 2016/11/29 13:44:32

Game started
Game ID: 786987576 0.25/0.50 (PRR) Gorgons (Short) (Hold'em)
Seat 6 is the button
Seat 1: Ball Crusher (120.71).
Seat 2: Jui Kuen (34.68).
Seat 3: PokerBrat1127 (9.45).
Seat 5: IlxxxlI (10).
Seat 6: anabeliangrape (29.39).
Player Ball Crusher has small blind (0.25)
Player Jui Kuen has big blind (0.50)
Player IlxxxlI received card: [9d]
Player IlxxxlI received card: [5c]
Player PokerBrat1127 folds
Player IlxxxlI folds
Player anabeliangrape raises (1.50)
Player Ball Crusher calls (1.25)
Player Jui Kuen calls (1)
*** FLOP ***: [Js 4c 2h]
Player Ball Crusher checks
Player Jui Kuen checks
Player anabeliangrape bets (2.14)
Player Ball Crusher folds
Player Jui Kuen raises (10.70)
Player anabeliangrape folds
Uncalled bet (8.56) returned to Jui Kuen
Player Jui Kuen mucks cards
------ Summary ------
Pot: 8.35. Rake 0.29. JP fee 0.14
Board: [Js 4c 2h]
Player Ball Crusher does not show cards.Bets: 1.50. Collects: 0. Loses: 1.50.
*Player Jui Kuen mucks (does not show cards). Bets: 3.64. Collects: 8.35. Wins: 4.71.
Player PokerBrat1127 does not show cards.Bets: 0. Collects: 0. Wins: 0.
Player IlxxxlI does not show cards.Bets: 0. Collects: 0. Wins: 0.
Player anabeliangrape does not show cards.Bets: 3.64. Collects: 0. Loses: 3.64.
Game ended at: 2016/11/29 13:45:29

Game started
Game ID: 786987522 0.25/0.50 (PRR) Gorgons - 2 (Hold'em)
Seat 3 is the button
Seat 1: BHawk12 (50).
Seat 3: flyshark01 (98.92).
Seat 4: Doubletwentyone (51.74).
Seat 5: IlxxxlI (20).
Seat 6: foreseen (57.41).
Player Doubletwentyone has small blind (0.25)
Player IlxxxlI has big blind (0.50)
Player IlxxxlI received card: [6d]
Player IlxxxlI received card: [2s]
Player foreseen folds
Player BHawk12 folds
Player flyshark01 raises (1.50)
Player Doubletwentyone folds
Player IlxxxlI folds
Uncalled bet (1) returned to flyshark01
Player flyshark01 mucks cards
------ Summary ------
Pot: 1.25. Rake 0
Player BHawk12 does not show cards.Bets: 0. Collects: 0. Wins: 0.
*Player flyshark01 mucks (does not show cards). Bets: 0.50. Collects: 1.25. Wins: 0.75.
Player Doubletwentyone does not show cards.Bets: 0.25. Collects: 0. Loses: 0.25.
Player IlxxxlI does not show cards.Bets: 0.50. Collects: 0. Loses: 0.50.
Player foreseen does not show cards.Bets: 0. Collects: 0. Wins: 0.
Game ended at: 2016/11/29 13:44:45

Game started
Game ID: 786987496 0.50/1 (PRR) Kraken - 13 (Hold'em)
Seat 4 is the button
Seat 1: CrimZnole (135.10).
Seat 2: bunnyfox2t (100).
Seat 3: IlxxxlI (40).
Seat 4: AironVega (104.90).
Seat 5: flyshark01 (102.31).
Seat 6: Doubletwentyone (120.22).
Player flyshark01 has small blind (0.50)
Player Doubletwentyone has big blind (1)
Player IlxxxlI received card: [10d]
Player IlxxxlI received card: [6c]
Player CrimZnole folds
Player bunnyfox2t folds
Player IlxxxlI folds
Player AironVega folds
Player flyshark01 raises (2.50)
Player Doubletwentyone folds
Uncalled bet (2) returned to flyshark01
Player flyshark01 mucks cards
------ Summary ------
Pot: 2. Rake 0
Player CrimZnole does not show cards.Bets: 0. Collects: 0. Wins: 0.
Player bunnyfox2t does not show cards.Bets: 0. Collects: 0. Wins: 0.
Player IlxxxlI does not show cards.Bets: 0. Collects: 0. Wins: 0.
Player AironVega does not show cards.Bets: 0. Collects: 0. Wins: 0.
*Player flyshark01 mucks (does not show cards). Bets: 1. Collects: 2. Wins: 1.
Player Doubletwentyone does not show cards.Bets: 1. Collects: 0. Loses: 1.
Game ended at: 2016/11/29 13:44:43

Game started
Game ID: 786987478 1/2 (PRR) Lakhey (Short) (Hold'em)
Seat 5 is the button
Seat 3: VegetablesArentYummy (219.53).
Seat 4: IlxxxlI (40).
Seat 5: AironVega (100).
Player VegetablesArentYummy has small blind (1)
Player IlxxxlI has big blind (2)
Player IlxxxlI received card: [8h]
Player IlxxxlI received card: [3d]
Player AironVega raises (4)
Player VegetablesArentYummy folds
Player IlxxxlI folds
Uncalled bet (2) returned to AironVega
Player AironVega mucks cards
------ Summary ------
Pot: 5. Rake 0
Player VegetablesArentYummy does not show cards.Bets: 1. Collects: 0. Loses: 1.
Player IlxxxlI does not show cards.Bets: 2. Collects: 0. Loses: 2.
*Player AironVega mucks (does not show cards). Bets: 2. Collects: 5. Wins: 3.
Game ended at: 2016/11/29 13:44:25

Game started
Game ID: 786987259 0.25/0.50 (PRR) Gorgons - 7 (Hold'em)
Seat 3 is the button
Seat 1: flyshark01 (87.95).
Seat 2: xROCKETMANx (41.07).
Seat 3: IlxxxlI (20.45).
Seat 4: fishinwithbobbo (19.53).
Seat 5: Beep_Beep (96.39).
Seat 6: foreseen (55.95).
Player fishinwithbobbo has small blind (0.25)
Player Beep_Beep has big blind (0.50)
Player IlxxxlI received card: [9c]
Player IlxxxlI received card: [Qh]
Player foreseen folds
Player flyshark01 raises (1.50)
Player xROCKETMANx folds
Player IlxxxlI folds
Player fishinwithbobbo calls (1.25)
Player Beep_Beep folds
*** FLOP ***: [3s Jd Ah]
Player fishinwithbobbo checks
Player flyshark01 checks
*** TURN ***: [3s Jd Ah] [Ac]
Player fishinwithbobbo checks
Player flyshark01 checks
*** RIVER ***: [3s Jd Ah Ac] [Ks]
Player fishinwithbobbo bets (2)
Player flyshark01 folds
Uncalled bet (2) returned to fishinwithbobbo
Player fishinwithbobbo mucks cards
------ Summary ------
Pot: 3.33. Rake 0.13. JP fee 0.04
Board: [3s Jd Ah Ac Ks]
Player flyshark01 does not show cards.Bets: 1.50. Collects: 0. Loses: 1.50.
Player xROCKETMANx does not show cards.Bets: 0. Collects: 0. Wins: 0.
Player IlxxxlI does not show cards.Bets: 0. Collects: 0. Wins: 0.
*Player fishinwithbobbo mucks (does not show cards). Bets: 1.50. Collects: 3.33. Wins: 1.83.
Player Beep_Beep does not show cards.Bets: 0.50. Collects: 0. Loses: 0.50.
Player foreseen does not show cards.Bets: 0. Collects: 0. Wins: 0.
Game ended at: 2016/11/29 13:44:54

Game started
Game ID: 786987215 0.25/0.50 (PRR) Gorgons - 12 (Hold'em)
Seat 6 is the button
Seat 1: BHawk12 (67).
Seat 2: WeakAndWeary (92.33).
Seat 3: IampokerKidd (98).
Seat 4: IlxxxlI (20.75).
Seat 6: foreseen (50).
Player BHawk12 has small blind (0.25)
Player WeakAndWeary has big blind (0.50)
Player IlxxxlI received card: [5h]
Player IlxxxlI received card: [Qd]
Player IampokerKidd folds
Player IlxxxlI folds
Player foreseen raises (1.25)
Player BHawk12 folds
Player WeakAndWeary calls (0.75)
*** FLOP ***: [3h Qs 2d]
Player WeakAndWeary checks
Player foreseen bets (2.62)
Player WeakAndWeary calls (2.62)
*** TURN ***: [3h Qs 2d] [4c]
Player WeakAndWeary checks
Player foreseen checks
*** RIVER ***: [3h Qs 2d 4c] [3c]
Player WeakAndWeary checks
Player foreseen checks
Player foreseen mucks cards
------ Summary ------
Pot: 7.60. Rake 0.27. JP fee 0.12
Board: [3h Qs 2d 4c 3c]
Player BHawk12 does not show cards.Bets: 0.25. Collects: 0. Loses: 0.25.
*Player WeakAndWeary shows: Straight to 5 [As 5s]. Bets: 3.87. Collects: 7.60. Wins: 3.73.
Player IampokerKidd does not show cards.Bets: 0. Collects: 0. Wins: 0.
Player IlxxxlI does not show cards.Bets: 0. Collects: 0. Wins: 0.
Player foreseen mucks (does not show cards). Bets: 3.87. Collects: 0. Loses: 3.87.
Game ended at: 2016/11/29 13:45:27

Game started
Game ID: 786987200 0.50/1 (PRR) Kraken - 13 (Hold'em)
Seat 3 is the button
Seat 1: CrimZnole (135.10).
Seat 2: bunnyfox2t (100).
Seat 3: IlxxxlI (40).
Seat 4: AironVega (105.40).
Seat 5: flyshark01 (103.31).
Seat 6: Doubletwentyone (118.72).
Player AironVega has small blind (0.50)
Player flyshark01 has big blind (1)
Player IlxxxlI received card: [7h]
Player IlxxxlI received card: [5d]
Player Doubletwentyone raises (3)
Player CrimZnole folds
Player bunnyfox2t folds
Player IlxxxlI folds
Player AironVega folds
Player flyshark01 folds
Uncalled bet (2) returned to Doubletwentyone
Player Doubletwentyone mucks cards
------ Summary ------
Pot: 2.50. Rake 0
Player CrimZnole does not show cards.Bets: 0. Collects: 0. Wins: 0.
Player bunnyfox2t does not show cards.Bets: 0. Collects: 0. Wins: 0.
Player IlxxxlI does not show cards.Bets: 0. Collects: 0. Wins: 0.
Player AironVega does not show cards.Bets: 0.50. Collects: 0. Loses: 0.50.
Player flyshark01 does not show cards.Bets: 1. Collects: 0. Loses: 1.
*Player Doubletwentyone mucks (does not show cards). Bets: 1. Collects: 2.50. Wins: 1.50.
Game ended at: 2016/11/29 13:44:7

Game started
Game ID: 786987180 0.50/1 (PRR) Kraken - 8 (Hold'em)
Seat 6 is the button
Seat 1: MadLifeGrinder (124.21).
Seat 2: bunnyfox2t (100).
Seat 3: AironVega (100).
Seat 4: rook_ (135.41).
Seat 5: IlxxxlI (49.50).
Seat 6: ThxBro (37).
Player MadLifeGrinder has small blind (0.50)
Player bunnyfox2t has big blind (1)
Player IlxxxlI received card: [Qs]
Player IlxxxlI received card: [10s]
Player AironVega folds
Player rook_ folds
Player IlxxxlI raises (2.40)
Player ThxBro raises (5.20)
Player MadLifeGrinder folds
Player bunnyfox2t folds
Player IlxxxlI calls (2.80)
*** FLOP ***: [Ks 5d 2c]
Player IlxxxlI checks
Player ThxBro bets (2.80)
Player IlxxxlI calls (2.80)
*** TURN ***: [Ks 5d 2c] [5s]
Player IlxxxlI checks
Player ThxBro bets (4.16)
Player IlxxxlI allin (41.50)
Player ThxBro folds
Uncalled bet (37.34) returned to IlxxxlI
Player IlxxxlI mucks cards
------ Summary ------
Pot: 24.53. Rake 1.05. JP fee 0.24
Board: [Ks 5d 2c 5s]
Player MadLifeGrinder does not show cards.Bets: 0.50. Collects: 0. Loses: 0.50.
Player bunnyfox2t does not show cards.Bets: 1. Collects: 0. Loses: 1.
Player AironVega does not show cards.Bets: 0. Collects: 0. Wins: 0.
Player rook_ does not show cards.Bets: 0. Collects: 0. Wins: 0.
*Player IlxxxlI mucks (does not show cards). Bets: 12.16. Collects: 24.53. Wins: 12.37.
Player ThxBro does not show cards.Bets: 12.16. Collects: 0. Loses: 12.16.
Game ended at: 2016/11/29 13:45:45

Game started
Game ID: 786987030 0.25/0.50 (PRR) Gorgons (Short) (Hold'em)
Seat 5 is the button
Seat 1: Ball Crusher (121.21).
Seat 2: Jui Kuen (28.58).
Seat 3: PokerBrat1127 (10.95).
Seat 5: IlxxxlI (10).
Seat 6: anabeliangrape (34.05).
Player anabeliangrape has small blind (0.25)
Player Ball Crusher has big blind (0.50)
Player IlxxxlI received card: [4h]
Player IlxxxlI received card: [3c]
Player Jui Kuen raises (1.50)
Player PokerBrat1127 calls (1.50)
Player IlxxxlI folds
Player anabeliangrape calls (1.25)
Player Ball Crusher folds
*** FLOP ***: [Qh 8d 7c]
Player anabeliangrape checks
Player Jui Kuen bets (3.16)
Player PokerBrat1127 folds
Player anabeliangrape calls (3.16)
*** TURN ***: [Qh 8d 7c] [Ks]
Player anabeliangrape checks
Player Jui Kuen bets (7.17)
Player anabeliangrape folds
Uncalled bet (7.17) returned to Jui Kuen
Player Jui Kuen mucks cards
------ Summary ------
Pot: 10.76. Rake 0.38. JP fee 0.18
Board: [Qh 8d 7c Ks]
Player Ball Crusher does not show cards.Bets: 0.50. Collects: 0. Loses: 0.50.
*Player Jui Kuen mucks (does not show cards). Bets: 4.66. Collects: 10.76. Wins: 6.10.
Player PokerBrat1127 does not show cards.Bets: 1.50. Collects: 0. Loses: 1.50.
Player IlxxxlI does not show cards.Bets: 0. Collects: 0. Wins: 0.
Player anabeliangrape does not show cards.Bets: 4.66. Collects: 0. Loses: 4.66.
Game ended at: 2016/11/29 13:44:15

Game started
Game ID: 786987018 0.50/1 (PRR) Kraken - 13 (Hold'em)
Seat 2 is the button
Seat 1: CrimZnole (135.10).
Seat 2: bunnyfox2t (100).
Seat 3: IlxxxlI (40).
Seat 4: AironVega (106.40).
Seat 5: flyshark01 (101.81).
Seat 6: Doubletwentyone (118.72).
Player IlxxxlI has small blind (0.50)
Player AironVega has big blind (1)
Player IlxxxlI received card: [3c]
Player IlxxxlI received card: [Kc]
Player flyshark01 raises (3)
Player Doubletwentyone folds
Player CrimZnole folds
Player bunnyfox2t folds
Player IlxxxlI folds
Player AironVega folds
Uncalled bet (2) returned to flyshark01
Player flyshark01 mucks cards
------ Summary ------
Pot: 2.50. Rake 0
Player CrimZnole does not show cards.Bets: 0. Collects: 0. Wins: 0.
Player bunnyfox2t does not show cards.Bets: 0. Collects: 0. Wins: 0.
Player IlxxxlI does not show cards.Bets: 0.50. Collects: 0. Loses: 0.50.
Player AironVega does not show cards.Bets: 1. Collects: 0. Loses: 1.
*Player flyshark01 mucks (does not show cards). Bets: 1. Collects: 2.50. Wins: 1.50.
Player Doubletwentyone does not show cards.Bets: 0. Collects: 0. Wins: 0.
Game ended at: 2016/11/29 13:43:32

Game started
Game ID: 786986992 0.25/0.50 (PRR) Gorgons - 7 (Hold'em)
Seat 2 is the button
Seat 1: flyshark01 (87.95).
Seat 2: xROCKETMANx (41.07).
Seat 3: IlxxxlI (20).
Seat 4: fishinwithbobbo (20.03).
Seat 5: Beep_Beep (96.39).
Seat 6: foreseen (55.95).
Player IlxxxlI has small blind (0.25)
Player fishinwithbobbo has big blind (0.50)
Player IlxxxlI received card: [10s]
Player IlxxxlI received card: [Kd]
Player Beep_Beep folds
Player foreseen folds
Player flyshark01 folds
Player xROCKETMANx folds
Player IlxxxlI calls (0.25)
Player fishinwithbobbo checks
*** FLOP ***: [8h 7h 8c]
Player IlxxxlI bets (0.50)
Player fishinwithbobbo folds
Uncalled bet (0.50) returned to IlxxxlI
Player IlxxxlI mucks cards
------ Summary ------
Pot: 0.95. Rake 0.05
Board: [8h 7h 8c]
Player flyshark01 does not show cards.Bets: 0. Collects: 0. Wins: 0.
Player xROCKETMANx does not show cards.Bets: 0. Collects: 0. Wins: 0.
*Player IlxxxlI mucks (does not show cards). Bets: 0.50. Collects: 0.95. Wins: 0.45.
Player fishinwithbobbo does not show cards.Bets: 0.50. Collects: 0. Loses: 0.50.
Player Beep_Beep does not show cards.Bets: 0. Collects: 0. Wins: 0.
Player foreseen does not show cards.Bets: 0. Collects: 0. Wins: 0.
Game ended at: 2016/11/29 13:43:39

Game started
Game ID: 786986879 0.50/1 (PRR) Kraken - 8 (Hold'em)
Seat 5 is the button
Seat 1: MadLifeGrinder (125.21).
Seat 2: bunnyfox2t (100).
Seat 3: AironVega (100).
Seat 4: rook_ (135.41).
Seat 5: IlxxxlI (49.50).
Seat 6: ThxBro (36).
Player ThxBro has small blind (0.50)
Player MadLifeGrinder has big blind (1)
Player IlxxxlI received card: [9s]
Player IlxxxlI received card: [6s]
Player bunnyfox2t folds
Player AironVega folds
Player rook_ folds
Player IlxxxlI folds
Player ThxBro raises (2.50)
Player MadLifeGrinder folds
Uncalled bet (2) returned to ThxBro
Player ThxBro mucks cards
------ Summary ------
Pot: 2. Rake 0
Player MadLifeGrinder does not show cards.Bets: 1. Collects: 0. Loses: 1.
Player bunnyfox2t does not show cards.Bets: 0. Collects: 0. Wins: 0.
Player AironVega does not show cards.Bets: 0. Collects: 0. Wins: 0.
Player rook_ does not show cards.Bets: 0. Collects: 0. Wins: 0.
Player IlxxxlI does not show cards.Bets: 0. Collects: 0. Wins: 0.
*Player ThxBro mucks (does not show cards). Bets: 1. Collects: 2. Wins: 1.
Game ended at: 2016/11/29 13:43:28

Game started
Game ID: 786986874 0.25/0.50 (PRR) Gorgons - 12 (Hold'em)
Seat 4 is the button
Seat 1: BHawk12 (67.50).
Seat 2: WeakAndWeary (92.33).
Seat 3: IampokerKidd (98).
Seat 4: IlxxxlI (20).
Seat 6: foreseen (50.25).
Player foreseen has small blind (0.25)
Player BHawk12 has big blind (0.50)
Player IlxxxlI received card: [Jc]
Player IlxxxlI received card: [Jh]
Player WeakAndWeary folds
Player IampokerKidd folds
Player IlxxxlI raises (1.50)
Player foreseen folds
Player BHawk12 folds
Uncalled bet (1) returned to IlxxxlI
Player IlxxxlI mucks cards
------ Summary ------
Pot: 1.25. Rake 0
Player BHawk12 does not show cards.Bets: 0.50. Collects: 0. Loses: 0.50.
Player WeakAndWeary does not show cards.Bets: 0. Collects: 0. Wins: 0.
Player IampokerKidd does not show cards.Bets: 0. Collects: 0. Wins: 0.
*Player IlxxxlI mucks (does not show cards). Bets: 0.50. Collects: 1.25. Wins: 0.75.
Player foreseen does not show cards.Bets: 0.25. Collects: 0. Loses: 0.25.
Game ended at: 2016/11/29 13:43:33

Game started
Game ID: 786986764 0.25/0.50 (PRR) Gorgons - 7 (Hold'em)
Seat 1 is the button
Seat 1: flyshark01 (87.20).
Seat 2: xROCKETMANx (41.32).
Seat 3: IlxxxlI (20).
Seat 4: fishinwithbobbo (20.03).
Seat 5: Beep_Beep (96.39).
Seat 6: foreseen (55.95).
Player xROCKETMANx has small blind (0.25)
Player IlxxxlI has big blind (0.50)
Player IlxxxlI received card: [Qh]
Player IlxxxlI received card: [2s]
Player fishinwithbobbo folds
Player Beep_Beep folds
Player foreseen folds
Player flyshark01 raises (1.50)
Player xROCKETMANx folds
Player IlxxxlI folds
Uncalled bet (1) returned to flyshark01
Player flyshark01 mucks cards
------ Summary ------
Pot: 1.25. Rake 0
*Player flyshark01 mucks (does not show cards). Bets: 0.50. Collects: 1.25. Wins: 0.75.
Player xROCKETMANx does not show cards.Bets: 0.25. Collects: 0. Loses: 0.25.
Player IlxxxlI does not show cards.Bets: 0.50. Collects: 0. Loses: 0.50.
Player fishinwithbobbo does not show cards.Bets: 0. Collects: 0. Wins: 0.
Player Beep_Beep does not show cards.Bets: 0. Collects: 0. Wins: 0.
Player foreseen does not show cards.Bets: 0. Collects: 0. Wins: 0.
Game ended at: 2016/11/29 13:43:4

Game started
Game ID: 786986721 0.25/0.50 (PRR) Gorgons - 2 (Hold'em)
Seat 1 is the button
Seat 1: BHawk12 (47).
Seat 3: flyshark01 (99.17).
Seat 4: Doubletwentyone (52.99).
Seat 5: IlxxxlI (20).
Seat 6: foreseen (56.04).
Player flyshark01 has small blind (0.25)
Player Doubletwentyone has big blind (0.50)
Player IlxxxlI received card: [6d]
Player IlxxxlI received card: [8c]
Player IlxxxlI folds
Player foreseen raises (1.25)
Player BHawk12 folds
Player flyshark01 folds
Player Doubletwentyone calls (0.75)
*** FLOP ***: [Jd Kd 9d]
Player Doubletwentyone checks
Player foreseen checks
*** TURN ***: [Jd Kd 9d] [4d]
Player Doubletwentyone checks
Player foreseen bets (1.02)
Player Doubletwentyone folds
Uncalled bet (1.02) returned to foreseen
Player foreseen mucks cards
------ Summary ------
Pot: 2.62. Rake 0.09. JP fee 0.04
Board: [Jd Kd 9d 4d]
Player BHawk12 does not show cards.Bets: 0. Collects: 0. Wins: 0.
Player flyshark01 does not show cards.Bets: 0.25. Collects: 0. Loses: 0.25.
Player Doubletwentyone does not show cards.Bets: 1.25. Collects: 0. Loses: 1.25.
Player IlxxxlI does not show cards.Bets: 0. Collects: 0. Wins: 0.
*Player foreseen mucks (does not show cards). Bets: 1.25. Collects: 2.62. Wins: 1.37.
Game ended at: 2016/11/29 13:44:10

Game started
Game ID: 786986668 0.25/0.50 (PRR) Gorgons (Short) (Hold'em)
Seat 3 is the button
Seat 1: Ball Crusher (121.21).
Seat 2: Jui Kuen (28.58).
Seat 3: PokerBrat1127 (10.95).
Seat 5: IlxxxlI (10).
Seat 6: anabeliangrape (33.80).
Player IlxxxlI has small blind (0.25)
Player anabeliangrape has big blind (0.50)
Player IlxxxlI received card: [Qc]
Player IlxxxlI received card: [7h]
Player Ball Crusher folds
Player Jui Kuen folds
Player PokerBrat1127 folds
Player IlxxxlI folds
Uncalled bet (0.25) returned to anabeliangrape
Player anabeliangrape mucks cards
------ Summary ------
Pot: 0.50. Rake 0
Player Ball Crusher does not show cards.Bets: 0. Collects: 0. Wins: 0.
Player Jui Kuen does not show cards.Bets: 0. Collects: 0. Wins: 0.
Player PokerBrat1127 does not show cards.Bets: 0. Collects: 0. Wins: 0.
Player IlxxxlI does not show cards.Bets: 0.25. Collects: 0. Loses: 0.25.
*Player anabeliangrape mucks (does not show cards). Bets: 0.25. Collects: 0.50. Wins: 0.25.
Game ended at: 2016/11/29 13:43:9

Game started
Game ID: 786986495 0.50/1 (PRR) Kraken - 8 (Hold'em)
Seat 4 is the button
Seat 1: MadLifeGrinder (125.21).
Seat 2: bunnyfox2t (100).
Seat 3: AironVega (100).
Seat 4: rook_ (133.91).
Seat 5: IlxxxlI (50).
Seat 6: ThxBro (37).
Player IlxxxlI has small blind (0.50)
Player ThxBro has big blind (1)
Player IlxxxlI received card: [3d]
Player IlxxxlI received card: [Ah]
Player MadLifeGrinder folds
Player bunnyfox2t folds
Player AironVega folds
Player rook_ raises (4)
Player IlxxxlI folds
Player ThxBro folds
Uncalled bet (3) returned to rook_
Player rook_ mucks cards
------ Summary ------
Pot: 2.50. Rake 0
Player MadLifeGrinder does not show cards.Bets: 0. Collects: 0. Wins: 0.
Player bunnyfox2t does not show cards.Bets: 0. Collects: 0. Wins: 0.
Player AironVega does not show cards.Bets: 0. Collects: 0. Wins: 0.
*Player rook_ mucks (does not show cards). Bets: 1. Collects: 2.50. Wins: 1.50.
Player IlxxxlI does not show cards.Bets: 0.50. Collects: 0. Loses: 0.50.
Player ThxBro does not show cards.Bets: 1. Collects: 0. Loses: 1.
Game ended at: 2016/11/29 13:42:51

Game started
Game ID: 786986457 0.25/0.50 (PRR) Gorgons - 2 (Hold'em)
Seat 6 is the button
Seat 1: BHawk12 (47.25).
Seat 3: flyshark01 (98.92).
Seat 4: Doubletwentyone (52.99).
Seat 5: IlxxxlI (20).
Seat 6: foreseen (56.04).
Player BHawk12 has small blind (0.25)
Player flyshark01 has big blind (0.50)
Player IlxxxlI received card: [Jc]
Player IlxxxlI received card: [Kd]
Player Doubletwentyone folds
Player IlxxxlI folds
Player foreseen folds
Player BHawk12 folds
Uncalled bet (0.25) returned to flyshark01
Player flyshark01 mucks cards
------ Summary ------
Pot: 0.50. Rake 0
Player BHawk12 does not show cards.Bets: 0.25. Collects: 0. Loses: 0.25.
*Player flyshark01 mucks (does not show cards). Bets: 0.25. Collects: 0.50. Wins: 0.25.
Player Doubletwentyone does not show cards.Bets: 0. Collects: 0. Wins: 0.
Player IlxxxlI does not show cards.Bets: 0. Collects: 0. Wins: 0.
Player foreseen does not show cards.Bets: 0. Collects: 0. Wins: 0.
Game ended at: 2016/11/29 13:42:31

Game started
Game ID: 786986447 1/2 (PRR) Lakhey (Short) (Hold'em)
Seat 4 is the button
Seat 1: uncle_argyle (100.62).
Seat 3: VegetablesArentYummy (214.13).
Seat 4: IlxxxlI (40).
Seat 5: AironVega (101).
Player AironVega has small blind (1)
Player uncle_argyle sitting out
Player VegetablesArentYummy has big blind (2)
Player IlxxxlI received card: [7s]
Player IlxxxlI received card: [10s]
Player IlxxxlI folds
Player AironVega raises (5)
Player VegetablesArentYummy calls (4)
*** FLOP ***: [7c 9d 10c]
Player AironVega checks
Player VegetablesArentYummy checks
*** TURN ***: [7c 9d 10c] [3s]
Player AironVega checks
Player VegetablesArentYummy checks
*** RIVER ***: [7c 9d 10c 3s] [8h]
Player AironVega checks
Player VegetablesArentYummy checks
Player AironVega mucks cards
------ Summary ------
Pot: 11.40. Rake 0.52. JP fee 0.08
Board: [7c 9d 10c 3s 8h]
Player uncle_argyle does not show cards.Bets: 0. Collects: 0. Wins: 0.
*Player VegetablesArentYummy shows: One pair of 8s [As 8d]. Bets: 6. Collects: 11.40. Wins: 5.40.
Player IlxxxlI does not show cards.Bets: 0. Collects: 0. Wins: 0.
Player AironVega mucks (does not show cards). Bets: 6. Collects: 0. Loses: 6.
Game ended at: 2016/11/29 13:44:3

Game started
Game ID: 786986311 0.25/0.50 (PRR) Gorgons (Short) (Hold'em)
Seat 2 is the button
Seat 1: Ball Crusher (121.21).
Seat 2: Jui Kuen (29.58).
Seat 3: PokerBrat1127 (9.45).
Seat 5: IlxxxlI (10).
Seat 6: anabeliangrape (33.80).
Player PokerBrat1127 has small blind (0.25)
Player IlxxxlI has big blind (0.50)
Player IlxxxlI received card: [Jd]
Player IlxxxlI received card: [6s]
Player anabeliangrape folds
Player Ball Crusher folds
Player Jui Kuen raises (1)
Player PokerBrat1127 allin (9.20)
Player IlxxxlI folds
Player Jui Kuen folds
Uncalled bet (8.45) returned to PokerBrat1127
Player PokerBrat1127 mucks cards
------ Summary ------
Pot: 2.50. Rake 0
Player Ball Crusher does not show cards.Bets: 0. Collects: 0. Wins: 0.
Player Jui Kuen does not show cards.Bets: 1. Collects: 0. Loses: 1.
*Player PokerBrat1127 mucks (does not show cards). Bets: 1. Collects: 2.50. Wins: 1.50.
Player IlxxxlI does not show cards.Bets: 0.50. Collects: 0. Loses: 0.50.
Player anabeliangrape does not show cards.Bets: 0. Collects: 0. Wins: 0.
Game ended at: 2016/11/29 13:42:24

Game started
Game ID: 786986297 0.25/0.50 (PRR) Gorgons - 12 (Hold'em)
Seat 3 is the button
Seat 1: BHawk12 (67.50).
Seat 2: WeakAndWeary (92.33).
Seat 3: IampokerKidd (98).
Seat 4: IlxxxlI (20).
Seat 5: Beep_Beep (50.75).
Seat 6: foreseen (50).
Player IlxxxlI has small blind (0.25)
Player Beep_Beep sitting out
Player foreseen has big blind (0.50)
Player IlxxxlI received card: [7c]
Player IlxxxlI received card: [Qd]
Player BHawk12 folds
Player WeakAndWeary folds
Player IampokerKidd folds
Player IlxxxlI is timed out.
Player IlxxxlI folds
Uncalled bet (0.25) returned to foreseen
Player foreseen mucks cards
------ Summary ------
Pot: 0.50. Rake 0
Player BHawk12 does not show cards.Bets: 0. Collects: 0. Wins: 0.
Player WeakAndWeary does not show cards.Bets: 0. Collects: 0. Wins: 0.
Player IampokerKidd does not show cards.Bets: 0. Collects: 0. Wins: 0.
Player IlxxxlI does not show cards.Bets: 0.25. Collects: 0. Loses: 0.25.
Player Beep_Beep does not show cards.Bets: 0. Collects: 0. Wins: 0.
*Player foreseen mucks (does not show cards). Bets: 0.25. Collects: 0.50. Wins: 0.25.
Game ended at: 2016/11/29 13:42:49

Game started
Game ID: 786986141 1/2 (PRR) Lakhey (Short) (Hold'em)
Seat 3 is the button
Seat 1: uncle_argyle (100.62).
Seat 3: VegetablesArentYummy (211.13).
Seat 4: IlxxxlI (40).
Seat 5: AironVega (103).
Seat 6: Pimpika (126.20).
Player IlxxxlI has small blind (1)
Player AironVega has big blind (2)
Player IlxxxlI received card: [Jh]
Player IlxxxlI received card: [7s]
Player Pimpika folds
Player uncle_argyle folds
Player VegetablesArentYummy raises (5)
Player IlxxxlI folds
Player AironVega folds
Uncalled bet (3) returned to VegetablesArentYummy
Player VegetablesArentYummy mucks cards
------ Summary ------
Pot: 5. Rake 0
Player uncle_argyle does not show cards.Bets: 0. Collects: 0. Wins: 0.
*Player VegetablesArentYummy mucks (does not show cards). Bets: 2. Collects: 5. Wins: 3.
Player IlxxxlI does not show cards.Bets: 1. Collects: 0. Loses: 1.
Player AironVega does not show cards.Bets: 2. Collects: 0. Loses: 2.
Player Pimpika does not show cards.Bets: 0. Collects: 0. Wins: 0.
Game ended at: 2016/11/29 13:41:56

Game started
Game ID: 786986034 0.50/1 (PRR) Kraken - 8 (Hold'em)
Seat 3 is the button
Seat 1: MadLifeGrinder (125.21).
Seat 2: bunnyfox2t (100).
Seat 3: AironVega (100).
Seat 4: rook_ (141.91).
Seat 5: IlxxxlI (40).
Seat 6: ThxBro (37).
Player rook_ has small blind (0.50)
Player IlxxxlI has big blind (1)
Player IlxxxlI received card: [As]
Player IlxxxlI received card: [Kh]
Player ThxBro folds
Player MadLifeGrinder folds
Player bunnyfox2t folds
Player AironVega raises (2)
Player rook_ raises (7.50)
Player IlxxxlI allin (39)
Player AironVega folds
Player rook_ folds
Uncalled bet (32) returned to IlxxxlI
Player IlxxxlI mucks cards
------ Summary ------
Pot: 18. Rake 0
Player MadLifeGrinder does not show cards.Bets: 0. Collects: 0. Wins: 0.
Player bunnyfox2t does not show cards.Bets: 0. Collects: 0. Wins: 0.
Player AironVega does not show cards.Bets: 2. Collects: 0. Loses: 2.
Player rook_ does not show cards.Bets: 8. Collects: 0. Loses: 8.
*Player IlxxxlI mucks (does not show cards). Bets: 8. Collects: 18. Wins: 10.
Player ThxBro does not show cards.Bets: 0. Collects: 0. Wins: 0.
Game ended at: 2016/11/29 13:42:2

Game started
Game ID: 786986007 1/2 (PRR) Lakhey (Short) (Hold'em)
Seat 1 is the button
Seat 1: uncle_argyle (100.62).
Seat 3: VegetablesArentYummy (212.13).
Seat 4: IlxxxlI (40).
Seat 5: AironVega (100).
Seat 6: Pimpika (126.20).
Player VegetablesArentYummy has small blind (1)
Player IlxxxlI has big blind (2)
Player IlxxxlI received card: [7c]
Player IlxxxlI received card: [2d]
Player AironVega raises (6)
Player Pimpika folds
Player uncle_argyle folds
Player VegetablesArentYummy folds
Player IlxxxlI folds
Uncalled bet (4) returned to AironVega
Player AironVega mucks cards
------ Summary ------
Pot: 5. Rake 0
Player uncle_argyle does not show cards.Bets: 0. Collects: 0. Wins: 0.
Player VegetablesArentYummy does not show cards.Bets: 1. Collects: 0. Loses: 1.
Player IlxxxlI does not show cards.Bets: 2. Collects: 0. Loses: 2.
*Player AironVega mucks (does not show cards). Bets: 2. Collects: 5. Wins: 3.
Player Pimpika does not show cards.Bets: 0. Collects: 0. Wins: 0.
Game ended at: 2016/11/29 13:41:19

Game started
Game ID: 786985994 0.25/0.50 (PRR) Gorgons - 2 (Hold'em)
Seat 5 is the button
Seat 1: BHawk12 (47.75).
Seat 3: flyshark01 (98.92).
Seat 4: Doubletwentyone (54.49).
Seat 5: IlxxxlI (20).
Seat 6: foreseen (54.04).
Player foreseen has small blind (0.25)
Player BHawk12 has big blind (0.50)
Player IlxxxlI received card: [10h]
Player IlxxxlI received card: [8s]
Player flyshark01 folds
Player Doubletwentyone raises (1.50)
Player IlxxxlI folds
Player foreseen raises (4.75)
Player BHawk12 folds
Player Doubletwentyone folds
Uncalled bet (3.50) returned to foreseen
Player foreseen mucks cards
------ Summary ------
Pot: 3.50. Rake 0
Player BHawk12 does not show cards.Bets: 0.50. Collects: 0. Loses: 0.50.
Player flyshark01 does not show cards.Bets: 0. Collects: 0. Wins: 0.
Player Doubletwentyone does not show cards.Bets: 1.50. Collects: 0. Loses: 1.50.
Player IlxxxlI does not show cards.Bets: 0. Collects: 0. Wins: 0.
*Player foreseen mucks (does not show cards). Bets: 1.50. Collects: 3.50. Wins: 2.
Game ended at: 2016/11/29 13:41:58

Game started
Game ID: 786985997 0.50/1 (PRR) Kraken - 13 (Hold'em)
Seat 1 is the button
Seat 1: CrimZnole (96.10).
Seat 2: bunnyfox2t (100.23).
Seat 3: IlxxxlI (41.50).
Seat 5: flyshark01 (101.81).
Seat 6: Doubletwentyone (118.72).
Player bunnyfox2t has small blind (0.50)
Player IlxxxlI has big blind (1)
Player IlxxxlI received card: [Ac]
Player IlxxxlI received card: [10c]
Player flyshark01 folds
Player Doubletwentyone folds
Player CrimZnole raises (2.40)
Player bunnyfox2t folds
Player IlxxxlI raises (5.13)
Player CrimZnole calls (3.73)
*** FLOP ***: [3h 4h 5c]
Player IlxxxlI bets (4.04)
Player CrimZnole calls (4.04)
*** TURN ***: [3h 4h 5c] [4c]
Player IlxxxlI checks
Player CrimZnole checks
*** RIVER ***: [3h 4h 5c 4c] [2c]
Player IlxxxlI allin (31.33)
Player CrimZnole calls (31.33)
------ Summary ------
Pot: 80.50. Rake 2.76. JP fee 0.24
Board: [3h 4h 5c 4c 2c]
*Player CrimZnole shows: Full House (2/4) [2h 2d]. Bets: 41.50. Collects: 80.50. Wins: 39.
Player bunnyfox2t does not show cards.Bets: 0.50. Collects: 0. Loses: 0.50.
Player IlxxxlI shows: Flush, A high [Ac 10c]. Bets: 41.50. Collects: 0. Loses: 41.50.
Player flyshark01 does not show cards.Bets: 0. Collects: 0. Wins: 0.
Player Doubletwentyone does not show cards.Bets: 0. Collects: 0. Wins: 0.
Game ended at: 2016/11/29 13:43:7

Game started
Game ID: 786985845 0.50/1 (PRR) Kraken - 13 (Hold'em)
Seat 6 is the button
Seat 1: CrimZnole (96.60).
Seat 2: bunnyfox2t (101.23).
Seat 3: IlxxxlI (40).
Seat 5: flyshark01 (101.81).
Seat 6: Doubletwentyone (118.72).
Player CrimZnole has small blind (0.50)
Player bunnyfox2t has big blind (1)
Player IlxxxlI received card: [9c]
Player IlxxxlI received card: [Qc]
Player IlxxxlI raises (3.50)
Player flyshark01 folds
Player Doubletwentyone folds
Player CrimZnole folds
Player bunnyfox2t folds
Uncalled bet (2.50) returned to IlxxxlI
Player IlxxxlI mucks cards
------ Summary ------
Pot: 2.50. Rake 0
Player CrimZnole does not show cards.Bets: 0.50. Collects: 0. Loses: 0.50.
Player bunnyfox2t does not show cards.Bets: 1. Collects: 0. Loses: 1.
*Player IlxxxlI mucks (does not show cards). Bets: 1. Collects: 2.50. Wins: 1.50.
Player flyshark01 does not show cards.Bets: 0. Collects: 0. Wins: 0.
Player Doubletwentyone does not show cards.Bets: 0. Collects: 0. Wins: 0.
Game ended at: 2016/11/29 13:41:1

Game started
Game ID: 786985806 0.25/0.50 (PRR) Gorgons (Short) (Hold'em)
Seat 1 is the button
Seat 1: Ball Crusher (119.62).
Seat 2: Jui Kuen (29.83).
Seat 3: PokerBrat1127 (10.95).
Seat 5: IlxxxlI (10).
Seat 6: anabeliangrape (33.80).
Player Jui Kuen has small blind (0.25)
Player PokerBrat1127 has big blind (0.50)
Player IlxxxlI received card: [Ks]
Player IlxxxlI received card: [9d]
Player IlxxxlI folds
Player anabeliangrape folds
Player Ball Crusher raises (1.50)
Player Jui Kuen folds
Player PokerBrat1127 calls (1)
*** FLOP ***: [Qs 10c 4d]
Player PokerBrat1127 checks
Player Ball Crusher checks
*** TURN ***: [Qs 10c 4d] [4h]
Player PokerBrat1127 checks
Player Ball Crusher bets (1.03)
Player PokerBrat1127 folds
Uncalled bet (1.03) returned to Ball Crusher
Player Ball Crusher mucks cards
------ Summary ------
Pot: 3.09. Rake 0.12. JP fee 0.04
Board: [Qs 10c 4d 4h]
*Player Ball Crusher mucks (does not show cards). Bets: 1.50. Collects: 3.09. Wins: 1.59.
Player Jui Kuen does not show cards.Bets: 0.25. Collects: 0. Loses: 0.25.
Player PokerBrat1127 does not show cards.Bets: 1.50. Collects: 0. Loses: 1.50.
Player IlxxxlI does not show cards.Bets: 0. Collects: 0. Wins: 0.
Player anabeliangrape does not show cards.Bets: 0. Collects: 0. Wins: 0.
Game ended at: 2016/11/29 13:41:38

Game started
Game ID: 786985508 0.25/0.50 (PRR) Gorgons (Short) (Hold'em)
Seat 6 is the button
Seat 1: Ball Crusher (119.87).
Seat 2: Jui Kuen (30.33).
Seat 3: PokerBrat1127 (10.20).
Seat 5: IlxxxlI (10).
Seat 6: anabeliangrape (33.80).
Player Ball Crusher has small blind (0.25)
Player Jui Kuen has big blind (0.50)
Player IlxxxlI received card: [8c]
Player IlxxxlI received card: [7h]
Player PokerBrat1127 raises (1.50)
Player IlxxxlI folds
Player anabeliangrape folds
Player Ball Crusher folds
Player Jui Kuen folds
Uncalled bet (1) returned to PokerBrat1127
Player PokerBrat1127 mucks cards
------ Summary ------
Pot: 1.25. Rake 0
Player Ball Crusher does not show cards.Bets: 0.25. Collects: 0. Loses: 0.25.
Player Jui Kuen does not show cards.Bets: 0.50. Collects: 0. Loses: 0.50.
*Player PokerBrat1127 mucks (does not show cards). Bets: 0.50. Collects: 1.25. Wins: 0.75.
Player IlxxxlI does not show cards.Bets: 0. Collects: 0. Wins: 0.
Player anabeliangrape does not show cards.Bets: 0. Collects: 0. Wins: 0.
Game ended at: 2016/11/29 13:40:39

Game started
Game ID: 786985417 0.50/1 (PRR) Kraken - 13 (Hold'em)
Seat 5 is the button
Seat 1: CrimZnole (97.60).
Seat 2: bunnyfox2t (101.23).
Seat 3: IlxxxlI (40).
Seat 5: flyshark01 (104.81).
Seat 6: Doubletwentyone (114.72).
Player Doubletwentyone has small blind (0.50)
Player CrimZnole has big blind (1)
Player IlxxxlI received card: [6d]
Player IlxxxlI received card: [Jh]
Player bunnyfox2t folds
Player IlxxxlI folds
Player flyshark01 raises (3)
Player Doubletwentyone raises (10.50)
Player CrimZnole folds
Player flyshark01 folds
Uncalled bet (8) returned to Doubletwentyone
Player Doubletwentyone mucks cards
------ Summary ------
Pot: 7. Rake 0
Player CrimZnole does not show cards.Bets: 1. Collects: 0. Loses: 1.
Player bunnyfox2t does not show cards.Bets: 0. Collects: 0. Wins: 0.
Player IlxxxlI does not show cards.Bets: 0. Collects: 0. Wins: 0.
Player flyshark01 does not show cards.Bets: 3. Collects: 0. Loses: 3.
*Player Doubletwentyone mucks (does not show cards). Bets: 3. Collects: 7. Wins: 4.
Game ended at: 2016/11/29 13:40:44

Game started
Game ID: 786985364 0.25/0.50 (PRR) Gorgons - 2 (Hold'em)
Seat 4 is the button
Seat 1: BHawk12 (47.75).
Seat 3: flyshark01 (98.92).
Seat 4: Doubletwentyone (52).
Seat 5: IlxxxlI (20).
Seat 6: foreseen (56.54).
Player IlxxxlI has small blind (0.25)
Player foreseen has big blind (0.50)
Player IlxxxlI received card: [10d]
Player IlxxxlI received card: [2d]
Player BHawk12 folds
Player flyshark01 folds
Player Doubletwentyone raises (2.50)
Player IlxxxlI folds
Player foreseen calls (2)
*** FLOP ***: [3s 5h 2s]
Player foreseen checks
Player Doubletwentyone bets (2.49)
Player foreseen folds
Uncalled bet (2.49) returned to Doubletwentyone
Player Doubletwentyone mucks cards
------ Summary ------
Pot: 4.99. Rake 0.18. JP fee 0.08
Board: [3s 5h 2s]
Player BHawk12 does not show cards.Bets: 0. Collects: 0. Wins: 0.
Player flyshark01 does not show cards.Bets: 0. Collects: 0. Wins: 0.
*Player Doubletwentyone mucks (does not show cards). Bets: 2.50. Collects: 4.99. Wins: 2.49.
Player IlxxxlI does not show cards.Bets: 0.25. Collects: 0. Loses: 0.25.
Player foreseen does not show cards.Bets: 2.50. Collects: 0. Loses: 2.50.
Game ended at: 2016/11/29 13:41:1

Game started
Game ID: 786985156 0.25/0.50 (PRR) Gorgons - 12 (Hold'em)
Seat 2 is the button
Seat 1: BHawk12 (67.50).
Seat 2: WeakAndWeary (92.33).
Seat 3: IampokerKidd (50.25).
Seat 4: IlxxxlI (20).
Seat 5: Beep_Beep (50.75).
Seat 6: foreseen (65.62).
Player IampokerKidd has small blind (0.25)
Player IlxxxlI has big blind (0.50)
Player IlxxxlI received card: [Qc]
Player IlxxxlI received card: [7d]
Player Beep_Beep folds
Player foreseen raises (1.25)
Player BHawk12 folds
Player WeakAndWeary folds
Player IampokerKidd calls (1)
Player IlxxxlI folds
*** FLOP ***: [9c Qs 5s]
Player IampokerKidd checks
Player foreseen bets (2.84)
Player IampokerKidd calls (2.84)
*** TURN ***: [9c Qs 5s] [8c]
Player IampokerKidd checks
Player foreseen bets (12.38)
Player IampokerKidd calls (12.38)
*** RIVER ***: [9c Qs 5s 8c] [6s]
Player IampokerKidd checks
Player foreseen allin (49.15)
Player IampokerKidd allin (33.78)
Uncalled bet (15.37) returned to foreseen
------ Summary ------
Pot: 98. Rake 2.76. JP fee 0.24
Board: [9c Qs 5s 8c 6s]
Player BHawk12 does not show cards.Bets: 0. Collects: 0. Wins: 0.
Player WeakAndWeary does not show cards.Bets: 0. Collects: 0. Wins: 0.
*Player IampokerKidd shows: Flush, A high [7s As]. Bets: 50.25. Collects: 98. Wins: 47.75.
Player IlxxxlI does not show cards.Bets: 0.50. Collects: 0. Loses: 0.50.
Player Beep_Beep does not show cards.Bets: 0. Collects: 0. Wins: 0.
Player foreseen shows: High card K [10h Kh]. Bets: 50.25. Collects: 0. Loses: 50.25.
Game ended at: 2016/11/29 13:41:35

Game started
Game ID: 786985038 0.25/0.50 (PRR) Gorgons - 2 (Hold'em)
Seat 3 is the button
Seat 1: BHawk12 (47.75).
Seat 3: flyshark01 (100.42).
Seat 4: Doubletwentyone (50).
Seat 5: IlxxxlI (20).
Seat 6: foreseen (56.54).
Player Doubletwentyone has small blind (0.25)
Player IlxxxlI has big blind (0.50)
Player IlxxxlI received card: [5d]
Player IlxxxlI received card: [8h]
Player foreseen folds
Player BHawk12 folds
Player flyshark01 raises (1.50)
Player Doubletwentyone raises (5.25)
Player IlxxxlI folds
Player flyshark01 folds
Uncalled bet (4) returned to Doubletwentyone
Player Doubletwentyone mucks cards
------ Summary ------
Pot: 3.50. Rake 0
Player BHawk12 does not show cards.Bets: 0. Collects: 0. Wins: 0.
Player flyshark01 does not show cards.Bets: 1.50. Collects: 0. Loses: 1.50.
*Player Doubletwentyone mucks (does not show cards). Bets: 1.50. Collects: 3.50. Wins: 2.
Player IlxxxlI does not show cards.Bets: 0.50. Collects: 0. Loses: 0.50.
Player foreseen does not show cards.Bets: 0. Collects: 0. Wins: 0.
Game ended at: 2016/11/29 13:39:44

Game started
Game ID: 786984973 0.25/0.50 (PRR) Gorgons (Short) (Hold'em)
Seat 5 is the button
Seat 1: Ball Crusher (122.79).
Seat 2: Jui Kuen (30.33).
Seat 3: PokerBrat1127 (10.20).
Seat 5: IlxxxlI (10).
Seat 6: anabeliangrape (28.39).
Player anabeliangrape has small blind (0.25)
Player Ball Crusher has big blind (0.50)
Player IlxxxlI received card: [Qd]
Player IlxxxlI received card: [Qc]
Player Jui Kuen folds
Player PokerBrat1127 folds
Player IlxxxlI raises (1.50)
Player anabeliangrape calls (1.25)
Player Ball Crusher calls (1)
*** FLOP ***: [5h Kc 10s]
Player anabeliangrape checks
Player Ball Crusher checks
Player IlxxxlI checks
*** TURN ***: [5h Kc 10s] [8s]
Player anabeliangrape bets (1.42)
Player Ball Crusher calls (1.42)
Player IlxxxlI calls (1.42)
*** RIVER ***: [5h Kc 10s 8s] [9s]
Player anabeliangrape bets (4.16)
Player Ball Crusher folds
Player IlxxxlI folds
Uncalled bet (4.16) returned to anabeliangrape
Player anabeliangrape mucks cards
------ Summary ------
Pot: 8.33. Rake 0.29. JP fee 0.14
Board: [5h Kc 10s 8s 9s]
Player Ball Crusher does not show cards.Bets: 2.92. Collects: 0. Loses: 2.92.
Player Jui Kuen does not show cards.Bets: 0. Collects: 0. Wins: 0.
Player PokerBrat1127 does not show cards.Bets: 0. Collects: 0. Wins: 0.
Player IlxxxlI does not show cards.Bets: 2.92. Collects: 0. Loses: 2.92.
*Player anabeliangrape mucks (does not show cards). Bets: 2.92. Collects: 8.33. Wins: 5.41.
Game ended at: 2016/11/29 13:40:3

Game started
Game ID: 786984531 0.25/0.50 (PRR) Gorgons (Short) (Hold'em)
Seat 3 is the button
Seat 1: Ball Crusher (122.79).
Seat 2: Jui Kuen (30.33).
Seat 3: PokerBrat1127 (13.70).
Seat 5: IlxxxlI (10).
Seat 6: anabeliangrape (25).
Player IlxxxlI has small blind (0.25)
Player anabeliangrape has big blind (0.50)
Player IlxxxlI received card: [8h]
Player IlxxxlI received card: [6s]
Player Ball Crusher folds
Player Jui Kuen folds
Player PokerBrat1127 raises (1.50)
Player IlxxxlI folds
Player anabeliangrape calls (1)
*** FLOP ***: [Qs As 7s]
Player anabeliangrape checks
Player PokerBrat1127 bets (2)
Player anabeliangrape calls (2)
*** TURN ***: [Qs As 7s] [10d]
Player anabeliangrape bets (3.44)
Player PokerBrat1127 folds
Uncalled bet (3.44) returned to anabeliangrape
Player anabeliangrape mucks cards
------ Summary ------
Pot: 6.89. Rake 0.24. JP fee 0.12
Board: [Qs As 7s 10d]
Player Ball Crusher does not show cards.Bets: 0. Collects: 0. Wins: 0.
Player Jui Kuen does not show cards.Bets: 0. Collects: 0. Wins: 0.
Player PokerBrat1127 does not show cards.Bets: 3.50. Collects: 0. Loses: 3.50.
Player IlxxxlI does not show cards.Bets: 0.25. Collects: 0. Loses: 0.25.
*Player anabeliangrape mucks (does not show cards). Bets: 3.50. Collects: 6.89. Wins: 3.39.
Game ended at: 2016/11/29 13:38:57

Game started
Game ID: 786984480 0.50/1 (PRR) Kraken - 13 (Hold'em)
Seat 4 is the button
Seat 1: CrimZnole (97.60).
Seat 2: bunnyfox2t (101.23).
Seat 3: IlxxxlI (40).
Seat 4: AironVega (106.40).
Seat 5: flyshark01 (105.31).
Seat 6: Doubletwentyone (105.21).
Player flyshark01 has small blind (0.50)
Player Doubletwentyone has big blind (1)
Player IlxxxlI received card: [Qd]
Player IlxxxlI received card: [Qh]
Player CrimZnole folds
Player bunnyfox2t folds
Player IlxxxlI raises (2.40)
Player AironVega is timed out.
Player AironVega folds
Player flyshark01 folds
Player Doubletwentyone calls (1.40)
*** FLOP ***: [8h 3d 6d]
Player Doubletwentyone checks
Player IlxxxlI bets (2.62)
Player Doubletwentyone calls (2.62)
*** TURN ***: [8h 3d 6d] [Ac]
Player Doubletwentyone checks
Player IlxxxlI checks
*** RIVER ***: [8h 3d 6d Ac] [9s]
Player Doubletwentyone bets (5.01)
Player IlxxxlI calls (5.01)
Player IlxxxlI mucks cards
------ Summary ------
Pot: 19.54. Rake 0.78. JP fee 0.24
Board: [8h 3d 6d Ac 9s]
Player CrimZnole does not show cards.Bets: 0. Collects: 0. Wins: 0.
Player bunnyfox2t does not show cards.Bets: 0. Collects: 0. Wins: 0.
Player IlxxxlI mucks (does not show: [Qd Qh]). Bets: 10.03. Collects: 0. Loses: 10.03.
Player AironVega does not show cards.Bets: 0. Collects: 0. Wins: 0.
Player flyshark01 does not show cards.Bets: 0.50. Collects: 0. Loses: 0.50.
*Player Doubletwentyone shows: One pair of As [10h Ah]. Bets: 10.03. Collects: 19.54. Wins: 9.51.
Game ended at: 2016/11/29 13:39:50

Game started
Game ID: 786984238 0.25/0.50 (PRR) Gorgons (Short) (Hold'em)
Seat 2 is the button
Seat 1: Ball Crusher (122.04).
Seat 2: Jui Kuen (30.33).
Seat 3: PokerBrat1127 (13.95).
Seat 5: IlxxxlI (10).
Player PokerBrat1127 has small blind (0.25)
Player IlxxxlI has big blind (0.50)
Player IlxxxlI received card: [Qh]
Player IlxxxlI received card: [7s]
Player Ball Crusher raises (1.50)
Player Jui Kuen folds
Player PokerBrat1127 folds
Player IlxxxlI folds
Uncalled bet (1) returned to Ball Crusher
Player Ball Crusher mucks cards
------ Summary ------
Pot: 1.25. Rake 0
*Player Ball Crusher mucks (does not show cards). Bets: 0.50. Collects: 1.25. Wins: 0.75.
Player Jui Kuen does not show cards.Bets: 0. Collects: 0. Wins: 0.
Player PokerBrat1127 does not show cards.Bets: 0.25. Collects: 0. Loses: 0.25.
Player IlxxxlI does not show cards.Bets: 0.50. Collects: 0. Loses: 0.50.
Game ended at: 2016/11/29 13:38:3

Game started
Game ID: 786984035 0.25/0.50 (PRR) Gorgons (Short) (Hold'em)
Seat 1 is the button
Seat 1: Ball Crusher (121.29).
Seat 2: Jui Kuen (30.58).
Seat 3: PokerBrat1127 (14.45).
Seat 5: IlxxxlI (10).
Player Jui Kuen has small blind (0.25)
Player PokerBrat1127 has big blind (0.50)
Player IlxxxlI received card: [10s]
Player IlxxxlI received card: [Jd]
Player IlxxxlI folds
Player Ball Crusher raises (1.50)
Player Jui Kuen folds
Player PokerBrat1127 folds
Uncalled bet (1) returned to Ball Crusher
Player Ball Crusher mucks cards
------ Summary ------
Pot: 1.25. Rake 0
*Player Ball Crusher mucks (does not show cards). Bets: 0.50. Collects: 1.25. Wins: 0.75.
Player Jui Kuen does not show cards.Bets: 0.25. Collects: 0. Loses: 0.25.
Player PokerBrat1127 does not show cards.Bets: 0.50. Collects: 0. Loses: 0.50.
Player IlxxxlI does not show cards.Bets: 0. Collects: 0. Wins: 0.
Game ended at: 2016/11/29 13:37:29

Game started
Game ID: 786984007 0.50/1 (PRR) Kraken - 13 (Hold'em)
Seat 3 is the button
Seat 1: CrimZnole (100).
Seat 2: bunnyfox2t (101.23).
Seat 3: IlxxxlI (40).
Seat 4: AironVega (103).
Seat 5: flyshark01 (106.31).
Seat 6: Doubletwentyone (105.21).
Player AironVega has small blind (0.50)
Player flyshark01 has big blind (1)
Player IlxxxlI received card: [7s]
Player IlxxxlI received card: [4d]
Player Doubletwentyone folds
Player CrimZnole raises (2.40)
Player bunnyfox2t folds
Player IlxxxlI folds
Player AironVega raises (9.50)
Player flyshark01 folds
Player CrimZnole folds
Uncalled bet (7.60) returned to AironVega
Player AironVega mucks cards
------ Summary ------
Pot: 5.80. Rake 0
Player CrimZnole does not show cards.Bets: 2.40. Collects: 0. Loses: 2.40.
Player bunnyfox2t does not show cards.Bets: 0. Collects: 0. Wins: 0.
Player IlxxxlI does not show cards.Bets: 0. Collects: 0. Wins: 0.
*Player AironVega mucks (does not show cards). Bets: 2.40. Collects: 5.80. Wins: 3.40.
Player flyshark01 does not show cards.Bets: 1. Collects: 0. Loses: 1.
Player Doubletwentyone does not show cards.Bets: 0. Collects: 0. Wins: 0.
Game ended at: 2016/11/29 13:37:58

Game started
Game ID: 786983880 0.25/0.50 (PRR) Gorgons (Short) (Hold'em)
Seat 5 is the button
Seat 1: Ball Crusher (121.54).
Seat 2: Jui Kuen (31.08).
Seat 3: PokerBrat1127 (13.70).
Seat 5: IlxxxlI (10).
Player Ball Crusher has small blind (0.25)
Player Jui Kuen has big blind (0.50)
Player IlxxxlI received card: [10s]
Player IlxxxlI received card: [Ad]
Player PokerBrat1127 raises (1.50)
Player IlxxxlI folds
Player Ball Crusher folds
Player Jui Kuen folds
Uncalled bet (1) returned to PokerBrat1127
Player PokerBrat1127 mucks cards
------ Summary ------
Pot: 1.25. Rake 0
Player Ball Crusher does not show cards.Bets: 0.25. Collects: 0. Loses: 0.25.
Player Jui Kuen does not show cards.Bets: 0.50. Collects: 0. Loses: 0.50.
*Player PokerBrat1127 mucks (does not show cards). Bets: 0.50. Collects: 1.25. Wins: 0.75.
Player IlxxxlI does not show cards.Bets: 0. Collects: 0. Wins: 0.
Game ended at: 2016/11/29 13:37:7

Game started
Game ID: 786983701 0.25/0.50 (PRR) Gorgons (Short) (Hold'em)
Seat 3 is the button
Seat 1: Ball Crusher (122.04).
Seat 2: Jui Kuen (31.08).
Seat 3: PokerBrat1127 (12.95).
Seat 5: IlxxxlI (10.25).
Player IlxxxlI has small blind (0.25)
Player Ball Crusher has big blind (0.50)
Player IlxxxlI received card: [Kc]
Player IlxxxlI received card: [5h]
Player Jui Kuen folds
Player PokerBrat1127 raises (1.50)
Player IlxxxlI folds
Player Ball Crusher folds
Uncalled bet (1) returned to PokerBrat1127
Player PokerBrat1127 mucks cards
------ Summary ------
Pot: 1.25. Rake 0
Player Ball Crusher does not show cards.Bets: 0.50. Collects: 0. Loses: 0.50.
Player Jui Kuen does not show cards.Bets: 0. Collects: 0. Wins: 0.
*Player PokerBrat1127 mucks (does not show cards). Bets: 0.50. Collects: 1.25. Wins: 0.75.
Player IlxxxlI does not show cards.Bets: 0.25. Collects: 0. Loses: 0.25.
Game ended at: 2016/11/29 13:36:51

Game started
Game ID: 786983687 0.50/1 (PRR) Kraken - 13 (Hold'em)
Seat 2 is the button
Seat 1: CrimZnole (100).
Seat 2: bunnyfox2t (101.23).
Seat 3: IlxxxlI (40).
Seat 4: AironVega (104).
Seat 5: flyshark01 (104.81).
Seat 6: Doubletwentyone (105.21).
Player IlxxxlI has small blind (0.50)
Player AironVega has big blind (1)
Player IlxxxlI received card: [3c]
Player IlxxxlI received card: [Kh]
Player flyshark01 raises (3)
Player Doubletwentyone folds
Player CrimZnole folds
Player bunnyfox2t folds
Player IlxxxlI folds
Player AironVega folds
Uncalled bet (2) returned to flyshark01
Player flyshark01 mucks cards
------ Summary ------
Pot: 2.50. Rake 0
Player CrimZnole does not show cards.Bets: 0. Collects: 0. Wins: 0.
Player bunnyfox2t does not show cards.Bets: 0. Collects: 0. Wins: 0.
Player IlxxxlI does not show cards.Bets: 0.50. Collects: 0. Loses: 0.50.
Player AironVega does not show cards.Bets: 1. Collects: 0. Loses: 1.
*Player flyshark01 mucks (does not show cards). Bets: 1. Collects: 2.50. Wins: 1.50.
Player Doubletwentyone does not show cards.Bets: 0. Collects: 0. Wins: 0.
Game ended at: 2016/11/29 13:37:3

Game started
Game ID: 786983336 0.50/1 (PRR) Kraken - 13 (Hold'em)
Seat 1 is the button
Seat 1: CrimZnole (98.50).
Seat 2: bunnyfox2t (101.73).
Seat 3: IlxxxlI (40).
Seat 4: AironVega (104).
Seat 5: flyshark01 (104.81).
Seat 6: Doubletwentyone (105.21).
Player bunnyfox2t has small blind (0.50)
Player IlxxxlI has big blind (1)
Player IlxxxlI received card: [5h]
Player IlxxxlI received card: [10c]
Player AironVega folds
Player flyshark01 folds
Player Doubletwentyone folds
Player CrimZnole raises (2.40)
Player bunnyfox2t folds
Player IlxxxlI folds
Uncalled bet (1.40) returned to CrimZnole
Player CrimZnole mucks cards
------ Summary ------
Pot: 2.50. Rake 0
*Player CrimZnole mucks (does not show cards). Bets: 1. Collects: 2.50. Wins: 1.50.
Player bunnyfox2t does not show cards.Bets: 0.50. Collects: 0. Loses: 0.50.
Player IlxxxlI does not show cards.Bets: 1. Collects: 0. Loses: 1.
Player AironVega does not show cards.Bets: 0. Collects: 0. Wins: 0.
Player flyshark01 does not show cards.Bets: 0. Collects: 0. Wins: 0.
Player Doubletwentyone does not show cards.Bets: 0. Collects: 0. Wins: 0.
Game ended at: 2016/11/29 13:36:27

Game started
Game ID: 786979563 1/2 (PRR) Longana (Short) - 2 (Hold'em)
Seat 5 is the button
Seat 1: actionjax24 (132.38).
Seat 2: ShawnFrie (109.72).
Seat 3: VegetablesArentYummy (100).
Seat 4: gust (87).
Seat 5: St3p04ka (80).
Seat 6: Pimpika (89.58).
Seat 7: dbrinker (372.59).
Seat 8: IlxxxlI (40).
Player Pimpika has small blind (1)
Player dbrinker has big blind (2)
Player IlxxxlI received card: [Jc]
Player IlxxxlI received card: [Ah]
Player IlxxxlI raises (4)
Player actionjax24 folds
Player ShawnFrie folds
Player VegetablesArentYummy folds
Player gust folds
Player St3p04ka folds
Player Pimpika folds
Player dbrinker calls (2)
*** FLOP ***: [6s Qh Qs]
Player dbrinker checks
Player IlxxxlI bets (4.45)
Player dbrinker folds
Uncalled bet (4.45) returned to IlxxxlI
Player IlxxxlI mucks cards
------ Summary ------
Pot: 8.55. Rake 0.31. JP fee 0.14
Board: [6s Qh Qs]
Player actionjax24 does not show cards.Bets: 0. Collects: 0. Wins: 0.
Player ShawnFrie does not show cards.Bets: 0. Collects: 0. Wins: 0.
Player VegetablesArentYummy does not show cards.Bets: 0. Collects: 0. Wins: 0.
Player gust does not show cards.Bets: 0. Collects: 0. Wins: 0.
Player St3p04ka does not show cards.Bets: 0. Collects: 0. Wins: 0.
Player Pimpika does not show cards.Bets: 1. Collects: 0. Loses: 1.
Player dbrinker does not show cards.Bets: 4. Collects: 0. Loses: 4.
*Player IlxxxlI mucks (does not show cards). Bets: 4. Collects: 8.55. Wins: 4.55.
Game ended at: 2016/11/29 13:29:38

Game started
Game ID: 786979261 1/2 (PRR) Longana (Short) - 2 (Hold'em)
Seat 4 is the button
Seat 1: actionjax24 (132.38).
Seat 2: ShawnFrie (106.72).
Seat 3: VegetablesArentYummy (100).
Seat 4: gust (87).
Seat 5: St3p04ka (80).
Seat 6: Pimpika (91.58).
Seat 7: dbrinker (372.59).
Seat 8: IlxxxlI (40).
Player St3p04ka has small blind (1)
Player Pimpika has big blind (2)
Player IlxxxlI received card: [Qh]
Player IlxxxlI received card: [4h]
Player dbrinker folds
Player IlxxxlI folds
Player actionjax24 folds
Player ShawnFrie raises (6)
Player VegetablesArentYummy folds
Player gust folds
Player St3p04ka folds
Player Pimpika folds
Uncalled bet (4) returned to ShawnFrie
Player ShawnFrie mucks cards
------ Summary ------
Pot: 5. Rake 0
Player actionjax24 does not show cards.Bets: 0. Collects: 0. Wins: 0.
*Player ShawnFrie mucks (does not show cards). Bets: 2. Collects: 5. Wins: 3.
Player VegetablesArentYummy does not show cards.Bets: 0. Collects: 0. Wins: 0.
Player gust does not show cards.Bets: 0. Collects: 0. Wins: 0.
Player St3p04ka does not show cards.Bets: 1. Collects: 0. Loses: 1.
Player Pimpika does not show cards.Bets: 2. Collects: 0. Loses: 2.
Player dbrinker does not show cards.Bets: 0. Collects: 0. Wins: 0.
Player IlxxxlI does not show cards.Bets: 0. Collects: 0. Wins: 0.
Game ended at: 2016/11/29 13:28:45

Game started
Game ID: 786978205 1/2 (PRR) Longana (Short) - 2 (Hold'em)
Seat 3 is the button
Seat 1: actionjax24 (132.38).
Seat 2: ShawnFrie (106.72).
Seat 3: VegetablesArentYummy (100).
Seat 4: gust (80).
Seat 5: St3p04ka (80).
Seat 6: Pimpika (91.58).
Seat 7: dbrinker (372.59).
Seat 8: IlxxxlI (40).
Player gust has small blind (1)
Player St3p04ka has big blind (2)
Player IlxxxlI received card: [6h]
Player IlxxxlI received card: [10h]
Player Pimpika folds
Player dbrinker folds
Player IlxxxlI folds
Player actionjax24 folds
Player ShawnFrie folds
Player VegetablesArentYummy raises (5)
Player gust raises (13)
Player St3p04ka folds
Player VegetablesArentYummy folds
Uncalled bet (9) returned to gust
Player gust mucks cards
------ Summary ------
Pot: 12. Rake 0
Player actionjax24 does not show cards.Bets: 0. Collects: 0. Wins: 0.
Player ShawnFrie does not show cards.Bets: 0. Collects: 0. Wins: 0.
Player VegetablesArentYummy does not show cards.Bets: 5. Collects: 0. Loses: 5.
*Player gust mucks (does not show cards). Bets: 5. Collects: 12. Wins: 7.
Player St3p04ka does not show cards.Bets: 2. Collects: 0. Loses: 2.
Player Pimpika does not show cards.Bets: 0. Collects: 0. Wins: 0.
Player dbrinker does not show cards.Bets: 0. Collects: 0. Wins: 0.
Player IlxxxlI does not show cards.Bets: 0. Collects: 0. Wins: 0.
Game ended at: 2016/11/29 13:28:13

Game started
Game ID: 786978108 1/2 (PRR) Lakhey - 2 (Hold'em)
Seat 4 is the button
Seat 1: KingGuciGuci (208.14).
Seat 2: IlxxxlI (80).
Seat 3: gust (102.56).
Seat 4: SCking (578.47).
Seat 5: VegetablesArentYummy (200).
Seat 6: Pimpika (179.30).
Player VegetablesArentYummy has small blind (1)
Player Pimpika has big blind (2)
Player IlxxxlI received card: [9d]
Player IlxxxlI received card: [6s]
Player KingGuciGuci folds
Player IlxxxlI folds
Player gust folds
Player SCking calls (2)
Player VegetablesArentYummy folds
Player Pimpika raises (6)
Player SCking folds
Uncalled bet (6) returned to Pimpika
Player Pimpika mucks cards
------ Summary ------
Pot: 5. Rake 0
Player KingGuciGuci does not show cards.Bets: 0. Collects: 0. Wins: 0.
Player IlxxxlI does not show cards.Bets: 0. Collects: 0. Wins: 0.
Player gust does not show cards.Bets: 0. Collects: 0. Wins: 0.
Player SCking does not show cards.Bets: 2. Collects: 0. Loses: 2.
Player VegetablesArentYummy does not show cards.Bets: 1. Collects: 0. Loses: 1.
*Player Pimpika mucks (does not show cards). Bets: 2. Collects: 5. Wins: 3.
Game ended at: 2016/11/29 13:26:46

Game started
Game ID: 786977860 1/2 (PRR) Longana (Short) - 2 (Hold'em)
Seat 2 is the button
Seat 1: actionjax24 (129.38).
Seat 2: ShawnFrie (106.72).
Seat 3: VegetablesArentYummy (101).
Seat 4: gust (80).
Seat 6: Pimpika (91.58).
Seat 7: dbrinker (372.59).
Seat 8: IlxxxlI (40).
Player VegetablesArentYummy has small blind (1)
Player gust has big blind (2)
Player IlxxxlI received card: [5c]
Player IlxxxlI received card: [2h]
Player Pimpika folds
Player dbrinker folds
Player IlxxxlI folds
Player actionjax24 raises (6)
Player ShawnFrie folds
Player VegetablesArentYummy folds
Player gust folds
Uncalled bet (4) returned to actionjax24
Player actionjax24 mucks cards
------ Summary ------
Pot: 5. Rake 0
*Player actionjax24 mucks (does not show cards). Bets: 2. Collects: 5. Wins: 3.
Player ShawnFrie does not show cards.Bets: 0. Collects: 0. Wins: 0.
Player VegetablesArentYummy does not show cards.Bets: 1. Collects: 0. Loses: 1.
Player gust does not show cards.Bets: 2. Collects: 0. Loses: 2.
Player Pimpika does not show cards.Bets: 0. Collects: 0. Wins: 0.
Player dbrinker does not show cards.Bets: 0. Collects: 0. Wins: 0.
Player IlxxxlI does not show cards.Bets: 0. Collects: 0. Wins: 0.
Game ended at: 2016/11/29 13:26:15

Game started
Game ID: 786977635 0.25/0.50 (PRR) Gorgons - 18 (Hold'em)
Seat 6 is the button
Seat 1: Abundance4All (80.89).
Seat 2: xROCKETMANx (68.40).
Seat 4: IlxxxlI (22).
Seat 5: GagaPoker (82.78).
Seat 6: foreseen (55.12).
Player Abundance4All has small blind (0.25)
Player xROCKETMANx has big blind (0.50)
Player IlxxxlI received card: [2d]
Player IlxxxlI received card: [4c]
Player IlxxxlI folds
Player GagaPoker folds
Player foreseen folds
Player Abundance4All raises (1.25)
Player xROCKETMANx folds
Uncalled bet (1) returned to Abundance4All
Player Abundance4All mucks cards
------ Summary ------
Pot: 1. Rake 0
*Player Abundance4All mucks (does not show cards). Bets: 0.50. Collects: 1. Wins: 0.50.
Player xROCKETMANx does not show cards.Bets: 0.50. Collects: 0. Loses: 0.50.
Player IlxxxlI does not show cards.Bets: 0. Collects: 0. Wins: 0.
Player GagaPoker does not show cards.Bets: 0. Collects: 0. Wins: 0.
Player foreseen does not show cards.Bets: 0. Collects: 0. Wins: 0.
Game ended at: 2016/11/29 13:25:44

Game started
Game ID: 786977583 0.25/0.50 (PRR) Gorgons - 10 (Hold'em)
Seat 4 is the button
Seat 1: WeakAndWeary (52.99).
Seat 2: foreseen (163.10).
Seat 3: IlxxxlI (22).
Seat 4: Beep_Beep (66.48).
Seat 6: xROCKETMANx (55.51).
Player xROCKETMANx has small blind (0.25)
Player WeakAndWeary has big blind (0.50)
Player IlxxxlI received card: [Ad]
Player IlxxxlI received card: [As]
Player foreseen folds
Player IlxxxlI raises (1.20)
Player Beep_Beep calls (1.20)
Player xROCKETMANx folds
Player WeakAndWeary calls (0.70)
*** FLOP ***: [10h 9d 2s]
Player WeakAndWeary checks
Player IlxxxlI bets (2.44)
Player Beep_Beep folds
Player WeakAndWeary calls (2.44)
*** TURN ***: [10h 9d 2s] [7s]
Player WeakAndWeary checks
Player IlxxxlI bets (5.53)
Player WeakAndWeary allin (49.35)
Player IlxxxlI allin (12.83)
Uncalled bet (30.99) returned to WeakAndWeary
*** RIVER ***: [10h 9d 2s 7s] [2d]
------ Summary ------
Pot: 43.18. Rake 2.03. JP fee 0.24
Board: [10h 9d 2s 7s 2d]
Player WeakAndWeary shows: Two pairs. 9s and 7s [9s 7h]. Bets: 22. Collects: 0. Loses: 22.
Player foreseen does not show cards.Bets: 0. Collects: 0. Wins: 0.
*Player IlxxxlI shows: Two pairs. As and 2s [Ad As]. Bets: 22. Collects: 43.18. Wins: 21.18.
Player Beep_Beep does not show cards.Bets: 1.20. Collects: 0. Loses: 1.20.
Player xROCKETMANx does not show cards.Bets: 0.25. Collects: 0. Loses: 0.25.
Game ended at: 2016/11/29 13:27:4

Game started
Game ID: 786977554 1/2 (PRR) Longana (Short) - 2 (Hold'em)
Seat 1 is the button
Seat 1: actionjax24 (129.38).
Seat 2: ShawnFrie (107.72).
Seat 3: VegetablesArentYummy (100).
Seat 4: gust (80).
Seat 6: Pimpika (91.58).
Seat 7: dbrinker (372.59).
Seat 8: IlxxxlI (40).
Player ShawnFrie has small blind (1)
Player VegetablesArentYummy has big blind (2)
Player IlxxxlI received card: [6d]
Player IlxxxlI received card: [2s]
Player gust folds
Player Pimpika folds
Player dbrinker folds
Player IlxxxlI folds
Player actionjax24 folds
Player ShawnFrie folds
Uncalled bet (1) returned to VegetablesArentYummy
Player VegetablesArentYummy mucks cards
------ Summary ------
Pot: 2. Rake 0
Player actionjax24 does not show cards.Bets: 0. Collects: 0. Wins: 0.
Player ShawnFrie does not show cards.Bets: 1. Collects: 0. Loses: 1.
*Player VegetablesArentYummy mucks (does not show cards). Bets: 1. Collects: 2. Wins: 1.
Player gust does not show cards.Bets: 0. Collects: 0. Wins: 0.
Player Pimpika does not show cards.Bets: 0. Collects: 0. Wins: 0.
Player dbrinker does not show cards.Bets: 0. Collects: 0. Wins: 0.
Player IlxxxlI does not show cards.Bets: 0. Collects: 0. Wins: 0.
Game ended at: 2016/11/29 13:25:37

Game started
Game ID: 786977553 1/2 (PRR) Lakhey - 2 (Hold'em)
Seat 3 is the button
Seat 1: KingGuciGuci (208.14).
Seat 2: IlxxxlI (80).
Seat 3: gust (102.56).
Seat 4: SCking (572.25).
Seat 5: VegetablesArentYummy (200).
Seat 6: Pimpika (179.30).
Player SCking has small blind (1)
Player VegetablesArentYummy has big blind (2)
Player IlxxxlI received card: [10s]
Player IlxxxlI received card: [Kc]
Player Pimpika folds
Player KingGuciGuci folds
Player IlxxxlI raises (4.80)
Player gust folds
Player SCking calls (3.80)
Player VegetablesArentYummy folds
*** FLOP ***: [Jh 7d 7h]
Player SCking bets (4)
Player IlxxxlI folds
Uncalled bet (4) returned to SCking
Player SCking mucks cards
------ Summary ------
Pot: 11.02. Rake 0.40. JP fee 0.18
Board: [Jh 7d 7h]
Player KingGuciGuci does not show cards.Bets: 0. Collects: 0. Wins: 0.
Player IlxxxlI does not show cards.Bets: 4.80. Collects: 0. Loses: 4.80.
Player gust does not show cards.Bets: 0. Collects: 0. Wins: 0.
*Player SCking mucks (does not show cards). Bets: 4.80. Collects: 11.02. Wins: 6.22.
Player VegetablesArentYummy does not show cards.Bets: 2. Collects: 0. Loses: 2.
Player Pimpika does not show cards.Bets: 0. Collects: 0. Wins: 0.
Game ended at: 2016/11/29 13:26:5

Game started
Game ID: 786977226 0.25/0.50 (PRR) Gorgons - 18 (Hold'em)
Seat 5 is the button
Seat 1: Abundance4All (80.64).
Seat 2: xROCKETMANx (68.40).
Seat 4: IlxxxlI (22).
Seat 5: GagaPoker (82.78).
Seat 6: foreseen (55.37).
Player foreseen has small blind (0.25)
Player Abundance4All has big blind (0.50)
Player IlxxxlI received card: [7c]
Player IlxxxlI received card: [6s]
Player xROCKETMANx folds
Player IlxxxlI folds
Player GagaPoker folds
Player foreseen folds
Uncalled bet (0.25) returned to Abundance4All
Player Abundance4All mucks cards
------ Summary ------
Pot: 0.50. Rake 0
*Player Abundance4All mucks (does not show cards). Bets: 0.25. Collects: 0.50. Wins: 0.25.
Player xROCKETMANx does not show cards.Bets: 0. Collects: 0. Wins: 0.
Player IlxxxlI does not show cards.Bets: 0. Collects: 0. Wins: 0.
Player GagaPoker does not show cards.Bets: 0. Collects: 0. Wins: 0.
Player foreseen does not show cards.Bets: 0.25. Collects: 0. Loses: 0.25.
Game ended at: 2016/11/29 13:25:13

Game started
Game ID: 786977120 0.25/0.50 (PRR) Gorgons - 10 (Hold'em)
Seat 3 is the button
Seat 1: WeakAndWeary (52.99).
Seat 2: foreseen (164.35).
Seat 3: IlxxxlI (20).
Seat 4: Beep_Beep (66.73).
Seat 6: xROCKETMANx (56.01).
Player Beep_Beep has small blind (0.25)
Player xROCKETMANx has big blind (0.50)
Player IlxxxlI received card: [10c]
Player IlxxxlI received card: [Kc]
Player WeakAndWeary folds
Player foreseen raises (1.25)
Player IlxxxlI raises (3.04)
Player Beep_Beep folds
Player xROCKETMANx folds
Player foreseen folds
Uncalled bet (1.79) returned to IlxxxlI
Player IlxxxlI mucks cards
------ Summary ------
Pot: 3.25. Rake 0
Player WeakAndWeary does not show cards.Bets: 0. Collects: 0. Wins: 0.
Player foreseen does not show cards.Bets: 1.25. Collects: 0. Loses: 1.25.
*Player IlxxxlI mucks (does not show cards). Bets: 1.25. Collects: 3.25. Wins: 2.
Player Beep_Beep does not show cards.Bets: 0.25. Collects: 0. Loses: 0.25.
Player xROCKETMANx does not show cards.Bets: 0.50. Collects: 0. Loses: 0.50.
Game ended at: 2016/11/29 13:25:8

Game started
Game ID: 786977083 0.50/1 (PRR) Kraken - 22 (Hold'em)
Seat 5 is the button
Seat 1: TTSO (40).
Seat 2: IlxxxlI (41.38).
Seat 4: gust (40.78).
Seat 5: MadLifeGrinder (103).
Seat 6: WeakAndWeary (275.84).
Player WeakAndWeary has small blind (0.50)
Player TTSO has big blind (1)
Player IlxxxlI received card: [Qs]
Player IlxxxlI received card: [6c]
Player IlxxxlI folds
Player gust folds
Player MadLifeGrinder raises (2.50)
Player WeakAndWeary calls (2)
Player TTSO calls (1.50)
*** FLOP ***: [4d 10d 3d]
Player WeakAndWeary checks
Player TTSO checks
Player MadLifeGrinder checks
*** TURN ***: [4d 10d 3d] [4s]
Player WeakAndWeary checks
Player TTSO checks
Player MadLifeGrinder checks
*** RIVER ***: [4d 10d 3d 4s] [Ks]
Player WeakAndWeary checks
Player TTSO checks
Player MadLifeGrinder bets (4)
Player WeakAndWeary folds
Player TTSO calls (4)
------ Summary ------
Pot: 14.73. Rake 0.53. JP fee 0.24
Board: [4d 10d 3d 4s Ks]
*Player TTSO shows: Two pairs. Ks and 4s [9c Kd]. Bets: 6.50. Collects: 7.36. Wins: 0.86.
Player IlxxxlI does not show cards.Bets: 0. Collects: 0. Wins: 0.
Player gust does not show cards.Bets: 0. Collects: 0. Wins: 0.
*Player MadLifeGrinder shows: Two pairs. Ks and 4s [7h Kh]. Bets: 6.50. Collects: 7.37. Wins: 0.87.
Player WeakAndWeary does not show cards.Bets: 2.50. Collects: 0. Loses: 2.50.
Game ended at: 2016/11/29 13:25:51

Game started
Game ID: 786976861 0.50/1 (PRR) Kraken - 22 (Hold'em)
Seat 4 is the button
Seat 2: IlxxxlI (41.38).
Seat 4: gust (40.78).
Seat 5: MadLifeGrinder (103.50).
Seat 6: WeakAndWeary (275.34).
Player MadLifeGrinder has small blind (0.50)
Player WeakAndWeary has big blind (1)
Player IlxxxlI received card: [2c]
Player IlxxxlI received card: [8h]
Player IlxxxlI folds
Player gust folds
Player MadLifeGrinder folds
Uncalled bet (0.50) returned to WeakAndWeary
Player WeakAndWeary mucks cards
------ Summary ------
Pot: 1. Rake 0
Player IlxxxlI does not show cards.Bets: 0. Collects: 0. Wins: 0.
Player gust does not show cards.Bets: 0. Collects: 0. Wins: 0.
Player MadLifeGrinder does not show cards.Bets: 0.50. Collects: 0. Loses: 0.50.
*Player WeakAndWeary mucks (does not show cards). Bets: 0.50. Collects: 1. Wins: 0.50.
Game ended at: 2016/11/29 13:24:17

Game started
Game ID: 786976795 1/2 (PRR) Longana (Short) - 2 (Hold'em)
Seat 8 is the button
Seat 1: actionjax24 (130.38).
Seat 2: ShawnFrie (96).
Seat 3: VegetablesArentYummy (100).
Seat 4: gust (80).
Seat 6: Pimpika (103.54).
Seat 7: dbrinker (372.59).
Seat 8: IlxxxlI (40).
Player actionjax24 has small blind (1)
Player ShawnFrie has big blind (2)
Player IlxxxlI received card: [Kd]
Player IlxxxlI received card: [3s]
Player VegetablesArentYummy folds
Player gust folds
Player Pimpika raises (5)
Player dbrinker folds
Player IlxxxlI folds
Player actionjax24 folds
Player ShawnFrie calls (3)
*** FLOP ***: [4c 9d 10c]
Player ShawnFrie checks
Player Pimpika bets (6.96)
Player ShawnFrie calls (6.96)
*** TURN ***: [4c 9d 10c] [2d]
Player ShawnFrie checks
Player Pimpika checks
*** RIVER ***: [4c 9d 10c 2d] [6s]
Player ShawnFrie bets (18)
Player Pimpika folds
Uncalled bet (18) returned to ShawnFrie
Player ShawnFrie mucks cards
------ Summary ------
Pot: 23.68. Rake 1. JP fee 0.24
Board: [4c 9d 10c 2d 6s]
Player actionjax24 does not show cards.Bets: 1. Collects: 0. Loses: 1.
*Player ShawnFrie mucks (does not show cards). Bets: 11.96. Collects: 23.68. Wins: 11.72.
Player VegetablesArentYummy does not show cards.Bets: 0. Collects: 0. Wins: 0.
Player gust does not show cards.Bets: 0. Collects: 0. Wins: 0.
Player Pimpika does not show cards.Bets: 11.96. Collects: 0. Loses: 11.96.
Player dbrinker does not show cards.Bets: 0. Collects: 0. Wins: 0.
Player IlxxxlI does not show cards.Bets: 0. Collects: 0. Wins: 0.
Game ended at: 2016/11/29 13:25:5

Game started
Game ID: 786976776 0.25/0.50 (PRR) Gorgons - 18 (Hold'em)
Seat 4 is the button
Seat 1: Abundance4All (80.64).
Seat 2: xROCKETMANx (68.40).
Seat 4: IlxxxlI (22).
Seat 5: GagaPoker (84.28).
Seat 6: foreseen (53.87).
Player GagaPoker has small blind (0.25)
Player foreseen has big blind (0.50)
Player IlxxxlI received card: [5h]
Player IlxxxlI received card: [9c]
Player Abundance4All folds
Player xROCKETMANx folds
Player IlxxxlI folds
Player GagaPoker raises (1.25)
Player foreseen raises (4.15)
Player GagaPoker folds
Uncalled bet (3.15) returned to foreseen
Player foreseen mucks cards
------ Summary ------
Pot: 3. Rake 0
Player Abundance4All does not show cards.Bets: 0. Collects: 0. Wins: 0.
Player xROCKETMANx does not show cards.Bets: 0. Collects: 0. Wins: 0.
Player IlxxxlI does not show cards.Bets: 0. Collects: 0. Wins: 0.
Player GagaPoker does not show cards.Bets: 1.50. Collects: 0. Loses: 1.50.
*Player foreseen mucks (does not show cards). Bets: 1.50. Collects: 3. Wins: 1.50.
Game ended at: 2016/11/29 13:24:31

Game started
Game ID: 786976761 0.25/0.50 (PRR) Gorgons - 10 (Hold'em)
Seat 2 is the button
Seat 1: WeakAndWeary (52.99).
Seat 2: foreseen (163.60).
Seat 3: IlxxxlI (20).
Seat 4: Beep_Beep (67.23).
Player IlxxxlI has small blind (0.25)
Player Beep_Beep has big blind (0.50)
Player IlxxxlI received card: [Jh]
Player IlxxxlI received card: [9d]
Player WeakAndWeary folds
Player foreseen raises (1.12)
Player IlxxxlI folds
Player Beep_Beep folds
Uncalled bet (0.62) returned to foreseen
Player foreseen mucks cards
------ Summary ------
Pot: 1.25. Rake 0
Player WeakAndWeary does not show cards.Bets: 0. Collects: 0. Wins: 0.
*Player foreseen mucks (does not show cards). Bets: 0.50. Collects: 1.25. Wins: 0.75.
Player IlxxxlI does not show cards.Bets: 0.25. Collects: 0. Loses: 0.25.
Player Beep_Beep does not show cards.Bets: 0.50. Collects: 0. Loses: 0.50.
Game ended at: 2016/11/29 13:24:21

Game started
Game ID: 786976618 1/2 (PRR) Lakhey - 2 (Hold'em)
Seat 2 is the button
Seat 1: KingGuciGuci (200).
Seat 2: IlxxxlI (80).
Seat 3: gust (106.96).
Seat 4: SCking (576.65).
Seat 5: VegetablesArentYummy (200).
Seat 6: Pimpika (179.30).
Player gust has small blind (1)
Player SCking has big blind (2)
Player IlxxxlI received card: [7h]
Player IlxxxlI received card: [Ks]
Player VegetablesArentYummy folds
Player Pimpika folds
Player KingGuciGuci raises (4.40)
Player IlxxxlI folds
Player gust calls (3.40)
Player SCking calls (2.40)
*** FLOP ***: [9c Qd 6c]
Player gust checks
Player SCking checks
Player KingGuciGuci bets (6.90)
Player gust folds
Player SCking folds
Uncalled bet (6.90) returned to KingGuciGuci
Player KingGuciGuci mucks cards
------ Summary ------
Pot: 12.54. Rake 0.44. JP fee 0.22
Board: [9c Qd 6c]
*Player KingGuciGuci mucks (does not show cards). Bets: 4.40. Collects: 12.54. Wins: 8.14.
Player IlxxxlI does not show cards.Bets: 0. Collects: 0. Wins: 0.
Player gust does not show cards.Bets: 4.40. Collects: 0. Loses: 4.40.
Player SCking does not show cards.Bets: 4.40. Collects: 0. Loses: 4.40.
Player VegetablesArentYummy does not show cards.Bets: 0. Collects: 0. Wins: 0.
Player Pimpika does not show cards.Bets: 0. Collects: 0. Wins: 0.
Game ended at: 2016/11/29 13:25:4

Game started
Game ID: 786976401 1/2 (PRR) Longana (Short) - 2 (Hold'em)
Seat 7 is the button
Seat 1: actionjax24 (125.20).
Seat 2: ShawnFrie (96).
Seat 3: VegetablesArentYummy (100).
Seat 4: gust (80).
Seat 6: Pimpika (103.54).
Seat 7: dbrinker (377.29).
Seat 8: IlxxxlI (40).
Player IlxxxlI has small blind (1)
Player actionjax24 has big blind (2)
Player IlxxxlI received card: [2c]
Player IlxxxlI received card: [6d]
Player ShawnFrie folds
Player VegetablesArentYummy folds
Player gust folds
Player Pimpika folds
Player dbrinker raises (4.70)
Player IlxxxlI folds
Player actionjax24 calls (2.70)
*** FLOP ***: [2h 4c 3h]
Player actionjax24 bets (5)
Player dbrinker folds
Uncalled bet (5) returned to actionjax24
Player actionjax24 mucks cards
------ Summary ------
Pot: 9.88. Rake 0.36. JP fee 0.16
Board: [2h 4c 3h]
*Player actionjax24 mucks (does not show cards). Bets: 4.70. Collects: 9.88. Wins: 5.18.
Player ShawnFrie does not show cards.Bets: 0. Collects: 0. Wins: 0.
Player VegetablesArentYummy does not show cards.Bets: 0. Collects: 0. Wins: 0.
Player gust does not show cards.Bets: 0. Collects: 0. Wins: 0.
Player Pimpika does not show cards.Bets: 0. Collects: 0. Wins: 0.
Player dbrinker does not show cards.Bets: 4.70. Collects: 0. Loses: 4.70.
Player IlxxxlI does not show cards.Bets: 1. Collects: 0. Loses: 1.
Game ended at: 2016/11/29 13:23:48

Game started
Game ID: 786976321 0.50/1 (PRR) Kraken - 20 (Hold'em)
Seat 4 is the button
Seat 4: WeakAndWeary (102.50).
Seat 6: IlxxxlI (40.50).
Player WeakAndWeary has small blind (0.50)
Player IlxxxlI has big blind (1)
Player IlxxxlI received card: [4d]
Player IlxxxlI received card: [9d]
Player WeakAndWeary raises (1.50)
Player IlxxxlI calls (1)
*** FLOP ***: [5h Qc 4s]
Player IlxxxlI checks
Player WeakAndWeary checks
*** TURN ***: [5h Qc 4s] [Ac]
Player IlxxxlI checks
Player WeakAndWeary checks
*** RIVER ***: [5h Qc 4s Ac] [Kd]
Player IlxxxlI checks
Player WeakAndWeary checks
Player IlxxxlI mucks cards
------ Summary ------
Pot: 3.80. Rake 0.16. JP fee 0.04
Board: [5h Qc 4s Ac Kd]
*Player WeakAndWeary shows: One pair of Qs [3h Qd]. Bets: 2. Collects: 3.80. Wins: 1.80.
Player IlxxxlI mucks (does not show: [4d 9d]). Bets: 2. Collects: 0. Loses: 2.
Game ended at: 2016/11/29 13:24:14

Game started
Game ID: 786976297 1/2 (PRR) Lakhey - 2 (Hold'em)
Seat 1 is the button
Seat 1: KingGuciGuci (200).
Seat 2: IlxxxlI (80).
Seat 3: gust (108.96).
Seat 4: SCking (576.65).
Seat 5: VegetablesArentYummy (200).
Seat 6: Pimpika (176.30).
Player IlxxxlI has small blind (1)
Player gust has big blind (2)
Player IlxxxlI received card: [Jh]
Player IlxxxlI received card: [7s]
Player SCking folds
Player VegetablesArentYummy folds
Player Pimpika raises (5)
Player KingGuciGuci folds
Player IlxxxlI folds
Player gust folds
Uncalled bet (3) returned to Pimpika
Player Pimpika mucks cards
------ Summary ------
Pot: 5. Rake 0
Player KingGuciGuci does not show cards.Bets: 0. Collects: 0. Wins: 0.
Player IlxxxlI does not show cards.Bets: 1. Collects: 0. Loses: 1.
Player gust does not show cards.Bets: 2. Collects: 0. Loses: 2.
Player SCking does not show cards.Bets: 0. Collects: 0. Wins: 0.
Player VegetablesArentYummy does not show cards.Bets: 0. Collects: 0. Wins: 0.
*Player Pimpika mucks (does not show cards). Bets: 2. Collects: 5. Wins: 3.
Game ended at: 2016/11/29 13:23:29

Game started
Game ID: 786976296 0.25/0.50 (PRR) Gorgons - 9 (Hold'em)
Seat 6 is the button
Seat 1: xROCKETMANx (135.96).
Seat 2: Jui Kuen (50).
Seat 3: IlxxxlI (24.19).
Seat 4: foreseen (52.89).
Seat 5: Beep_Beep (50).
Seat 6: violin2 (62.95).
Player xROCKETMANx has small blind (0.25)
Player Jui Kuen has big blind (0.50)
Player IlxxxlI received card: [Kc]
Player IlxxxlI received card: [6d]
Player IlxxxlI folds
Player foreseen raises (1.25)
Player Beep_Beep folds
Player violin2 calls (1.25)
Player xROCKETMANx folds
Player Jui Kuen folds
*** FLOP ***: [4c Jh As]
Player foreseen checks
Player violin2 bets (1.54)
Player foreseen calls (1.54)
*** TURN ***: [4c Jh As] [9h]
Player foreseen checks
Player violin2 bets (3.01)
Player foreseen calls (3.01)
*** RIVER ***: [4c Jh As 9h] [8c]
Player foreseen checks
Player violin2 checks
------ Summary ------
Pot: 11.74. Rake 0.41. JP fee 0.20
Board: [4c Jh As 9h 8c]
Player xROCKETMANx does not show cards.Bets: 0.25. Collects: 0. Loses: 0.25.
Player Jui Kuen does not show cards.Bets: 0.50. Collects: 0. Loses: 0.50.
Player IlxxxlI does not show cards.Bets: 0. Collects: 0. Wins: 0.
*Player foreseen shows: Two pairs. As and 8s [8d Ad]. Bets: 5.80. Collects: 11.74. Wins: 5.94.
Player Beep_Beep does not show cards.Bets: 0. Collects: 0. Wins: 0.
Player violin2 shows: One pair of Js [Jd 10h]. Bets: 5.80. Collects: 0. Loses: 5.80.
Game ended at: 2016/11/29 13:24:45

Game started
Game ID: 786976118 0.25/0.50 (PRR) Gorgons - 9 (Hold'em)
Seat 5 is the button
Seat 1: xROCKETMANx (136.46).
Seat 2: Jui Kuen (50).
Seat 3: IlxxxlI (24.19).
Seat 4: foreseen (52.14).
Seat 5: Beep_Beep (50).
Seat 6: violin2 (63.20).
Player violin2 has small blind (0.25)
Player xROCKETMANx has big blind (0.50)
Player IlxxxlI received card: [Kh]
Player IlxxxlI received card: [6d]
Player Jui Kuen folds
Player IlxxxlI folds
Player foreseen raises (1.25)
Player Beep_Beep folds
Player violin2 folds
Player xROCKETMANx folds
Uncalled bet (0.75) returned to foreseen
Player foreseen mucks cards
------ Summary ------
Pot: 1.25. Rake 0
Player xROCKETMANx does not show cards.Bets: 0.50. Collects: 0. Loses: 0.50.
Player Jui Kuen does not show cards.Bets: 0. Collects: 0. Wins: 0.
Player IlxxxlI does not show cards.Bets: 0. Collects: 0. Wins: 0.
*Player foreseen mucks (does not show cards). Bets: 0.50. Collects: 1.25. Wins: 0.75.
Player Beep_Beep does not show cards.Bets: 0. Collects: 0. Wins: 0.
Player violin2 does not show cards.Bets: 0.25. Collects: 0. Loses: 0.25.
Game ended at: 2016/11/29 13:22:55

Game started
Game ID: 786976071 0.50/1 (PRR) Kraken - 20 (Hold'em)
Seat 1 is the button
Seat 1: MadLifeGrinder (144.24).
Seat 4: WeakAndWeary (103).
Seat 6: IlxxxlI (40).
Player WeakAndWeary has small blind (0.50)
Player IlxxxlI has big blind (1)
Player IlxxxlI received card: [9d]
Player IlxxxlI received card: [Jd]
Player MadLifeGrinder folds
Player WeakAndWeary folds
Uncalled bet (0.50) returned to IlxxxlI
Player IlxxxlI mucks cards
------ Summary ------
Pot: 1. Rake 0
Player MadLifeGrinder does not show cards.Bets: 0. Collects: 0. Wins: 0.
Player WeakAndWeary does not show cards.Bets: 0.50. Collects: 0. Loses: 0.50.
*Player IlxxxlI mucks (does not show cards). Bets: 0.50. Collects: 1. Wins: 0.50.
Game ended at: 2016/11/29 13:22:58

Game started
Game ID: 786976031 0.25/0.50 (PRR) Gorgons - 10 (Hold'em)
Seat 1 is the button
Seat 1: WeakAndWeary (52.99).
Seat 2: foreseen (160.01).
Seat 3: IlxxxlI (20).
Seat 4: Beep_Beep (67.23).
Player foreseen has small blind (0.25)
Player IlxxxlI has big blind (0.50)
Player IlxxxlI received card: [8c]
Player IlxxxlI received card: [6c]
Player Beep_Beep folds
Player WeakAndWeary folds
Player foreseen raises (1.39)
Player IlxxxlI calls (1.14)
*** FLOP ***: [3d 8s 10d]
Player foreseen bets (2.34)
Player IlxxxlI calls (2.34)
*** TURN ***: [3d 8s 10d] [9c]
Player foreseen checks
Player IlxxxlI checks
*** RIVER ***: [3d 8s 10d 9c] [Kh]
Player foreseen checks
Player IlxxxlI checks
Player IlxxxlI mucks cards
------ Summary ------
Pot: 7.57. Rake 0.27. JP fee 0.12
Board: [3d 8s 10d 9c Kh]
Player WeakAndWeary does not show cards.Bets: 0. Collects: 0. Wins: 0.
*Player foreseen shows: One pair of 10s [Ad 10c]. Bets: 3.98. Collects: 7.57. Wins: 3.59.
Player IlxxxlI mucks (does not show: [8c 6c]). Bets: 3.98. Collects: 0. Loses: 3.98.
Player Beep_Beep does not show cards.Bets: 0. Collects: 0. Wins: 0.
Game ended at: 2016/11/29 13:23:41

Game started
Game ID: 786975970 0.50/1 (PRR) Kraken - 22 (Hold'em)
Seat 2 is the button
Seat 2: IlxxxlI (40).
Seat 4: gust (41.28).
Seat 5: MadLifeGrinder (104.50).
Seat 6: WeakAndWeary (275.34).
Player gust has small blind (0.50)
Player MadLifeGrinder has big blind (1)
Player IlxxxlI received card: [2d]
Player IlxxxlI received card: [3d]
Player WeakAndWeary folds
Player IlxxxlI calls (1)
Player gust folds
Player MadLifeGrinder checks
*** FLOP ***: [Js 5c 9c]
Player MadLifeGrinder checks
Player IlxxxlI bets (1.24)
Player MadLifeGrinder folds
Uncalled bet (1.24) returned to IlxxxlI
Player IlxxxlI mucks cards
------ Summary ------
Pot: 2.38. Rake 0.08. JP fee 0.04
Board: [Js 5c 9c]
*Player IlxxxlI mucks (does not show cards). Bets: 1. Collects: 2.38. Wins: 1.38.
Player gust does not show cards.Bets: 0.50. Collects: 0. Loses: 0.50.
Player MadLifeGrinder does not show cards.Bets: 1. Collects: 0. Loses: 1.
Player WeakAndWeary does not show cards.Bets: 0. Collects: 0. Wins: 0.
Game ended at: 2016/11/29 13:23:54

Game started
Game ID: 786975851 0.25/0.50 (PRR) Gorgons - 18 (Hold'em)
Seat 2 is the button
Seat 1: Abundance4All (87.82).
Seat 2: xROCKETMANx (61.22).
Seat 4: IlxxxlI (22.25).
Seat 5: GagaPoker (84.78).
Seat 6: foreseen (53.87).
Player IlxxxlI has small blind (0.25)
Player GagaPoker has big blind (0.50)
Player IlxxxlI received card: [3d]
Player IlxxxlI received card: [Ah]
Player foreseen folds
Player Abundance4All raises (1)
Player xROCKETMANx raises (3.50)
Player IlxxxlI folds
Player GagaPoker folds
Player Abundance4All calls (2.50)
*** FLOP ***: [Ac 8d 7c]
Player Abundance4All checks
Player xROCKETMANx bets (3.68)
Player Abundance4All calls (3.68)
*** TURN ***: [Ac 8d 7c] [6h]
Player Abundance4All checks
Player xROCKETMANx checks
*** RIVER ***: [Ac 8d 7c 6h] [Kd]
Player Abundance4All checks
Player xROCKETMANx bets (16)
Player Abundance4All folds
Uncalled bet (16) returned to xROCKETMANx
Player xROCKETMANx mucks cards
------ Summary ------
Pot: 14.36. Rake 0.51. JP fee 0.24
Board: [Ac 8d 7c 6h Kd]
Player Abundance4All does not show cards.Bets: 7.18. Collects: 0. Loses: 7.18.
*Player xROCKETMANx mucks (does not show cards). Bets: 7.18. Collects: 14.36. Wins: 7.18.
Player IlxxxlI does not show cards.Bets: 0.25. Collects: 0. Loses: 0.25.
Player GagaPoker does not show cards.Bets: 0.50. Collects: 0. Loses: 0.50.
Player foreseen does not show cards.Bets: 0. Collects: 0. Wins: 0.
Game ended at: 2016/11/29 13:23:45

Game started
Game ID: 786975775 0.50/1 (PRR) Kraken (Hold'em)
Seat 2 is the button
Seat 1: WeakAndWeary (112.16).
Seat 2: MadLifeGrinder (100).
Seat 3: Sephiroth1 (106.39).
Seat 4: LloydXmas (169.83).
Seat 5: Im Don King (113.33).
Seat 6: IlxxxlI (60.13).
Player Sephiroth1 has small blind (0.50)
Player LloydXmas has big blind (1)
Player IlxxxlI received card: [5d]
Player IlxxxlI received card: [3h]
Player Im Don King folds
Player IlxxxlI folds
Player WeakAndWeary folds
Player MadLifeGrinder raises (2.50)
Player Sephiroth1 folds
Player LloydXmas calls (1.50)
*** FLOP ***: [6d 5h Qs]
Player LloydXmas checks
Player MadLifeGrinder checks
*** TURN ***: [6d 5h Qs] [9c]
Player LloydXmas bets (3.92)
Player MadLifeGrinder calls (3.92)
*** RIVER ***: [6d 5h Qs 9c] [3c]
Player LloydXmas checks
Player MadLifeGrinder checks
Player MadLifeGrinder mucks cards
------ Summary ------
Pot: 12.68. Rake 0.44. JP fee 0.22
Board: [6d 5h Qs 9c 3c]
Player WeakAndWeary does not show cards.Bets: 0. Collects: 0. Wins: 0.
Player MadLifeGrinder mucks (does not show cards). Bets: 6.42. Collects: 0. Loses: 6.42.
Player Sephiroth1 does not show cards.Bets: 0.50. Collects: 0. Loses: 0.50.
*Player LloydXmas shows: High card A [Ah 8h]. Bets: 6.42. Collects: 12.68. Wins: 6.26.
Player Im Don King does not show cards.Bets: 0. Collects: 0. Wins: 0.
Player IlxxxlI does not show cards.Bets: 0. Collects: 0. Wins: 0.
Game ended at: 2016/11/29 13:24:19

Game started
Game ID: 786975727 0.25/0.50 (PRR) Gorgons - 10 (Hold'em)
Seat 4 is the button
Seat 1: WeakAndWeary (53.24).
Seat 2: foreseen (159.76).
Seat 3: IlxxxlI (20).
Seat 4: Beep_Beep (67.23).
Player WeakAndWeary has small blind (0.25)
Player foreseen has big blind (0.50)
Player IlxxxlI received card: [2d]
Player IlxxxlI received card: [Ah]
Player IlxxxlI folds
Player Beep_Beep folds
Player WeakAndWeary folds
Uncalled bet (0.25) returned to foreseen
Player foreseen mucks cards
------ Summary ------
Pot: 0.50. Rake 0
Player WeakAndWeary does not show cards.Bets: 0.25. Collects: 0. Loses: 0.25.
*Player foreseen mucks (does not show cards). Bets: 0.25. Collects: 0.50. Wins: 0.25.
Player IlxxxlI does not show cards.Bets: 0. Collects: 0. Wins: 0.
Player Beep_Beep does not show cards.Bets: 0. Collects: 0. Wins: 0.
Game ended at: 2016/11/29 13:22:29

Game started
Game ID: 786975711 0.25/0.50 (PRR) Gorgons - 18 (Hold'em)
Seat 1 is the button
Seat 1: Abundance4All (87.82).
Seat 2: xROCKETMANx (61.47).
Seat 4: IlxxxlI (22).
Seat 5: GagaPoker (84.78).
Seat 6: foreseen (53.87).
Player xROCKETMANx has small blind (0.25)
Player IlxxxlI has big blind (0.50)
Player IlxxxlI received card: [Qd]
Player IlxxxlI received card: [3s]
Player GagaPoker folds
Player foreseen folds
Player Abundance4All folds
Player xROCKETMANx folds
Uncalled bet (0.25) returned to IlxxxlI
Player IlxxxlI mucks cards
------ Summary ------
Pot: 0.50. Rake 0
Player Abundance4All does not show cards.Bets: 0. Collects: 0. Wins: 0.
Player xROCKETMANx does not show cards.Bets: 0.25. Collects: 0. Loses: 0.25.
*Player IlxxxlI mucks (does not show cards). Bets: 0.25. Collects: 0.50. Wins: 0.25.
Player GagaPoker does not show cards.Bets: 0. Collects: 0. Wins: 0.
Player foreseen does not show cards.Bets: 0. Collects: 0. Wins: 0.
Game ended at: 2016/11/29 13:22:9

Game started
Game ID: 786975670 1/2 (PRR) Lakhey - 2 (Hold'em)
Seat 6 is the button
Seat 1: KingGuciGuci (200).
Seat 2: IlxxxlI (80).
Seat 3: gust (108.96).
Seat 4: SCking (568.50).
Seat 5: VegetablesArentYummy (200).
Seat 6: Pimpika (176.30).
Player KingGuciGuci has small blind (1)
Player IlxxxlI has big blind (2)
Player IlxxxlI received card: [Js]
Player IlxxxlI received card: [Kh]
Player gust folds
Player SCking raises (8)
Player VegetablesArentYummy folds
Player Pimpika folds
Player KingGuciGuci folds
Player IlxxxlI calls (6)
*** FLOP ***: [4s 2s 2h]
Player IlxxxlI checks
Player SCking bets (14)
Player IlxxxlI folds
Uncalled bet (14) returned to SCking
Player SCking mucks cards
------ Summary ------
Pot: 16.15. Rake 0.61. JP fee 0.24
Board: [4s 2s 2h]
Player KingGuciGuci does not show cards.Bets: 1. Collects: 0. Loses: 1.
Player IlxxxlI does not show cards.Bets: 8. Collects: 0. Loses: 8.
Player gust does not show cards.Bets: 0. Collects: 0. Wins: 0.
*Player SCking mucks (does not show cards). Bets: 8. Collects: 16.15. Wins: 8.15.
Player VegetablesArentYummy does not show cards.Bets: 0. Collects: 0. Wins: 0.
Player Pimpika does not show cards.Bets: 0. Collects: 0. Wins: 0.
Game ended at: 2016/11/29 13:22:56

Game started
Game ID: 786975517 0.25/0.50 (PRR) Gorgons - 9 (Hold'em)
Seat 4 is the button
Seat 2: Jui Kuen (50).
Seat 3: IlxxxlI (24.19).
Seat 4: foreseen (50).
Seat 5: Beep_Beep (50).
Seat 6: violin2 (65.31).
Player Beep_Beep has small blind (0.25)
Player violin2 has big blind (0.50)
Player IlxxxlI received card: [8c]
Player IlxxxlI received card: [Qs]
Player Jui Kuen folds
Player IlxxxlI folds
Player foreseen raises (1.25)
Player Beep_Beep folds
Player violin2 calls (0.75)
*** FLOP ***: [7d 7s 7h]
Player violin2 checks
Player foreseen bets (0.86)
Player violin2 calls (0.86)
*** TURN ***: [7d 7s 7h] [6s]
Player violin2 checks
Player foreseen bets (3.49)
Player violin2 folds
Uncalled bet (3.49) returned to foreseen
Player foreseen mucks cards
------ Summary ------
Pot: 4.25. Rake 0.16. JP fee 0.06
Board: [7d 7s 7h 6s]
Player Jui Kuen does not show cards.Bets: 0. Collects: 0. Wins: 0.
Player IlxxxlI does not show cards.Bets: 0. Collects: 0. Wins: 0.
*Player foreseen mucks (does not show cards). Bets: 2.11. Collects: 4.25. Wins: 2.14.
Player Beep_Beep does not show cards.Bets: 0.25. Collects: 0. Loses: 0.25.
Player violin2 does not show cards.Bets: 2.11. Collects: 0. Loses: 2.11.
Game ended at: 2016/11/29 13:22:37

Game started
Game ID: 786975458 0.25/0.50 (PRR) Gorgons - 18 (Hold'em)
Seat 6 is the button
Seat 1: Abundance4All (88.07).
Seat 2: xROCKETMANx (61.97).
Seat 4: IlxxxlI (21.25).
Seat 5: GagaPoker (84.78).
Seat 6: foreseen (53.87).
Player Abundance4All has small blind (0.25)
Player xROCKETMANx has big blind (0.50)
Player IlxxxlI received card: [Ad]
Player IlxxxlI received card: [Ks]
Player IlxxxlI raises (1.75)
Player GagaPoker folds
Player foreseen folds
Player Abundance4All folds
Player xROCKETMANx folds
Uncalled bet (1.25) returned to IlxxxlI
Player IlxxxlI mucks cards
------ Summary ------
Pot: 1.25. Rake 0
Player Abundance4All does not show cards.Bets: 0.25. Collects: 0. Loses: 0.25.
Player xROCKETMANx does not show cards.Bets: 0.50. Collects: 0. Loses: 0.50.
*Player IlxxxlI mucks (does not show cards). Bets: 0.50. Collects: 1.25. Wins: 0.75.
Player GagaPoker does not show cards.Bets: 0. Collects: 0. Wins: 0.
Player foreseen does not show cards.Bets: 0. Collects: 0. Wins: 0.
Game ended at: 2016/11/29 13:21:53

Game started
Game ID: 786975433 1/2 (PRR) Longana (Short) - 2 (Hold'em)
Seat 6 is the button
Seat 1: actionjax24 (125.20).
Seat 2: ShawnFrie (96).
Seat 3: VegetablesArentYummy (100).
Seat 4: gust (80).
Seat 6: Pimpika (80).
Seat 7: dbrinker (401.33).
Seat 8: IlxxxlI (40).
Seat 9: SuperMarioFold (184.46).
Player dbrinker has small blind (1)
Player IlxxxlI has big blind (2)
Player IlxxxlI received card: [9s]
Player IlxxxlI received card: [5s]
Player SuperMarioFold folds
Player actionjax24 folds
Player ShawnFrie folds
Player VegetablesArentYummy folds
Player gust folds
Player Pimpika raises (4)
Player dbrinker raises (11.79)
Player IlxxxlI folds
Player Pimpika calls (8.79)
*** FLOP ***: [6h 4s Ks]
Player dbrinker bets (11.25)
Player Pimpika raises (24)
Player dbrinker folds
Uncalled bet (12.75) returned to Pimpika
Player Pimpika mucks cards
------ Summary ------
Pot: 47.58. Rake 2.26. JP fee 0.24
Board: [6h 4s Ks]
Player actionjax24 does not show cards.Bets: 0. Collects: 0. Wins: 0.
Player ShawnFrie does not show cards.Bets: 0. Collects: 0. Wins: 0.
Player VegetablesArentYummy does not show cards.Bets: 0. Collects: 0. Wins: 0.
Player gust does not show cards.Bets: 0. Collects: 0. Wins: 0.
*Player Pimpika mucks (does not show cards). Bets: 24.04. Collects: 47.58. Wins: 23.54.
Player dbrinker does not show cards.Bets: 24.04. Collects: 0. Loses: 24.04.
Player IlxxxlI does not show cards.Bets: 2. Collects: 0. Loses: 2.
Player SuperMarioFold does not show cards.Bets: 0. Collects: 0. Wins: 0.
Game ended at: 2016/11/29 13:23:5

Game started
Game ID: 786975418 0.50/1 (PRR) Kraken (Hold'em)
Seat 1 is the button
Seat 1: WeakAndWeary (112.16).
Seat 2: MadLifeGrinder (100).
Seat 3: Sephiroth1 (107.39).
Seat 4: LloydXmas (169.83).
Seat 5: Im Don King (111.83).
Seat 6: IlxxxlI (60.13).
Player MadLifeGrinder has small blind (0.50)
Player Sephiroth1 has big blind (1)
Player IlxxxlI received card: [8h]
Player IlxxxlI received card: [5h]
Player LloydXmas folds
Player Im Don King raises (2.35)
Player IlxxxlI folds
Player WeakAndWeary folds
Player MadLifeGrinder folds
Player Sephiroth1 folds
Uncalled bet (1.35) returned to Im Don King
Player Im Don King mucks cards
------ Summary ------
Pot: 2.50. Rake 0
Player WeakAndWeary does not show cards.Bets: 0. Collects: 0. Wins: 0.
Player MadLifeGrinder does not show cards.Bets: 0.50. Collects: 0. Loses: 0.50.
Player Sephiroth1 does not show cards.Bets: 1. Collects: 0. Loses: 1.
Player LloydXmas does not show cards.Bets: 0. Collects: 0. Wins: 0.
*Player Im Don King mucks (does not show cards). Bets: 1. Collects: 2.50. Wins: 1.50.
Player IlxxxlI does not show cards.Bets: 0. Collects: 0. Wins: 0.
Game ended at: 2016/11/29 13:22:0

Game started
Game ID: 786975095 0.50/1 (PRR) Kraken - 22 (Hold'em)
Seat 6 is the button
Seat 2: IlxxxlI (40).
Seat 3: Beep_Beep (228.88).
Seat 4: gust (42.28).
Seat 5: MadLifeGrinder (104.50).
Seat 6: WeakAndWeary (263.42).
Player IlxxxlI has small blind (0.50)
Player Beep_Beep sitting out
Player gust has big blind (1)
Player IlxxxlI received card: [Qc]
Player IlxxxlI received card: [Ks]
Player MadLifeGrinder folds
Player WeakAndWeary raises (3)
Player IlxxxlI raises (5.50)
Player gust folds
Player WeakAndWeary calls (3)
*** FLOP ***: [Ah Qh 5s]
Player IlxxxlI checks
Player WeakAndWeary bets (6.18)
Player IlxxxlI calls (6.18)
*** TURN ***: [Ah Qh 5s] [Jc]
Player IlxxxlI checks
Player WeakAndWeary bets (16.07)
Player IlxxxlI folds
Uncalled bet (16.07) returned to WeakAndWeary
Player WeakAndWeary mucks cards
------ Summary ------
Pot: 24.10. Rake 1.02. JP fee 0.24
Board: [Ah Qh 5s Jc]
Player IlxxxlI does not show cards.Bets: 12.18. Collects: 0. Loses: 12.18.
Player Beep_Beep does not show cards.Bets: 0. Collects: 0. Wins: 0.
Player gust does not show cards.Bets: 1. Collects: 0. Loses: 1.
Player MadLifeGrinder does not show cards.Bets: 0. Collects: 0. Wins: 0.
*Player WeakAndWeary mucks (does not show cards). Bets: 12.18. Collects: 24.10. Wins: 11.92.
Game ended at: 2016/11/29 13:22:21

Game started
Game ID: 786975050 0.25/0.50 (PRR) Gorgons - 18 (Hold'em)
Seat 5 is the button
Seat 1: Abundance4All (88.57).
Seat 4: IlxxxlI (20.50).
Seat 5: GagaPoker (84.78).
Seat 6: foreseen (54.12).
Player foreseen has small blind (0.25)
Player Abundance4All has big blind (0.50)
Player IlxxxlI received card: [5s]
Player IlxxxlI received card: [5d]
Player IlxxxlI raises (1.20)
Player GagaPoker folds
Player foreseen folds
Player Abundance4All folds
Uncalled bet (0.70) returned to IlxxxlI
Player IlxxxlI mucks cards
------ Summary ------
Pot: 1.25. Rake 0
Player Abundance4All does not show cards.Bets: 0.50. Collects: 0. Loses: 0.50.
*Player IlxxxlI mucks (does not show cards). Bets: 0.50. Collects: 1.25. Wins: 0.75.
Player GagaPoker does not show cards.Bets: 0. Collects: 0. Wins: 0.
Player foreseen does not show cards.Bets: 0.25. Collects: 0. Loses: 0.25.
Game ended at: 2016/11/29 13:21:26

Game started
Game ID: 786974856 0.25/0.50 (PRR) Gorgons - 9 (Hold'em)
Seat 3 is the button
Seat 2: Jui Kuen (50.75).
Seat 3: IlxxxlI (24.19).
Seat 4: foreseen (50).
Seat 5: Beep_Beep (50).
Seat 6: violin2 (61.64).
Player foreseen has small blind (0.25)
Player Beep_Beep has big blind (0.50)
Player IlxxxlI received card: [7h]
Player IlxxxlI received card: [Jh]
Player violin2 raises (1)
Player Jui Kuen raises (1.50)
Player IlxxxlI folds
Player foreseen folds
Player Beep_Beep folds
Player violin2 calls (0.50)
*** FLOP ***: [7c 4c 9c]
Player violin2 checks
Player Jui Kuen checks
*** TURN ***: [7c 4c 9c] [Kh]
Player violin2 checks
Player Jui Kuen bets (1.78)
Player violin2 calls (1.78)
*** RIVER ***: [7c 4c 9c Kh] [Js]
Player violin2 checks
Player Jui Kuen checks
------ Summary ------
Pot: 6.95. Rake 0.24. JP fee 0.12
Board: [7c 4c 9c Kh Js]
Player Jui Kuen shows: One pair of 7s [As 7s]. Bets: 3.28. Collects: 0. Loses: 3.28.
Player IlxxxlI does not show cards.Bets: 0. Collects: 0. Wins: 0.
Player foreseen does not show cards.Bets: 0.25. Collects: 0. Loses: 0.25.
Player Beep_Beep does not show cards.Bets: 0.50. Collects: 0. Loses: 0.50.
*Player violin2 shows: One pair of Js [Jc Qh]. Bets: 3.28. Collects: 6.95. Wins: 3.67.
Game ended at: 2016/11/29 13:21:31

Game started
Game ID: 786974728 0.50/1 (PRR) Kraken - 22 (Hold'em)
Seat 5 is the button
Seat 2: IlxxxlI (40).
Seat 3: Beep_Beep (228.88).
Seat 4: gust (42.28).
Seat 5: MadLifeGrinder (103).
Seat 6: WeakAndWeary (263.92).
Player WeakAndWeary has small blind (0.50)
Player IlxxxlI has big blind (1)
Player IlxxxlI received card: [Kc]
Player IlxxxlI received card: [8h]
Player Beep_Beep folds
Player gust folds
Player MadLifeGrinder raises (2.50)
Player WeakAndWeary folds
Player IlxxxlI folds
Uncalled bet (1.50) returned to MadLifeGrinder
Player MadLifeGrinder mucks cards
------ Summary ------
Pot: 2.50. Rake 0
Player IlxxxlI does not show cards.Bets: 1. Collects: 0. Loses: 1.
Player Beep_Beep does not show cards.Bets: 0. Collects: 0. Wins: 0.
Player gust does not show cards.Bets: 0. Collects: 0. Wins: 0.
*Player MadLifeGrinder mucks (does not show cards). Bets: 1. Collects: 2.50. Wins: 1.50.
Player WeakAndWeary does not show cards.Bets: 0.50. Collects: 0. Loses: 0.50.
Game ended at: 2016/11/29 13:20:48

Game started
Game ID: 786974570 0.50/1 (PRR) Kraken - 22 (Hold'em)
Seat 4 is the button
Seat 2: IlxxxlI (40).
Seat 3: Beep_Beep (228.88).
Seat 4: gust (42.28).
Seat 5: MadLifeGrinder (103.50).
Seat 6: WeakAndWeary (263.42).
Player MadLifeGrinder has small blind (0.50)
Player WeakAndWeary has big blind (1)
Player IlxxxlI received card: [3d]
Player IlxxxlI received card: [Js]
Player IlxxxlI folds
Player Beep_Beep folds
Player gust folds
Player MadLifeGrinder folds
Uncalled bet (0.50) returned to WeakAndWeary
Player WeakAndWeary mucks cards
------ Summary ------
Pot: 1. Rake 0
Player IlxxxlI does not show cards.Bets: 0. Collects: 0. Wins: 0.
Player Beep_Beep does not show cards.Bets: 0. Collects: 0. Wins: 0.
Player gust does not show cards.Bets: 0. Collects: 0. Wins: 0.
Player MadLifeGrinder does not show cards.Bets: 0.50. Collects: 0. Loses: 0.50.
*Player WeakAndWeary mucks (does not show cards). Bets: 0.50. Collects: 1. Wins: 0.50.
Game ended at: 2016/11/29 13:20:10

Game started
Game ID: 786974567 0.25/0.50 (PRR) Gorgons - 9 (Hold'em)
Seat 2 is the button
Seat 2: Jui Kuen (50).
Seat 3: IlxxxlI (24.44).
Seat 4: foreseen (50).
Seat 5: Beep_Beep (50).
Seat 6: violin2 (61.64).
Player IlxxxlI has small blind (0.25)
Player foreseen has big blind (0.50)
Player IlxxxlI received card: [Qh]
Player IlxxxlI received card: [5h]
Player Beep_Beep folds
Player violin2 folds
Player Jui Kuen raises (1)
Player IlxxxlI folds
Player foreseen folds
Uncalled bet (0.50) returned to Jui Kuen
Player Jui Kuen mucks cards
------ Summary ------
Pot: 1.25. Rake 0
*Player Jui Kuen mucks (does not show cards). Bets: 0.50. Collects: 1.25. Wins: 0.75.
Player IlxxxlI does not show cards.Bets: 0.25. Collects: 0. Loses: 0.25.
Player foreseen does not show cards.Bets: 0.50. Collects: 0. Loses: 0.50.
Player Beep_Beep does not show cards.Bets: 0. Collects: 0. Wins: 0.
Player violin2 does not show cards.Bets: 0. Collects: 0. Wins: 0.
Game ended at: 2016/11/29 13:20:25

Game started
Game ID: 786974350 0.50/1 (PRR) Kraken (Hold'em)
Seat 6 is the button
Seat 1: WeakAndWeary (123.16).
Seat 2: MadLifeGrinder (100).
Seat 3: Sephiroth1 (107.39).
Seat 4: LloydXmas (169.83).
Seat 5: Im Don King (111.83).
Seat 6: IlxxxlI (49.28).
Player WeakAndWeary has small blind (0.50)
Player MadLifeGrinder has big blind (1)
Player IlxxxlI received card: [Jh]
Player IlxxxlI received card: [As]
Player Sephiroth1 folds
Player LloydXmas folds
Player Im Don King folds
Player IlxxxlI raises (3)
Player WeakAndWeary raises (10.50)
Player MadLifeGrinder folds
Player IlxxxlI calls (8)
*** FLOP ***: [Js 7d Kc]
Player WeakAndWeary checks
Player IlxxxlI checks
*** TURN ***: [Js 7d Kc] [7h]
Player WeakAndWeary checks
Player IlxxxlI checks
*** RIVER ***: [Js 7d Kc 7h] [8d]
Player WeakAndWeary checks
Player IlxxxlI bets (9)
Player WeakAndWeary folds
Uncalled bet (9) returned to IlxxxlI
Player IlxxxlI mucks cards
------ Summary ------
Pot: 21.85. Rake 0.91. JP fee 0.24
Board: [Js 7d Kc 7h 8d]
Player WeakAndWeary does not show cards.Bets: 11. Collects: 0. Loses: 11.
Player MadLifeGrinder does not show cards.Bets: 1. Collects: 0. Loses: 1.
Player Sephiroth1 does not show cards.Bets: 0. Collects: 0. Wins: 0.
Player LloydXmas does not show cards.Bets: 0. Collects: 0. Wins: 0.
Player Im Don King does not show cards.Bets: 0. Collects: 0. Wins: 0.
*Player IlxxxlI mucks (does not show cards). Bets: 11. Collects: 21.85. Wins: 10.85.
Game ended at: 2016/11/29 13:21:24

Game started
Game ID: 786974310 0.25/0.50 (PRR) Gorgons - 10 (Hold'em)
Seat 3 is the button
Seat 1: WeakAndWeary (50).
Seat 2: foreseen (159.76).
Seat 3: IlxxxlI (20).
Seat 4: Beep_Beep (68.98).
Player Beep_Beep has small blind (0.25)
Player WeakAndWeary has big blind (0.50)
Player IlxxxlI received card: [5c]
Player IlxxxlI received card: [7c]
Player foreseen folds
Player IlxxxlI calls (0.50)
Player Beep_Beep calls (0.25)
Player WeakAndWeary raises (1.25)
Player IlxxxlI calls (1.25)
Player Beep_Beep calls (1.25)
*** FLOP ***: [5s Ks 8d]
Player Beep_Beep checks
Player WeakAndWeary checks
Player IlxxxlI checks
*** TURN ***: [5s Ks 8d] [8h]
Player Beep_Beep checks
Player WeakAndWeary checks
Player IlxxxlI checks
*** RIVER ***: [5s Ks 8d 8h] [Ad]
Player Beep_Beep checks
Player WeakAndWeary checks
Player IlxxxlI checks
Player Beep_Beep mucks cards
Player IlxxxlI mucks cards
------ Summary ------
Pot: 4.99. Rake 0.18. JP fee 0.08
Board: [5s Ks 8d 8h Ad]
*Player WeakAndWeary shows: Two pairs. As and 8s [Ah Qh]. Bets: 1.75. Collects: 4.99. Wins: 3.24.
Player foreseen does not show cards.Bets: 0. Collects: 0. Wins: 0.
Player IlxxxlI mucks (does not show: [5c 7c]). Bets: 1.75. Collects: 0. Loses: 1.75.
Player Beep_Beep mucks (does not show cards). Bets: 1.75. Collects: 0. Loses: 1.75.
Game ended at: 2016/11/29 13:21:53

Game started
Game ID: 786974215 0.50/1 (PRR) Kraken - 22 (Hold'em)
Seat 3 is the button
Seat 2: IlxxxlI (40).
Seat 3: Beep_Beep (228.88).
Seat 4: gust (42.78).
Seat 5: MadLifeGrinder (103).
Seat 6: WeakAndWeary (263.42).
Player gust has small blind (0.50)
Player MadLifeGrinder has big blind (1)
Player IlxxxlI received card: [6s]
Player IlxxxlI received card: [2h]
Player WeakAndWeary folds
Player IlxxxlI folds
Player Beep_Beep folds
Player gust folds
Uncalled bet (0.50) returned to MadLifeGrinder
Player MadLifeGrinder mucks cards
------ Summary ------
Pot: 1. Rake 0
Player IlxxxlI does not show cards.Bets: 0. Collects: 0. Wins: 0.
Player Beep_Beep does not show cards.Bets: 0. Collects: 0. Wins: 0.
Player gust does not show cards.Bets: 0.50. Collects: 0. Loses: 0.50.
*Player MadLifeGrinder mucks (does not show cards). Bets: 0.50. Collects: 1. Wins: 0.50.
Player WeakAndWeary does not show cards.Bets: 0. Collects: 0. Wins: 0.
Game ended at: 2016/11/29 13:19:53

Game started
Game ID: 786973904 0.25/0.50 (PRR) Gorgons - 18 (Hold'em)
Seat 4 is the button
Seat 1: Abundance4All (88.57).
Seat 4: IlxxxlI (20.50).
Seat 5: GagaPoker (70.96).
Seat 6: foreseen (69.47).
Player GagaPoker has small blind (0.25)
Player foreseen has big blind (0.50)
Player IlxxxlI received card: [9h]
Player IlxxxlI received card: [6s]
Player Abundance4All folds
Player IlxxxlI folds
Player GagaPoker raises (1.25)
Player foreseen calls (1)
*** FLOP ***: [8h 5c 6h]
Player GagaPoker bets (0.95)
Player foreseen raises (4.35)
Player GagaPoker calls (3.40)
*** TURN ***: [8h 5c 6h] [7h]
Player GagaPoker checks
Player foreseen checks
*** RIVER ***: [8h 5c 6h 7h] [10h]
Player GagaPoker bets (9.50)
Player foreseen calls (9.50)
Player foreseen mucks cards
------ Summary ------
Pot: 29.17. Rake 1.29. JP fee 0.24
Board: [8h 5c 6h 7h 10h]
Player Abundance4All does not show cards.Bets: 0. Collects: 0. Wins: 0.
Player IlxxxlI does not show cards.Bets: 0. Collects: 0. Wins: 0.
*Player GagaPoker shows: Flush, K high [Kd Kh]. Bets: 15.35. Collects: 29.17. Wins: 13.82.
Player foreseen mucks (does not show cards). Bets: 15.35. Collects: 0. Loses: 15.35.
Game ended at: 2016/11/29 13:20:41

Game started
Game ID: 786973817 0.50/1 (PRR) Kraken - 22 (Hold'em)
Seat 2 is the button
Seat 2: IlxxxlI (40).
Seat 3: Beep_Beep (229.38).
Seat 4: gust (42.28).
Seat 5: MadLifeGrinder (103).
Seat 6: WeakAndWeary (263.42).
Player Beep_Beep has small blind (0.50)
Player gust has big blind (1)
Player IlxxxlI received card: [Jc]
Player IlxxxlI received card: [2d]
Player MadLifeGrinder folds
Player WeakAndWeary folds
Player IlxxxlI folds
Player Beep_Beep folds
Uncalled bet (0.50) returned to gust
Player gust mucks cards
------ Summary ------
Pot: 1. Rake 0
Player IlxxxlI does not show cards.Bets: 0. Collects: 0. Wins: 0.
Player Beep_Beep does not show cards.Bets: 0.50. Collects: 0. Loses: 0.50.
*Player gust mucks (does not show cards). Bets: 0.50. Collects: 1. Wins: 0.50.
Player MadLifeGrinder does not show cards.Bets: 0. Collects: 0. Wins: 0.
Player WeakAndWeary does not show cards.Bets: 0. Collects: 0. Wins: 0.
Game ended at: 2016/11/29 13:19:18

Game started
Game ID: 786973813 0.50/1 (PRR) Kraken (Hold'em)
Seat 5 is the button
Seat 1: WeakAndWeary (125.66).
Seat 2: MadLifeGrinder (100).
Seat 3: Sephiroth1 (107.39).
Seat 4: LloydXmas (169.83).
Seat 5: Im Don King (111.83).
Seat 6: IlxxxlI (47.03).
Player IlxxxlI has small blind (0.50)
Player WeakAndWeary has big blind (1)
Player IlxxxlI received card: [10d]
Player IlxxxlI received card: [Kd]
Player MadLifeGrinder folds
Player Sephiroth1 folds
Player LloydXmas folds
Player Im Don King folds
Player IlxxxlI raises (2)
Player WeakAndWeary calls (1.50)
*** FLOP ***: [6s Qd 6h]
Player IlxxxlI bets (2.47)
Player WeakAndWeary folds
Uncalled bet (2.47) returned to IlxxxlI
Player IlxxxlI mucks cards
------ Summary ------
Pot: 4.75. Rake 0.17. JP fee 0.08
Board: [6s Qd 6h]
Player WeakAndWeary does not show cards.Bets: 2.50. Collects: 0. Loses: 2.50.
Player MadLifeGrinder does not show cards.Bets: 0. Collects: 0. Wins: 0.
Player Sephiroth1 does not show cards.Bets: 0. Collects: 0. Wins: 0.
Player LloydXmas does not show cards.Bets: 0. Collects: 0. Wins: 0.
Player Im Don King does not show cards.Bets: 0. Collects: 0. Wins: 0.
*Player IlxxxlI mucks (does not show cards). Bets: 2.50. Collects: 4.75. Wins: 2.25.
Game ended at: 2016/11/29 13:19:31

Game started
Game ID: 786973816 0.25/0.50 (PRR) Gorgons - 19 (Hold'em)
Seat 3 is the button
Seat 1: MirrorZrorriM (65.95).
Seat 2: IlxxxlI (38.48).
Seat 3: Hakuna_Matata777 (50).
Seat 4: FLDnLIVE2FLDagn (52.55).
Seat 5: foreseen (50).
Seat 6: QDevilQ (84.85).
Player FLDnLIVE2FLDagn has small blind (0.25)
Player foreseen has big blind (0.50)
Player IlxxxlI received card: [7h]
Player IlxxxlI received card: [6s]
Player QDevilQ folds
Player MirrorZrorriM raises (1.50)
Player IlxxxlI folds
Player Hakuna_Matata777 folds
Player FLDnLIVE2FLDagn raises (4.25)
Player foreseen folds
Player MirrorZrorriM folds
Uncalled bet (3) returned to FLDnLIVE2FLDagn
Player FLDnLIVE2FLDagn mucks cards
------ Summary ------
Pot: 3.50. Rake 0
Player MirrorZrorriM does not show cards.Bets: 1.50. Collects: 0. Loses: 1.50.
Player IlxxxlI does not show cards.Bets: 0. Collects: 0. Wins: 0.
Player Hakuna_Matata777 does not show cards.Bets: 0. Collects: 0. Wins: 0.
*Player FLDnLIVE2FLDagn mucks (does not show cards). Bets: 1.50. Collects: 3.50. Wins: 2.
Player foreseen does not show cards.Bets: 0.50. Collects: 0. Loses: 0.50.
Player QDevilQ does not show cards.Bets: 0. Collects: 0. Wins: 0.
Game ended at: 2016/11/29 13:19:11

Game started
Game ID: 786973596 0.25/0.50 (PRR) Gorgons - 10 (Hold'em)
Seat 2 is the button
Seat 1: WeakAndWeary (50).
Seat 2: foreseen (159.76).
Seat 3: IlxxxlI (20).
Seat 4: Beep_Beep (56.73).
Player IlxxxlI has small blind (0.25)
Player Beep_Beep has big blind (0.50)
Player IlxxxlI received card: [9h]
Player IlxxxlI received card: [8h]
Player WeakAndWeary raises (1.50)
Player foreseen folds
Player IlxxxlI folds
Player Beep_Beep raises (4.50)
Player WeakAndWeary raises (10.50)
Player Beep_Beep allin (51.73)
Player WeakAndWeary folds
Uncalled bet (44.73) returned to Beep_Beep
Player Beep_Beep mucks cards
------ Summary ------
Pot: 24.25. Rake 0
Player WeakAndWeary does not show cards.Bets: 12. Collects: 0. Loses: 12.
Player foreseen does not show cards.Bets: 0. Collects: 0. Wins: 0.
Player IlxxxlI does not show cards.Bets: 0.25. Collects: 0. Loses: 0.25.
*Player Beep_Beep mucks (does not show cards). Bets: 12. Collects: 24.25. Wins: 12.25.
Game ended at: 2016/11/29 13:19:27

Game started
Game ID: 786973588 0.50/1 (PRR) Kraken - 22 (Hold'em)
Seat 6 is the button
Seat 2: IlxxxlI (40).
Seat 3: Beep_Beep (228.88).
Seat 4: gust (42.28).
Seat 5: MadLifeGrinder (103).
Seat 6: WeakAndWeary (263.42).
Player IlxxxlI has small blind (0.50)
Player Beep_Beep has big blind (1)
Player IlxxxlI received card: [3d]
Player IlxxxlI received card: [9s]
Player gust folds
Player MadLifeGrinder folds
Player WeakAndWeary folds
Player IlxxxlI folds
Uncalled bet (0.50) returned to Beep_Beep
Player Beep_Beep mucks cards
------ Summary ------
Pot: 1. Rake 0
Player IlxxxlI does not show cards.Bets: 0.50. Collects: 0. Loses: 0.50.
*Player Beep_Beep mucks (does not show cards). Bets: 0.50. Collects: 1. Wins: 0.50.
Player gust does not show cards.Bets: 0. Collects: 0. Wins: 0.
Player MadLifeGrinder does not show cards.Bets: 0. Collects: 0. Wins: 0.
Player WeakAndWeary does not show cards.Bets: 0. Collects: 0. Wins: 0.
Game ended at: 2016/11/29 13:18:36

Game started
Game ID: 786973578 0.25/0.50 (PRR) Gorgons - 18 (Hold'em)
Seat 1 is the button
Seat 1: Abundance4All (88.57).
Seat 4: IlxxxlI (20).
Seat 5: GagaPoker (71.46).
Seat 6: foreseen (69.47).
Player IlxxxlI has small blind (0.25)
Player GagaPoker has big blind (0.50)
Player IlxxxlI received card: [Ah]
Player IlxxxlI received card: [Qh]
Player foreseen folds
Player Abundance4All folds
Player IlxxxlI raises (1)
Player GagaPoker folds
Uncalled bet (0.75) returned to IlxxxlI
Player IlxxxlI mucks cards
------ Summary ------
Pot: 1. Rake 0
Player Abundance4All does not show cards.Bets: 0. Collects: 0. Wins: 0.
*Player IlxxxlI mucks (does not show cards). Bets: 0.50. Collects: 1. Wins: 0.50.
Player GagaPoker does not show cards.Bets: 0.50. Collects: 0. Loses: 0.50.
Player foreseen does not show cards.Bets: 0. Collects: 0. Wins: 0.
Game ended at: 2016/11/29 13:18:46

Game started
Game ID: 786973503 0.25/0.50 (PRR) Gorgons - 9 (Hold'em)
Seat 6 is the button
Seat 2: Jui Kuen (50).
Seat 3: IlxxxlI (20).
Seat 4: foreseen (51.37).
Seat 5: Beep_Beep (50).
Seat 6: violin2 (62.89).
Player Jui Kuen has small blind (0.25)
Player IlxxxlI has big blind (0.50)
Player IlxxxlI received card: [8d]
Player IlxxxlI received card: [5d]
Player foreseen raises (1.25)
Player Beep_Beep folds
Player violin2 calls (1.25)
Player Jui Kuen folds
Player IlxxxlI calls (0.75)
*** FLOP ***: [8c Kd 9h]
Player IlxxxlI checks
Player foreseen checks
Player violin2 checks
*** TURN ***: [8c Kd 9h] [8h]
Player IlxxxlI bets (2.09)
Player foreseen calls (2.09)
Player violin2 folds
*** RIVER ***: [8c Kd 9h 8h] [4d]
Player IlxxxlI bets (10.50)
Player foreseen folds
Uncalled bet (10.50) returned to IlxxxlI
Player IlxxxlI mucks cards
------ Summary ------
Pot: 7.78. Rake 0.28. JP fee 0.12
Board: [8c Kd 9h 8h 4d]
Player Jui Kuen does not show cards.Bets: 0.25. Collects: 0. Loses: 0.25.
*Player IlxxxlI mucks (does not show cards). Bets: 3.34. Collects: 7.78. Wins: 4.44.
Player foreseen does not show cards.Bets: 3.34. Collects: 0. Loses: 3.34.
Player Beep_Beep does not show cards.Bets: 0. Collects: 0. Wins: 0.
Player violin2 does not show cards.Bets: 1.25. Collects: 0. Loses: 1.25.
Game ended at: 2016/11/29 13:19:54

Game started
Game ID: 786973337 0.25/0.50 (PRR) Gorgons - 19 (Hold'em)
Seat 2 is the button
Seat 1: MirrorZrorriM (65.95).
Seat 2: IlxxxlI (38.48).
Seat 3: Hakuna_Matata777 (50).
Seat 4: FLDnLIVE2FLDagn (60.64).
Seat 5: foreseen (50).
Seat 6: QDevilQ (77.33).
Player Hakuna_Matata777 has small blind (0.25)
Player FLDnLIVE2FLDagn has big blind (0.50)
Player IlxxxlI received card: [4s]
Player IlxxxlI received card: [3c]
Player foreseen folds
Player QDevilQ raises (1.50)
Player MirrorZrorriM folds
Player IlxxxlI folds
Player Hakuna_Matata777 folds
Player FLDnLIVE2FLDagn calls (1)
*** FLOP ***: [Js 6h 9s]
Player FLDnLIVE2FLDagn checks
Player QDevilQ bets (2)
Player FLDnLIVE2FLDagn calls (2)
*** TURN ***: [Js 6h 9s] [3s]
Player FLDnLIVE2FLDagn checks
Player QDevilQ checks
*** RIVER ***: [Js 6h 9s 3s] [Ah]
Player FLDnLIVE2FLDagn bets (4.59)
Player QDevilQ calls (4.59)
------ Summary ------
Pot: 15.61. Rake 0.58. JP fee 0.24
Board: [Js 6h 9s 3s Ah]
Player MirrorZrorriM does not show cards.Bets: 0. Collects: 0. Wins: 0.
Player IlxxxlI does not show cards.Bets: 0. Collects: 0. Wins: 0.
Player Hakuna_Matata777 does not show cards.Bets: 0.25. Collects: 0. Loses: 0.25.
Player FLDnLIVE2FLDagn shows: One pair of As [Qd As]. Bets: 8.09. Collects: 0. Loses: 8.09.
Player foreseen does not show cards.Bets: 0. Collects: 0. Wins: 0.
*Player QDevilQ shows: Three Of Kind of Js [Jd Jc]. Bets: 8.09. Collects: 15.61. Wins: 7.52.
Game ended at: 2016/11/29 13:18:34

Game started
Game ID: 786973300 0.25/0.50 (PRR) Gorgons - 18 (Hold'em)
Seat 6 is the button
Seat 1: Abundance4All (88.82).
Seat 4: IlxxxlI (20).
Seat 5: GagaPoker (71.46).
Seat 6: foreseen (68.72).
Player Abundance4All has small blind (0.25)
Player IlxxxlI has big blind (0.50)
Player IlxxxlI received card: [10h]
Player IlxxxlI received card: [6d]
Player GagaPoker folds
Player foreseen raises (1.12)
Player Abundance4All folds
Player IlxxxlI folds
Uncalled bet (0.62) returned to foreseen
Player foreseen mucks cards
------ Summary ------
Pot: 1.25. Rake 0
Player Abundance4All does not show cards.Bets: 0.25. Collects: 0. Loses: 0.25.
Player IlxxxlI does not show cards.Bets: 0.50. Collects: 0. Loses: 0.50.
Player GagaPoker does not show cards.Bets: 0. Collects: 0. Wins: 0.
*Player foreseen mucks (does not show cards). Bets: 0.50. Collects: 1.25. Wins: 0.75.
Game ended at: 2016/11/29 13:18:10

Game started
Game ID: 786973231 0.25/0.50 (PRR) Gorgons - 10 (Hold'em)
Seat 1 is the button
Seat 1: WeakAndWeary (50).
Seat 2: foreseen (160.01).
Seat 3: IlxxxlI (20).
Seat 4: Beep_Beep (55.98).
Player foreseen has small blind (0.25)
Player IlxxxlI has big blind (0.50)
Player IlxxxlI received card: [4c]
Player IlxxxlI received card: [9s]
Player Beep_Beep raises (1.50)
Player WeakAndWeary folds
Player foreseen folds
Player IlxxxlI folds
Uncalled bet (1) returned to Beep_Beep
Player Beep_Beep mucks cards
------ Summary ------
Pot: 1.25. Rake 0
Player WeakAndWeary does not show cards.Bets: 0. Collects: 0. Wins: 0.
Player foreseen does not show cards.Bets: 0.25. Collects: 0. Loses: 0.25.
Player IlxxxlI does not show cards.Bets: 0.50. Collects: 0. Loses: 0.50.
*Player Beep_Beep mucks (does not show cards). Bets: 0.50. Collects: 1.25. Wins: 0.75.
Game ended at: 2016/11/29 13:18:12

Game started
Game ID: 786973116 0.25/0.50 (PRR) Gorgons - 9 (Hold'em)
Seat 5 is the button
Seat 2: Jui Kuen (50).
Seat 3: IlxxxlI (20).
Seat 4: foreseen (51.37).
Seat 5: Beep_Beep (50).
Seat 6: violin2 (62.44).
Player violin2 has small blind (0.25)
Player Jui Kuen has big blind (0.50)
Player IlxxxlI received card: [4d]
Player IlxxxlI received card: [As]
Player IlxxxlI folds
Player foreseen folds
Player Beep_Beep folds
Player violin2 calls (0.25)
Player Jui Kuen checks
*** FLOP ***: [8c 2c 4c]
Player violin2 bets (1)
Player Jui Kuen folds
Uncalled bet (1) returned to violin2
Player violin2 mucks cards
------ Summary ------
Pot: 0.95. Rake 0.05
Board: [8c 2c 4c]
Player Jui Kuen does not show cards.Bets: 0.50. Collects: 0. Loses: 0.50.
Player IlxxxlI does not show cards.Bets: 0. Collects: 0. Wins: 0.
Player foreseen does not show cards.Bets: 0. Collects: 0. Wins: 0.
Player Beep_Beep does not show cards.Bets: 0. Collects: 0. Wins: 0.
*Player violin2 mucks (does not show cards). Bets: 0.50. Collects: 0.95. Wins: 0.45.
Game ended at: 2016/11/29 13:18:2

Game started
Game ID: 786972982 0.50/1 (PRR) Kraken (Hold'em)
Seat 4 is the button
Seat 1: WeakAndWeary (125.66).
Seat 2: MadLifeGrinder (100).
Seat 3: Sephiroth1 (100).
Seat 4: LloydXmas (169.83).
Seat 5: Im Don King (112.33).
Seat 6: IlxxxlI (48.03).
Player Im Don King has small blind (0.50)
Player IlxxxlI has big blind (1)
Player IlxxxlI received card: [Ac]
Player IlxxxlI received card: [8d]
Player WeakAndWeary folds
Player MadLifeGrinder raises (2.50)
Player Sephiroth1 calls (2.50)
Player LloydXmas folds
Player Im Don King folds
Player IlxxxlI folds
*** FLOP ***: [Jd Kc 4c]
Player MadLifeGrinder checks
Player Sephiroth1 checks
*** TURN ***: [Jd Kc 4c] [5s]
Player MadLifeGrinder checks
Player Sephiroth1 bets (4.12)
Player MadLifeGrinder calls (4.12)
*** RIVER ***: [Jd Kc 4c 5s] [Kd]
Player MadLifeGrinder checks
Player Sephiroth1 checks
Player MadLifeGrinder mucks cards
------ Summary ------
Pot: 14.01. Rake 0.49. JP fee 0.24
Board: [Jd Kc 4c 5s Kd]
Player WeakAndWeary does not show cards.Bets: 0. Collects: 0. Wins: 0.
Player MadLifeGrinder mucks (does not show cards). Bets: 6.62. Collects: 0. Loses: 6.62.
*Player Sephiroth1 shows: Two pairs. Ks and Js [Ah Js]. Bets: 6.62. Collects: 14.01. Wins: 7.39.
Player LloydXmas does not show cards.Bets: 0. Collects: 0. Wins: 0.
Player Im Don King does not show cards.Bets: 0.50. Collects: 0. Loses: 0.50.
Player IlxxxlI does not show cards.Bets: 1. Collects: 0. Loses: 1.
Game ended at: 2016/11/29 13:18:34

Game started
Game ID: 786972919 0.25/0.50 (PRR) Gorgons - 18 (Hold'em)
Seat 5 is the button
Seat 1: Abundance4All (89.32).
Seat 4: IlxxxlI (20).
Seat 5: GagaPoker (70.71).
Seat 6: foreseen (68.97).
Player foreseen has small blind (0.25)
Player Abundance4All has big blind (0.50)
Player IlxxxlI received card: [7c]
Player IlxxxlI received card: [2s]
Player IlxxxlI folds
Player GagaPoker raises (1.50)
Player foreseen folds
Player Abundance4All folds
Uncalled bet (1) returned to GagaPoker
Player GagaPoker mucks cards
------ Summary ------
Pot: 1.25. Rake 0
Player Abundance4All does not show cards.Bets: 0.50. Collects: 0. Loses: 0.50.
Player IlxxxlI does not show cards.Bets: 0. Collects: 0. Wins: 0.
*Player GagaPoker mucks (does not show cards). Bets: 0.50. Collects: 1.25. Wins: 0.75.
Player foreseen does not show cards.Bets: 0.25. Collects: 0. Loses: 0.25.
Game ended at: 2016/11/29 13:17:40

Game started
Game ID: 786972840 0.25/0.50 (PRR) Gorgons - 10 (Hold'em)
Seat 4 is the button
Seat 1: WeakAndWeary (50).
Seat 2: foreseen (160.51).
Seat 3: IlxxxlI (20).
Seat 4: Beep_Beep (55.23).
Player WeakAndWeary has small blind (0.25)
Player foreseen has big blind (0.50)
Player IlxxxlI received card: [2c]
Player IlxxxlI received card: [5s]
Player IlxxxlI folds
Player Beep_Beep raises (1.50)
Player WeakAndWeary folds
Player foreseen folds
Uncalled bet (1) returned to Beep_Beep
Player Beep_Beep mucks cards
------ Summary ------
Pot: 1.25. Rake 0
Player WeakAndWeary does not show cards.Bets: 0.25. Collects: 0. Loses: 0.25.
Player foreseen does not show cards.Bets: 0.50. Collects: 0. Loses: 0.50.
Player IlxxxlI does not show cards.Bets: 0. Collects: 0. Wins: 0.
*Player Beep_Beep mucks (does not show cards). Bets: 0.50. Collects: 1.25. Wins: 0.75.
Game ended at: 2016/11/29 13:17:32

Game started
Game ID: 786972805 0.25/0.50 (PRR) Gorgons - 19 (Hold'em)
Seat 1 is the button
Seat 1: MirrorZrorriM (65.95).
Seat 2: IlxxxlI (20).
Seat 3: Hakuna_Matata777 (50).
Seat 4: FLDnLIVE2FLDagn (60.64).
Seat 5: foreseen (50).
Seat 6: QDevilQ (77.33).
Player IlxxxlI has small blind (0.25)
Player Hakuna_Matata777 has big blind (0.50)
Player IlxxxlI received card: [Ks]
Player IlxxxlI received card: [Kc]
Player FLDnLIVE2FLDagn folds
Player foreseen raises (1.25)
Player QDevilQ folds
Player MirrorZrorriM folds
Player IlxxxlI raises (2.94)
Player Hakuna_Matata777 folds
Player foreseen allin (48.75)
Player IlxxxlI allin (16.81)
Uncalled bet (30) returned to foreseen
*** FLOP ***: [2h 10s Kd]
*** TURN ***: [2h 10s Kd] [As]
*** RIVER ***: [2h 10s Kd As] [7c]
------ Summary ------
Pot: 38.48. Rake 1.78. JP fee 0.24
Board: [2h 10s Kd As 7c]
Player MirrorZrorriM does not show cards.Bets: 0. Collects: 0. Wins: 0.
*Player IlxxxlI shows: Three Of Kind of Ks [Ks Kc]. Bets: 20. Collects: 38.48. Wins: 18.48.
Player Hakuna_Matata777 does not show cards.Bets: 0.50. Collects: 0. Loses: 0.50.
Player FLDnLIVE2FLDagn does not show cards.Bets: 0. Collects: 0. Wins: 0.
Player foreseen shows: One pair of Qs [Qh Qc]. Bets: 20. Collects: 0. Loses: 20.
Player QDevilQ does not show cards.Bets: 0. Collects: 0. Wins: 0.
Game ended at: 2016/11/29 13:17:42

Game started
Game ID: 786972540 0.25/0.50 (PRR) Gorgons - 18 (Hold'em)
Seat 4 is the button
Seat 1: Abundance4All (89.32).
Seat 4: IlxxxlI (20).
Seat 5: GagaPoker (70.96).
Seat 6: foreseen (68.72).
Player GagaPoker has small blind (0.25)
Player foreseen has big blind (0.50)
Player IlxxxlI received card: [8c]
Player IlxxxlI received card: [4d]
Player Abundance4All folds
Player IlxxxlI folds
Player GagaPoker folds
Uncalled bet (0.25) returned to foreseen
Player foreseen mucks cards
------ Summary ------
Pot: 0.50. Rake 0
Player Abundance4All does not show cards.Bets: 0. Collects: 0. Wins: 0.
Player IlxxxlI does not show cards.Bets: 0. Collects: 0. Wins: 0.
Player GagaPoker does not show cards.Bets: 0.25. Collects: 0. Loses: 0.25.
*Player foreseen mucks (does not show cards). Bets: 0.25. Collects: 0.50. Wins: 0.25.
Game ended at: 2016/11/29 13:17:0

Game started
Game ID: 786972440 0.50/1 (PRR) Kraken - 7 (Hold'em)
Seat 4 is the button
Seat 2: WeakAndWeary (101.80).
Seat 3: Keggston99 (100).
Seat 4: IlxxxlI (42.16).
Player WeakAndWeary has small blind (0.50)
Player Keggston99 has big blind (1)
Player IlxxxlI received card: [10d]
Player IlxxxlI received card: [6s]
Player IlxxxlI folds
Player WeakAndWeary folds
Uncalled bet (0.50) returned to Keggston99
Player Keggston99 mucks cards
------ Summary ------
Pot: 1. Rake 0
Player WeakAndWeary does not show cards.Bets: 0.50. Collects: 0. Loses: 0.50.
*Player Keggston99 mucks (does not show cards). Bets: 0.50. Collects: 1. Wins: 0.50.
Player IlxxxlI does not show cards.Bets: 0. Collects: 0. Wins: 0.
Game ended at: 2016/11/29 13:16:35

Game started
Game ID: 786972356 0.25/0.50 (PRR) Gorgons - 18 (Hold'em)
Seat 1 is the button
Seat 1: Abundance4All (88.57).
Seat 4: IlxxxlI (20.25).
Seat 5: GagaPoker (71.46).
Seat 6: foreseen (68.72).
Player IlxxxlI has small blind (0.25)
Player GagaPoker has big blind (0.50)
Player IlxxxlI received card: [Kh]
Player IlxxxlI received card: [7d]
Player foreseen folds
Player Abundance4All raises (1)
Player IlxxxlI folds
Player GagaPoker folds
Uncalled bet (0.50) returned to Abundance4All
Player Abundance4All mucks cards
------ Summary ------
Pot: 1.25. Rake 0
*Player Abundance4All mucks (does not show cards). Bets: 0.50. Collects: 1.25. Wins: 0.75.
Player IlxxxlI does not show cards.Bets: 0.25. Collects: 0. Loses: 0.25.
Player GagaPoker does not show cards.Bets: 0.50. Collects: 0. Loses: 0.50.
Player foreseen does not show cards.Bets: 0. Collects: 0. Wins: 0.
Game ended at: 2016/11/29 13:16:20

Game started
Game ID: 786972168 0.25/0.50 (PRR) Gorgons - 18 (Hold'em)
Seat 6 is the button
Seat 1: Abundance4All (88.82).
Seat 3: imperceptible (20).
Seat 4: IlxxxlI (20).
Seat 5: GagaPoker (71.46).
Seat 6: foreseen (68.72).
Player Abundance4All has small blind (0.25)
Player imperceptible is timed out.
Player imperceptible sitting out
Player IlxxxlI has big blind (0.50)
Player IlxxxlI received card: [Qh]
Player IlxxxlI received card: [Kc]
Player GagaPoker folds
Player foreseen folds
Player Abundance4All folds
Uncalled bet (0.25) returned to IlxxxlI
Player IlxxxlI mucks cards
------ Summary ------
Pot: 0.50. Rake 0
Player Abundance4All does not show cards.Bets: 0.25. Collects: 0. Loses: 0.25.
Player imperceptible does not show cards.Bets: 0. Collects: 0. Wins: 0.
*Player IlxxxlI mucks (does not show cards). Bets: 0.25. Collects: 0.50. Wins: 0.25.
Player GagaPoker does not show cards.Bets: 0. Collects: 0. Wins: 0.
Player foreseen does not show cards.Bets: 0. Collects: 0. Wins: 0.
Game ended at: 2016/11/29 13:16:1

Game started
Game ID: 786972048 0.25/0.50 (PRR) Gorgons - 9 (Hold'em)
Seat 4 is the button
Seat 2: Jui Kuen (50).
Seat 3: IlxxxlI (20).
Seat 4: foreseen (51.37).
Seat 5: Beep_Beep (50).
Seat 6: violin2 (61.12).
Player Beep_Beep has small blind (0.25)
Player violin2 has big blind (0.50)
Player IlxxxlI received card: [7d]
Player IlxxxlI received card: [7s]
Player Jui Kuen folds
Player IlxxxlI raises (1.20)
Player foreseen folds
Player Beep_Beep folds
Player violin2 calls (0.70)
*** FLOP ***: [Ad Ah 3s]
Player violin2 checks
Player IlxxxlI is timed out.
Player IlxxxlI checks
*** TURN ***: [Ad Ah 3s] [5c]
Player violin2 bets (1.26)
Player IlxxxlI folds
Uncalled bet (1.26) returned to violin2
Player violin2 mucks cards
------ Summary ------
Pot: 2.52. Rake 0.09. JP fee 0.04
Board: [Ad Ah 3s 5c]
Player Jui Kuen does not show cards.Bets: 0. Collects: 0. Wins: 0.
Player IlxxxlI does not show cards.Bets: 1.20. Collects: 0. Loses: 1.20.
Player foreseen does not show cards.Bets: 0. Collects: 0. Wins: 0.
Player Beep_Beep does not show cards.Bets: 0.25. Collects: 0. Loses: 0.25.
*Player violin2 mucks (does not show cards). Bets: 1.20. Collects: 2.52. Wins: 1.32.
Game ended at: 2016/11/29 13:17:20

Game started
Game ID: 786971993 0.25/0.50 (PRR) Gorgons - 19 (Hold'em)
Seat 6 is the button
Seat 1: MirrorZrorriM (61.74).
Seat 2: IlxxxlI (20).
Seat 4: FLDnLIVE2FLDagn (60.64).
Seat 5: foreseen (50).
Seat 6: QDevilQ (77.33).
Player MirrorZrorriM has small blind (0.25)
Player IlxxxlI has big blind (0.50)
Player IlxxxlI received card: [Qs]
Player IlxxxlI received card: [4s]
Player FLDnLIVE2FLDagn folds
Player foreseen folds
Player QDevilQ folds
Player MirrorZrorriM raises (1.25)
Player IlxxxlI calls (1)
*** FLOP ***: [8c 9s 9c]
Player MirrorZrorriM bets (1.43)
Player IlxxxlI raises (3.17)
Player MirrorZrorriM calls (1.74)
*** TURN ***: [8c 9s 9c] [Jc]
Player MirrorZrorriM checks
Player IlxxxlI checks
*** RIVER ***: [8c 9s 9c Jc] [Jh]
Player MirrorZrorriM bets (4.44)
Player IlxxxlI folds
Uncalled bet (4.44) returned to MirrorZrorriM
Player MirrorZrorriM mucks cards
------ Summary ------
Pot: 8.88. Rake 0.32. JP fee 0.14
Board: [8c 9s 9c Jc Jh]
*Player MirrorZrorriM mucks (does not show cards). Bets: 4.67. Collects: 8.88. Wins: 4.21.
Player IlxxxlI does not show cards.Bets: 4.67. Collects: 0. Loses: 4.67.
Player FLDnLIVE2FLDagn does not show cards.Bets: 0. Collects: 0. Wins: 0.
Player foreseen does not show cards.Bets: 0. Collects: 0. Wins: 0.
Player QDevilQ does not show cards.Bets: 0. Collects: 0. Wins: 0.
Game ended at: 2016/11/29 13:16:48

Game started
Game ID: 786971968 0.50/1 (PRR) Kraken - 22 (Hold'em)
Seat 5 is the button
Seat 2: IlxxxlI (40).
Seat 3: Beep_Beep (214).
Seat 4: gust (42.28).
Seat 5: MadLifeGrinder (103).
Seat 6: WeakAndWeary (263.92).
Player WeakAndWeary has small blind (0.50)
Player IlxxxlI has big blind (1)
Player IlxxxlI received card: [Jd]
Player IlxxxlI received card: [10d]
Player Beep_Beep raises (3)
Player gust folds
Player MadLifeGrinder folds
Player WeakAndWeary folds
Player IlxxxlI calls (2)
*** FLOP ***: [4s Jc 4d]
Player IlxxxlI checks
Player Beep_Beep bets (4)
Player IlxxxlI calls (4)
*** TURN ***: [4s Jc 4d] [6d]
Player IlxxxlI checks
Player Beep_Beep bets (9)
Player IlxxxlI calls (9)
*** RIVER ***: [4s Jc 4d 6d] [7s]
Player IlxxxlI checks
Player Beep_Beep bets (24)
Player IlxxxlI folds
Uncalled bet (24) returned to Beep_Beep
Player Beep_Beep mucks cards
------ Summary ------
Pot: 30.88. Rake 1.38. JP fee 0.24
Board: [4s Jc 4d 6d 7s]
Player IlxxxlI does not show cards.Bets: 16. Collects: 0. Loses: 16.
*Player Beep_Beep mucks (does not show cards). Bets: 16. Collects: 30.88. Wins: 14.88.
Player gust does not show cards.Bets: 0. Collects: 0. Wins: 0.
Player MadLifeGrinder does not show cards.Bets: 0. Collects: 0. Wins: 0.
Player WeakAndWeary does not show cards.Bets: 0.50. Collects: 0. Loses: 0.50.
Game ended at: 2016/11/29 13:18:11

Game started
Game ID: 786971955 0.50/1 (PRR) Kraken - 7 (Hold'em)
Seat 2 is the button
Seat 2: WeakAndWeary (100).
Seat 4: IlxxxlI (44.16).
Player WeakAndWeary has small blind (0.50)
Player IlxxxlI has big blind (1)
Player IlxxxlI received card: [7d]
Player IlxxxlI received card: [2d]
Player WeakAndWeary raises (1.50)
Player IlxxxlI calls (1)
*** FLOP ***: [10c Kd 4s]
Player IlxxxlI checks
Player WeakAndWeary bets (2.53)
Player IlxxxlI folds
Uncalled bet (2.53) returned to WeakAndWeary
Player WeakAndWeary mucks cards
------ Summary ------
Pot: 3.80. Rake 0.16. JP fee 0.04
Board: [10c Kd 4s]
*Player WeakAndWeary mucks (does not show cards). Bets: 2. Collects: 3.80. Wins: 1.80.
Player IlxxxlI does not show cards.Bets: 2. Collects: 0. Loses: 2.
Game ended at: 2016/11/29 13:16:11

Game started
Game ID: 786971840 1/2 (PRR) Lakhey (Hold'em)
Seat 5 is the button
Seat 1: bfish602 (200.31).
Seat 2: KingGuciGuci (209.22).
Seat 3: IbetUmuck (714.74).
Seat 4: IlxxxlI (80).
Seat 5: MadLifeGrinder (210.21).
Player bfish602 has small blind (1)
Player KingGuciGuci has big blind (2)
Player IlxxxlI received card: [Kc]
Player IlxxxlI received card: [9c]
Player IbetUmuck folds
Player IlxxxlI raises (4.80)
Player MadLifeGrinder folds
Player bfish602 calls (3.80)
Player KingGuciGuci folds
*** FLOP ***: [Kd 8c 6d]
Player bfish602 bets (5.51)
Player IlxxxlI calls (5.51)
*** TURN ***: [Kd 8c 6d] [7s]
Player bfish602 checks
Player IlxxxlI bets (7.16)
Player bfish602 raises (21.48)
Player IlxxxlI calls (14.32)
*** RIVER ***: [Kd 8c 6d 7s] [3c]
Player bfish602 bets (20.86)
Player IlxxxlI calls (20.86)
------ Summary ------
Pot: 104.30. Rake 2.76. JP fee 0.24
Board: [Kd 8c 6d 7s 3c]
Player bfish602 shows: High card K [Js Qs]. Bets: 52.65. Collects: 0. Loses: 52.65.
Player KingGuciGuci does not show cards.Bets: 2. Collects: 0. Loses: 2.
Player IbetUmuck does not show cards.Bets: 0. Collects: 0. Wins: 0.
*Player IlxxxlI shows: One pair of Ks [Kc 9c]. Bets: 52.65. Collects: 104.30. Wins: 51.65.
Player MadLifeGrinder does not show cards.Bets: 0. Collects: 0. Wins: 0.
Game ended at: 2016/11/29 13:17:14

Game started
Game ID: 786971823 0.25/0.50 (PRR) Gorgons - 18 (Hold'em)
Seat 5 is the button
Seat 1: Abundance4All (89.32).
Seat 4: IlxxxlI (20).
Seat 5: GagaPoker (70.21).
Seat 6: foreseen (68.97).
Player foreseen has small blind (0.25)
Player Abundance4All has big blind (0.50)
Player IlxxxlI received card: [7h]
Player IlxxxlI received card: [6h]
Player IlxxxlI calls (0.50)
Player GagaPoker raises (2)
Player foreseen folds
Player Abundance4All folds
Player IlxxxlI folds
Uncalled bet (1.50) returned to GagaPoker
Player GagaPoker mucks cards
------ Summary ------
Pot: 1.75. Rake 0
Player Abundance4All does not show cards.Bets: 0.50. Collects: 0. Loses: 0.50.
Player IlxxxlI does not show cards.Bets: 0.50. Collects: 0. Loses: 0.50.
*Player GagaPoker mucks (does not show cards). Bets: 0.50. Collects: 1.75. Wins: 1.25.
Player foreseen does not show cards.Bets: 0.25. Collects: 0. Loses: 0.25.
Game ended at: 2016/11/29 13:15:41

Game started
Game ID: 786971806 0.25/0.50 (PRR) Gorgons - 10 (Hold'em)
Seat 3 is the button
Seat 1: WeakAndWeary (50).
Seat 2: foreseen (160.51).
Seat 3: IlxxxlI (20.65).
Seat 4: Beep_Beep (50.25).
Player Beep_Beep has small blind (0.25)
Player WeakAndWeary has big blind (0.50)
Player IlxxxlI received card: [Jd]
Player IlxxxlI received card: [Kc]
Player foreseen folds
Player IlxxxlI raises (1.50)
Player Beep_Beep raises (4.75)
Player WeakAndWeary folds
Player IlxxxlI calls (3.50)
*** FLOP ***: [8h 4d 3s]
Player Beep_Beep bets (5)
Player IlxxxlI folds
Uncalled bet (5) returned to Beep_Beep
Player Beep_Beep mucks cards
------ Summary ------
Pot: 9.98. Rake 0.36. JP fee 0.16
Board: [8h 4d 3s]
Player WeakAndWeary does not show cards.Bets: 0.50. Collects: 0. Loses: 0.50.
Player foreseen does not show cards.Bets: 0. Collects: 0. Wins: 0.
Player IlxxxlI does not show cards.Bets: 5. Collects: 0. Loses: 5.
*Player Beep_Beep mucks (does not show cards). Bets: 5. Collects: 9.98. Wins: 4.98.
Game ended at: 2016/11/29 13:16:51

Game started
Game ID: 786971705 0.25/0.50 (PRR) Gorgons - 9 (Hold'em)
Seat 3 is the button
Seat 2: Jui Kuen (50).
Seat 3: IlxxxlI (20).
Seat 4: foreseen (50.87).
Seat 5: Beep_Beep (50).
Seat 6: violin2 (61.12).
Player foreseen has small blind (0.25)
Player Beep_Beep has big blind (0.50)
Player IlxxxlI received card: [8h]
Player IlxxxlI received card: [3d]
Player violin2 folds
Player Jui Kuen folds
Player IlxxxlI folds
Player foreseen raises (1.39)
Player Beep_Beep folds
Uncalled bet (1.14) returned to foreseen
Player foreseen mucks cards
------ Summary ------
Pot: 1. Rake 0
Player Jui Kuen does not show cards.Bets: 0. Collects: 0. Wins: 0.
Player IlxxxlI does not show cards.Bets: 0. Collects: 0. Wins: 0.
*Player foreseen mucks (does not show cards). Bets: 0.50. Collects: 1. Wins: 0.50.
Player Beep_Beep does not show cards.Bets: 0.50. Collects: 0. Loses: 0.50.
Player violin2 does not show cards.Bets: 0. Collects: 0. Wins: 0.
Game ended at: 2016/11/29 13:15:27

Game started
Game ID: 786971622 0.25/0.50 (PRR) Gorgons - 18 (Hold'em)
Seat 4 is the button
Seat 1: Abundance4All (89.32).
Seat 3: imperceptible (20).
Seat 4: IlxxxlI (20).
Seat 5: GagaPoker (70.46).
Seat 6: foreseen (68.72).
Player GagaPoker has small blind (0.25)
Player foreseen has big blind (0.50)
Player imperceptible is timed out.
Player imperceptible wait BB
Player IlxxxlI received card: [3h]
Player IlxxxlI received card: [Kc]
Player Abundance4All folds
Player IlxxxlI folds
Player GagaPoker folds
Uncalled bet (0.25) returned to foreseen
Player foreseen mucks cards
------ Summary ------
Pot: 0.50. Rake 0
Player Abundance4All does not show cards.Bets: 0. Collects: 0. Wins: 0.
Player imperceptible does not show cards.Bets: 0. Collects: 0. Wins: 0.
Player IlxxxlI does not show cards.Bets: 0. Collects: 0. Wins: 0.
Player GagaPoker does not show cards.Bets: 0.25. Collects: 0. Loses: 0.25.
*Player foreseen mucks (does not show cards). Bets: 0.25. Collects: 0.50. Wins: 0.25.
Game ended at: 2016/11/29 13:15:5

Game started
Game ID: 786971610 0.25/0.50 (PRR) Gorgons - 19 (Hold'em)
Seat 5 is the button
Seat 1: MirrorZrorriM (62.24).
Seat 2: IlxxxlI (20).
Seat 4: FLDnLIVE2FLDagn (59.89).
Seat 5: foreseen (50).
Seat 6: QDevilQ (77.58).
Player QDevilQ has small blind (0.25)
Player MirrorZrorriM has big blind (0.50)
Player IlxxxlI received card: [Jd]
Player IlxxxlI received card: [Qc]
Player IlxxxlI folds
Player FLDnLIVE2FLDagn raises (1.50)
Player foreseen folds
Player QDevilQ folds
Player MirrorZrorriM folds
Uncalled bet (1) returned to FLDnLIVE2FLDagn
Player FLDnLIVE2FLDagn mucks cards
------ Summary ------
Pot: 1.25. Rake 0
Player MirrorZrorriM does not show cards.Bets: 0.50. Collects: 0. Loses: 0.50.
Player IlxxxlI does not show cards.Bets: 0. Collects: 0. Wins: 0.
*Player FLDnLIVE2FLDagn mucks (does not show cards). Bets: 0.50. Collects: 1.25. Wins: 0.75.
Player foreseen does not show cards.Bets: 0. Collects: 0. Wins: 0.
Player QDevilQ does not show cards.Bets: 0.25. Collects: 0. Loses: 0.25.
Game ended at: 2016/11/29 13:15:22

Game started
Game ID: 786971552 0.25/0.50 (PRR) Gorgons - 10 (Hold'em)
Seat 2 is the button
Seat 1: WeakAndWeary (50).
Seat 2: foreseen (160.51).
Seat 3: IlxxxlI (20.90).
Seat 4: Beep_Beep (50).
Player IlxxxlI has small blind (0.25)
Player Beep_Beep has big blind (0.50)
Player IlxxxlI received card: [5c]
Player IlxxxlI received card: [8h]
Player WeakAndWeary folds
Player foreseen folds
Player IlxxxlI folds
Uncalled bet (0.25) returned to Beep_Beep
Player Beep_Beep mucks cards
------ Summary ------
Pot: 0.50. Rake 0
Player WeakAndWeary does not show cards.Bets: 0. Collects: 0. Wins: 0.
Player foreseen does not show cards.Bets: 0. Collects: 0. Wins: 0.
Player IlxxxlI does not show cards.Bets: 0.25. Collects: 0. Loses: 0.25.
*Player Beep_Beep mucks (does not show cards). Bets: 0.25. Collects: 0.50. Wins: 0.25.
Game ended at: 2016/11/29 13:15:4

Game started
Game ID: 786971475 0.50/1 (PRR) Kraken (Hold'em)
Seat 3 is the button
Seat 1: WeakAndWeary (128.66).
Seat 2: MadLifeGrinder (100).
Seat 3: Sephiroth1 (100).
Seat 4: LloydXmas (170.33).
Seat 5: Im Don King (100).
Seat 6: IlxxxlI (48.03).
Player LloydXmas has small blind (0.50)
Player Im Don King has big blind (1)
Player IlxxxlI received card: [7s]
Player IlxxxlI received card: [Kd]
Player IlxxxlI folds
Player WeakAndWeary raises (3)
Player MadLifeGrinder calls (3)
Player Sephiroth1 folds
Player LloydXmas folds
Player Im Don King calls (2)
*** FLOP ***: [Qc 8c 4h]
Player Im Don King checks
Player WeakAndWeary checks
Player MadLifeGrinder checks
*** TURN ***: [Qc 8c 4h] [7h]
Player Im Don King checks
Player WeakAndWeary checks
Player MadLifeGrinder bets (7)
Player Im Don King calls (7)
Player WeakAndWeary folds
*** RIVER ***: [Qc 8c 4h 7h] [9h]
Player Im Don King checks
Player MadLifeGrinder checks
------ Summary ------
Pot: 22.33. Rake 0.93. JP fee 0.24
Board: [Qc 8c 4h 7h 9h]
Player WeakAndWeary does not show cards.Bets: 3. Collects: 0. Loses: 3.
Player MadLifeGrinder shows: One pair of 10s [10h 10d]. Bets: 10. Collects: 0. Loses: 10.
Player Sephiroth1 does not show cards.Bets: 0. Collects: 0. Wins: 0.
Player LloydXmas does not show cards.Bets: 0.50. Collects: 0. Loses: 0.50.
*Player Im Don King shows: Flush, J high [8h Jh]. Bets: 10. Collects: 22.33. Wins: 12.33.
Player IlxxxlI does not show cards.Bets: 0. Collects: 0. Wins: 0.
Game ended at: 2016/11/29 13:17:3

Game started
Game ID: 786971380 0.50/1 (PRR) Kraken - 22 (Hold'em)
Seat 4 is the button
Seat 2: IlxxxlI (40).
Seat 3: Beep_Beep (214).
Seat 4: gust (40).
Seat 5: MadLifeGrinder (103.50).
Seat 6: WeakAndWeary (265.92).
Player MadLifeGrinder has small blind (0.50)
Player WeakAndWeary has big blind (1)
Player IlxxxlI received card: [8s]
Player IlxxxlI received card: [Ac]
Player IlxxxlI folds
Player Beep_Beep folds
Player gust raises (2)
Player MadLifeGrinder folds
Player WeakAndWeary calls (1)
*** FLOP ***: [3d 3s 4s]
Player WeakAndWeary checks
Player gust bets (2.14)
Player WeakAndWeary folds
Uncalled bet (2.14) returned to gust
Player gust mucks cards
------ Summary ------
Pot: 4.28. Rake 0.16. JP fee 0.06
Board: [3d 3s 4s]
Player IlxxxlI does not show cards.Bets: 0. Collects: 0. Wins: 0.
Player Beep_Beep does not show cards.Bets: 0. Collects: 0. Wins: 0.
*Player gust mucks (does not show cards). Bets: 2. Collects: 4.28. Wins: 2.28.
Player MadLifeGrinder does not show cards.Bets: 0.50. Collects: 0. Loses: 0.50.
Player WeakAndWeary does not show cards.Bets: 2. Collects: 0. Loses: 2.
Game ended at: 2016/11/29 13:15:20

Game started
Game ID: 786971244 1/2 (PRR) Lakhey (Hold'em)
Seat 4 is the button
Seat 1: bfish602 (201).
Seat 2: KingGuciGuci (209.22).
Seat 3: IbetUmuck (715.42).
Seat 4: IlxxxlI (80).
Seat 5: MadLifeGrinder (211.21).
Seat 6: LazyFish (288.05).
Player MadLifeGrinder has small blind (1)
Player LazyFish sitting out
Player bfish602 has big blind (2)
Player IlxxxlI received card: [4d]
Player IlxxxlI received card: [9d]
Player KingGuciGuci folds
Player IbetUmuck raises (5.75)
Player IlxxxlI folds
Player MadLifeGrinder folds
Player bfish602 calls (3.75)
*** FLOP ***: [10d 10s 9c]
Player bfish602 checks
Player IbetUmuck checks
*** TURN ***: [10d 10s 9c] [Qd]
Player bfish602 bets (5.94)
Player IbetUmuck calls (5.94)
*** RIVER ***: [10d 10s 9c Qd] [2c]
Player bfish602 bets (11.58)
Player IbetUmuck calls (11.58)
------ Summary ------
Pot: 45.17. Rake 2.13. JP fee 0.24
Board: [10d 10s 9c Qd 2c]
*Player bfish602 shows: Two pairs. Qs and 10s [Qh Ah]. Bets: 23.27. Collects: 22.58. Loses: 0.69.
Player KingGuciGuci does not show cards.Bets: 0. Collects: 0. Wins: 0.
*Player IbetUmuck shows: Two pairs. Qs and 10s [Ac Qc]. Bets: 23.27. Collects: 22.59. Loses: 0.68.
Player IlxxxlI does not show cards.Bets: 0. Collects: 0. Wins: 0.
Player MadLifeGrinder does not show cards.Bets: 1. Collects: 0. Loses: 1.
Player LazyFish does not show cards.Bets: 0. Collects: 0. Wins: 0.
Game ended at: 2016/11/29 13:15:4

Game started
Game ID: 786971223 0.25/0.50 (PRR) Gorgons - 9 (Hold'em)
Seat 2 is the button
Seat 2: Jui Kuen (50).
Seat 3: IlxxxlI (20).
Seat 4: foreseen (51.37).
Seat 5: Beep_Beep (50).
Seat 6: violin2 (60.37).
Player IlxxxlI has small blind (0.25)
Player foreseen has big blind (0.50)
Player IlxxxlI received card: [5s]
Player IlxxxlI received card: [7c]
Player Beep_Beep folds
Player violin2 raises (1)
Player Jui Kuen folds
Player IlxxxlI folds
Player foreseen folds
Uncalled bet (0.50) returned to violin2
Player violin2 mucks cards
------ Summary ------
Pot: 1.25. Rake 0
Player Jui Kuen does not show cards.Bets: 0. Collects: 0. Wins: 0.
Player IlxxxlI does not show cards.Bets: 0.25. Collects: 0. Loses: 0.25.
Player foreseen does not show cards.Bets: 0.50. Collects: 0. Loses: 0.50.
Player Beep_Beep does not show cards.Bets: 0. Collects: 0. Wins: 0.
*Player violin2 mucks (does not show cards). Bets: 0.50. Collects: 1.25. Wins: 0.75.
Game ended at: 2016/11/29 13:14:51

Game started
Game ID: 786970946 0.50/1 (PRR) Kraken - 7 (Hold'em)
Seat 4 is the button
Seat 2: WeakAndWeary (102.50).
Seat 4: IlxxxlI (40).
Player IlxxxlI has small blind (0.50)
Player WeakAndWeary has big blind (1)
Player IlxxxlI received card: [5d]
Player IlxxxlI received card: [8d]
Player IlxxxlI calls (0.50)
Player WeakAndWeary checks
*** FLOP ***: [3d Kd Kh]
Player WeakAndWeary checks
Player IlxxxlI bets (1.26)
Player WeakAndWeary calls (1.26)
*** TURN ***: [3d Kd Kh] [3h]
Player WeakAndWeary checks
Player IlxxxlI bets (2.36)
Player WeakAndWeary calls (2.36)
*** RIVER ***: [3d Kd Kh 3h] [9d]
Player WeakAndWeary checks
Player IlxxxlI checks
Player WeakAndWeary mucks cards
------ Summary ------
Pot: 8.78. Rake 0.42. JP fee 0.04
Board: [3d Kd Kh 3h 9d]
Player WeakAndWeary mucks (does not show cards). Bets: 4.62. Collects: 0. Loses: 4.62.
*Player IlxxxlI shows: Flush, K high [5d 8d]. Bets: 4.62. Collects: 8.78. Wins: 4.16.
Game ended at: 2016/11/29 13:15:13

Game started
Game ID: 786970930 0.50/1 (PRR) Kraken (Hold'em)
Seat 2 is the button
Seat 1: WeakAndWeary (127.16).
Seat 2: MadLifeGrinder (100).
Seat 3: Sephiroth1 (100.50).
Seat 4: LloydXmas (171.33).
Seat 6: IlxxxlI (48.03).
Player Sephiroth1 has small blind (0.50)
Player LloydXmas has big blind (1)
Player IlxxxlI received card: [4s]
Player IlxxxlI received card: [Ah]
Player IlxxxlI folds
Player WeakAndWeary raises (3)
Player MadLifeGrinder folds
Player Sephiroth1 folds
Player LloydXmas folds
Uncalled bet (2) returned to WeakAndWeary
Player WeakAndWeary mucks cards
------ Summary ------
Pot: 2.50. Rake 0
*Player WeakAndWeary mucks (does not show cards). Bets: 1. Collects: 2.50. Wins: 1.50.
Player MadLifeGrinder does not show cards.Bets: 0. Collects: 0. Wins: 0.
Player Sephiroth1 does not show cards.Bets: 0.50. Collects: 0. Loses: 0.50.
Player LloydXmas does not show cards.Bets: 1. Collects: 0. Loses: 1.
Player IlxxxlI does not show cards.Bets: 0. Collects: 0. Wins: 0.
Game ended at: 2016/11/29 13:14:29

Game started
Game ID: 786970877 1/2 (PRR) Lakhey (Hold'em)
Seat 3 is the button
Seat 1: bfish602 (201).
Seat 2: KingGuciGuci (209.22).
Seat 3: IbetUmuck (712.42).
Seat 4: IlxxxlI (80).
Seat 5: MadLifeGrinder (213.21).
Seat 6: LazyFish (288.05).
Player IlxxxlI has small blind (1)
Player MadLifeGrinder has big blind (2)
Player IlxxxlI received card: [8h]
Player IlxxxlI received card: [6d]
Player LazyFish folds
Player bfish602 folds
Player KingGuciGuci folds
Player IbetUmuck raises (5.75)
Player IlxxxlI folds
Player MadLifeGrinder folds
Uncalled bet (3.75) returned to IbetUmuck
Player IbetUmuck mucks cards
------ Summary ------
Pot: 5. Rake 0
Player bfish602 does not show cards.Bets: 0. Collects: 0. Wins: 0.
Player KingGuciGuci does not show cards.Bets: 0. Collects: 0. Wins: 0.
*Player IbetUmuck mucks (does not show cards). Bets: 2. Collects: 5. Wins: 3.
Player IlxxxlI does not show cards.Bets: 1. Collects: 0. Loses: 1.
Player MadLifeGrinder does not show cards.Bets: 2. Collects: 0. Loses: 2.
Player LazyFish does not show cards.Bets: 0. Collects: 0. Wins: 0.
Game ended at: 2016/11/29 13:14:6

Game started
Game ID: 786970739 0.50/1 (PRR) Kraken - 22 (Hold'em)
Seat 3 is the button
Seat 1: meandkids (8.38).
Seat 2: IlxxxlI (40).
Seat 3: Beep_Beep (217).
Seat 4: gust (40).
Seat 5: MadLifeGrinder (100).
Seat 6: WeakAndWeary (265.92).
Player gust has small blind (0.50)
Player MadLifeGrinder has big blind (1)
Player IlxxxlI received card: [2h]
Player IlxxxlI received card: [4s]
Player WeakAndWeary folds
Player meandkids folds
Player IlxxxlI folds
Player Beep_Beep raises (3)
Player gust folds
Player MadLifeGrinder raises (10)
Player Beep_Beep folds
Uncalled bet (8) returned to MadLifeGrinder
Player MadLifeGrinder mucks cards
------ Summary ------
Pot: 6.50. Rake 0
Player meandkids does not show cards.Bets: 0. Collects: 0. Wins: 0.
Player IlxxxlI does not show cards.Bets: 0. Collects: 0. Wins: 0.
Player Beep_Beep does not show cards.Bets: 3. Collects: 0. Loses: 3.
Player gust does not show cards.Bets: 0.50. Collects: 0. Loses: 0.50.
*Player MadLifeGrinder mucks (does not show cards). Bets: 3. Collects: 6.50. Wins: 3.50.
Player WeakAndWeary does not show cards.Bets: 0. Collects: 0. Wins: 0.
Game ended at: 2016/11/29 13:14:21

Game started
Game ID: 786970673 0.25/0.50 (PRR) Gorgons - 10 (Hold'em)
Seat 1 is the button
Seat 1: WeakAndWeary (50).
Seat 2: foreseen (161.51).
Seat 3: IlxxxlI (20).
Seat 4: Beep_Beep (50).
Seat 5: yigbn1 (63.92).
Seat 6: xROCKETMANx (56.01).
Player foreseen has small blind (0.25)
Player IlxxxlI has big blind (0.50)
Player IlxxxlI received card: [Kd]
Player IlxxxlI received card: [4c]
Player Beep_Beep folds
Player yigbn1 folds
Player xROCKETMANx folds
Player WeakAndWeary folds
Player foreseen calls (0.25)
Player IlxxxlI checks
*** FLOP ***: [Ad 4h 7d]
Player foreseen bets (0.50)
Player IlxxxlI calls (0.50)
*** TURN ***: [Ad 4h 7d] [2d]
Player foreseen checks
Player IlxxxlI checks
*** RIVER ***: [Ad 4h 7d 2d] [3d]
Player foreseen checks
Player IlxxxlI bets (4)
Player foreseen folds
Uncalled bet (4) returned to IlxxxlI
Player IlxxxlI mucks cards
------ Summary ------
Pot: 1.90. Rake 0.08. JP fee 0.02
Board: [Ad 4h 7d 2d 3d]
Player WeakAndWeary does not show cards.Bets: 0. Collects: 0. Wins: 0.
Player foreseen does not show cards.Bets: 1. Collects: 0. Loses: 1.
*Player IlxxxlI mucks (does not show cards). Bets: 1. Collects: 1.90. Wins: 0.90.
Player Beep_Beep does not show cards.Bets: 0. Collects: 0. Wins: 0.
Player yigbn1 does not show cards.Bets: 0. Collects: 0. Wins: 0.
Player xROCKETMANx does not show cards.Bets: 0. Collects: 0. Wins: 0.
Game ended at: 2016/11/29 13:14:36

Game started
Game ID: 786970674 0.50/1 (PRR) Kraken - 7 (Hold'em)
Seat 2 is the button
Seat 2: WeakAndWeary (101.50).
Seat 4: IlxxxlI (40).
Seat 6: MadLifeGrinder (107.07).
Player IlxxxlI has small blind (0.50)
Player MadLifeGrinder sitting out
Player WeakAndWeary has big blind (1)
Player IlxxxlI received card: [3c]
Player IlxxxlI received card: [4c]
Player IlxxxlI calls (0.50)
Player WeakAndWeary raises (2)
Player IlxxxlI folds
Uncalled bet (2) returned to WeakAndWeary
Player WeakAndWeary mucks cards
------ Summary ------
Pot: 2. Rake 0
*Player WeakAndWeary mucks (does not show cards). Bets: 1. Collects: 2. Wins: 1.
Player IlxxxlI does not show cards.Bets: 1. Collects: 0. Loses: 1.
Player MadLifeGrinder does not show cards.Bets: 0. Collects: 0. Wins: 0.
Game ended at: 2016/11/29 13:13:35

Game started
Game ID: 786970658 0.25/0.50 (PRR) Gorgons - 18 (Hold'em)
Seat 2 is the button
Seat 1: Abundance4All (89.32).
Seat 2: xROCKETMANx (56.21).
Seat 4: IlxxxlI (20).
Seat 5: GagaPoker (70.96).
Seat 6: foreseen (68.72).
Player IlxxxlI has small blind (0.25)
Player GagaPoker has big blind (0.50)
Player IlxxxlI received card: [10d]
Player IlxxxlI received card: [Ac]
Player foreseen folds
Player Abundance4All folds
Player xROCKETMANx raises (1.50)
Player IlxxxlI raises (3.25)
Player GagaPoker folds
Player xROCKETMANx calls (2)
*** FLOP ***: [3h 7d Ah]
Player IlxxxlI checks
Player xROCKETMANx bets (2.37)
Player IlxxxlI calls (2.37)
*** TURN ***: [3h 7d Ah] [5h]
Player IlxxxlI checks
Player xROCKETMANx bets (8)
Player IlxxxlI folds
Uncalled bet (8) returned to xROCKETMANx
Player xROCKETMANx mucks cards
------ Summary ------
Pot: 11.63. Rake 0.41. JP fee 0.20
Board: [3h 7d Ah 5h]
Player Abundance4All does not show cards.Bets: 0. Collects: 0. Wins: 0.
*Player xROCKETMANx mucks (does not show cards). Bets: 5.87. Collects: 11.63. Wins: 5.76.
Player IlxxxlI does not show cards.Bets: 5.87. Collects: 0. Loses: 5.87.
Player GagaPoker does not show cards.Bets: 0.50. Collects: 0. Loses: 0.50.
Player foreseen does not show cards.Bets: 0. Collects: 0. Wins: 0.
Game ended at: 2016/11/29 13:14:43

Game started
Game ID: 786970630 0.25/0.50 (PRR) Gorgons - 19 (Hold'em)
Seat 4 is the button
Seat 1: MirrorZrorriM (62.24).
Seat 2: IlxxxlI (20).
Seat 4: FLDnLIVE2FLDagn (59.89).
Seat 5: foreseen (50).
Seat 6: QDevilQ (60.69).
Player foreseen has small blind (0.25)
Player QDevilQ has big blind (0.50)
Player IlxxxlI received card: [9s]
Player IlxxxlI received card: [Qd]
Player MirrorZrorriM folds
Player IlxxxlI folds
Player FLDnLIVE2FLDagn folds
Player foreseen calls (0.25)
Player QDevilQ raises (1.50)
Player foreseen calls (1.50)
*** FLOP ***: [Kh 4h 7d]
Player foreseen checks
Player QDevilQ bets (1.26)
Player foreseen calls (1.26)
*** TURN ***: [Kh 4h 7d] [4c]
Player foreseen checks
Player QDevilQ bets (4.50)
Player foreseen calls (4.50)
*** RIVER ***: [Kh 4h 7d 4c] [2c]
Player foreseen checks
Player QDevilQ bets (11)
Player foreseen calls (11)
Player foreseen mucks cards
------ Summary ------
Pot: 35.65. Rake 1.63. JP fee 0.24
Board: [Kh 4h 7d 4c 2c]
Player MirrorZrorriM does not show cards.Bets: 0. Collects: 0. Wins: 0.
Player IlxxxlI does not show cards.Bets: 0. Collects: 0. Wins: 0.
Player FLDnLIVE2FLDagn does not show cards.Bets: 0. Collects: 0. Wins: 0.
Player foreseen mucks (does not show cards). Bets: 18.76. Collects: 0. Loses: 18.76.
*Player QDevilQ shows: Two pairs. Ks and 4s [Kc Qh]. Bets: 18.76. Collects: 35.65. Wins: 16.89.
Game ended at: 2016/11/29 13:14:40

Game started
Game ID: 786970592 1/2 (PRR) Lakhey (Hold'em)
Seat 2 is the button
Seat 1: bfish602 (201).
Seat 2: KingGuciGuci (209.22).
Seat 3: IbetUmuck (713.42).
Seat 4: IlxxxlI (80).
Seat 5: MadLifeGrinder (210.21).
Seat 6: LazyFish (288.05).
Player IbetUmuck has small blind (1)
Player IlxxxlI has big blind (2)
Player IlxxxlI received card: [2h]
Player IlxxxlI received card: [10s]
Player MadLifeGrinder raises (5)
Player LazyFish folds
Player bfish602 folds
Player KingGuciGuci folds
Player IbetUmuck folds
Player IlxxxlI folds
Uncalled bet (3) returned to MadLifeGrinder
Player MadLifeGrinder mucks cards
------ Summary ------
Pot: 5. Rake 0
Player bfish602 does not show cards.Bets: 0. Collects: 0. Wins: 0.
Player KingGuciGuci does not show cards.Bets: 0. Collects: 0. Wins: 0.
Player IbetUmuck does not show cards.Bets: 1. Collects: 0. Loses: 1.
Player IlxxxlI does not show cards.Bets: 2. Collects: 0. Loses: 2.
*Player MadLifeGrinder mucks (does not show cards). Bets: 2. Collects: 5. Wins: 3.
Player LazyFish does not show cards.Bets: 0. Collects: 0. Wins: 0.
Game ended at: 2016/11/29 13:13:28

Game started
Game ID: 786970527 0.50/1 (PRR) Kraken (Hold'em)
Seat 1 is the button
Seat 1: WeakAndWeary (127.16).
Seat 2: MadLifeGrinder (100).
Seat 3: Sephiroth1 (100).
Seat 4: LloydXmas (171.33).
Seat 6: IlxxxlI (48.03).
Player MadLifeGrinder has small blind (0.50)
Player Sephiroth1 has big blind (1)
Player IlxxxlI received card: [4h]
Player IlxxxlI received card: [Ad]
Player LloydXmas folds
Player IlxxxlI folds
Player WeakAndWeary folds
Player MadLifeGrinder folds
Uncalled bet (0.50) returned to Sephiroth1
Player Sephiroth1 mucks cards
------ Summary ------
Pot: 1. Rake 0
Player WeakAndWeary does not show cards.Bets: 0. Collects: 0. Wins: 0.
Player MadLifeGrinder does not show cards.Bets: 0.50. Collects: 0. Loses: 0.50.
*Player Sephiroth1 mucks (does not show cards). Bets: 0.50. Collects: 1. Wins: 0.50.
Player LloydXmas does not show cards.Bets: 0. Collects: 0. Wins: 0.
Player IlxxxlI does not show cards.Bets: 0. Collects: 0. Wins: 0.
Game ended at: 2016/11/29 13:13:32

Game started
Game ID: 786970425 0.25/0.50 (PRR) Gorgons - 19 (Hold'em)
Seat 2 is the button
Seat 1: MirrorZrorriM (62.24).
Seat 2: IlxxxlI (20).
Seat 4: FLDnLIVE2FLDagn (60.14).
Seat 5: foreseen (50).
Seat 6: QDevilQ (59.94).
Player FLDnLIVE2FLDagn has small blind (0.25)
Player foreseen has big blind (0.50)
Player IlxxxlI received card: [5s]
Player IlxxxlI received card: [3d]
Player QDevilQ raises (1.50)
Player MirrorZrorriM folds
Player IlxxxlI folds
Player FLDnLIVE2FLDagn folds
Player foreseen folds
Uncalled bet (1) returned to QDevilQ
Player QDevilQ mucks cards
------ Summary ------
Pot: 1.25. Rake 0
Player MirrorZrorriM does not show cards.Bets: 0. Collects: 0. Wins: 0.
Player IlxxxlI does not show cards.Bets: 0. Collects: 0. Wins: 0.
Player FLDnLIVE2FLDagn does not show cards.Bets: 0.25. Collects: 0. Loses: 0.25.
Player foreseen does not show cards.Bets: 0.50. Collects: 0. Loses: 0.50.
*Player QDevilQ mucks (does not show cards). Bets: 0.50. Collects: 1.25. Wins: 0.75.
Game ended at: 2016/11/29 13:13:3

Game started
Game ID: 786970396 0.50/1 (PRR) Kraken - 7 (Hold'em)
Seat 6 is the button
Seat 2: WeakAndWeary (102).
Seat 4: IlxxxlI (40).
Seat 6: MadLifeGrinder (105.57).
Player WeakAndWeary has small blind (0.50)
Player IlxxxlI has big blind (1)
Player IlxxxlI received card: [2d]
Player IlxxxlI received card: [8s]
Player MadLifeGrinder raises (2.50)
Player WeakAndWeary folds
Player IlxxxlI folds
Uncalled bet (1.50) returned to MadLifeGrinder
Player MadLifeGrinder mucks cards
------ Summary ------
Pot: 2.50. Rake 0
Player WeakAndWeary does not show cards.Bets: 0.50. Collects: 0. Loses: 0.50.
Player IlxxxlI does not show cards.Bets: 1. Collects: 0. Loses: 1.
*Player MadLifeGrinder mucks (does not show cards). Bets: 1. Collects: 2.50. Wins: 1.50.
Game ended at: 2016/11/29 13:13:7

Game started
Game ID: 786970335 1/2 (PRR) Lakhey (Hold'em)
Seat 1 is the button
Seat 1: bfish602 (201).
Seat 2: KingGuciGuci (210.22).
Seat 3: IbetUmuck (712.42).
Seat 4: IlxxxlI (80).
Seat 5: MadLifeGrinder (210.21).
Seat 6: LazyFish (288.05).
Player KingGuciGuci has small blind (1)
Player IbetUmuck has big blind (2)
Player IlxxxlI received card: [7h]
Player IlxxxlI received card: [4c]
Player IlxxxlI folds
Player MadLifeGrinder folds
Player LazyFish folds
Player bfish602 folds
Player KingGuciGuci folds
Uncalled bet (1) returned to IbetUmuck
Player IbetUmuck mucks cards
------ Summary ------
Pot: 2. Rake 0
Player bfish602 does not show cards.Bets: 0. Collects: 0. Wins: 0.
Player KingGuciGuci does not show cards.Bets: 1. Collects: 0. Loses: 1.
*Player IbetUmuck mucks (does not show cards). Bets: 1. Collects: 2. Wins: 1.
Player IlxxxlI does not show cards.Bets: 0. Collects: 0. Wins: 0.
Player MadLifeGrinder does not show cards.Bets: 0. Collects: 0. Wins: 0.
Player LazyFish does not show cards.Bets: 0. Collects: 0. Wins: 0.
Game ended at: 2016/11/29 13:13:0

Game started
Game ID: 786970264 0.50/1 (PRR) Kraken (Hold'em)
Seat 6 is the button
Seat 1: WeakAndWeary (127.66).
Seat 2: MadLifeGrinder (100).
Seat 4: LloydXmas (169.83).
Seat 6: IlxxxlI (48.03).
Player WeakAndWeary has small blind (0.50)
Player MadLifeGrinder has big blind (1)
Player IlxxxlI received card: [7s]
Player IlxxxlI received card: [2s]
Player LloydXmas raises (2.88)
Player IlxxxlI folds
Player WeakAndWeary folds
Player MadLifeGrinder folds
Uncalled bet (1.88) returned to LloydXmas
Player LloydXmas mucks cards
------ Summary ------
Pot: 2.50. Rake 0
Player WeakAndWeary does not show cards.Bets: 0.50. Collects: 0. Loses: 0.50.
Player MadLifeGrinder does not show cards.Bets: 1. Collects: 0. Loses: 1.
*Player LloydXmas mucks (does not show cards). Bets: 1. Collects: 2.50. Wins: 1.50.
Player IlxxxlI does not show cards.Bets: 0. Collects: 0. Wins: 0.
Game ended at: 2016/11/29 13:12:53

Game started
Game ID: 786970211 0.50/1 (PRR) Kraken - 22 (Hold'em)
Seat 2 is the button
Seat 1: meandkids (8.38).
Seat 2: IlxxxlI (40).
Seat 3: Beep_Beep (216).
Seat 4: gust (40).
Seat 5: MadLifeGrinder (100).
Seat 6: WeakAndWeary (265.92).
Player Beep_Beep has small blind (0.50)
Player gust has big blind (1)
Player IlxxxlI received card: [Jc]
Player IlxxxlI received card: [5s]
Player MadLifeGrinder folds
Player WeakAndWeary folds
Player meandkids folds
Player IlxxxlI folds
Player Beep_Beep raises (2.50)
Player gust folds
Uncalled bet (2) returned to Beep_Beep
Player Beep_Beep mucks cards
------ Summary ------
Pot: 2. Rake 0
Player meandkids does not show cards.Bets: 0. Collects: 0. Wins: 0.
Player IlxxxlI does not show cards.Bets: 0. Collects: 0. Wins: 0.
*Player Beep_Beep mucks (does not show cards). Bets: 1. Collects: 2. Wins: 1.
Player gust does not show cards.Bets: 1. Collects: 0. Loses: 1.
Player MadLifeGrinder does not show cards.Bets: 0. Collects: 0. Wins: 0.
Player WeakAndWeary does not show cards.Bets: 0. Collects: 0. Wins: 0.
Game ended at: 2016/11/29 13:13:13

Game started
Game ID: 786970213 0.50/1 (PRR) Kraken - 7 (Hold'em)
Seat 4 is the button
Seat 1: gust (41.58).
Seat 2: WeakAndWeary (101.50).
Seat 4: IlxxxlI (40).
Seat 6: MadLifeGrinder (106.07).
Player MadLifeGrinder has small blind (0.50)
Player gust sitting out
Player WeakAndWeary has big blind (1)
Player IlxxxlI received card: [Qd]
Player IlxxxlI received card: [6s]
Player IlxxxlI folds
Player MadLifeGrinder folds
Uncalled bet (0.50) returned to WeakAndWeary
Player WeakAndWeary mucks cards
------ Summary ------
Pot: 1. Rake 0
Player gust does not show cards.Bets: 0. Collects: 0. Wins: 0.
*Player WeakAndWeary mucks (does not show cards). Bets: 0.50. Collects: 1. Wins: 0.50.
Player IlxxxlI does not show cards.Bets: 0. Collects: 0. Wins: 0.
Player MadLifeGrinder does not show cards.Bets: 0.50. Collects: 0. Loses: 0.50.
Game ended at: 2016/11/29 13:12:40

Game started
Game ID: 786970095 0.25/0.50 (PRR) Gorgons - 18 (Hold'em)
Seat 1 is the button
Seat 1: Abundance4All (89.32).
Seat 2: xROCKETMANx (55.71).
Seat 3: imperceptible (20).
Seat 4: IlxxxlI (20).
Seat 5: GagaPoker (70.96).
Seat 6: foreseen (68.72).
Player xROCKETMANx has small blind (0.25)
Player imperceptible is timed out.
Player imperceptible sitting out
Player IlxxxlI has big blind (0.50)
Player IlxxxlI received card: [Jc]
Player IlxxxlI received card: [3d]
Player GagaPoker folds
Player foreseen folds
Player Abundance4All folds
Player xROCKETMANx raises (1.25)
Player IlxxxlI folds
Uncalled bet (1) returned to xROCKETMANx
Player xROCKETMANx mucks cards
------ Summary ------
Pot: 1. Rake 0
Player Abundance4All does not show cards.Bets: 0. Collects: 0. Wins: 0.
*Player xROCKETMANx mucks (does not show cards). Bets: 0.50. Collects: 1. Wins: 0.50.
Player imperceptible does not show cards.Bets: 0. Collects: 0. Wins: 0.
Player IlxxxlI does not show cards.Bets: 0.50. Collects: 0. Loses: 0.50.
Player GagaPoker does not show cards.Bets: 0. Collects: 0. Wins: 0.
Player foreseen does not show cards.Bets: 0. Collects: 0. Wins: 0.
Game ended at: 2016/11/29 13:13:5

Game started
Game ID: 786970009 0.25/0.50 (PRR) Gorgons - 19 (Hold'em)
Seat 1 is the button
Seat 1: MirrorZrorriM (60.65).
Seat 2: IlxxxlI (20).
Seat 3: constant revelation (44.45).
Seat 6: QDevilQ (59.94).
Player IlxxxlI has small blind (0.25)
Player constant revelation has big blind (0.50)
Player IlxxxlI received card: [3d]
Player IlxxxlI received card: [As]
Player QDevilQ folds
Player MirrorZrorriM raises (1.50)
Player IlxxxlI folds
Player constant revelation calls (1)
*** FLOP ***: [7s 8c Qd]
Player constant revelation checks
Player MirrorZrorriM bets (2.30)
Player constant revelation folds
Uncalled bet (2.30) returned to MirrorZrorriM
Player MirrorZrorriM mucks cards
------ Summary ------
Pot: 3.09. Rake 0.12. JP fee 0.04
Board: [7s 8c Qd]
*Player MirrorZrorriM mucks (does not show cards). Bets: 1.50. Collects: 3.09. Wins: 1.59.
Player IlxxxlI does not show cards.Bets: 0.25. Collects: 0. Loses: 0.25.
Player constant revelation does not show cards.Bets: 1.50. Collects: 0. Loses: 1.50.
Player QDevilQ does not show cards.Bets: 0. Collects: 0. Wins: 0.
Game ended at: 2016/11/29 13:12:42

Game started
Game ID: 786969927 0.50/1 (PRR) Kraken (Hold'em)
Seat 4 is the button
Seat 1: WeakAndWeary (127.16).
Seat 2: MadLifeGrinder (100).
Seat 4: LloydXmas (169.83).
Seat 6: IlxxxlI (48.53).
Player IlxxxlI has small blind (0.50)
Player WeakAndWeary has big blind (1)
Player IlxxxlI received card: [7c]
Player IlxxxlI received card: [3s]
Player MadLifeGrinder folds
Player LloydXmas folds
Player IlxxxlI folds
Uncalled bet (0.50) returned to WeakAndWeary
Player WeakAndWeary mucks cards
------ Summary ------
Pot: 1. Rake 0
*Player WeakAndWeary mucks (does not show cards). Bets: 0.50. Collects: 1. Wins: 0.50.
Player MadLifeGrinder does not show cards.Bets: 0. Collects: 0. Wins: 0.
Player LloydXmas does not show cards.Bets: 0. Collects: 0. Wins: 0.
Player IlxxxlI does not show cards.Bets: 0.50. Collects: 0. Loses: 0.50.
Game ended at: 2016/11/29 13:12:26

Game started
Game ID: 786969812 1/2 (PRR) Lakhey (Hold'em)
Seat 6 is the button
Seat 1: bfish602 (202).
Seat 2: KingGuciGuci (212.22).
Seat 3: IbetUmuck (709.42).
Seat 4: IlxxxlI (80).
Seat 5: MadLifeGrinder (210.21).
Seat 6: LazyFish (288.05).
Player bfish602 has small blind (1)
Player KingGuciGuci has big blind (2)
Player IlxxxlI received card: [5c]
Player IlxxxlI received card: [Ac]
Player IbetUmuck raises (5.75)
Player IlxxxlI folds
Player MadLifeGrinder folds
Player LazyFish folds
Player bfish602 folds
Player KingGuciGuci folds
Uncalled bet (3.75) returned to IbetUmuck
Player IbetUmuck mucks cards
------ Summary ------
Pot: 5. Rake 0
Player bfish602 does not show cards.Bets: 1. Collects: 0. Loses: 1.
Player KingGuciGuci does not show cards.Bets: 2. Collects: 0. Loses: 2.
*Player IbetUmuck mucks (does not show cards). Bets: 2. Collects: 5. Wins: 3.
Player IlxxxlI does not show cards.Bets: 0. Collects: 0. Wins: 0.
Player MadLifeGrinder does not show cards.Bets: 0. Collects: 0. Wins: 0.
Player LazyFish does not show cards.Bets: 0. Collects: 0. Wins: 0.
Game ended at: 2016/11/29 13:12:34

Game started
Game ID: 786969810 0.25/0.50 (PRR) Gorgons - 9 (Hold'em)
Seat 6 is the button
Seat 1: xROCKETMANx (136.71).
Seat 2: Jui Kuen (59.93).
Seat 3: IlxxxlI (20).
Seat 4: foreseen (51.37).
Seat 5: Beep_Beep (50).
Seat 6: violin2 (49.25).
Player xROCKETMANx has small blind (0.25)
Player Jui Kuen has big blind (0.50)
Player IlxxxlI received card: [10d]
Player IlxxxlI received card: [2c]
Player IlxxxlI folds
Player foreseen folds
Player Beep_Beep raises (1.50)
Player violin2 calls (1.50)
Player xROCKETMANx folds
Player Jui Kuen calls (1)
*** FLOP ***: [Qc Ad 5d]
Player Jui Kuen checks
Player Beep_Beep checks
Player violin2 bets (3)
Player Jui Kuen calls (3)
Player Beep_Beep folds
*** TURN ***: [Qc Ad 5d] [3c]
Player Jui Kuen checks
Player violin2 bets (6)
Player Jui Kuen calls (6)
*** RIVER ***: [Qc Ad 5d 3c] [9c]
Player Jui Kuen checks
Player violin2 bets (10.50)
Player Jui Kuen folds
Uncalled bet (10.50) returned to violin2
Player violin2 mucks cards
------ Summary ------
Pot: 21.62. Rake 0.89. JP fee 0.24
Board: [Qc Ad 5d 3c 9c]
Player xROCKETMANx does not show cards.Bets: 0.25. Collects: 0. Loses: 0.25.
Player Jui Kuen does not show cards.Bets: 10.50. Collects: 0. Loses: 10.50.
Player IlxxxlI does not show cards.Bets: 0. Collects: 0. Wins: 0.
Player foreseen does not show cards.Bets: 0. Collects: 0. Wins: 0.
Player Beep_Beep does not show cards.Bets: 1.50. Collects: 0. Loses: 1.50.
*Player violin2 mucks (does not show cards). Bets: 10.50. Collects: 21.62. Wins: 11.12.
Game ended at: 2016/11/29 13:14:2

Game started
Game ID: 786969686 0.50/1 (PRR) Kraken - 22 (Hold'em)
Seat 1 is the button
Seat 1: meandkids (8.38).
Seat 2: IlxxxlI (40).
Seat 3: Beep_Beep (215.50).
Seat 4: gust (40).
Seat 5: MadLifeGrinder (100).
Seat 6: WeakAndWeary (265.92).
Player IlxxxlI has small blind (0.50)
Player Beep_Beep has big blind (1)
Player IlxxxlI received card: [Qc]
Player IlxxxlI received card: [7h]
Player gust folds
Player MadLifeGrinder folds
Player WeakAndWeary folds
Player meandkids folds
Player IlxxxlI folds
Uncalled bet (0.50) returned to Beep_Beep
Player Beep_Beep mucks cards
------ Summary ------
Pot: 1. Rake 0
Player meandkids does not show cards.Bets: 0. Collects: 0. Wins: 0.
Player IlxxxlI does not show cards.Bets: 0.50. Collects: 0. Loses: 0.50.
*Player Beep_Beep mucks (does not show cards). Bets: 0.50. Collects: 1. Wins: 0.50.
Player gust does not show cards.Bets: 0. Collects: 0. Wins: 0.
Player MadLifeGrinder does not show cards.Bets: 0. Collects: 0. Wins: 0.
Player WeakAndWeary does not show cards.Bets: 0. Collects: 0. Wins: 0.
Game ended at: 2016/11/29 13:12:21

Game started
Game ID: 786969678 0.50/1 (PRR) Kraken - 7 (Hold'em)
Seat 2 is the button
Seat 1: gust (40.08).
Seat 2: WeakAndWeary (101.50).
Seat 4: IlxxxlI (40).
Seat 5: Im Don King (112.70).
Seat 6: MadLifeGrinder (107.07).
Player IlxxxlI has small blind (0.50)
Player Im Don King sitting out
Player MadLifeGrinder has big blind (1)
Player IlxxxlI received card: [Ks]
Player IlxxxlI received card: [8c]
Player gust raises (2)
Player WeakAndWeary folds
Player IlxxxlI folds
Player MadLifeGrinder folds
Uncalled bet (1) returned to gust
Player gust mucks cards
------ Summary ------
Pot: 2.50. Rake 0
*Player gust mucks (does not show cards). Bets: 1. Collects: 2.50. Wins: 1.50.
Player WeakAndWeary does not show cards.Bets: 0. Collects: 0. Wins: 0.
Player IlxxxlI does not show cards.Bets: 0.50. Collects: 0. Loses: 0.50.
Player Im Don King does not show cards.Bets: 0. Collects: 0. Wins: 0.
Player MadLifeGrinder does not show cards.Bets: 1. Collects: 0. Loses: 1.
Game ended at: 2016/11/29 13:12:22

Game started
Game ID: 786969646 1/2 (PRR) Lakhey (Hold'em)
Seat 5 is the button
Seat 1: bfish602 (204).
Seat 2: KingGuciGuci (209.22).
Seat 3: IbetUmuck (709.42).
Seat 4: IlxxxlI (80).
Seat 5: MadLifeGrinder (210.21).
Seat 6: LazyFish (289.05).
Player LazyFish has small blind (1)
Player bfish602 has big blind (2)
Player IlxxxlI received card: [Kh]
Player IlxxxlI received card: [7c]
Player KingGuciGuci raises (5)
Player IbetUmuck folds
Player IlxxxlI folds
Player MadLifeGrinder folds
Player LazyFish folds
Player bfish602 folds
Uncalled bet (3) returned to KingGuciGuci
Player KingGuciGuci mucks cards
------ Summary ------
Pot: 5. Rake 0
Player bfish602 does not show cards.Bets: 2. Collects: 0. Loses: 2.
*Player KingGuciGuci mucks (does not show cards). Bets: 2. Collects: 5. Wins: 3.
Player IbetUmuck does not show cards.Bets: 0. Collects: 0. Wins: 0.
Player IlxxxlI does not show cards.Bets: 0. Collects: 0. Wins: 0.
Player MadLifeGrinder does not show cards.Bets: 0. Collects: 0. Wins: 0.
Player LazyFish does not show cards.Bets: 1. Collects: 0. Loses: 1.
Game ended at: 2016/11/29 13:11:42

Game started
Game ID: 786969643 0.25/0.50 (PRR) Gorgons - 19 (Hold'em)
Seat 6 is the button
Seat 1: MirrorZrorriM (60.90).
Seat 2: IlxxxlI (20).
Seat 3: constant revelation (40.58).
Seat 6: QDevilQ (63.44).
Player MirrorZrorriM has small blind (0.25)
Player IlxxxlI has big blind (0.50)
Player IlxxxlI received card: [3h]
Player IlxxxlI received card: [6h]
Player constant revelation calls (0.50)
Player QDevilQ raises (2)
Player MirrorZrorriM folds
Player IlxxxlI folds
Player constant revelation calls (1.50)
*** FLOP ***: [6c 5d 5h]
Player constant revelation checks
Player QDevilQ bets (1.50)
Player constant revelation raises (3)
Player QDevilQ folds
Uncalled bet (1.50) returned to constant revelation
Player constant revelation mucks cards
------ Summary ------
Pot: 7.37. Rake 0.26. JP fee 0.12
Board: [6c 5d 5h]
Player MirrorZrorriM does not show cards.Bets: 0.25. Collects: 0. Loses: 0.25.
Player IlxxxlI does not show cards.Bets: 0.50. Collects: 0. Loses: 0.50.
*Player constant revelation mucks (does not show cards). Bets: 3.50. Collects: 7.37. Wins: 3.87.
Player QDevilQ does not show cards.Bets: 3.50. Collects: 0. Loses: 3.50.
Game ended at: 2016/11/29 13:12:1

Game started
Game ID: 786969468 0.25/0.50 (PRR) Gorgons - 9 (Hold'em)
Seat 5 is the button
Seat 1: xROCKETMANx (137.21).
Seat 2: Jui Kuen (59.93).
Seat 3: IlxxxlI (20).
Seat 4: foreseen (51.37).
Seat 5: Beep_Beep (50).
Seat 6: violin2 (48.75).
Player violin2 has small blind (0.25)
Player xROCKETMANx has big blind (0.50)
Player IlxxxlI received card: [Kc]
Player IlxxxlI received card: [2h]
Player Jui Kuen folds
Player IlxxxlI folds
Player foreseen folds
Player Beep_Beep folds
Player violin2 raises (1.25)
Player xROCKETMANx folds
Uncalled bet (1) returned to violin2
Player violin2 mucks cards
------ Summary ------
Pot: 1. Rake 0
Player xROCKETMANx does not show cards.Bets: 0.50. Collects: 0. Loses: 0.50.
Player Jui Kuen does not show cards.Bets: 0. Collects: 0. Wins: 0.
Player IlxxxlI does not show cards.Bets: 0. Collects: 0. Wins: 0.
Player foreseen does not show cards.Bets: 0. Collects: 0. Wins: 0.
Player Beep_Beep does not show cards.Bets: 0. Collects: 0. Wins: 0.
*Player violin2 mucks (does not show cards). Bets: 0.50. Collects: 1. Wins: 0.50.
Game ended at: 2016/11/29 13:11:41

Game started
Game ID: 786969355 0.25/0.50 (PRR) Gorgons - 18 (Hold'em)
Seat 6 is the button
Seat 1: Abundance4All (89.57).
Seat 2: xROCKETMANx (56.21).
Seat 4: IlxxxlI (20).
Seat 5: GagaPoker (70.21).
Seat 6: foreseen (68.72).
Player Abundance4All has small blind (0.25)
Player xROCKETMANx has big blind (0.50)
Player IlxxxlI received card: [Qd]
Player IlxxxlI received card: [7s]
Player IlxxxlI folds
Player GagaPoker raises (1)
Player foreseen folds
Player Abundance4All folds
Player xROCKETMANx folds
Uncalled bet (0.50) returned to GagaPoker
Player GagaPoker mucks cards
------ Summary ------
Pot: 1.25. Rake 0
Player Abundance4All does not show cards.Bets: 0.25. Collects: 0. Loses: 0.25.
Player xROCKETMANx does not show cards.Bets: 0.50. Collects: 0. Loses: 0.50.
Player IlxxxlI does not show cards.Bets: 0. Collects: 0. Wins: 0.
*Player GagaPoker mucks (does not show cards). Bets: 0.50. Collects: 1.25. Wins: 0.75.
Player foreseen does not show cards.Bets: 0. Collects: 0. Wins: 0.
Game ended at: 2016/11/29 13:12:10

Game started
Game ID: 786969271 0.50/1 (PRR) Kraken - 22 (Hold'em)
Seat 6 is the button
Seat 1: meandkids (7.38).
Seat 2: IlxxxlI (40).
Seat 3: Beep_Beep (215.50).
Seat 4: gust (40).
Seat 5: MadLifeGrinder (100).
Seat 6: WeakAndWeary (265.92).
Player meandkids has small blind (0.50)
Player IlxxxlI has big blind (1)
Player IlxxxlI received card: [2d]
Player IlxxxlI received card: [10h]
Player Beep_Beep folds
Player gust folds
Player MadLifeGrinder folds
Player WeakAndWeary folds
Player meandkids allin (6.88)
Player IlxxxlI folds
Uncalled bet (6.38) returned to meandkids
Player meandkids mucks cards
------ Summary ------
Pot: 2. Rake 0
*Player meandkids mucks (does not show cards). Bets: 1. Collects: 2. Wins: 1.
Player IlxxxlI does not show cards.Bets: 1. Collects: 0. Loses: 1.
Player Beep_Beep does not show cards.Bets: 0. Collects: 0. Wins: 0.
Player gust does not show cards.Bets: 0. Collects: 0. Wins: 0.
Player MadLifeGrinder does not show cards.Bets: 0. Collects: 0. Wins: 0.
Player WeakAndWeary does not show cards.Bets: 0. Collects: 0. Wins: 0.
Game ended at: 2016/11/29 13:11:28

Game started
Game ID: 786969109 0.25/0.50 (PRR) Gorgons - 19 (Hold'em)
Seat 4 is the button
Seat 1: MirrorZrorriM (61.40).
Seat 2: IlxxxlI (20).
Seat 3: constant revelation (40.58).
Seat 4: FLDnLIVE2FLDagn (60.14).
Seat 6: QDevilQ (62.94).
Player QDevilQ has small blind (0.25)
Player MirrorZrorriM has big blind (0.50)
Player IlxxxlI received card: [Jh]
Player IlxxxlI received card: [7d]
Player IlxxxlI is timed out.
Player IlxxxlI folds
Player constant revelation folds
Player FLDnLIVE2FLDagn folds
Player QDevilQ raises (1.25)
Player MirrorZrorriM folds
Uncalled bet (1) returned to QDevilQ
Player QDevilQ mucks cards
------ Summary ------
Pot: 1. Rake 0
Player MirrorZrorriM does not show cards.Bets: 0.50. Collects: 0. Loses: 0.50.
Player IlxxxlI does not show cards.Bets: 0. Collects: 0. Wins: 0.
Player constant revelation does not show cards.Bets: 0. Collects: 0. Wins: 0.
Player FLDnLIVE2FLDagn does not show cards.Bets: 0. Collects: 0. Wins: 0.
*Player QDevilQ mucks (does not show cards). Bets: 0.50. Collects: 1. Wins: 0.50.
Game ended at: 2016/11/29 13:11:25

Game started
Game ID: 786969056 0.50/1 (PRR) Kraken - 7 (Hold'em)
Seat 1 is the button
Seat 1: gust (40.08).
Seat 2: WeakAndWeary (102).
Seat 3: Beep_Beep (106.75).
Seat 4: IlxxxlI (40).
Seat 5: Im Don King (111.20).
Seat 6: MadLifeGrinder (107.07).
Player WeakAndWeary has small blind (0.50)
Player Beep_Beep sitting out
Player IlxxxlI has big blind (1)
Player IlxxxlI received card: [10h]
Player IlxxxlI received card: [5s]
Player Im Don King raises (2.35)
Player MadLifeGrinder folds
Player gust folds
Player WeakAndWeary folds
Player IlxxxlI folds
Uncalled bet (1.35) returned to Im Don King
Player Im Don King mucks cards
------ Summary ------
Pot: 2.50. Rake 0
Player gust does not show cards.Bets: 0. Collects: 0. Wins: 0.
Player WeakAndWeary does not show cards.Bets: 0.50. Collects: 0. Loses: 0.50.
Player Beep_Beep does not show cards.Bets: 0. Collects: 0. Wins: 0.
Player IlxxxlI does not show cards.Bets: 1. Collects: 0. Loses: 1.
*Player Im Don King mucks (does not show cards). Bets: 1. Collects: 2.50. Wins: 1.50.
Player MadLifeGrinder does not show cards.Bets: 0. Collects: 0. Wins: 0.
Game ended at: 2016/11/29 13:11:27

Game started
Game ID: 786969011 0.25/0.50 (PRR) Gorgons - 18 (Hold'em)
Seat 5 is the button
Seat 1: Abundance4All (90.07).
Seat 2: xROCKETMANx (55.52).
Seat 4: IlxxxlI (20).
Seat 5: GagaPoker (70.21).
Seat 6: foreseen (68.97).
Player foreseen has small blind (0.25)
Player Abundance4All has big blind (0.50)
Player IlxxxlI received card: [10s]
Player IlxxxlI received card: [7d]
Player xROCKETMANx calls (0.50)
Player IlxxxlI folds
Player GagaPoker folds
Player foreseen folds
Player Abundance4All checks
*** FLOP ***: [Jh Qs 8d]
Player Abundance4All checks
Player xROCKETMANx bets (0.79)
Player Abundance4All folds
Uncalled bet (0.79) returned to xROCKETMANx
Player xROCKETMANx mucks cards
------ Summary ------
Pot: 1.19. Rake 0.04. JP fee 0.02
Board: [Jh Qs 8d]
Player Abundance4All does not show cards.Bets: 0.50. Collects: 0. Loses: 0.50.
*Player xROCKETMANx mucks (does not show cards). Bets: 0.50. Collects: 1.19. Wins: 0.69.
Player IlxxxlI does not show cards.Bets: 0. Collects: 0. Wins: 0.
Player GagaPoker does not show cards.Bets: 0. Collects: 0. Wins: 0.
Player foreseen does not show cards.Bets: 0.25. Collects: 0. Loses: 0.25.
Game ended at: 2016/11/29 13:10:54

Game started
Game ID: 786968898 0.25/0.50 (PRR) Gorgons - 19 (Hold'em)
Seat 3 is the button
Seat 1: MirrorZrorriM (61.40).
Seat 2: IlxxxlI (20).
Seat 3: constant revelation (40.58).
Seat 4: FLDnLIVE2FLDagn (60.39).
Seat 6: QDevilQ (62.69).
Player FLDnLIVE2FLDagn has small blind (0.25)
Player QDevilQ has big blind (0.50)
Player IlxxxlI received card: [4s]
Player IlxxxlI received card: [8s]
Player MirrorZrorriM folds
Player IlxxxlI folds
Player constant revelation folds
Player FLDnLIVE2FLDagn folds
Uncalled bet (0.25) returned to QDevilQ
Player QDevilQ mucks cards
------ Summary ------
Pot: 0.50. Rake 0
Player MirrorZrorriM does not show cards.Bets: 0. Collects: 0. Wins: 0.
Player IlxxxlI does not show cards.Bets: 0. Collects: 0. Wins: 0.
Player constant revelation does not show cards.Bets: 0. Collects: 0. Wins: 0.
Player FLDnLIVE2FLDagn does not show cards.Bets: 0.25. Collects: 0. Loses: 0.25.
*Player QDevilQ mucks (does not show cards). Bets: 0.25. Collects: 0.50. Wins: 0.25.
Game ended at: 2016/11/29 13:10:29

Game started
Game ID: 786968872 0.25/0.50 (PRR) Gorgons - 9 (Hold'em)
Seat 4 is the button
Seat 1: xROCKETMANx (137.21).
Seat 2: Jui Kuen (59.93).
Seat 3: IlxxxlI (20).
Seat 4: foreseen (50).
Seat 5: Beep_Beep (50).
Seat 6: violin2 (50).
Player Beep_Beep has small blind (0.25)
Player violin2 has big blind (0.50)
Player IlxxxlI received card: [3c]
Player IlxxxlI received card: [Kc]
Player xROCKETMANx folds
Player Jui Kuen folds
Player IlxxxlI folds
Player foreseen raises (1.25)
Player Beep_Beep folds
Player violin2 calls (0.75)
*** FLOP ***: [As 8d Jc]
Player violin2 checks
Player foreseen bets (1.36)
Player violin2 folds
Uncalled bet (1.36) returned to foreseen
Player foreseen mucks cards
------ Summary ------
Pot: 2.62. Rake 0.09. JP fee 0.04
Board: [As 8d Jc]
Player xROCKETMANx does not show cards.Bets: 0. Collects: 0. Wins: 0.
Player Jui Kuen does not show cards.Bets: 0. Collects: 0. Wins: 0.
Player IlxxxlI does not show cards.Bets: 0. Collects: 0. Wins: 0.
*Player foreseen mucks (does not show cards). Bets: 1.25. Collects: 2.62. Wins: 1.37.
Player Beep_Beep does not show cards.Bets: 0.25. Collects: 0. Loses: 0.25.
Player violin2 does not show cards.Bets: 1.25. Collects: 0. Loses: 1.25.
Game ended at: 2016/11/29 13:11:5

Game started
Game ID: 786968690 0.50/1 (PRR) Kraken - 22 (Hold'em)
Seat 5 is the button
Seat 1: meandkids (107.38).
Seat 2: IlxxxlI (40).
Seat 3: Beep_Beep (100).
Seat 4: gust (40).
Seat 5: MadLifeGrinder (100).
Seat 6: WeakAndWeary (280.92).
Player WeakAndWeary has small blind (0.50)
Player meandkids has big blind (1)
Player IlxxxlI received card: [Ah]
Player IlxxxlI received card: [9h]
Player IlxxxlI raises (3.50)
Player Beep_Beep calls (3.50)
Player gust folds
Player MadLifeGrinder folds
Player WeakAndWeary raises (14.50)
Player meandkids calls (14)
Player IlxxxlI folds
Player Beep_Beep allin (96.50)
Player WeakAndWeary folds
Player meandkids calls (85)
*** FLOP ***: [6h 7s 3h]
*** TURN ***: [6h 7s 3h] [Jc]
*** RIVER ***: [6h 7s 3h Jc] [3s]
------ Summary ------
Pot: 215.50. Rake 2.76. JP fee 0.24
Board: [6h 7s 3h Jc 3s]
Player meandkids shows: Two pairs. 8s and 3s [8h 8c]. Bets: 100. Collects: 0. Loses: 100.
Player IlxxxlI does not show cards.Bets: 3.50. Collects: 0. Loses: 3.50.
*Player Beep_Beep shows: Two pairs. As and 3s [Ac Ad]. Bets: 100. Collects: 215.50. Wins: 115.50.
Player gust does not show cards.Bets: 0. Collects: 0. Wins: 0.
Player MadLifeGrinder does not show cards.Bets: 0. Collects: 0. Wins: 0.
Player WeakAndWeary does not show cards.Bets: 15. Collects: 0. Loses: 15.
Game ended at: 2016/11/29 13:10:43

Game started
Game ID: 786968678 0.25/0.50 (PRR) Gorgons - 18 (Hold'em)
Seat 4 is the button
Seat 1: Abundance4All (90.07).
Seat 2: xROCKETMANx (54.77).
Seat 4: IlxxxlI (20).
Seat 5: GagaPoker (70.46).
Seat 6: foreseen (69.47).
Player GagaPoker has small blind (0.25)
Player foreseen has big blind (0.50)
Player IlxxxlI received card: [Kc]
Player IlxxxlI received card: [10d]
Player Abundance4All folds
Player xROCKETMANx raises (1)
Player IlxxxlI folds
Player GagaPoker folds
Player foreseen folds
Uncalled bet (0.50) returned to xROCKETMANx
Player xROCKETMANx mucks cards
------ Summary ------
Pot: 1.25. Rake 0
Player Abundance4All does not show cards.Bets: 0. Collects: 0. Wins: 0.
*Player xROCKETMANx mucks (does not show cards). Bets: 0.50. Collects: 1.25. Wins: 0.75.
Player IlxxxlI does not show cards.Bets: 0. Collects: 0. Wins: 0.
Player GagaPoker does not show cards.Bets: 0.25. Collects: 0. Loses: 0.25.
Player foreseen does not show cards.Bets: 0.50. Collects: 0. Loses: 0.50.
Game ended at: 2016/11/29 13:10:19

Game started
Game ID: 786968641 0.50/1 (PRR) Kraken - 7 (Hold'em)
Seat 6 is the button
Seat 1: gust (40.58).
Seat 2: WeakAndWeary (101.50).
Seat 3: Beep_Beep (106.75).
Seat 4: IlxxxlI (40).
Seat 5: Im Don King (111.20).
Seat 6: MadLifeGrinder (107.07).
Player gust has small blind (0.50)
Player WeakAndWeary has big blind (1)
Player IlxxxlI received card: [5d]
Player IlxxxlI received card: [Kh]
Player Beep_Beep folds
Player IlxxxlI folds
Player Im Don King folds
Player MadLifeGrinder folds
Player gust folds
Uncalled bet (0.50) returned to WeakAndWeary
Player WeakAndWeary mucks cards
------ Summary ------
Pot: 1. Rake 0
Player gust does not show cards.Bets: 0.50. Collects: 0. Loses: 0.50.
*Player WeakAndWeary mucks (does not show cards). Bets: 0.50. Collects: 1. Wins: 0.50.
Player Beep_Beep does not show cards.Bets: 0. Collects: 0. Wins: 0.
Player IlxxxlI does not show cards.Bets: 0. Collects: 0. Wins: 0.
Player Im Don King does not show cards.Bets: 0. Collects: 0. Wins: 0.
Player MadLifeGrinder does not show cards.Bets: 0. Collects: 0. Wins: 0.
Game ended at: 2016/11/29 13:10:24

Game started
Game ID: 786968612 0.50/1 (PRR) Kraken (Hold'em)
Seat 2 is the button
Seat 1: WeakAndWeary (127.16).
Seat 2: MadLifeGrinder (100).
Seat 4: LloydXmas (131.37).
Seat 6: IlxxxlI (49.53).
Player LloydXmas has small blind (0.50)
Player IlxxxlI has big blind (1)
Player IlxxxlI received card: [5d]
Player IlxxxlI received card: [4c]
Player WeakAndWeary folds
Player MadLifeGrinder raises (2.50)
Player LloydXmas raises (9.50)
Player IlxxxlI folds
Player MadLifeGrinder calls (7.50)
*** FLOP ***: [Qh Ad 7d]
Player LloydXmas bets (9.98)
Player MadLifeGrinder calls (9.98)
*** TURN ***: [Qh Ad 7d] [Qs]
Player LloydXmas bets (19.48)
Player MadLifeGrinder calls (19.48)
*** RIVER ***: [Qh Ad 7d Qs] [10c]
Player LloydXmas allin (91.91)
Player MadLifeGrinder folds
Uncalled bet (91.91) returned to LloydXmas
Player LloydXmas mucks cards
------ Summary ------
Pot: 77.92. Rake 1.76. JP fee 0.24
Board: [Qh Ad 7d Qs 10c]
Player WeakAndWeary does not show cards.Bets: 0. Collects: 0. Wins: 0.
Player MadLifeGrinder does not show cards.Bets: 39.46. Collects: 0. Loses: 39.46.
*Player LloydXmas mucks (does not show cards). Bets: 39.46. Collects: 77.92. Wins: 38.46.
Player IlxxxlI does not show cards.Bets: 1. Collects: 0. Loses: 1.
Game ended at: 2016/11/29 13:11:53

Game started
Game ID: 786968594 0.25/0.50 (PRR) Gorgons - 19 (Hold'em)
Seat 2 is the button
Seat 1: MirrorZrorriM (61.40).
Seat 2: IlxxxlI (20).
Seat 3: constant revelation (39.65).
Seat 4: FLDnLIVE2FLDagn (60.89).
Seat 6: QDevilQ (62.69).
Player constant revelation has small blind (0.25)
Player FLDnLIVE2FLDagn has big blind (0.50)
Player IlxxxlI received card: [10h]
Player IlxxxlI received card: [6h]
Player QDevilQ folds
Player MirrorZrorriM folds
Player IlxxxlI calls (0.50)
Player constant revelation calls (0.25)
Player FLDnLIVE2FLDagn checks
*** FLOP ***: [2h Ac Qs]
Player constant revelation bets (0.71)
Player FLDnLIVE2FLDagn folds
Player IlxxxlI folds
Uncalled bet (0.71) returned to constant revelation
Player constant revelation mucks cards
------ Summary ------
Pot: 1.43. Rake 0.05. JP fee 0.02
Board: [2h Ac Qs]
Player MirrorZrorriM does not show cards.Bets: 0. Collects: 0. Wins: 0.
Player IlxxxlI does not show cards.Bets: 0.50. Collects: 0. Loses: 0.50.
*Player constant revelation mucks (does not show cards). Bets: 0.50. Collects: 1.43. Wins: 0.93.
Player FLDnLIVE2FLDagn does not show cards.Bets: 0.50. Collects: 0. Loses: 0.50.
Player QDevilQ does not show cards.Bets: 0. Collects: 0. Wins: 0.
Game ended at: 2016/11/29 13:10:5

Game started
Game ID: 786968377 0.25/0.50 (PRR) Gorgons - 19 (Hold'em)
Seat 1 is the button
Seat 1: MirrorZrorriM (61.40).
Seat 2: IlxxxlI (20).
Seat 3: constant revelation (39.40).
Seat 4: FLDnLIVE2FLDagn (60.89).
Seat 6: QDevilQ (62.69).
Player IlxxxlI has small blind (0.25)
Player constant revelation has big blind (0.50)
Player IlxxxlI received card: [4d]
Player IlxxxlI received card: [8c]
Player FLDnLIVE2FLDagn folds
Player QDevilQ folds
Player MirrorZrorriM folds
Player IlxxxlI folds
Uncalled bet (0.25) returned to constant revelation
Player constant revelation mucks cards
------ Summary ------
Pot: 0.50. Rake 0
Player MirrorZrorriM does not show cards.Bets: 0. Collects: 0. Wins: 0.
Player IlxxxlI does not show cards.Bets: 0.25. Collects: 0. Loses: 0.25.
*Player constant revelation mucks (does not show cards). Bets: 0.25. Collects: 0.50. Wins: 0.25.
Player FLDnLIVE2FLDagn does not show cards.Bets: 0. Collects: 0. Wins: 0.
Player QDevilQ does not show cards.Bets: 0. Collects: 0. Wins: 0.
Game ended at: 2016/11/29 13:9:37

Game started
Game ID: 786968272 0.50/1 (PRR) Kraken (Hold'em)
Seat 1 is the button
Seat 1: WeakAndWeary (127.16).
Seat 2: MadLifeGrinder (100).
Seat 3: Beep_Beep (105.50).
Seat 4: LloydXmas (132.37).
Seat 6: IlxxxlI (48.03).
Player MadLifeGrinder has small blind (0.50)
Player Beep_Beep sitting out
Player LloydXmas has big blind (1)
Player IlxxxlI received card: [Qd]
Player IlxxxlI received card: [Qs]
Player IlxxxlI raises (2.40)
Player WeakAndWeary folds
Player MadLifeGrinder folds
Player LloydXmas folds
Uncalled bet (1.40) returned to IlxxxlI
Player IlxxxlI mucks cards
------ Summary ------
Pot: 2.50. Rake 0
Player WeakAndWeary does not show cards.Bets: 0. Collects: 0. Wins: 0.
Player MadLifeGrinder does not show cards.Bets: 0.50. Collects: 0. Loses: 0.50.
Player Beep_Beep does not show cards.Bets: 0. Collects: 0. Wins: 0.
Player LloydXmas does not show cards.Bets: 1. Collects: 0. Loses: 1.
*Player IlxxxlI mucks (does not show cards). Bets: 1. Collects: 2.50. Wins: 1.50.
Game ended at: 2016/11/29 13:9:38

Game started
Game ID: 786968223 1/2 (PRR) Lakhey (Hold'em)
Seat 4 is the button
Seat 1: bfish602 (204).
Seat 2: KingGuciGuci (209.22).
Seat 3: IbetUmuck (709.42).
Seat 4: IlxxxlI (86.67).
Seat 5: MadLifeGrinder (211.21).
Seat 6: LazyFish (264.70).
Player MadLifeGrinder has small blind (1)
Player LazyFish has big blind (2)
Player IlxxxlI received card: [Kd]
Player IlxxxlI received card: [6d]
Player bfish602 folds
Player KingGuciGuci folds
Player IbetUmuck folds
Player IlxxxlI raises (6)
Player MadLifeGrinder folds
Player LazyFish calls (4)
*** FLOP ***: [10d Qc 4d]
Player LazyFish checks
Player IlxxxlI bets (6.42)
Player LazyFish raises (20)
Player IlxxxlI calls (13.58)
*** TURN ***: [10d Qc 4d] [6s]
Player LazyFish bets (66)
Player IlxxxlI folds
Uncalled bet (66) returned to LazyFish
Player LazyFish mucks cards
------ Summary ------
Pot: 50.35. Rake 2.41. JP fee 0.24
Board: [10d Qc 4d 6s]
Player bfish602 does not show cards.Bets: 0. Collects: 0. Wins: 0.
Player KingGuciGuci does not show cards.Bets: 0. Collects: 0. Wins: 0.
Player IbetUmuck does not show cards.Bets: 0. Collects: 0. Wins: 0.
Player IlxxxlI does not show cards.Bets: 26. Collects: 0. Loses: 26.
Player MadLifeGrinder does not show cards.Bets: 1. Collects: 0. Loses: 1.
*Player LazyFish mucks (does not show cards). Bets: 26. Collects: 50.35. Wins: 24.35.
Game ended at: 2016/11/29 13:11:25

Game started
Game ID: 786968191 0.25/0.50 (PRR) Gorgons - 18 (Hold'em)
Seat 2 is the button
Seat 1: Abundance4All (89.32).
Seat 2: xROCKETMANx (54.77).
Seat 4: IlxxxlI (20).
Seat 5: GagaPoker (70.96).
Seat 6: foreseen (69.47).
Player IlxxxlI has small blind (0.25)
Player GagaPoker has big blind (0.50)
Player IlxxxlI received card: [4c]
Player IlxxxlI received card: [Qs]
Player foreseen folds
Player Abundance4All raises (1)
Player xROCKETMANx folds
Player IlxxxlI folds
Player GagaPoker folds
Uncalled bet (0.50) returned to Abundance4All
Player Abundance4All mucks cards
------ Summary ------
Pot: 1.25. Rake 0
*Player Abundance4All mucks (does not show cards). Bets: 0.50. Collects: 1.25. Wins: 0.75.
Player xROCKETMANx does not show cards.Bets: 0. Collects: 0. Wins: 0.
Player IlxxxlI does not show cards.Bets: 0.25. Collects: 0. Loses: 0.25.
Player GagaPoker does not show cards.Bets: 0.50. Collects: 0. Loses: 0.50.
Player foreseen does not show cards.Bets: 0. Collects: 0. Wins: 0.
Game ended at: 2016/11/29 13:9:44

Game started
Game ID: 786968169 0.50/1 (PRR) Kraken - 7 (Hold'em)
Seat 5 is the button
Seat 1: gust (41.58).
Seat 2: WeakAndWeary (100).
Seat 3: Beep_Beep (106.75).
Seat 4: IlxxxlI (40).
Seat 5: Im Don King (111.20).
Seat 6: MadLifeGrinder (107.57).
Player MadLifeGrinder has small blind (0.50)
Player gust has big blind (1)
Player IlxxxlI received card: [2c]
Player IlxxxlI received card: [6h]
Player WeakAndWeary raises (3)
Player Beep_Beep folds
Player IlxxxlI folds
Player Im Don King folds
Player MadLifeGrinder folds
Player gust folds
Uncalled bet (2) returned to WeakAndWeary
Player WeakAndWeary mucks cards
------ Summary ------
Pot: 2.50. Rake 0
Player gust does not show cards.Bets: 1. Collects: 0. Loses: 1.
*Player WeakAndWeary mucks (does not show cards). Bets: 1. Collects: 2.50. Wins: 1.50.
Player Beep_Beep does not show cards.Bets: 0. Collects: 0. Wins: 0.
Player IlxxxlI does not show cards.Bets: 0. Collects: 0. Wins: 0.
Player Im Don King does not show cards.Bets: 0. Collects: 0. Wins: 0.
Player MadLifeGrinder does not show cards.Bets: 0.50. Collects: 0. Loses: 0.50.
Game ended at: 2016/11/29 13:9:40

Game started
Game ID: 786967917 0.50/1 (PRR) Kraken (Hold'em)
Seat 6 is the button
Seat 1: WeakAndWeary (127.66).
Seat 2: MadLifeGrinder (100).
Seat 3: Beep_Beep (104).
Seat 4: LloydXmas (132.37).
Seat 6: IlxxxlI (48.03).
Player WeakAndWeary has small blind (0.50)
Player MadLifeGrinder has big blind (1)
Player IlxxxlI received card: [6h]
Player IlxxxlI received card: [7h]
Player Beep_Beep raises (3)
Player LloydXmas folds
Player IlxxxlI folds
Player WeakAndWeary folds
Player MadLifeGrinder folds
Uncalled bet (2) returned to Beep_Beep
Player Beep_Beep mucks cards
------ Summary ------
Pot: 2.50. Rake 0
Player WeakAndWeary does not show cards.Bets: 0.50. Collects: 0. Loses: 0.50.
Player MadLifeGrinder does not show cards.Bets: 1. Collects: 0. Loses: 1.
*Player Beep_Beep mucks (does not show cards). Bets: 1. Collects: 2.50. Wins: 1.50.
Player LloydXmas does not show cards.Bets: 0. Collects: 0. Wins: 0.
Player IlxxxlI does not show cards.Bets: 0. Collects: 0. Wins: 0.
Game ended at: 2016/11/29 13:9:6

Game started
Game ID: 786967918 0.25/0.50 (PRR) Gorgons - 19 (Hold'em)
Seat 6 is the button
Seat 1: MirrorZrorriM (61.65).
Seat 2: IlxxxlI (20).
Seat 3: constant revelation (44.40).
Seat 4: FLDnLIVE2FLDagn (60.89).
Seat 6: QDevilQ (57.47).
Player MirrorZrorriM has small blind (0.25)
Player IlxxxlI has big blind (0.50)
Player IlxxxlI received card: [3d]
Player IlxxxlI received card: [5s]
Player constant revelation raises (1.50)
Player FLDnLIVE2FLDagn folds
Player QDevilQ raises (5)
Player MirrorZrorriM folds
Player IlxxxlI folds
Player constant revelation calls (3.50)
*** FLOP ***: [Qd 5h Ac]
Player constant revelation checks
Player QDevilQ bets (3.40)
Player constant revelation folds
Uncalled bet (3.40) returned to QDevilQ
Player QDevilQ mucks cards
------ Summary ------
Pot: 10.22. Rake 0.37. JP fee 0.16
Board: [Qd 5h Ac]
Player MirrorZrorriM does not show cards.Bets: 0.25. Collects: 0. Loses: 0.25.
Player IlxxxlI does not show cards.Bets: 0.50. Collects: 0. Loses: 0.50.
Player constant revelation does not show cards.Bets: 5. Collects: 0. Loses: 5.
Player FLDnLIVE2FLDagn does not show cards.Bets: 0. Collects: 0. Wins: 0.
*Player QDevilQ mucks (does not show cards). Bets: 5. Collects: 10.22. Wins: 5.22.
Game ended at: 2016/11/29 13:9:16

Game started
Game ID: 786967848 1/2 (PRR) Lakhey (Hold'em)
Seat 3 is the button
Seat 1: bfish602 (204).
Seat 2: KingGuciGuci (209.22).
Seat 3: IbetUmuck (706.42).
Seat 4: IlxxxlI (87.67).
Seat 5: MadLifeGrinder (213.21).
Seat 6: LazyFish (264.70).
Player IlxxxlI has small blind (1)
Player MadLifeGrinder has big blind (2)
Player IlxxxlI received card: [7s]
Player IlxxxlI received card: [Qh]
Player LazyFish folds
Player bfish602 folds
Player KingGuciGuci folds
Player IbetUmuck raises (5.75)
Player IlxxxlI folds
Player MadLifeGrinder folds
Uncalled bet (3.75) returned to IbetUmuck
Player IbetUmuck mucks cards
------ Summary ------
Pot: 5. Rake 0
Player bfish602 does not show cards.Bets: 0. Collects: 0. Wins: 0.
Player KingGuciGuci does not show cards.Bets: 0. Collects: 0. Wins: 0.
*Player IbetUmuck mucks (does not show cards). Bets: 2. Collects: 5. Wins: 3.
Player IlxxxlI does not show cards.Bets: 1. Collects: 0. Loses: 1.
Player MadLifeGrinder does not show cards.Bets: 2. Collects: 0. Loses: 2.
Player LazyFish does not show cards.Bets: 0. Collects: 0. Wins: 0.
Game ended at: 2016/11/29 13:9:1

Game started
Game ID: 786967846 0.50/1 (PRR) Kraken - 22 (Hold'em)
Seat 4 is the button
Seat 1: meandkids (107.38).
Seat 2: IlxxxlI (40).
Seat 3: Beep_Beep (100).
Seat 4: gust (40).
Seat 5: MadLifeGrinder (100).
Seat 6: WeakAndWeary (278.64).
Player MadLifeGrinder has small blind (0.50)
Player WeakAndWeary has big blind (1)
Player IlxxxlI received card: [5h]
Player IlxxxlI received card: [5c]
Player meandkids folds
Player IlxxxlI raises (2)
Player Beep_Beep folds
Player gust folds
Player MadLifeGrinder folds
Player WeakAndWeary calls (1)
*** FLOP ***: [4s 10h 6h]
Player WeakAndWeary checks
Player IlxxxlI checks
*** TURN ***: [4s 10h 6h] [Kd]
Player WeakAndWeary bets (2.85)
Player IlxxxlI folds
Uncalled bet (2.85) returned to WeakAndWeary
Player WeakAndWeary mucks cards
------ Summary ------
Pot: 4.28. Rake 0.16. JP fee 0.06
Board: [4s 10h 6h Kd]
Player meandkids does not show cards.Bets: 0. Collects: 0. Wins: 0.
Player IlxxxlI does not show cards.Bets: 2. Collects: 0. Loses: 2.
Player Beep_Beep does not show cards.Bets: 0. Collects: 0. Wins: 0.
Player gust does not show cards.Bets: 0. Collects: 0. Wins: 0.
Player MadLifeGrinder does not show cards.Bets: 0.50. Collects: 0. Loses: 0.50.
*Player WeakAndWeary mucks (does not show cards). Bets: 2. Collects: 4.28. Wins: 2.28.
Game ended at: 2016/11/29 13:9:45

Game started
Game ID: 786967779 0.50/1 (PRR) Kraken (Hold'em)
Seat 4 is the button
Seat 1: WeakAndWeary (127.16).
Seat 2: MadLifeGrinder (100).
Seat 3: Beep_Beep (104).
Seat 4: LloydXmas (132.37).
Seat 6: IlxxxlI (48.53).
Player IlxxxlI has small blind (0.50)
Player WeakAndWeary has big blind (1)
Player IlxxxlI received card: [4c]
Player IlxxxlI received card: [Js]
Player MadLifeGrinder folds
Player Beep_Beep folds
Player LloydXmas folds
Player IlxxxlI folds
Uncalled bet (0.50) returned to WeakAndWeary
Player WeakAndWeary mucks cards
------ Summary ------
Pot: 1. Rake 0
*Player WeakAndWeary mucks (does not show cards). Bets: 0.50. Collects: 1. Wins: 0.50.
Player MadLifeGrinder does not show cards.Bets: 0. Collects: 0. Wins: 0.
Player Beep_Beep does not show cards.Bets: 0. Collects: 0. Wins: 0.
Player LloydXmas does not show cards.Bets: 0. Collects: 0. Wins: 0.
Player IlxxxlI does not show cards.Bets: 0.50. Collects: 0. Loses: 0.50.
Game ended at: 2016/11/29 13:8:30

Game started
Game ID: 786967780 0.50/1 (PRR) Kraken - 7 (Hold'em)
Seat 4 is the button
Seat 1: gust (41.58).
Seat 2: WeakAndWeary (100).
Seat 3: Beep_Beep (106.75).
Seat 4: IlxxxlI (40).
Seat 5: Im Don King (111.70).
Seat 6: MadLifeGrinder (107.07).
Player Im Don King has small blind (0.50)
Player MadLifeGrinder has big blind (1)
Player IlxxxlI received card: [Kc]
Player IlxxxlI received card: [6s]
Player gust folds
Player WeakAndWeary folds
Player Beep_Beep folds
Player IlxxxlI folds
Player Im Don King folds
Uncalled bet (0.50) returned to MadLifeGrinder
Player MadLifeGrinder mucks cards
------ Summary ------
Pot: 1. Rake 0
Player gust does not show cards.Bets: 0. Collects: 0. Wins: 0.
Player WeakAndWeary does not show cards.Bets: 0. Collects: 0. Wins: 0.
Player Beep_Beep does not show cards.Bets: 0. Collects: 0. Wins: 0.
Player IlxxxlI does not show cards.Bets: 0. Collects: 0. Wins: 0.
Player Im Don King does not show cards.Bets: 0.50. Collects: 0. Loses: 0.50.
*Player MadLifeGrinder mucks (does not show cards). Bets: 0.50. Collects: 1. Wins: 0.50.
Game ended at: 2016/11/29 13:8:55

Game started
Game ID: 786967696 0.25/0.50 (PRR) Gorgons - 9 (Hold'em)
Seat 3 is the button
Seat 1: xROCKETMANx (86.96).
Seat 2: Jui Kuen (59.93).
Seat 3: IlxxxlI (20).
Seat 4: foreseen (52.25).
Seat 5: Beep_Beep (50).
Seat 6: violin2 (50).
Player foreseen has small blind (0.25)
Player Beep_Beep has big blind (0.50)
Player violin2 posts (0.50)
Player IlxxxlI received card: [Js]
Player IlxxxlI received card: [6c]
Player violin2 checks
Player xROCKETMANx raises (2)
Player Jui Kuen folds
Player IlxxxlI folds
Player foreseen raises (8.42)
Player Beep_Beep folds
Player violin2 folds
Player xROCKETMANx calls (6.67)
*** FLOP ***: [2d 4s 6d]
Player foreseen bets (8.71)
Player xROCKETMANx calls (8.71)
*** TURN ***: [2d 4s 6d] [8s]
Player foreseen allin (34.87)
Player xROCKETMANx calls (34.87)
*** RIVER ***: [2d 4s 6d 8s] [5s]
------ Summary ------
Pot: 102.50. Rake 2.76. JP fee 0.24
Board: [2d 4s 6d 8s 5s]
*Player xROCKETMANx shows: Straight to 8 [7s 7c]. Bets: 52.25. Collects: 102.50. Wins: 50.25.
Player Jui Kuen does not show cards.Bets: 0. Collects: 0. Wins: 0.
Player IlxxxlI does not show cards.Bets: 0. Collects: 0. Wins: 0.
Player foreseen shows: One pair of 5s [Ah 5h]. Bets: 52.25. Collects: 0. Loses: 52.25.
Player Beep_Beep does not show cards.Bets: 0.50. Collects: 0. Loses: 0.50.
Player violin2 does not show cards.Bets: 0.50. Collects: 0. Loses: 0.50.
Game ended at: 2016/11/29 13:10:2

Game started
Game ID: 786967602 0.25/0.50 (PRR) Gorgons - 19 (Hold'em)
Seat 4 is the button
Seat 1: MirrorZrorriM (62.15).
Seat 2: IlxxxlI (20).
Seat 3: constant revelation (44.40).
Seat 4: FLDnLIVE2FLDagn (60.89).
Seat 6: QDevilQ (56.97).
Player QDevilQ has small blind (0.25)
Player MirrorZrorriM has big blind (0.50)
Player IlxxxlI received card: [9h]
Player IlxxxlI received card: [2c]
Player IlxxxlI folds
Player constant revelation folds
Player FLDnLIVE2FLDagn folds
Player QDevilQ raises (1.25)
Player MirrorZrorriM folds
Uncalled bet (1) returned to QDevilQ
Player QDevilQ mucks cards
------ Summary ------
Pot: 1. Rake 0
Player MirrorZrorriM does not show cards.Bets: 0.50. Collects: 0. Loses: 0.50.
Player IlxxxlI does not show cards.Bets: 0. Collects: 0. Wins: 0.
Player constant revelation does not show cards.Bets: 0. Collects: 0. Wins: 0.
Player FLDnLIVE2FLDagn does not show cards.Bets: 0. Collects: 0. Wins: 0.
*Player QDevilQ mucks (does not show cards). Bets: 0.50. Collects: 1. Wins: 0.50.
Game ended at: 2016/11/29 13:8:29

Game started
Game ID: 786967553 0.25/0.50 (PRR) Garuda - 4 (Hold'em)
Seat 7 is the button
Seat 1: wrongcolorchip (146.08).
Seat 2: IlxxxlI (29.27).
Seat 3: kid4life (124.72).
Seat 4: MortalLock (50).
Seat 5: GagaPoker (50).
Seat 6: Spagetti1 (28.82).
Seat 7: Hakuna_Matata777 (93.17).
Seat 8: Korobochka (61.02).
Seat 9: constant revelation (21.42).
Player Korobochka has small blind (0.25)
Player constant revelation has big blind (0.50)
Player IlxxxlI received card: [Jc]
Player IlxxxlI received card: [9c]
Player wrongcolorchip folds
Player IlxxxlI folds
Player kid4life raises (1.50)
Player MortalLock folds
Player GagaPoker folds
Player Spagetti1 folds
Player Hakuna_Matata777 folds
Player Korobochka folds
Player constant revelation calls (1)
*** FLOP ***: [8c Jh Ad]
Player constant revelation checks
Player kid4life checks
*** TURN ***: [8c Jh Ad] [Qh]
Player constant revelation checks
Player kid4life bets (2.06)
Player constant revelation folds
Uncalled bet (2.06) returned to kid4life
Player kid4life mucks cards
------ Summary ------
Pot: 3.09. Rake 0.12. JP fee 0.04
Board: [8c Jh Ad Qh]
Player wrongcolorchip does not show cards.Bets: 0. Collects: 0. Wins: 0.
Player IlxxxlI does not show cards.Bets: 0. Collects: 0. Wins: 0.
*Player kid4life mucks (does not show cards). Bets: 1.50. Collects: 3.09. Wins: 1.59.
Player MortalLock does not show cards.Bets: 0. Collects: 0. Wins: 0.
Player GagaPoker does not show cards.Bets: 0. Collects: 0. Wins: 0.
Player Spagetti1 does not show cards.Bets: 0. Collects: 0. Wins: 0.
Player Hakuna_Matata777 does not show cards.Bets: 0. Collects: 0. Wins: 0.
Player Korobochka does not show cards.Bets: 0.25. Collects: 0. Loses: 0.25.
Player constant revelation does not show cards.Bets: 1.50. Collects: 0. Loses: 1.50.
Game ended at: 2016/11/29 13:9:9

Game started
Game ID: 786967473 1/2 (PRR) Lakhey (Hold'em)
Seat 2 is the button
Seat 1: bfish602 (204).
Seat 2: KingGuciGuci (206.22).
Seat 3: IbetUmuck (707.42).
Seat 4: IlxxxlI (89.67).
Seat 5: MadLifeGrinder (213.21).
Seat 6: LazyFish (264.70).
Player IbetUmuck has small blind (1)
Player IlxxxlI has big blind (2)
Player IlxxxlI received card: [6h]
Player IlxxxlI received card: [10d]
Player MadLifeGrinder folds
Player LazyFish folds
Player bfish602 folds
Player KingGuciGuci raises (4.40)
Player IbetUmuck folds
Player IlxxxlI folds
Uncalled bet (2.40) returned to KingGuciGuci
Player KingGuciGuci mucks cards
------ Summary ------
Pot: 5. Rake 0
Player bfish602 does not show cards.Bets: 0. Collects: 0. Wins: 0.
*Player KingGuciGuci mucks (does not show cards). Bets: 2. Collects: 5. Wins: 3.
Player IbetUmuck does not show cards.Bets: 1. Collects: 0. Loses: 1.
Player IlxxxlI does not show cards.Bets: 2. Collects: 0. Loses: 2.
Player MadLifeGrinder does not show cards.Bets: 0. Collects: 0. Wins: 0.
Player LazyFish does not show cards.Bets: 0. Collects: 0. Wins: 0.
Game ended at: 2016/11/29 13:8:24

Game started
Game ID: 786967366 0.25/0.50 (PRR) Gorgons - 18 (Hold'em)
Seat 1 is the button
Seat 1: Abundance4All (89.32).
Seat 2: xROCKETMANx (51.71).
Seat 3: imperceptible (20).
Seat 4: IlxxxlI (20).
Seat 5: GagaPoker (70.96).
Seat 6: foreseen (69.47).
Player xROCKETMANx has small blind (0.25)
Player imperceptible is timed out.
Player imperceptible sitting out
Player IlxxxlI has big blind (0.50)
Player IlxxxlI received card: [8c]
Player IlxxxlI received card: [8d]
Player GagaPoker folds
Player foreseen folds
Player Abundance4All folds
Player xROCKETMANx raises (1.25)
Player IlxxxlI calls (1)
*** FLOP ***: [Qd 5s 3s]
Player xROCKETMANx bets (1.90)
Player IlxxxlI calls (1.90)
*** TURN ***: [Qd 5s 3s] [9s]
Player xROCKETMANx bets (3.23)
Player IlxxxlI folds
Uncalled bet (3.23) returned to xROCKETMANx
Player xROCKETMANx mucks cards
------ Summary ------
Pot: 6.46. Rake 0.24. JP fee 0.10
Board: [Qd 5s 3s 9s]
Player Abundance4All does not show cards.Bets: 0. Collects: 0. Wins: 0.
*Player xROCKETMANx mucks (does not show cards). Bets: 3.40. Collects: 6.46. Wins: 3.06.
Player imperceptible does not show cards.Bets: 0. Collects: 0. Wins: 0.
Player IlxxxlI does not show cards.Bets: 3.40. Collects: 0. Loses: 3.40.
Player GagaPoker does not show cards.Bets: 0. Collects: 0. Wins: 0.
Player foreseen does not show cards.Bets: 0. Collects: 0. Wins: 0.
Game ended at: 2016/11/29 13:8:57

Game started
Game ID: 786967152 0.25/0.50 (PRR) Gorgons - 19 (Hold'em)
Seat 3 is the button
Seat 1: MirrorZrorriM (62.15).
Seat 2: IlxxxlI (20).
Seat 3: constant revelation (44.90).
Seat 4: FLDnLIVE2FLDagn (61.14).
Seat 6: QDevilQ (56.28).
Player FLDnLIVE2FLDagn has small blind (0.25)
Player QDevilQ has big blind (0.50)
Player IlxxxlI received card: [2s]
Player IlxxxlI received card: [2h]
Player MirrorZrorriM folds
Player IlxxxlI folds
Player constant revelation calls (0.50)
Player FLDnLIVE2FLDagn folds
Player QDevilQ checks
*** FLOP ***: [Ah 10d 4d]
Player QDevilQ checks
Player constant revelation checks
*** TURN ***: [Ah 10d 4d] [7h]
Player QDevilQ bets (0.50)
Player constant revelation folds
Uncalled bet (0.50) returned to QDevilQ
Player QDevilQ mucks cards
------ Summary ------
Pot: 1.19. Rake 0.04. JP fee 0.02
Board: [Ah 10d 4d 7h]
Player MirrorZrorriM does not show cards.Bets: 0. Collects: 0. Wins: 0.
Player IlxxxlI does not show cards.Bets: 0. Collects: 0. Wins: 0.
Player constant revelation does not show cards.Bets: 0.50. Collects: 0. Loses: 0.50.
Player FLDnLIVE2FLDagn does not show cards.Bets: 0.25. Collects: 0. Loses: 0.25.
*Player QDevilQ mucks (does not show cards). Bets: 0.50. Collects: 1.19. Wins: 0.69.
Game ended at: 2016/11/29 13:7:58

Game started
Game ID: 786967063 0.50/1 (PRR) Kraken (Hold'em)
Seat 3 is the button
Seat 1: WeakAndWeary (127.16).
Seat 2: MadLifeGrinder (101).
Seat 3: Beep_Beep (100).
Seat 4: LloydXmas (132.87).
Seat 6: IlxxxlI (49.53).
Player LloydXmas has small blind (0.50)
Player IlxxxlI has big blind (1)
Player IlxxxlI received card: [10h]
Player IlxxxlI received card: [Jh]
Player WeakAndWeary folds
Player MadLifeGrinder raises (2.50)
Player Beep_Beep raises (7)
Player LloydXmas folds
Player IlxxxlI folds
Player MadLifeGrinder folds
Uncalled bet (4.50) returned to Beep_Beep
Player Beep_Beep mucks cards
------ Summary ------
Pot: 6.50. Rake 0
Player WeakAndWeary does not show cards.Bets: 0. Collects: 0. Wins: 0.
Player MadLifeGrinder does not show cards.Bets: 2.50. Collects: 0. Loses: 2.50.
*Player Beep_Beep mucks (does not show cards). Bets: 2.50. Collects: 6.50. Wins: 4.
Player LloydXmas does not show cards.Bets: 0.50. Collects: 0. Loses: 0.50.
Player IlxxxlI does not show cards.Bets: 1. Collects: 0. Loses: 1.
Game ended at: 2016/11/29 13:8:18

Game started
Game ID: 786967007 0.50/1 (PRR) Kraken - 22 (Hold'em)
Seat 3 is the button
Seat 1: meandkids (101.50).
Seat 2: IlxxxlI (40).
Seat 3: Beep_Beep (100).
Seat 4: gust (40.50).
Seat 5: MadLifeGrinder (101.50).
Seat 6: WeakAndWeary (278.64).
Player gust has small blind (0.50)
Player MadLifeGrinder has big blind (1)
Player IlxxxlI received card: [10c]
Player IlxxxlI received card: [2c]
Player WeakAndWeary folds
Player meandkids raises (6)
Player IlxxxlI folds
Player Beep_Beep folds
Player gust folds
Player MadLifeGrinder calls (5)
*** FLOP ***: [As 2d 3c]
Player MadLifeGrinder checks
Player meandkids bets (7.92)
Player MadLifeGrinder folds
Uncalled bet (7.92) returned to meandkids
Player meandkids mucks cards
------ Summary ------
Pot: 11.88. Rake 0.42. JP fee 0.20
Board: [As 2d 3c]
*Player meandkids mucks (does not show cards). Bets: 6. Collects: 11.88. Wins: 5.88.
Player IlxxxlI does not show cards.Bets: 0. Collects: 0. Wins: 0.
Player Beep_Beep does not show cards.Bets: 0. Collects: 0. Wins: 0.
Player gust does not show cards.Bets: 0.50. Collects: 0. Loses: 0.50.
Player MadLifeGrinder does not show cards.Bets: 6. Collects: 0. Loses: 6.
Player WeakAndWeary does not show cards.Bets: 0. Collects: 0. Wins: 0.
Game ended at: 2016/11/29 13:8:23

Game started
Game ID: 786966774 0.25/0.50 (PRR) Gorgons - 19 (Hold'em)
Seat 2 is the button
Seat 1: MirrorZrorriM (62.15).
Seat 2: IlxxxlI (20).
Seat 3: constant revelation (45.40).
Seat 4: FLDnLIVE2FLDagn (60.69).
Seat 6: QDevilQ (56.28).
Player constant revelation has small blind (0.25)
Player FLDnLIVE2FLDagn has big blind (0.50)
Player IlxxxlI received card: [9s]
Player IlxxxlI received card: [2h]
Player QDevilQ folds
Player MirrorZrorriM folds
Player IlxxxlI folds
Player constant revelation calls (0.25)
Player FLDnLIVE2FLDagn checks
*** FLOP ***: [Kc As 9d]
Player constant revelation checks
Player FLDnLIVE2FLDagn checks
*** TURN ***: [Kc As 9d] [5h]
Player constant revelation checks
Player FLDnLIVE2FLDagn bets (0.50)
Player constant revelation folds
Uncalled bet (0.50) returned to FLDnLIVE2FLDagn
Player FLDnLIVE2FLDagn mucks cards
------ Summary ------
Pot: 0.95. Rake 0.05
Board: [Kc As 9d 5h]
Player MirrorZrorriM does not show cards.Bets: 0. Collects: 0. Wins: 0.
Player IlxxxlI does not show cards.Bets: 0. Collects: 0. Wins: 0.
Player constant revelation does not show cards.Bets: 0.50. Collects: 0. Loses: 0.50.
*Player FLDnLIVE2FLDagn mucks (does not show cards). Bets: 0.50. Collects: 0.95. Wins: 0.45.
Player QDevilQ does not show cards.Bets: 0. Collects: 0. Wins: 0.
Game ended at: 2016/11/29 13:7:13

Game started
Game ID: 786966726 0.50/1 (PRR) Kraken (Hold'em)
Seat 2 is the button
Seat 1: WeakAndWeary (127.16).
Seat 2: MadLifeGrinder (101).
Seat 3: Beep_Beep (100).
Seat 4: LloydXmas (133.87).
Seat 6: IlxxxlI (48.03).
Player Beep_Beep has small blind (0.50)
Player LloydXmas has big blind (1)
Player IlxxxlI received card: [Qs]
Player IlxxxlI received card: [Js]
Player IlxxxlI raises (3.50)
Player WeakAndWeary folds
Player MadLifeGrinder folds
Player Beep_Beep folds
Player LloydXmas folds
Uncalled bet (2.50) returned to IlxxxlI
Player IlxxxlI mucks cards
------ Summary ------
Pot: 2.50. Rake 0
Player WeakAndWeary does not show cards.Bets: 0. Collects: 0. Wins: 0.
Player MadLifeGrinder does not show cards.Bets: 0. Collects: 0. Wins: 0.
Player Beep_Beep does not show cards.Bets: 0.50. Collects: 0. Loses: 0.50.
Player LloydXmas does not show cards.Bets: 1. Collects: 0. Loses: 1.
*Player IlxxxlI mucks (does not show cards). Bets: 1. Collects: 2.50. Wins: 1.50.
Game ended at: 2016/11/29 13:7:3

Game started
Game ID: 786966637 0.50/1 (PRR) Kraken - 22 (Hold'em)
Seat 2 is the button
Seat 1: meandkids (101.50).
Seat 2: IlxxxlI (40).
Seat 3: Beep_Beep (100.50).
Seat 4: gust (40).
Seat 5: MadLifeGrinder (101.50).
Seat 6: WeakAndWeary (278.64).
Player Beep_Beep has small blind (0.50)
Player gust has big blind (1)
Player IlxxxlI received card: [3h]
Player IlxxxlI received card: [5d]
Player MadLifeGrinder folds
Player WeakAndWeary folds
Player meandkids folds
Player IlxxxlI folds
Player Beep_Beep folds
Uncalled bet (0.50) returned to gust
Player gust mucks cards
------ Summary ------
Pot: 1. Rake 0
Player meandkids does not show cards.Bets: 0. Collects: 0. Wins: 0.
Player IlxxxlI does not show cards.Bets: 0. Collects: 0. Wins: 0.
Player Beep_Beep does not show cards.Bets: 0.50. Collects: 0. Loses: 0.50.
*Player gust mucks (does not show cards). Bets: 0.50. Collects: 1. Wins: 0.50.
Player MadLifeGrinder does not show cards.Bets: 0. Collects: 0. Wins: 0.
Player WeakAndWeary does not show cards.Bets: 0. Collects: 0. Wins: 0.
Game ended at: 2016/11/29 13:6:56

Game started
Game ID: 786966636 0.25/0.50 (PRR) Gorgons - 9 (Hold'em)
Seat 2 is the button
Seat 1: xROCKETMANx (86.96).
Seat 2: Jui Kuen (59.93).
Seat 3: IlxxxlI (20).
Seat 4: foreseen (50).
Player IlxxxlI has small blind (0.25)
Player foreseen has big blind (0.50)
Player IlxxxlI received card: [Qd]
Player IlxxxlI received card: [7d]
Player xROCKETMANx folds
Player Jui Kuen folds
Player IlxxxlI raises (1)
Player foreseen calls (0.75)
*** FLOP ***: [8c 2s 9h]
Player IlxxxlI bets (1.24)
Player foreseen calls (1.24)
*** TURN ***: [8c 2s 9h] [8s]
Player IlxxxlI checks
Player foreseen checks
*** RIVER ***: [8c 2s 9h 8s] [Kh]
Player IlxxxlI checks
Player foreseen checks
Player IlxxxlI mucks cards
------ Summary ------
Pot: 4.74. Rake 0.16. JP fee 0.08
Board: [8c 2s 9h 8s Kh]
Player xROCKETMANx does not show cards.Bets: 0. Collects: 0. Wins: 0.
Player Jui Kuen does not show cards.Bets: 0. Collects: 0. Wins: 0.
Player IlxxxlI mucks (does not show: [Qd 7d]). Bets: 2.49. Collects: 0. Loses: 2.49.
*Player foreseen shows: One pair of 8s [Ah Js]. Bets: 2.49. Collects: 4.74. Wins: 2.25.
Game ended at: 2016/11/29 13:8:7

Game started
Game ID: 786966625 0.25/0.50 (PRR) Gorgons - 18 (Hold'em)
Seat 6 is the button
Seat 1: Abundance4All (89.57).
Seat 2: xROCKETMANx (53.82).
Seat 4: IlxxxlI (20).
Seat 5: GagaPoker (70.96).
Seat 6: foreseen (67.33).
Player Abundance4All has small blind (0.25)
Player xROCKETMANx has big blind (0.50)
Player IlxxxlI received card: [9d]
Player IlxxxlI received card: [Jh]
Player IlxxxlI folds
Player GagaPoker folds
Player foreseen raises (1.25)
Player Abundance4All folds
Player xROCKETMANx calls (0.75)
*** FLOP ***: [6c 9c Ac]
Player xROCKETMANx checks
Player foreseen bets (0.86)
Player xROCKETMANx calls (0.86)
*** TURN ***: [6c 9c Ac] [3s]
Player xROCKETMANx checks
Player foreseen bets (3.27)
Player xROCKETMANx folds
Uncalled bet (3.27) returned to foreseen
Player foreseen mucks cards
------ Summary ------
Pot: 4.25. Rake 0.16. JP fee 0.06
Board: [6c 9c Ac 3s]
Player Abundance4All does not show cards.Bets: 0.25. Collects: 0. Loses: 0.25.
Player xROCKETMANx does not show cards.Bets: 2.11. Collects: 0. Loses: 2.11.
Player IlxxxlI does not show cards.Bets: 0. Collects: 0. Wins: 0.
Player GagaPoker does not show cards.Bets: 0. Collects: 0. Wins: 0.
*Player foreseen mucks (does not show cards). Bets: 2.11. Collects: 4.25. Wins: 2.14.
Game ended at: 2016/11/29 13:7:35

Game started
Game ID: 786966488 1/2 (PRR) Lakhey (Hold'em)
Seat 1 is the button
Seat 1: bfish602 (204).
Seat 2: KingGuciGuci (227.12).
Seat 3: IbetUmuck (688.61).
Seat 4: IlxxxlI (89.67).
Seat 5: MadLifeGrinder (213.21).
Seat 6: LazyFish (264.70).
Player KingGuciGuci has small blind (1)
Player IbetUmuck has big blind (2)
Player IlxxxlI received card: [8h]
Player IlxxxlI received card: [9s]
Player IlxxxlI folds
Player MadLifeGrinder folds
Player LazyFish folds
Player bfish602 folds
Player KingGuciGuci calls (1)
Player IbetUmuck checks
*** FLOP ***: [5s Qh Ad]
Player KingGuciGuci bets (3)
Player IbetUmuck calls (3)
*** TURN ***: [5s Qh Ad] [6h]
Player KingGuciGuci bets (15.90)
Player IbetUmuck calls (15.90)
*** RIVER ***: [5s Qh Ad 6h] [As]
Player KingGuciGuci checks
Player IbetUmuck bets (42)
Player KingGuciGuci folds
Uncalled bet (42) returned to IbetUmuck
Player IbetUmuck mucks cards
------ Summary ------
Pot: 39.71. Rake 1.85. JP fee 0.24
Board: [5s Qh Ad 6h As]
Player bfish602 does not show cards.Bets: 0. Collects: 0. Wins: 0.
Player KingGuciGuci does not show cards.Bets: 20.90. Collects: 0. Loses: 20.90.
*Player IbetUmuck mucks (does not show cards). Bets: 20.90. Collects: 39.71. Wins: 18.81.
Player IlxxxlI does not show cards.Bets: 0. Collects: 0. Wins: 0.
Player MadLifeGrinder does not show cards.Bets: 0. Collects: 0. Wins: 0.
Player LazyFish does not show cards.Bets: 0. Collects: 0. Wins: 0.
Game ended at: 2016/11/29 13:7:43

Game started
Game ID: 786966426 0.50/1 (PRR) Kraken - 7 (Hold'em)
Seat 3 is the button
Seat 1: gust (41.58).
Seat 2: WeakAndWeary (100).
Seat 3: Beep_Beep (109.75).
Seat 4: IlxxxlI (40).
Seat 5: Im Don King (108.52).
Seat 6: MadLifeGrinder (107.07).
Player IlxxxlI has small blind (0.50)
Player Im Don King has big blind (1)
Player IlxxxlI received card: [5d]
Player IlxxxlI received card: [2d]
Player MadLifeGrinder folds
Player gust folds
Player WeakAndWeary folds
Player Beep_Beep raises (3)
Player IlxxxlI folds
Player Im Don King calls (2)
*** FLOP ***: [6d 3h 2c]
Player Im Don King checks
Player Beep_Beep checks
*** TURN ***: [6d 3h 2c] [8c]
Player Im Don King checks
Player Beep_Beep checks
*** RIVER ***: [6d 3h 2c 8c] [5h]
Player Im Don King bets (5)
Player Beep_Beep folds
Uncalled bet (5) returned to Im Don King
Player Im Don King mucks cards
------ Summary ------
Pot: 6.18. Rake 0.22. JP fee 0.10
Board: [6d 3h 2c 8c 5h]
Player gust does not show cards.Bets: 0. Collects: 0. Wins: 0.
Player WeakAndWeary does not show cards.Bets: 0. Collects: 0. Wins: 0.
Player Beep_Beep does not show cards.Bets: 3. Collects: 0. Loses: 3.
Player IlxxxlI does not show cards.Bets: 0.50. Collects: 0. Loses: 0.50.
*Player Im Don King mucks (does not show cards). Bets: 3. Collects: 6.18. Wins: 3.18.
Player MadLifeGrinder does not show cards.Bets: 0. Collects: 0. Wins: 0.
Game ended at: 2016/11/29 13:8:18

Game started
Game ID: 786966418 0.25/0.50 (PRR) Gorgons - 19 (Hold'em)
Seat 1 is the button
Seat 1: MirrorZrorriM (62.15).
Seat 2: IlxxxlI (20).
Seat 3: constant revelation (45.90).
Seat 4: FLDnLIVE2FLDagn (60.69).
Seat 6: QDevilQ (55.53).
Player IlxxxlI has small blind (0.25)
Player constant revelation has big blind (0.50)
Player IlxxxlI received card: [Jc]
Player IlxxxlI received card: [5c]
Player FLDnLIVE2FLDagn folds
Player QDevilQ raises (1.50)
Player MirrorZrorriM folds
Player IlxxxlI folds
Player constant revelation is timed out.
Player constant revelation folds
Uncalled bet (1) returned to QDevilQ
Player QDevilQ mucks cards
------ Summary ------
Pot: 1.25. Rake 0
Player MirrorZrorriM does not show cards.Bets: 0. Collects: 0. Wins: 0.
Player IlxxxlI does not show cards.Bets: 0.25. Collects: 0. Loses: 0.25.
Player constant revelation does not show cards.Bets: 0.50. Collects: 0. Loses: 0.50.
Player FLDnLIVE2FLDagn does not show cards.Bets: 0. Collects: 0. Wins: 0.
*Player QDevilQ mucks (does not show cards). Bets: 0.50. Collects: 1.25. Wins: 0.75.
Game ended at: 2016/11/29 13:6:33

Game started
Game ID: 786966386 0.50/1 (PRR) Kraken (Hold'em)
Seat 1 is the button
Seat 1: WeakAndWeary (127.16).
Seat 2: MadLifeGrinder (100).
Seat 3: Beep_Beep (100).
Seat 4: LloydXmas (133.87).
Seat 6: IlxxxlI (48.03).
Player MadLifeGrinder has small blind (0.50)
Player Beep_Beep has big blind (1)
Player IlxxxlI received card: [9h]
Player IlxxxlI received card: [Qd]
Player LloydXmas folds
Player IlxxxlI folds
Player WeakAndWeary folds
Player MadLifeGrinder raises (2.50)
Player Beep_Beep folds
Uncalled bet (2) returned to MadLifeGrinder
Player MadLifeGrinder mucks cards
------ Summary ------
Pot: 2. Rake 0
Player WeakAndWeary does not show cards.Bets: 0. Collects: 0. Wins: 0.
*Player MadLifeGrinder mucks (does not show cards). Bets: 1. Collects: 2. Wins: 1.
Player Beep_Beep does not show cards.Bets: 1. Collects: 0. Loses: 1.
Player LloydXmas does not show cards.Bets: 0. Collects: 0. Wins: 0.
Player IlxxxlI does not show cards.Bets: 0. Collects: 0. Wins: 0.
Game ended at: 2016/11/29 13:6:29

Game started
Game ID: 786966375 0.25/0.50 (PRR) Gorgons - 9 (Hold'em)
Seat 1 is the button
Seat 1: xROCKETMANx (86.21).
Seat 2: Jui Kuen (60.18).
Seat 3: IlxxxlI (20).
Seat 4: foreseen (50).
Player Jui Kuen has small blind (0.25)
Player IlxxxlI has big blind (0.50)
Player IlxxxlI received card: [6d]
Player IlxxxlI received card: [8c]
Player foreseen folds
Player xROCKETMANx raises (1.50)
Player Jui Kuen folds
Player IlxxxlI folds
Uncalled bet (1) returned to xROCKETMANx
Player xROCKETMANx mucks cards
------ Summary ------
Pot: 1.25. Rake 0
*Player xROCKETMANx mucks (does not show cards). Bets: 0.50. Collects: 1.25. Wins: 0.75.
Player Jui Kuen does not show cards.Bets: 0.25. Collects: 0. Loses: 0.25.
Player IlxxxlI does not show cards.Bets: 0.50. Collects: 0. Loses: 0.50.
Player foreseen does not show cards.Bets: 0. Collects: 0. Wins: 0.
Game ended at: 2016/11/29 13:6:20

Game started
Game ID: 786966281 0.50/1 (PRR) Kraken - 22 (Hold'em)
Seat 1 is the button
Seat 1: meandkids (100).
Seat 2: IlxxxlI (40.50).
Seat 3: Beep_Beep (101.50).
Seat 5: MadLifeGrinder (101.50).
Seat 6: WeakAndWeary (278.64).
Player IlxxxlI has small blind (0.50)
Player Beep_Beep has big blind (1)
Player IlxxxlI received card: [8c]
Player IlxxxlI received card: [7d]
Player MadLifeGrinder folds
Player WeakAndWeary folds
Player meandkids raises (6)
Player IlxxxlI folds
Player Beep_Beep folds
Uncalled bet (5) returned to meandkids
Player meandkids mucks cards
------ Summary ------
Pot: 2.50. Rake 0
*Player meandkids mucks (does not show cards). Bets: 1. Collects: 2.50. Wins: 1.50.
Player IlxxxlI does not show cards.Bets: 0.50. Collects: 0. Loses: 0.50.
Player Beep_Beep does not show cards.Bets: 1. Collects: 0. Loses: 1.
Player MadLifeGrinder does not show cards.Bets: 0. Collects: 0. Wins: 0.
Player WeakAndWeary does not show cards.Bets: 0. Collects: 0. Wins: 0.
Game ended at: 2016/11/29 13:6:20

Game started
Game ID: 786966189 0.25/0.50 (PRR) Gorgons - 9 (Hold'em)
Seat 4 is the button
Seat 1: xROCKETMANx (86.46).
Seat 2: Jui Kuen (59.93).
Seat 3: IlxxxlI (20).
Seat 4: foreseen (50).
Player xROCKETMANx has small blind (0.25)
Player Jui Kuen has big blind (0.50)
Player IlxxxlI received card: [7h]
Player IlxxxlI received card: [4d]
Player IlxxxlI folds
Player foreseen folds
Player xROCKETMANx folds
Uncalled bet (0.25) returned to Jui Kuen
Player Jui Kuen mucks cards
------ Summary ------
Pot: 0.50. Rake 0
Player xROCKETMANx does not show cards.Bets: 0.25. Collects: 0. Loses: 0.25.
*Player Jui Kuen mucks (does not show cards). Bets: 0.25. Collects: 0.50. Wins: 0.25.
Player IlxxxlI does not show cards.Bets: 0. Collects: 0. Wins: 0.
Player foreseen does not show cards.Bets: 0. Collects: 0. Wins: 0.
Game ended at: 2016/11/29 13:5:53

Game started
Game ID: 786966082 0.25/0.50 (PRR) Gorgons - 19 (Hold'em)
Seat 6 is the button
Seat 1: MirrorZrorriM (57.17).
Seat 2: IlxxxlI (20).
Seat 3: constant revelation (45.90).
Seat 4: FLDnLIVE2FLDagn (65.69).
Seat 6: QDevilQ (55.53).
Player MirrorZrorriM has small blind (0.25)
Player IlxxxlI has big blind (0.50)
Player IlxxxlI received card: [3c]
Player IlxxxlI received card: [2c]
Player constant revelation folds
Player FLDnLIVE2FLDagn raises (1.50)
Player QDevilQ folds
Player MirrorZrorriM raises (4.75)
Player IlxxxlI folds
Player FLDnLIVE2FLDagn calls (3.50)
*** FLOP ***: [8c 10s As]
Player MirrorZrorriM bets (6.75)
Player FLDnLIVE2FLDagn folds
Uncalled bet (6.75) returned to MirrorZrorriM
Player MirrorZrorriM mucks cards
------ Summary ------
Pot: 9.98. Rake 0.36. JP fee 0.16
Board: [8c 10s As]
*Player MirrorZrorriM mucks (does not show cards). Bets: 5. Collects: 9.98. Wins: 4.98.
Player IlxxxlI does not show cards.Bets: 0.50. Collects: 0. Loses: 0.50.
Player constant revelation does not show cards.Bets: 0. Collects: 0. Wins: 0.
Player FLDnLIVE2FLDagn does not show cards.Bets: 5. Collects: 0. Loses: 5.
Player QDevilQ does not show cards.Bets: 0. Collects: 0. Wins: 0.
Game ended at: 2016/11/29 13:5:58

Game started
Game ID: 786966021 1/2 (PRR) Lakhey (Hold'em)
Seat 6 is the button
Seat 1: bfish602 (205).
Seat 2: KingGuciGuci (200).
Seat 3: IbetUmuck (717.68).
Seat 4: IlxxxlI (89.67).
Seat 5: MadLifeGrinder (213.21).
Seat 6: LazyFish (264.70).
Player bfish602 has small blind (1)
Player KingGuciGuci has big blind (2)
Player IlxxxlI received card: [8h]
Player IlxxxlI received card: [10s]
Player IbetUmuck raises (5.75)
Player IlxxxlI folds
Player MadLifeGrinder folds
Player LazyFish folds
Player bfish602 folds
Player KingGuciGuci calls (3.75)
*** FLOP ***: [7c Jc 3s]
Player KingGuciGuci checks
Player IbetUmuck bets (5.94)
Player KingGuciGuci calls (5.94)
*** TURN ***: [7c Jc 3s] [5d]
Player KingGuciGuci checks
Player IbetUmuck bets (17.38)
Player KingGuciGuci calls (17.38)
*** RIVER ***: [7c Jc 3s 5d] [Kd]
Player KingGuciGuci checks
Player IbetUmuck checks
------ Summary ------
Pot: 56.19. Rake 2.71. JP fee 0.24
Board: [7c Jc 3s 5d Kd]
Player bfish602 does not show cards.Bets: 1. Collects: 0. Loses: 1.
*Player KingGuciGuci shows: One pair of Js [Qc Js]. Bets: 29.07. Collects: 56.19. Wins: 27.12.
Player IbetUmuck shows: One pair of 7s [7s 8s]. Bets: 29.07. Collects: 0. Loses: 29.07.
Player IlxxxlI does not show cards.Bets: 0. Collects: 0. Wins: 0.
Player MadLifeGrinder does not show cards.Bets: 0. Collects: 0. Wins: 0.
Player LazyFish does not show cards.Bets: 0. Collects: 0. Wins: 0.
Game ended at: 2016/11/29 13:6:4

Game started
Game ID: 786966025 0.50/1 (PRR) Kraken (Hold'em)
Seat 6 is the button
Seat 1: WeakAndWeary (127.66).
Seat 2: MadLifeGrinder (100).
Seat 4: LloydXmas (132.37).
Seat 6: IlxxxlI (48.03).
Player WeakAndWeary has small blind (0.50)
Player MadLifeGrinder has big blind (1)
Player IlxxxlI received card: [Qd]
Player IlxxxlI received card: [9c]
Player LloydXmas raises (3)
Player IlxxxlI folds
Player WeakAndWeary folds
Player MadLifeGrinder folds
Uncalled bet (2) returned to LloydXmas
Player LloydXmas mucks cards
------ Summary ------
Pot: 2.50. Rake 0
Player WeakAndWeary does not show cards.Bets: 0.50. Collects: 0. Loses: 0.50.
Player MadLifeGrinder does not show cards.Bets: 1. Collects: 0. Loses: 1.
*Player LloydXmas mucks (does not show cards). Bets: 1. Collects: 2.50. Wins: 1.50.
Player IlxxxlI does not show cards.Bets: 0. Collects: 0. Wins: 0.
Game ended at: 2016/11/29 13:5:54

Game started
Game ID: 786966004 0.50/1 (PRR) Kraken - 22 (Hold'em)
Seat 6 is the button
Seat 1: meandkids (100.50).
Seat 2: IlxxxlI (40).
Seat 3: Beep_Beep (101.50).
Seat 5: MadLifeGrinder (101.50).
Seat 6: WeakAndWeary (278.64).
Player meandkids has small blind (0.50)
Player IlxxxlI has big blind (1)
Player IlxxxlI received card: [Ad]
Player IlxxxlI received card: [9d]
Player Beep_Beep folds
Player MadLifeGrinder folds
Player WeakAndWeary folds
Player meandkids folds
Uncalled bet (0.50) returned to IlxxxlI
Player IlxxxlI mucks cards
------ Summary ------
Pot: 1. Rake 0
Player meandkids does not show cards.Bets: 0.50. Collects: 0. Loses: 0.50.
*Player IlxxxlI mucks (does not show cards). Bets: 0.50. Collects: 1. Wins: 0.50.
Player Beep_Beep does not show cards.Bets: 0. Collects: 0. Wins: 0.
Player MadLifeGrinder does not show cards.Bets: 0. Collects: 0. Wins: 0.
Player WeakAndWeary does not show cards.Bets: 0. Collects: 0. Wins: 0.
Game ended at: 2016/11/29 13:5:43

Game started
Game ID: 786965981 0.25/0.50 (PRR) Garuda - 4 (Hold'em)
Seat 6 is the button
Seat 1: wrongcolorchip (146.08).
Seat 2: IlxxxlI (29.27).
Seat 3: kid4life (124.72).
Seat 4: MortalLock (50).
Seat 5: GagaPoker (50).
Seat 6: Spagetti1 (28.82).
Seat 7: Hakuna_Matata777 (93.42).
Seat 8: Korobochka (50).
Seat 9: constant revelation (21.42).
Player Hakuna_Matata777 has small blind (0.25)
Player Korobochka has big blind (0.50)
Player IlxxxlI received card: [3s]
Player IlxxxlI received card: [4d]
Player constant revelation folds
Player wrongcolorchip folds
Player IlxxxlI folds
Player kid4life folds
Player MortalLock folds
Player GagaPoker raises (1)
Player Spagetti1 folds
Player Hakuna_Matata777 folds
Player Korobochka calls (0.50)
*** FLOP ***: [7s 3c Qh]
Player Korobochka checks
Player GagaPoker bets (0.71)
Player Korobochka calls (0.71)
*** TURN ***: [7s 3c Qh] [Jc]
Player Korobochka bets (3.50)
Player GagaPoker calls (3.50)
*** RIVER ***: [7s 3c Qh Jc] [5h]
Player Korobochka bets (6.76)
Player GagaPoker calls (6.76)
Player GagaPoker mucks cards
------ Summary ------
Pot: 22.99. Rake 0.96. JP fee 0.24
Board: [7s 3c Qh Jc 5h]
Player wrongcolorchip does not show cards.Bets: 0. Collects: 0. Wins: 0.
Player IlxxxlI does not show cards.Bets: 0. Collects: 0. Wins: 0.
Player kid4life does not show cards.Bets: 0. Collects: 0. Wins: 0.
Player MortalLock does not show cards.Bets: 0. Collects: 0. Wins: 0.
Player GagaPoker mucks (does not show cards). Bets: 11.97. Collects: 0. Loses: 11.97.
Player Spagetti1 does not show cards.Bets: 0. Collects: 0. Wins: 0.
Player Hakuna_Matata777 does not show cards.Bets: 0.25. Collects: 0. Loses: 0.25.
*Player Korobochka shows: Two pairs. Qs and Js [Js Qd]. Bets: 11.97. Collects: 22.99. Wins: 11.02.
Player constant revelation does not show cards.Bets: 0. Collects: 0. Wins: 0.
Game ended at: 2016/11/29 13:7:51

Game started
Game ID: 786965830 0.50/1 (PRR) Kraken (Hold'em)
Seat 4 is the button
Seat 1: WeakAndWeary (128.66).
Seat 2: MadLifeGrinder (100).
Seat 4: LloydXmas (130.87).
Seat 6: IlxxxlI (48.53).
Player IlxxxlI has small blind (0.50)
Player WeakAndWeary has big blind (1)
Player IlxxxlI received card: [7h]
Player IlxxxlI received card: [2c]
Player MadLifeGrinder folds
Player LloydXmas raises (2.25)
Player IlxxxlI folds
Player WeakAndWeary folds
Uncalled bet (1.25) returned to LloydXmas
Player LloydXmas mucks cards
------ Summary ------
Pot: 2.50. Rake 0
Player WeakAndWeary does not show cards.Bets: 1. Collects: 0. Loses: 1.
Player MadLifeGrinder does not show cards.Bets: 0. Collects: 0. Wins: 0.
*Player LloydXmas mucks (does not show cards). Bets: 1. Collects: 2.50. Wins: 1.50.
Player IlxxxlI does not show cards.Bets: 0.50. Collects: 0. Loses: 0.50.
Game ended at: 2016/11/29 13:5:18

Game started
Game ID: 786965764 1/2 (PRR) Lakhey (Hold'em)
Seat 5 is the button
Seat 1: bfish602 (207).
Seat 2: KingGuciGuci (200).
Seat 3: IbetUmuck (717.68).
Seat 4: IlxxxlI (89.67).
Seat 5: MadLifeGrinder (210.21).
Seat 6: LazyFish (265.70).
Player LazyFish has small blind (1)
Player bfish602 has big blind (2)
Player IlxxxlI received card: [3d]
Player IlxxxlI received card: [Jc]
Player KingGuciGuci folds
Player IbetUmuck folds
Player IlxxxlI folds
Player MadLifeGrinder raises (5)
Player LazyFish folds
Player bfish602 folds
Uncalled bet (3) returned to MadLifeGrinder
Player MadLifeGrinder mucks cards
------ Summary ------
Pot: 5. Rake 0
Player bfish602 does not show cards.Bets: 2. Collects: 0. Loses: 2.
Player KingGuciGuci does not show cards.Bets: 0. Collects: 0. Wins: 0.
Player IbetUmuck does not show cards.Bets: 0. Collects: 0. Wins: 0.
Player IlxxxlI does not show cards.Bets: 0. Collects: 0. Wins: 0.
*Player MadLifeGrinder mucks (does not show cards). Bets: 2. Collects: 5. Wins: 3.
Player LazyFish does not show cards.Bets: 1. Collects: 0. Loses: 1.
Game ended at: 2016/11/29 13:5:18

Game started
Game ID: 786965619 0.50/1 (PRR) Kraken (Hold'em)
Seat 2 is the button
Seat 1: WeakAndWeary (128.66).
Seat 2: MadLifeGrinder (100).
Seat 4: LloydXmas (131.37).
Seat 5: Hakuna_Matata777 (100).
Seat 6: IlxxxlI (48.03).
Player LloydXmas has small blind (0.50)
Player Hakuna_Matata777 sitting out
Player IlxxxlI has big blind (1)
Player IlxxxlI received card: [6d]
Player IlxxxlI received card: [10d]
Player WeakAndWeary folds
Player MadLifeGrinder folds
Player LloydXmas folds
Uncalled bet (0.50) returned to IlxxxlI
Player IlxxxlI mucks cards
------ Summary ------
Pot: 1. Rake 0
Player WeakAndWeary does not show cards.Bets: 0. Collects: 0. Wins: 0.
Player MadLifeGrinder does not show cards.Bets: 0. Collects: 0. Wins: 0.
Player LloydXmas does not show cards.Bets: 0.50. Collects: 0. Loses: 0.50.
Player Hakuna_Matata777 does not show cards.Bets: 0. Collects: 0. Wins: 0.
*Player IlxxxlI mucks (does not show cards). Bets: 0.50. Collects: 1. Wins: 0.50.
Game ended at: 2016/11/29 13:4:57

Game started
Game ID: 786965577 0.25/0.50 (PRR) Gorgons - 18 (Hold'em)
Seat 5 is the button
Seat 1: Abundance4All (83.28).
Seat 2: xROCKETMANx (53.82).
Seat 4: IlxxxlI (20).
Seat 5: GagaPoker (77.68).
Seat 6: foreseen (67.58).
Player foreseen has small blind (0.25)
Player Abundance4All has big blind (0.50)
Player IlxxxlI received card: [Kh]
Player IlxxxlI received card: [8s]
Player xROCKETMANx folds
Player IlxxxlI folds
Player GagaPoker raises (1.50)
Player foreseen folds
Player Abundance4All calls (1)
*** FLOP ***: [6c Ac Qh]
Player Abundance4All checks
Player GagaPoker checks
*** TURN ***: [6c Ac Qh] [Kc]
Player Abundance4All checks
Player GagaPoker bets (2.22)
Player Abundance4All calls (2.22)
*** RIVER ***: [6c Ac Qh Kc] [9d]
Player Abundance4All checks
Player GagaPoker bets (3)
Player Abundance4All calls (3)
------ Summary ------
Pot: 13.01. Rake 0.46. JP fee 0.22
Board: [6c Ac Qh Kc 9d]
*Player Abundance4All shows: Two pairs. As and Ks [As Kd]. Bets: 6.72. Collects: 13.01. Wins: 6.29.
Player xROCKETMANx does not show cards.Bets: 0. Collects: 0. Wins: 0.
Player IlxxxlI does not show cards.Bets: 0. Collects: 0. Wins: 0.
Player GagaPoker shows: Two pairs. Ks and Qs [Qd Ks]. Bets: 6.72. Collects: 0. Loses: 6.72.
Player foreseen does not show cards.Bets: 0.25. Collects: 0. Loses: 0.25.
Game ended at: 2016/11/29 13:6:17

Game started
Game ID: 786965507 0.50/1 (PRR) Kraken - 22 (Hold'em)
Seat 5 is the button
Seat 1: meandkids (101.50).
Seat 2: IlxxxlI (40).
Seat 3: Beep_Beep (101.50).
Seat 5: MadLifeGrinder (100).
Seat 6: WeakAndWeary (279.14).
Player WeakAndWeary has small blind (0.50)
Player meandkids has big blind (1)
Player IlxxxlI received card: [2h]
Player IlxxxlI received card: [5d]
Player IlxxxlI folds
Player Beep_Beep folds
Player MadLifeGrinder raises (2.50)
Player WeakAndWeary folds
Player meandkids folds
Uncalled bet (1.50) returned to MadLifeGrinder
Player MadLifeGrinder mucks cards
------ Summary ------
Pot: 2.50. Rake 0
Player meandkids does not show cards.Bets: 1. Collects: 0. Loses: 1.
Player IlxxxlI does not show cards.Bets: 0. Collects: 0. Wins: 0.
Player Beep_Beep does not show cards.Bets: 0. Collects: 0. Wins: 0.
*Player MadLifeGrinder mucks (does not show cards). Bets: 1. Collects: 2.50. Wins: 1.50.
Player WeakAndWeary does not show cards.Bets: 0.50. Collects: 0. Loses: 0.50.
Game ended at: 2016/11/29 13:5:15

Game started
Game ID: 786965442 0.25/0.50 (PRR) Gorgons - 2 (Hold'em)
Seat 4 is the button
Seat 1: BHawk12 (58.34).
Seat 2: IlxxxlI (25.93).
Seat 3: flyshark01 (96.20).
Seat 4: Jui Kuen (50).
Seat 5: constant revelation (29.19).
Seat 6: foreseen (50).
Player constant revelation has small blind (0.25)
Player foreseen has big blind (0.50)
Player IlxxxlI received card: [6s]
Player IlxxxlI received card: [Jc]
Player BHawk12 raises (1.50)
Player IlxxxlI folds
Player flyshark01 folds
Player Jui Kuen is timed out.
Player Jui Kuen folds
Player constant revelation raises (4.25)
Player foreseen folds
Player BHawk12 calls (3)
*** FLOP ***: [10s 3c 4h]
Player constant revelation checks
Player BHawk12 checks
*** TURN ***: [10s 3c 4h] [2d]
Player constant revelation bets (4.51)
Player BHawk12 calls (4.51)
*** RIVER ***: [10s 3c 4h 2d] [8s]
Player constant revelation checks
Player BHawk12 bets (20.18)
Player constant revelation allin (20.18)
------ Summary ------
Pot: 55.94. Rake 2.70. JP fee 0.24
Board: [10s 3c 4h 2d 8s]
Player BHawk12 shows: High card A [7c Ac]. Bets: 29.19. Collects: 0. Loses: 29.19.
Player IlxxxlI does not show cards.Bets: 0. Collects: 0. Wins: 0.
Player flyshark01 does not show cards.Bets: 0. Collects: 0. Wins: 0.
Player Jui Kuen does not show cards.Bets: 0. Collects: 0. Wins: 0.
*Player constant revelation shows: One pair of Qs [Qs Qh]. Bets: 29.19. Collects: 55.94. Wins: 26.75.
Player foreseen does not show cards.Bets: 0.50. Collects: 0. Loses: 0.50.
Game ended at: 2016/11/29 13:6:3

Game started
Game ID: 786965412 1/2 (PRR) Lakhey (Hold'em)
Seat 4 is the button
Seat 1: bfish602 (207).
Seat 2: KingGuciGuci (200).
Seat 3: IbetUmuck (717.68).
Seat 4: IlxxxlI (89.67).
Seat 5: MadLifeGrinder (211.21).
Seat 6: LazyFish (264.70).
Player MadLifeGrinder has small blind (1)
Player LazyFish has big blind (2)
Player IlxxxlI received card: [3d]
Player IlxxxlI received card: [6h]
Player bfish602 folds
Player KingGuciGuci folds
Player IbetUmuck folds
Player IlxxxlI folds
Player MadLifeGrinder folds
Uncalled bet (1) returned to LazyFish
Player LazyFish mucks cards
------ Summary ------
Pot: 2. Rake 0
Player bfish602 does not show cards.Bets: 0. Collects: 0. Wins: 0.
Player KingGuciGuci does not show cards.Bets: 0. Collects: 0. Wins: 0.
Player IbetUmuck does not show cards.Bets: 0. Collects: 0. Wins: 0.
Player IlxxxlI does not show cards.Bets: 0. Collects: 0. Wins: 0.
Player MadLifeGrinder does not show cards.Bets: 1. Collects: 0. Loses: 1.
*Player LazyFish mucks (does not show cards). Bets: 1. Collects: 2. Wins: 1.
Game ended at: 2016/11/29 13:4:52

Game started
Game ID: 786965294 0.50/1 (PRR) Kraken (Hold'em)
Seat 1 is the button
Seat 1: WeakAndWeary (128.66).
Seat 2: MadLifeGrinder (100).
Seat 4: LloydXmas (130.87).
Seat 5: Hakuna_Matata777 (100).
Seat 6: IlxxxlI (48.03).
Player MadLifeGrinder has small blind (0.50)
Player LloydXmas has big blind (1)
Player IlxxxlI received card: [10c]
Player IlxxxlI received card: [5s]
Player Hakuna_Matata777 folds
Player IlxxxlI folds
Player WeakAndWeary folds
Player MadLifeGrinder folds
Uncalled bet (0.50) returned to LloydXmas
Player LloydXmas mucks cards
------ Summary ------
Pot: 1. Rake 0
Player WeakAndWeary does not show cards.Bets: 0. Collects: 0. Wins: 0.
Player MadLifeGrinder does not show cards.Bets: 0.50. Collects: 0. Loses: 0.50.
*Player LloydXmas mucks (does not show cards). Bets: 0.50. Collects: 1. Wins: 0.50.
Player Hakuna_Matata777 does not show cards.Bets: 0. Collects: 0. Wins: 0.
Player IlxxxlI does not show cards.Bets: 0. Collects: 0. Wins: 0.
Game ended at: 2016/11/29 13:4:38

Game started
Game ID: 786965250 0.25/0.50 (PRR) Gorgons - 9 (Hold'em)
Seat 3 is the button
Seat 1: xROCKETMANx (86.96).
Seat 2: Jui Kuen (50).
Seat 3: IlxxxlI (20).
Seat 4: foreseen (52.63).
Seat 6: GagaPoker (60.81).
Player foreseen has small blind (0.25)
Player GagaPoker sitting out
Player xROCKETMANx has big blind (0.50)
Player IlxxxlI received card: [7h]
Player IlxxxlI received card: [Qs]
Player Jui Kuen raises (1.50)
Player IlxxxlI folds
Player foreseen raises (4.75)
Player xROCKETMANx folds
Player Jui Kuen calls (3.50)
*** FLOP ***: [9s 7s Kc]
Player foreseen bets (5.50)
Player Jui Kuen raises (16.50)
Player foreseen folds
Uncalled bet (11) returned to Jui Kuen
Player Jui Kuen mucks cards
------ Summary ------
Pot: 20.43. Rake 0.83. JP fee 0.24
Board: [9s 7s Kc]
Player xROCKETMANx does not show cards.Bets: 0.50. Collects: 0. Loses: 0.50.
*Player Jui Kuen mucks (does not show cards). Bets: 10.50. Collects: 20.43. Wins: 9.93.
Player IlxxxlI does not show cards.Bets: 0. Collects: 0. Wins: 0.
Player foreseen does not show cards.Bets: 10.50. Collects: 0. Loses: 10.50.
Player GagaPoker does not show cards.Bets: 0. Collects: 0. Wins: 0.
Game ended at: 2016/11/29 13:5:35

Game started
Game ID: 786965227 0.50/1 (PRR) Kraken - 7 (Hold'em)
Seat 2 is the button
Seat 1: gust (41.58).
Seat 2: WeakAndWeary (100).
Seat 3: Beep_Beep (110.25).
Seat 4: IlxxxlI (40).
Seat 5: Im Don King (105.93).
Seat 6: MadLifeGrinder (107.07).
Player Beep_Beep has small blind (0.50)
Player IlxxxlI has big blind (1)
Player IlxxxlI received card: [5h]
Player IlxxxlI received card: [6h]
Player Im Don King raises (2.35)
Player MadLifeGrinder folds
Player gust folds
Player WeakAndWeary folds
Player Beep_Beep folds
Player IlxxxlI calls (1.35)
*** FLOP ***: [Js 9s Qc]
Player IlxxxlI checks
Player Im Don King checks
*** TURN ***: [Js 9s Qc] [Ac]
Player IlxxxlI checks
Player Im Don King checks
*** RIVER ***: [Js 9s Qc Ac] [4d]
Player IlxxxlI checks
Player Im Don King bets (9)
Player IlxxxlI folds
Uncalled bet (9) returned to Im Don King
Player Im Don King mucks cards
------ Summary ------
Pot: 4.94. Rake 0.18. JP fee 0.08
Board: [Js 9s Qc Ac 4d]
Player gust does not show cards.Bets: 0. Collects: 0. Wins: 0.
Player WeakAndWeary does not show cards.Bets: 0. Collects: 0. Wins: 0.
Player Beep_Beep does not show cards.Bets: 0.50. Collects: 0. Loses: 0.50.
Player IlxxxlI does not show cards.Bets: 2.35. Collects: 0. Loses: 2.35.
*Player Im Don King mucks (does not show cards). Bets: 2.35. Collects: 4.94. Wins: 2.59.
Player MadLifeGrinder does not show cards.Bets: 0. Collects: 0. Wins: 0.
Game ended at: 2016/11/29 13:5:59

Game started
Game ID: 786965218 0.25/0.50 (PRR) Gorgons - 18 (Hold'em)
Seat 4 is the button
Seat 1: Abundance4All (83.28).
Seat 2: xROCKETMANx (53.82).
Seat 3: imperceptible (20).
Seat 4: IlxxxlI (20).
Seat 5: GagaPoker (77.93).
Seat 6: foreseen (67.33).
Player GagaPoker has small blind (0.25)
Player foreseen has big blind (0.50)
Player imperceptible is timed out.
Player imperceptible wait BB
Player IlxxxlI received card: [10h]
Player IlxxxlI received card: [4d]
Player Abundance4All folds
Player xROCKETMANx folds
Player IlxxxlI folds
Player GagaPoker folds
Uncalled bet (0.25) returned to foreseen
Player foreseen mucks cards
------ Summary ------
Pot: 0.50. Rake 0
Player Abundance4All does not show cards.Bets: 0. Collects: 0. Wins: 0.
Player xROCKETMANx does not show cards.Bets: 0. Collects: 0. Wins: 0.
Player imperceptible does not show cards.Bets: 0. Collects: 0. Wins: 0.
Player IlxxxlI does not show cards.Bets: 0. Collects: 0. Wins: 0.
Player GagaPoker does not show cards.Bets: 0.25. Collects: 0. Loses: 0.25.
*Player foreseen mucks (does not show cards). Bets: 0.25. Collects: 0.50. Wins: 0.25.
Game ended at: 2016/11/29 13:4:33

Game started
Game ID: 786965206 0.25/0.50 (PRR) Garuda - 4 (Hold'em)
Seat 5 is the button
Seat 1: wrongcolorchip (146.08).
Seat 2: IlxxxlI (29.27).
Seat 3: kid4life (111.08).
Seat 4: MortalLock (50).
Seat 5: GagaPoker (50).
Seat 6: Spagetti1 (29.07).
Seat 7: Hakuna_Matata777 (93.92).
Seat 9: constant revelation (21.42).
Player Spagetti1 has small blind (0.25)
Player Hakuna_Matata777 has big blind (0.50)
Player IlxxxlI received card: [9s]
Player IlxxxlI received card: [4s]
Player constant revelation folds
Player wrongcolorchip folds
Player IlxxxlI folds
Player kid4life raises (1.50)
Player MortalLock raises (3.50)
Player GagaPoker folds
Player Spagetti1 folds
Player Hakuna_Matata777 folds
Player kid4life calls (2)
*** FLOP ***: [5s 9d 10d]
Player kid4life checks
Player MortalLock checks
*** TURN ***: [5s 9d 10d] [6c]
Player kid4life bets (3.68)
Player MortalLock calls (3.68)
*** RIVER ***: [5s 9d 10d 6c] [Kh]
Player kid4life bets (7.18)
Player MortalLock calls (7.18)
Player MortalLock mucks cards
------ Summary ------
Pot: 28. Rake 1.23. JP fee 0.24
Board: [5s 9d 10d 6c Kh]
Player wrongcolorchip does not show cards.Bets: 0. Collects: 0. Wins: 0.
Player IlxxxlI does not show cards.Bets: 0. Collects: 0. Wins: 0.
*Player kid4life shows: Two pairs. Ks and 10s [Kd 10h]. Bets: 14.36. Collects: 28. Wins: 13.64.
Player MortalLock mucks (does not show cards). Bets: 14.36. Collects: 0. Loses: 14.36.
Player GagaPoker does not show cards.Bets: 0. Collects: 0. Wins: 0.
Player Spagetti1 does not show cards.Bets: 0.25. Collects: 0. Loses: 0.25.
Player Hakuna_Matata777 does not show cards.Bets: 0.50. Collects: 0. Loses: 0.50.
Player constant revelation does not show cards.Bets: 0. Collects: 0. Wins: 0.
Game ended at: 2016/11/29 13:5:12

Game started
Game ID: 786965116 0.50/1 (PRR) Kraken - 22 (Hold'em)
Seat 3 is the button
Seat 1: meandkids (101.50).
Seat 2: IlxxxlI (40).
Seat 3: Beep_Beep (100).
Seat 5: MadLifeGrinder (100).
Seat 6: WeakAndWeary (280.14).
Player MadLifeGrinder has small blind (0.50)
Player WeakAndWeary has big blind (1)
Player IlxxxlI received card: [4h]
Player IlxxxlI received card: [Qc]
Player meandkids folds
Player IlxxxlI folds
Player Beep_Beep raises (3)
Player MadLifeGrinder folds
Player WeakAndWeary folds
Uncalled bet (2) returned to Beep_Beep
Player Beep_Beep mucks cards
------ Summary ------
Pot: 2.50. Rake 0
Player meandkids does not show cards.Bets: 0. Collects: 0. Wins: 0.
Player IlxxxlI does not show cards.Bets: 0. Collects: 0. Wins: 0.
*Player Beep_Beep mucks (does not show cards). Bets: 1. Collects: 2.50. Wins: 1.50.
Player MadLifeGrinder does not show cards.Bets: 0.50. Collects: 0. Loses: 0.50.
Player WeakAndWeary does not show cards.Bets: 1. Collects: 0. Loses: 1.
Game ended at: 2016/11/29 13:4:25

Game started
Game ID: 786964982 0.25/0.50 (PRR) Gorgons - 18 (Hold'em)
Seat 2 is the button
Seat 1: Abundance4All (82.53).
Seat 2: xROCKETMANx (53.82).
Seat 4: IlxxxlI (20).
Seat 5: GagaPoker (78.43).
Seat 6: foreseen (67.33).
Player IlxxxlI has small blind (0.25)
Player GagaPoker has big blind (0.50)
Player IlxxxlI received card: [10d]
Player IlxxxlI received card: [As]
Player foreseen folds
Player Abundance4All raises (1.44)
Player xROCKETMANx folds
Player IlxxxlI folds
Player GagaPoker folds
Uncalled bet (0.94) returned to Abundance4All
Player Abundance4All mucks cards
------ Summary ------
Pot: 1.25. Rake 0
*Player Abundance4All mucks (does not show cards). Bets: 0.50. Collects: 1.25. Wins: 0.75.
Player xROCKETMANx does not show cards.Bets: 0. Collects: 0. Wins: 0.
Player IlxxxlI does not show cards.Bets: 0.25. Collects: 0. Loses: 0.25.
Player GagaPoker does not show cards.Bets: 0.50. Collects: 0. Loses: 0.50.
Player foreseen does not show cards.Bets: 0. Collects: 0. Wins: 0.
Game ended at: 2016/11/29 13:3:53

Game started
Game ID: 786964858 0.25/0.50 (PRR) Gorgons - 2 (Hold'em)
Seat 3 is the button
Seat 1: BHawk12 (59.84).
Seat 2: IlxxxlI (25.93).
Seat 3: flyshark01 (96.20).
Seat 4: Jui Kuen (50).
Seat 5: constant revelation (27.60).
Seat 6: foreseen (50).
Player Jui Kuen has small blind (0.25)
Player constant revelation has big blind (0.50)
Player IlxxxlI received card: [Qd]
Player IlxxxlI received card: [8h]
Player foreseen folds
Player BHawk12 raises (1.50)
Player IlxxxlI folds
Player flyshark01 folds
Player Jui Kuen folds
Player constant revelation calls (1)
*** FLOP ***: [Ac 9s Jc]
Player constant revelation checks
Player BHawk12 checks
*** TURN ***: [Ac 9s Jc] [2d]
Player constant revelation checks
Player BHawk12 checks
*** RIVER ***: [Ac 9s Jc 2d] [Jd]
Player constant revelation checks
Player BHawk12 checks
Player BHawk12 mucks cards
------ Summary ------
Pot: 3.09. Rake 0.12. JP fee 0.04
Board: [Ac 9s Jc 2d Jd]
Player BHawk12 mucks (does not show cards). Bets: 1.50. Collects: 0. Loses: 1.50.
Player IlxxxlI does not show cards.Bets: 0. Collects: 0. Wins: 0.
Player flyshark01 does not show cards.Bets: 0. Collects: 0. Wins: 0.
Player Jui Kuen does not show cards.Bets: 0.25. Collects: 0. Loses: 0.25.
*Player constant revelation shows: Two pairs. Js and 9s [9h 8s]. Bets: 1.50. Collects: 3.09. Wins: 1.59.
Player foreseen does not show cards.Bets: 0. Collects: 0. Wins: 0.
Game ended at: 2016/11/29 13:4:17

Game started
Game ID: 786964685 0.50/1 (PRR) Kraken - 22 (Hold'em)
Seat 2 is the button
Seat 1: meandkids (100).
Seat 2: IlxxxlI (40).
Seat 3: Beep_Beep (100).
Seat 4: gust (40).
Seat 5: MadLifeGrinder (100).
Seat 6: WeakAndWeary (280.14).
Player Beep_Beep has small blind (0.50)
Player gust sitting out
Player MadLifeGrinder has big blind (1)
Player IlxxxlI received card: [Ks]
Player IlxxxlI received card: [8c]
Player WeakAndWeary folds
Player meandkids raises (6)
Player IlxxxlI folds
Player Beep_Beep folds
Player MadLifeGrinder folds
Uncalled bet (5) returned to meandkids
Player meandkids mucks cards
------ Summary ------
Pot: 2.50. Rake 0
*Player meandkids mucks (does not show cards). Bets: 1. Collects: 2.50. Wins: 1.50.
Player IlxxxlI does not show cards.Bets: 0. Collects: 0. Wins: 0.
Player Beep_Beep does not show cards.Bets: 0.50. Collects: 0. Loses: 0.50.
Player gust does not show cards.Bets: 0. Collects: 0. Wins: 0.
Player MadLifeGrinder does not show cards.Bets: 1. Collects: 0. Loses: 1.
Player WeakAndWeary does not show cards.Bets: 0. Collects: 0. Wins: 0.
Game ended at: 2016/11/29 13:3:43

Game started
Game ID: 786964634 1/2 (PRR) Lakhey (Hold'em)
Seat 3 is the button
Seat 1: bfish602 (207).
Seat 2: KingGuciGuci (207.99).
Seat 3: IbetUmuck (717.68).
Seat 4: IlxxxlI (90.67).
Seat 5: MadLifeGrinder (200).
Seat 6: LazyFish (264.70).
Player IlxxxlI has small blind (1)
Player MadLifeGrinder has big blind (2)
Player IlxxxlI received card: [Js]
Player IlxxxlI received card: [6c]
Player LazyFish folds
Player bfish602 folds
Player KingGuciGuci raises (4.40)
Player IbetUmuck folds
Player IlxxxlI folds
Player MadLifeGrinder calls (2.40)
*** FLOP ***: [2h Kd 7c]
Player MadLifeGrinder checks
Player KingGuciGuci checks
*** TURN ***: [2h Kd 7c] [Jh]
Player MadLifeGrinder bets (7)
Player KingGuciGuci calls (7)
*** RIVER ***: [2h Kd 7c Jh] [9c]
Player MadLifeGrinder bets (16)
Player KingGuciGuci folds
Uncalled bet (16) returned to MadLifeGrinder
Player MadLifeGrinder mucks cards
------ Summary ------
Pot: 22.61. Rake 0.95. JP fee 0.24
Board: [2h Kd 7c Jh 9c]
Player bfish602 does not show cards.Bets: 0. Collects: 0. Wins: 0.
Player KingGuciGuci does not show cards.Bets: 11.40. Collects: 0. Loses: 11.40.
Player IbetUmuck does not show cards.Bets: 0. Collects: 0. Wins: 0.
Player IlxxxlI does not show cards.Bets: 1. Collects: 0. Loses: 1.
*Player MadLifeGrinder mucks (does not show cards). Bets: 11.40. Collects: 22.61. Wins: 11.21.
Player LazyFish does not show cards.Bets: 0. Collects: 0. Wins: 0.
Game ended at: 2016/11/29 13:4:17

Game started
Game ID: 786964596 0.50/1 (PRR) Kraken (Hold'em)
Seat 6 is the button
Seat 1: WeakAndWeary (125.96).
Seat 2: MadLifeGrinder (100).
Seat 3: JoeRockwell (45.36).
Seat 4: LloydXmas (130.87).
Seat 5: Hakuna_Matata777 (100).
Seat 6: IlxxxlI (48.03).
Player WeakAndWeary has small blind (0.50)
Player MadLifeGrinder has big blind (1)
Player IlxxxlI received card: [Qh]
Player IlxxxlI received card: [8c]
Player JoeRockwell folds
Player LloydXmas folds
Player Hakuna_Matata777 folds
Player IlxxxlI folds
Player WeakAndWeary raises (2.50)
Player MadLifeGrinder calls (2)
*** FLOP ***: [5s Jd 10h]
Player WeakAndWeary bets (4.28)
Player MadLifeGrinder folds
Uncalled bet (4.28) returned to WeakAndWeary
Player WeakAndWeary mucks cards
------ Summary ------
Pot: 5.70. Rake 0.20. JP fee 0.10
Board: [5s Jd 10h]
*Player WeakAndWeary mucks (does not show cards). Bets: 3. Collects: 5.70. Wins: 2.70.
Player MadLifeGrinder does not show cards.Bets: 3. Collects: 0. Loses: 3.
Player JoeRockwell does not show cards.Bets: 0. Collects: 0. Wins: 0.
Player LloydXmas does not show cards.Bets: 0. Collects: 0. Wins: 0.
Player Hakuna_Matata777 does not show cards.Bets: 0. Collects: 0. Wins: 0.
Player IlxxxlI does not show cards.Bets: 0. Collects: 0. Wins: 0.
Game ended at: 2016/11/29 13:4:2

Game started
Game ID: 786964519 0.25/0.50 (PRR) Gorgons - 2 (Hold'em)
Seat 2 is the button
Seat 1: BHawk12 (59.09).
Seat 2: IlxxxlI (25.93).
Seat 3: flyshark01 (96.45).
Seat 4: Jui Kuen (50).
Seat 5: constant revelation (27.60).
Seat 6: foreseen (50).
Player flyshark01 has small blind (0.25)
Player Jui Kuen has big blind (0.50)
Player IlxxxlI received card: [9s]
Player IlxxxlI received card: [Qc]
Player constant revelation folds
Player foreseen folds
Player BHawk12 raises (1.50)
Player IlxxxlI folds
Player flyshark01 folds
Player Jui Kuen folds
Uncalled bet (1) returned to BHawk12
Player BHawk12 mucks cards
------ Summary ------
Pot: 1.25. Rake 0
*Player BHawk12 mucks (does not show cards). Bets: 0.50. Collects: 1.25. Wins: 0.75.
Player IlxxxlI does not show cards.Bets: 0. Collects: 0. Wins: 0.
Player flyshark01 does not show cards.Bets: 0.25. Collects: 0. Loses: 0.25.
Player Jui Kuen does not show cards.Bets: 0.50. Collects: 0. Loses: 0.50.
Player constant revelation does not show cards.Bets: 0. Collects: 0. Wins: 0.
Player foreseen does not show cards.Bets: 0. Collects: 0. Wins: 0.
Game ended at: 2016/11/29 13:3:15

Game started
Game ID: 786964521 0.25/0.50 (PRR) Gorgons - 9 (Hold'em)
Seat 2 is the button
Seat 1: xROCKETMANx (86.96).
Seat 2: Jui Kuen (50).
Seat 3: IlxxxlI (20.25).
Seat 4: foreseen (50).
Seat 6: GagaPoker (60.81).
Player IlxxxlI has small blind (0.25)
Player foreseen has big blind (0.50)
Player IlxxxlI received card: [6s]
Player IlxxxlI received card: [2c]
Player GagaPoker folds
Player xROCKETMANx folds
Player Jui Kuen raises (1)
Player IlxxxlI folds
Player foreseen calls (0.50)
*** FLOP ***: [2d Ad Kh]
Player foreseen checks
Player Jui Kuen checks
*** TURN ***: [2d Ad Kh] [Jc]
Player foreseen bets (1.65)
Player Jui Kuen calls (1.65)
*** RIVER ***: [2d Ad Kh Jc] [7s]
Player foreseen bets (1.76)
Player Jui Kuen folds
Uncalled bet (1.76) returned to foreseen
Player foreseen mucks cards
------ Summary ------
Pot: 5.28. Rake 0.19. JP fee 0.08
Board: [2d Ad Kh Jc 7s]
Player xROCKETMANx does not show cards.Bets: 0. Collects: 0. Wins: 0.
Player Jui Kuen does not show cards.Bets: 2.65. Collects: 0. Loses: 2.65.
Player IlxxxlI does not show cards.Bets: 0.25. Collects: 0. Loses: 0.25.
*Player foreseen mucks (does not show cards). Bets: 2.65. Collects: 5.28. Wins: 2.63.
Player GagaPoker does not show cards.Bets: 0. Collects: 0. Wins: 0.
Game ended at: 2016/11/29 13:3:57

Game started
Game ID: 786964459 1/2 (PRR) Lakhey (Hold'em)
Seat 2 is the button
Seat 1: bfish602 (207).
Seat 2: KingGuciGuci (207.99).
Seat 3: IbetUmuck (718.68).
Seat 4: IlxxxlI (89.67).
Seat 5: MadLifeGrinder (200).
Seat 6: LazyFish (264.70).
Player IbetUmuck has small blind (1)
Player IlxxxlI has big blind (2)
Player IlxxxlI received card: [Ac]
Player IlxxxlI received card: [5c]
Player MadLifeGrinder folds
Player LazyFish folds
Player bfish602 folds
Player KingGuciGuci folds
Player IbetUmuck folds
Uncalled bet (1) returned to IlxxxlI
Player IlxxxlI mucks cards
------ Summary ------
Pot: 2. Rake 0
Player bfish602 does not show cards.Bets: 0. Collects: 0. Wins: 0.
Player KingGuciGuci does not show cards.Bets: 0. Collects: 0. Wins: 0.
Player IbetUmuck does not show cards.Bets: 1. Collects: 0. Loses: 1.
*Player IlxxxlI mucks (does not show cards). Bets: 1. Collects: 2. Wins: 1.
Player MadLifeGrinder does not show cards.Bets: 0. Collects: 0. Wins: 0.
Player LazyFish does not show cards.Bets: 0. Collects: 0. Wins: 0.
Game ended at: 2016/11/29 13:2:50

Game started
Game ID: 786964358 0.50/1 (PRR) Kraken - 22 (Hold'em)
Seat 1 is the button
Seat 1: meandkids (100).
Seat 2: IlxxxlI (40).
Seat 3: Beep_Beep (100).
Seat 4: gust (40).
Seat 5: MadLifeGrinder (100).
Seat 6: WeakAndWeary (278.64).
Player IlxxxlI has small blind (0.50)
Player Beep_Beep has big blind (1)
Player IlxxxlI received card: [Qs]
Player IlxxxlI received card: [Jd]
Player gust folds
Player MadLifeGrinder folds
Player WeakAndWeary raises (3)
Player meandkids folds
Player IlxxxlI folds
Player Beep_Beep folds
Uncalled bet (2) returned to WeakAndWeary
Player WeakAndWeary mucks cards
------ Summary ------
Pot: 2.50. Rake 0
Player meandkids does not show cards.Bets: 0. Collects: 0. Wins: 0.
Player IlxxxlI does not show cards.Bets: 0.50. Collects: 0. Loses: 0.50.
Player Beep_Beep does not show cards.Bets: 1. Collects: 0. Loses: 1.
Player gust does not show cards.Bets: 0. Collects: 0. Wins: 0.
Player MadLifeGrinder does not show cards.Bets: 0. Collects: 0. Wins: 0.
*Player WeakAndWeary mucks (does not show cards). Bets: 1. Collects: 2.50. Wins: 1.50.
Game ended at: 2016/11/29 13:2:57

Game started
Game ID: 786964206 0.25/0.50 (PRR) Garuda - 4 (Hold'em)
Seat 4 is the button
Seat 1: wrongcolorchip (155.58).
Seat 2: IlxxxlI (20).
Seat 3: kid4life (111.08).
Seat 4: MortalLock (50).
Seat 5: GagaPoker (50).
Seat 6: Spagetti1 (29.57).
Seat 7: Hakuna_Matata777 (93.92).
Seat 9: constant revelation (21.42).
Player GagaPoker has small blind (0.25)
Player Spagetti1 has big blind (0.50)
Player IlxxxlI received card: [10c]
Player IlxxxlI received card: [Ac]
Player Hakuna_Matata777 folds
Player constant revelation folds
Player wrongcolorchip raises (1.50)
Player IlxxxlI calls (1.50)
Player kid4life folds
Player MortalLock folds
Player GagaPoker folds
Player Spagetti1 folds
*** FLOP ***: [7c 4c Jd]
Player wrongcolorchip bets (2.50)
Player IlxxxlI calls (2.50)
*** TURN ***: [7c 4c Jd] [Qc]
Player wrongcolorchip bets (5.50)
Player IlxxxlI calls (5.50)
*** RIVER ***: [7c 4c Jd Qc] [4d]
Player wrongcolorchip checks
Player IlxxxlI allin (10.50)
Player wrongcolorchip folds
Uncalled bet (10.50) returned to IlxxxlI
Player IlxxxlI mucks cards
------ Summary ------
Pot: 18.77. Rake 0.74. JP fee 0.24
Board: [7c 4c Jd Qc 4d]
Player wrongcolorchip does not show cards.Bets: 9.50. Collects: 0. Loses: 9.50.
*Player IlxxxlI mucks (does not show cards). Bets: 9.50. Collects: 18.77. Wins: 9.27.
Player kid4life does not show cards.Bets: 0. Collects: 0. Wins: 0.
Player MortalLock does not show cards.Bets: 0. Collects: 0. Wins: 0.
Player GagaPoker does not show cards.Bets: 0.25. Collects: 0. Loses: 0.25.
Player Spagetti1 does not show cards.Bets: 0.50. Collects: 0. Loses: 0.50.
Player Hakuna_Matata777 does not show cards.Bets: 0. Collects: 0. Wins: 0.
Player constant revelation does not show cards.Bets: 0. Collects: 0. Wins: 0.
Game ended at: 2016/11/29 13:3:52

Game started
Game ID: 786964192 0.50/1 (PRR) Kraken - 7 (Hold'em)
Seat 1 is the button
Seat 1: gust (41.58).
Seat 2: WeakAndWeary (100).
Seat 3: Beep_Beep (104.13).
Seat 4: IlxxxlI (40).
Seat 5: Im Don King (105.93).
Seat 6: MadLifeGrinder (107.07).
Player WeakAndWeary has small blind (0.50)
Player Beep_Beep has big blind (1)
Player IlxxxlI received card: [3h]
Player IlxxxlI received card: [4d]
Player IlxxxlI folds
Player Im Don King folds
Player MadLifeGrinder folds
Player gust folds
Player WeakAndWeary raises (2.50)
Player Beep_Beep calls (2)
*** FLOP ***: [3d 3s Qh]
Player WeakAndWeary bets (3.80)
Player Beep_Beep calls (3.80)
*** TURN ***: [3d 3s Qh] [3c]
Player WeakAndWeary checks
Player Beep_Beep bets (8)
Player WeakAndWeary folds
Uncalled bet (8) returned to Beep_Beep
Player Beep_Beep mucks cards
------ Summary ------
Pot: 12.92. Rake 0.46. JP fee 0.22
Board: [3d 3s Qh 3c]
Player gust does not show cards.Bets: 0. Collects: 0. Wins: 0.
Player WeakAndWeary does not show cards.Bets: 6.80. Collects: 0. Loses: 6.80.
*Player Beep_Beep mucks (does not show cards). Bets: 6.80. Collects: 12.92. Wins: 6.12.
Player IlxxxlI does not show cards.Bets: 0. Collects: 0. Wins: 0.
Player Im Don King does not show cards.Bets: 0. Collects: 0. Wins: 0.
Player MadLifeGrinder does not show cards.Bets: 0. Collects: 0. Wins: 0.
Game ended at: 2016/11/29 13:3:54

Game started
Game ID: 786964167 0.25/0.50 (PRR) Gorgons - 9 (Hold'em)
Seat 1 is the button
Seat 1: xROCKETMANx (86.96).
Seat 2: Jui Kuen (50).
Seat 3: IlxxxlI (20).
Seat 4: foreseen (50).
Seat 6: GagaPoker (60.81).
Player Jui Kuen has small blind (0.25)
Player IlxxxlI has big blind (0.50)
Player IlxxxlI received card: [5h]
Player IlxxxlI received card: [2d]
Player foreseen folds
Player GagaPoker folds
Player xROCKETMANx folds
Player Jui Kuen folds
Uncalled bet (0.25) returned to IlxxxlI
Player IlxxxlI mucks cards
------ Summary ------
Pot: 0.50. Rake 0
Player xROCKETMANx does not show cards.Bets: 0. Collects: 0. Wins: 0.
Player Jui Kuen does not show cards.Bets: 0.25. Collects: 0. Loses: 0.25.
*Player IlxxxlI mucks (does not show cards). Bets: 0.25. Collects: 0.50. Wins: 0.25.
Player foreseen does not show cards.Bets: 0. Collects: 0. Wins: 0.
Player GagaPoker does not show cards.Bets: 0. Collects: 0. Wins: 0.
Game ended at: 2016/11/29 13:2:38

Game started
Game ID: 786964101 1/2 (PRR) Lakhey (Hold'em)
Seat 1 is the button
Seat 1: bfish602 (207).
Seat 2: KingGuciGuci (209.99).
Seat 3: IbetUmuck (716.88).
Seat 4: IlxxxlI (89.67).
Seat 5: MadLifeGrinder (200).
Seat 6: LazyFish (264.70).
Player KingGuciGuci has small blind (1)
Player IbetUmuck has big blind (2)
Player IlxxxlI received card: [Ks]
Player IlxxxlI received card: [2h]
Player IlxxxlI folds
Player MadLifeGrinder folds
Player LazyFish folds
Player bfish602 folds
Player KingGuciGuci calls (1)
Player IbetUmuck checks
*** FLOP ***: [4c As 7d]
Player KingGuciGuci checks
Player IbetUmuck checks
*** TURN ***: [4c As 7d] [3c]
Player KingGuciGuci checks
Player IbetUmuck bets (2.85)
Player KingGuciGuci folds
Uncalled bet (2.85) returned to IbetUmuck
Player IbetUmuck mucks cards
------ Summary ------
Pot: 3.80. Rake 0.14. JP fee 0.06
Board: [4c As 7d 3c]
Player bfish602 does not show cards.Bets: 0. Collects: 0. Wins: 0.
Player KingGuciGuci does not show cards.Bets: 2. Collects: 0. Loses: 2.
*Player IbetUmuck mucks (does not show cards). Bets: 2. Collects: 3.80. Wins: 1.80.
Player IlxxxlI does not show cards.Bets: 0. Collects: 0. Wins: 0.
Player MadLifeGrinder does not show cards.Bets: 0. Collects: 0. Wins: 0.
Player LazyFish does not show cards.Bets: 0. Collects: 0. Wins: 0.
Game ended at: 2016/11/29 13:2:31

Game started
Game ID: 786964035 0.25/0.50 (PRR) Gorgons - 2 (Hold'em)
Seat 1 is the button
Seat 1: BHawk12 (59.09).
Seat 2: IlxxxlI (25.48).
Seat 3: flyshark01 (96.95).
Seat 4: Jui Kuen (50).
Seat 5: constant revelation (27.60).
Seat 6: foreseen (50).
Player IlxxxlI has small blind (0.25)
Player flyshark01 has big blind (0.50)
Player IlxxxlI received card: [9c]
Player IlxxxlI received card: [6c]
Player Jui Kuen folds
Player constant revelation folds
Player foreseen folds
Player BHawk12 folds
Player IlxxxlI calls (0.25)
Player flyshark01 checks
*** FLOP ***: [8h 4h Qs]
Player IlxxxlI bets (0.50)
Player flyshark01 folds
Uncalled bet (0.50) returned to IlxxxlI
Player IlxxxlI mucks cards
------ Summary ------
Pot: 0.95. Rake 0.05
Board: [8h 4h Qs]
Player BHawk12 does not show cards.Bets: 0. Collects: 0. Wins: 0.
*Player IlxxxlI mucks (does not show cards). Bets: 0.50. Collects: 0.95. Wins: 0.45.
Player flyshark01 does not show cards.Bets: 0.50. Collects: 0. Loses: 0.50.
Player Jui Kuen does not show cards.Bets: 0. Collects: 0. Wins: 0.
Player constant revelation does not show cards.Bets: 0. Collects: 0. Wins: 0.
Player foreseen does not show cards.Bets: 0. Collects: 0. Wins: 0.
Game ended at: 2016/11/29 13:2:38

Game started
Game ID: 786963917 0.50/1 (PRR) Kraken (Hold'em)
Seat 5 is the button
Seat 1: WeakAndWeary (126.96).
Seat 2: MadLifeGrinder (120.76).
Seat 3: JoeRockwell (23.12).
Seat 4: LloydXmas (130.87).
Seat 5: Hakuna_Matata777 (100).
Seat 6: IlxxxlI (48.53).
Player IlxxxlI has small blind (0.50)
Player WeakAndWeary has big blind (1)
Player IlxxxlI received card: [10c]
Player IlxxxlI received card: [9d]
Player MadLifeGrinder raises (2.50)
Player JoeRockwell calls (2.50)
Player LloydXmas folds
Player Hakuna_Matata777 folds
Player IlxxxlI folds
Player WeakAndWeary folds
*** FLOP ***: [3h 8s 6d]
Player MadLifeGrinder checks
Player JoeRockwell bets (4.12)
Player MadLifeGrinder calls (4.12)
*** TURN ***: [3h 8s 6d] [Qs]
Player MadLifeGrinder checks
Player JoeRockwell bets (7)
Player MadLifeGrinder calls (7)
*** RIVER ***: [3h 8s 6d Qs] [7s]
Player MadLifeGrinder checks
Player JoeRockwell allin (9.50)
Player MadLifeGrinder calls (9.50)
------ Summary ------
Pot: 45.36. Rake 2.14. JP fee 0.24
Board: [3h 8s 6d Qs 7s]
Player WeakAndWeary does not show cards.Bets: 1. Collects: 0. Loses: 1.
Player MadLifeGrinder shows: One pair of 6s [6h 5h]. Bets: 23.12. Collects: 0. Loses: 23.12.
*Player JoeRockwell shows: One pair of Js [Jd Jh]. Bets: 23.12. Collects: 45.36. Wins: 22.24.
Player LloydXmas does not show cards.Bets: 0. Collects: 0. Wins: 0.
Player Hakuna_Matata777 does not show cards.Bets: 0. Collects: 0. Wins: 0.
Player IlxxxlI does not show cards.Bets: 0.50. Collects: 0. Loses: 0.50.
Game ended at: 2016/11/29 13:2:46

Game started
Game ID: 786963858 1/2 (PRR) Lakhey (Hold'em)
Seat 6 is the button
Seat 1: bfish602 (208).
Seat 2: KingGuciGuci (211.99).
Seat 3: IbetUmuck (713.88).
Seat 4: IlxxxlI (89.67).
Seat 5: MadLifeGrinder (200).
Seat 6: LazyFish (264.70).
Player bfish602 has small blind (1)
Player KingGuciGuci has big blind (2)
Player IlxxxlI received card: [4d]
Player IlxxxlI received card: [Qc]
Player IbetUmuck raises (5.75)
Player IlxxxlI folds
Player MadLifeGrinder folds
Player LazyFish folds
Player bfish602 folds
Player KingGuciGuci folds
Uncalled bet (3.75) returned to IbetUmuck
Player IbetUmuck mucks cards
------ Summary ------
Pot: 5. Rake 0
Player bfish602 does not show cards.Bets: 1. Collects: 0. Loses: 1.
Player KingGuciGuci does not show cards.Bets: 2. Collects: 0. Loses: 2.
*Player IbetUmuck mucks (does not show cards). Bets: 2. Collects: 5. Wins: 3.
Player IlxxxlI does not show cards.Bets: 0. Collects: 0. Wins: 0.
Player MadLifeGrinder does not show cards.Bets: 0. Collects: 0. Wins: 0.
Player LazyFish does not show cards.Bets: 0. Collects: 0. Wins: 0.
Game ended at: 2016/11/29 13:1:52

Game started
Game ID: 786963501 1/2 (PRR) Lakhey (Hold'em)
Seat 5 is the button
Seat 1: bfish602 (210).
Seat 2: KingGuciGuci (211.99).
Seat 3: IbetUmuck (713.88).
Seat 4: IlxxxlI (89.67).
Seat 5: MadLifeGrinder (200).
Seat 6: LazyFish (262.70).
Player LazyFish has small blind (1)
Player bfish602 has big blind (2)
Player IlxxxlI received card: [6s]
Player IlxxxlI received card: [Ks]
Player KingGuciGuci folds
Player IbetUmuck folds
Player IlxxxlI folds
Player MadLifeGrinder folds
Player LazyFish raises (4)
Player bfish602 folds
Uncalled bet (3) returned to LazyFish
Player LazyFish mucks cards
------ Summary ------
Pot: 4. Rake 0
Player bfish602 does not show cards.Bets: 2. Collects: 0. Loses: 2.
Player KingGuciGuci does not show cards.Bets: 0. Collects: 0. Wins: 0.
Player IbetUmuck does not show cards.Bets: 0. Collects: 0. Wins: 0.
Player IlxxxlI does not show cards.Bets: 0. Collects: 0. Wins: 0.
Player MadLifeGrinder does not show cards.Bets: 0. Collects: 0. Wins: 0.
*Player LazyFish mucks (does not show cards). Bets: 2. Collects: 4. Wins: 2.
Game ended at: 2016/11/29 13:1:25

Game started
Game ID: 786963457 0.50/1 (PRR) Kraken - 7 (Hold'em)
Seat 6 is the button
Seat 1: gust (42.08).
Seat 2: WeakAndWeary (101.22).
Seat 3: Beep_Beep (104.13).
Seat 4: IlxxxlI (40).
Seat 5: Im Don King (105.93).
Seat 6: MadLifeGrinder (104.34).
Player gust has small blind (0.50)
Player WeakAndWeary has big blind (1)
Player IlxxxlI received card: [Qs]
Player IlxxxlI received card: [8c]
Player Beep_Beep folds
Player IlxxxlI folds
Player Im Don King folds
Player MadLifeGrinder raises (2.50)
Player gust folds
Player WeakAndWeary calls (1.50)
*** FLOP ***: [5s 3h Jd]
Player WeakAndWeary checks
Player MadLifeGrinder bets (2.61)
Player WeakAndWeary folds
Uncalled bet (2.61) returned to MadLifeGrinder
Player MadLifeGrinder mucks cards
------ Summary ------
Pot: 5.23. Rake 0.19. JP fee 0.08
Board: [5s 3h Jd]
Player gust does not show cards.Bets: 0.50. Collects: 0. Loses: 0.50.
Player WeakAndWeary does not show cards.Bets: 2.50. Collects: 0. Loses: 2.50.
Player Beep_Beep does not show cards.Bets: 0. Collects: 0. Wins: 0.
Player IlxxxlI does not show cards.Bets: 0. Collects: 0. Wins: 0.
Player Im Don King does not show cards.Bets: 0. Collects: 0. Wins: 0.
*Player MadLifeGrinder mucks (does not show cards). Bets: 2.50. Collects: 5.23. Wins: 2.73.
Game ended at: 2016/11/29 13:2:2

Game started
Game ID: 786963310 0.50/1 (PRR) Kraken - 9 (Hold'em)
Seat 1 is the button
Seat 1: WeakAndWeary (111.05).
Seat 2: LloydXmas (101.58).
Seat 3: GagaPoker (103.56).
Seat 4: Beep_Beep (100).
Seat 5: MadLifeGrinder (100).
Seat 6: IlxxxlI (62.23).
Player LloydXmas has small blind (0.50)
Player GagaPoker sitting out
Player Beep_Beep has big blind (1)
Player IlxxxlI received card: [6h]
Player IlxxxlI received card: [2d]
Player MadLifeGrinder folds
Player IlxxxlI folds
Player WeakAndWeary raises (2)
Player LloydXmas raises (7.50)
Player Beep_Beep folds
Player WeakAndWeary folds
Uncalled bet (6) returned to LloydXmas
Player LloydXmas mucks cards
------ Summary ------
Pot: 5. Rake 0
Player WeakAndWeary does not show cards.Bets: 2. Collects: 0. Loses: 2.
*Player LloydXmas mucks (does not show cards). Bets: 2. Collects: 5. Wins: 3.
Player GagaPoker does not show cards.Bets: 0. Collects: 0. Wins: 0.
Player Beep_Beep does not show cards.Bets: 1. Collects: 0. Loses: 1.
Player MadLifeGrinder does not show cards.Bets: 0. Collects: 0. Wins: 0.
Player IlxxxlI does not show cards.Bets: 0. Collects: 0. Wins: 0.
Game ended at: 2016/11/29 13:1:3

Game started
Game ID: 786963286 0.25/0.50 (PRR) Garuda - 4 (Hold'em)
Seat 3 is the button
Seat 1: wrongcolorchip (155.58).
Seat 2: IlxxxlI (25.02).
Seat 3: kid4life (111.08).
Seat 4: MortalLock (50.25).
Seat 5: GagaPoker (50).
Seat 6: Spagetti1 (22.50).
Seat 7: Hakuna_Matata777 (93.92).
Seat 9: constant revelation (21.42).
Player MortalLock has small blind (0.25)
Player GagaPoker has big blind (0.50)
Player IlxxxlI received card: [8s]
Player IlxxxlI received card: [8d]
Player Spagetti1 raises (1.50)
Player Hakuna_Matata777 folds
Player constant revelation folds
Player wrongcolorchip folds
Player IlxxxlI calls (1.50)
Player kid4life folds
Player MortalLock folds
Player GagaPoker calls (1)
*** FLOP ***: [Js Jd 3c]
Player GagaPoker checks
Player Spagetti1 checks
Player IlxxxlI bets (1.50)
Player GagaPoker folds
Player Spagetti1 calls (1.50)
*** TURN ***: [Js Jd 3c] [Qc]
Player Spagetti1 checks
Player IlxxxlI checks
*** RIVER ***: [Js Jd 3c Qc] [6h]
Player Spagetti1 bets (3)
Player IlxxxlI calls (3)
Player IlxxxlI mucks cards
------ Summary ------
Pot: 13.07. Rake 0.46. JP fee 0.22
Board: [Js Jd 3c Qc 6h]
Player wrongcolorchip does not show cards.Bets: 0. Collects: 0. Wins: 0.
Player IlxxxlI mucks (does not show: [8s 8d]). Bets: 6. Collects: 0. Loses: 6.
Player kid4life does not show cards.Bets: 0. Collects: 0. Wins: 0.
Player MortalLock does not show cards.Bets: 0.25. Collects: 0. Loses: 0.25.
Player GagaPoker does not show cards.Bets: 1.50. Collects: 0. Loses: 1.50.
*Player Spagetti1 shows: Three Of Kind of Js [Ah Jh]. Bets: 6. Collects: 13.07. Wins: 7.07.
Player Hakuna_Matata777 does not show cards.Bets: 0. Collects: 0. Wins: 0.
Player constant revelation does not show cards.Bets: 0. Collects: 0. Wins: 0.
Game ended at: 2016/11/29 13:2:2

Game started
Game ID: 786963254 0.50/1 (PRR) Kraken - 22 (Hold'em)
Seat 6 is the button
Seat 1: meandkids (100.50).
Seat 2: IlxxxlI (40).
Seat 4: gust (40).
Seat 5: MadLifeGrinder (100).
Seat 6: WeakAndWeary (273.52).
Player meandkids has small blind (0.50)
Player IlxxxlI has big blind (1)
Player IlxxxlI received card: [6h]
Player IlxxxlI received card: [6c]
Player gust folds
Player MadLifeGrinder folds
Player WeakAndWeary raises (2)
Player meandkids folds
Player IlxxxlI raises (4.16)
Player WeakAndWeary calls (3.16)
*** FLOP ***: [3c 9c 3s]
Player IlxxxlI checks
Player WeakAndWeary checks
*** TURN ***: [3c 9c 3s] [10h]
Player IlxxxlI checks
Player WeakAndWeary checks
*** RIVER ***: [3c 9c 3s 10h] [Qs]
Player IlxxxlI checks
Player WeakAndWeary allin (268.36)
Player IlxxxlI folds
Uncalled bet (268.36) returned to WeakAndWeary
Player WeakAndWeary mucks cards
------ Summary ------
Pot: 10.28. Rake 0.36. JP fee 0.18
Board: [3c 9c 3s 10h Qs]
Player meandkids does not show cards.Bets: 0.50. Collects: 0. Loses: 0.50.
Player IlxxxlI does not show cards.Bets: 5.16. Collects: 0. Loses: 5.16.
Player gust does not show cards.Bets: 0. Collects: 0. Wins: 0.
Player MadLifeGrinder does not show cards.Bets: 0. Collects: 0. Wins: 0.
*Player WeakAndWeary mucks (does not show cards). Bets: 5.16. Collects: 10.28. Wins: 5.12.
Game ended at: 2016/11/29 13:2:20

Game started
Game ID: 786963241 0.50/1 (PRR) Kraken (Hold'em)
Seat 4 is the button
Seat 1: WeakAndWeary (126.96).
Seat 2: MadLifeGrinder (120.76).
Seat 3: JoeRockwell (23.12).
Seat 4: LloydXmas (136.28).
Seat 5: Hakuna_Matata777 (100.50).
Seat 6: IlxxxlI (43.18).
Player Hakuna_Matata777 has small blind (0.50)
Player IlxxxlI has big blind (1)
Player IlxxxlI received card: [Qc]
Player IlxxxlI received card: [10d]
Player WeakAndWeary folds
Player MadLifeGrinder folds
Player JoeRockwell folds
Player LloydXmas raises (2.25)
Player Hakuna_Matata777 folds
Player IlxxxlI calls (1.25)
*** FLOP ***: [10c 2c 2s]
Player IlxxxlI checks
Player LloydXmas checks
*** TURN ***: [10c 2c 2s] [4h]
Player IlxxxlI bets (3.16)
Player LloydXmas calls (3.16)
*** RIVER ***: [10c 2c 2s 4h] [Kh]
Player IlxxxlI checks
Player LloydXmas checks
Player LloydXmas mucks cards
------ Summary ------
Pot: 10.76. Rake 0.38. JP fee 0.18
Board: [10c 2c 2s 4h Kh]
Player WeakAndWeary does not show cards.Bets: 0. Collects: 0. Wins: 0.
Player MadLifeGrinder does not show cards.Bets: 0. Collects: 0. Wins: 0.
Player JoeRockwell does not show cards.Bets: 0. Collects: 0. Wins: 0.
Player LloydXmas mucks (does not show cards). Bets: 5.41. Collects: 0. Loses: 5.41.
Player Hakuna_Matata777 does not show cards.Bets: 0.50. Collects: 0. Loses: 0.50.
*Player IlxxxlI shows: Two pairs. 10s and 2s [Qc 10d]. Bets: 5.41. Collects: 10.76. Wins: 5.35.
Game ended at: 2016/11/29 13:1:30

Game started
Game ID: 786963225 1/2 (PRR) Lakhey (Hold'em)
Seat 4 is the button
Seat 1: bfish602 (210).
Seat 2: KingGuciGuci (211.99).
Seat 3: IbetUmuck (713.88).
Seat 4: IlxxxlI (89.67).
Seat 5: MadLifeGrinder (201).
Seat 6: LazyFish (261.70).
Player MadLifeGrinder has small blind (1)
Player LazyFish has big blind (2)
Player IlxxxlI received card: [2h]
Player IlxxxlI received card: [6c]
Player bfish602 folds
Player KingGuciGuci folds
Player IbetUmuck folds
Player IlxxxlI folds
Player MadLifeGrinder folds
Uncalled bet (1) returned to LazyFish
Player LazyFish mucks cards
------ Summary ------
Pot: 2. Rake 0
Player bfish602 does not show cards.Bets: 0. Collects: 0. Wins: 0.
Player KingGuciGuci does not show cards.Bets: 0. Collects: 0. Wins: 0.
Player IbetUmuck does not show cards.Bets: 0. Collects: 0. Wins: 0.
Player IlxxxlI does not show cards.Bets: 0. Collects: 0. Wins: 0.
Player MadLifeGrinder does not show cards.Bets: 1. Collects: 0. Loses: 1.
*Player LazyFish mucks (does not show cards). Bets: 1. Collects: 2. Wins: 1.
Game ended at: 2016/11/29 13:0:45

Game started
Game ID: 786963156 0.25/0.50 (PRR) Garuda - 4 (Hold'em)
Seat 2 is the button
Seat 1: wrongcolorchip (155.58).
Seat 2: IlxxxlI (25.02).
Seat 3: kid4life (111.33).
Seat 4: MortalLock (50).
Seat 6: Spagetti1 (22.50).
Seat 7: Hakuna_Matata777 (93.92).
Seat 9: constant revelation (21.42).
Player kid4life has small blind (0.25)
Player MortalLock has big blind (0.50)
Player IlxxxlI received card: [5c]
Player IlxxxlI received card: [7h]
Player Spagetti1 folds
Player Hakuna_Matata777 folds
Player constant revelation folds
Player wrongcolorchip folds
Player IlxxxlI folds
Player kid4life folds
Uncalled bet (0.25) returned to MortalLock
Player MortalLock mucks cards
------ Summary ------
Pot: 0.50. Rake 0
Player wrongcolorchip does not show cards.Bets: 0. Collects: 0. Wins: 0.
Player IlxxxlI does not show cards.Bets: 0. Collects: 0. Wins: 0.
Player kid4life does not show cards.Bets: 0.25. Collects: 0. Loses: 0.25.
*Player MortalLock mucks (does not show cards). Bets: 0.25. Collects: 0.50. Wins: 0.25.
Player Spagetti1 does not show cards.Bets: 0. Collects: 0. Wins: 0.
Player Hakuna_Matata777 does not show cards.Bets: 0. Collects: 0. Wins: 0.
Player constant revelation does not show cards.Bets: 0. Collects: 0. Wins: 0.
Game ended at: 2016/11/29 13:0:15

Game started
Game ID: 786963099 0.25/0.50 (PRR) Gorgons - 2 (Hold'em)
Seat 6 is the button
Seat 1: BHawk12 (50.92).
Seat 2: IlxxxlI (25.98).
Seat 3: flyshark01 (96.95).
Seat 4: Jui Kuen (50).
Seat 5: constant revelation (27.60).
Seat 6: foreseen (50.34).
Player BHawk12 has small blind (0.25)
Player IlxxxlI has big blind (0.50)
Player IlxxxlI received card: [9h]
Player IlxxxlI received card: [Js]
Player flyshark01 folds
Player Jui Kuen folds
Player constant revelation folds
Player foreseen raises (1.12)
Player BHawk12 raises (3.75)
Player IlxxxlI folds
Player foreseen calls (2.88)
*** FLOP ***: [7d 3s Ks]
Player BHawk12 checks
Player foreseen bets (4.54)
Player BHawk12 calls (4.54)
*** TURN ***: [7d 3s Ks] [7h]
Player BHawk12 checks
Player foreseen checks
*** RIVER ***: [7d 3s Ks 7h] [Qd]
Player BHawk12 bets (8.35)
Player foreseen folds
Uncalled bet (8.35) returned to BHawk12
Player BHawk12 mucks cards
------ Summary ------
Pot: 16.71. Rake 0.63. JP fee 0.24
Board: [7d 3s Ks 7h Qd]
*Player BHawk12 mucks (does not show cards). Bets: 8.54. Collects: 16.71. Wins: 8.17.
Player IlxxxlI does not show cards.Bets: 0.50. Collects: 0. Loses: 0.50.
Player flyshark01 does not show cards.Bets: 0. Collects: 0. Wins: 0.
Player Jui Kuen does not show cards.Bets: 0. Collects: 0. Wins: 0.
Player constant revelation does not show cards.Bets: 0. Collects: 0. Wins: 0.
Player foreseen does not show cards.Bets: 8.54. Collects: 0. Loses: 8.54.
Game ended at: 2016/11/29 13:1:44

Game started
Game ID: 786963070 0.50/1 (PRR) Kraken (Hold'em)
Seat 3 is the button
Seat 1: WeakAndWeary (126.96).
Seat 2: MadLifeGrinder (120.76).
Seat 3: JoeRockwell (23.12).
Seat 4: LloydXmas (136.78).
Seat 5: Hakuna_Matata777 (100).
Seat 6: IlxxxlI (43.18).
Player LloydXmas has small blind (0.50)
Player Hakuna_Matata777 has big blind (1)
Player IlxxxlI received card: [Jh]
Player IlxxxlI received card: [Qc]
Player IlxxxlI folds
Player WeakAndWeary folds
Player MadLifeGrinder folds
Player JoeRockwell folds
Player LloydXmas folds
Uncalled bet (0.50) returned to Hakuna_Matata777
Player Hakuna_Matata777 mucks cards
------ Summary ------
Pot: 1. Rake 0
Player WeakAndWeary does not show cards.Bets: 0. Collects: 0. Wins: 0.
Player MadLifeGrinder does not show cards.Bets: 0. Collects: 0. Wins: 0.
Player JoeRockwell does not show cards.Bets: 0. Collects: 0. Wins: 0.
Player LloydXmas does not show cards.Bets: 0.50. Collects: 0. Loses: 0.50.
*Player Hakuna_Matata777 mucks (does not show cards). Bets: 0.50. Collects: 1. Wins: 0.50.
Player IlxxxlI does not show cards.Bets: 0. Collects: 0. Wins: 0.
Game ended at: 2016/11/29 13:0:10

Game started
Game ID: 786963054 1/2 (PRR) Lakhey (Hold'em)
Seat 3 is the button
Seat 1: bfish602 (210).
Seat 2: KingGuciGuci (211.99).
Seat 3: IbetUmuck (713.88).
Seat 4: IlxxxlI (90.67).
Seat 5: MadLifeGrinder (200).
Seat 6: LazyFish (261.70).
Player IlxxxlI has small blind (1)
Player MadLifeGrinder has big blind (2)
Player IlxxxlI received card: [7c]
Player IlxxxlI received card: [10s]
Player LazyFish folds
Player bfish602 folds
Player KingGuciGuci folds
Player IbetUmuck folds
Player IlxxxlI folds
Uncalled bet (1) returned to MadLifeGrinder
Player MadLifeGrinder mucks cards
------ Summary ------
Pot: 2. Rake 0
Player bfish602 does not show cards.Bets: 0. Collects: 0. Wins: 0.
Player KingGuciGuci does not show cards.Bets: 0. Collects: 0. Wins: 0.
Player IbetUmuck does not show cards.Bets: 0. Collects: 0. Wins: 0.
Player IlxxxlI does not show cards.Bets: 1. Collects: 0. Loses: 1.
*Player MadLifeGrinder mucks (does not show cards). Bets: 1. Collects: 2. Wins: 1.
Player LazyFish does not show cards.Bets: 0. Collects: 0. Wins: 0.
Game ended at: 2016/11/29 13:0:7

Game started
Game ID: 786963010 0.50/1 (PRR) Kraken - 22 (Hold'em)
Seat 5 is the button
Seat 1: meandkids (100).
Seat 2: IlxxxlI (40).
Seat 4: gust (40).
Seat 5: MadLifeGrinder (100).
Seat 6: WeakAndWeary (274.02).
Player WeakAndWeary has small blind (0.50)
Player meandkids has big blind (1)
Player IlxxxlI received card: [Jh]
Player IlxxxlI received card: [8d]
Player IlxxxlI folds
Player gust folds
Player MadLifeGrinder folds
Player WeakAndWeary folds
Uncalled bet (0.50) returned to meandkids
Player meandkids mucks cards
------ Summary ------
Pot: 1. Rake 0
*Player meandkids mucks (does not show cards). Bets: 0.50. Collects: 1. Wins: 0.50.
Player IlxxxlI does not show cards.Bets: 0. Collects: 0. Wins: 0.
Player gust does not show cards.Bets: 0. Collects: 0. Wins: 0.
Player MadLifeGrinder does not show cards.Bets: 0. Collects: 0. Wins: 0.
Player WeakAndWeary does not show cards.Bets: 0.50. Collects: 0. Loses: 0.50.
Game ended at: 2016/11/29 13:0:11

Game started
Game ID: 786962846 0.50/1 (PRR) Kraken (Hold'em)
Seat 2 is the button
Seat 1: WeakAndWeary (126.96).
Seat 2: MadLifeGrinder (120.76).
Seat 3: JoeRockwell (23.62).
Seat 4: LloydXmas (136.28).
Seat 5: Hakuna_Matata777 (100).
Seat 6: IlxxxlI (43.18).
Player JoeRockwell has small blind (0.50)
Player LloydXmas has big blind (1)
Player IlxxxlI received card: [Ks]
Player IlxxxlI received card: [10h]
Player Hakuna_Matata777 folds
Player IlxxxlI folds
Player WeakAndWeary folds
Player MadLifeGrinder folds
Player JoeRockwell folds
Uncalled bet (0.50) returned to LloydXmas
Player LloydXmas mucks cards
------ Summary ------
Pot: 1. Rake 0
Player WeakAndWeary does not show cards.Bets: 0. Collects: 0. Wins: 0.
Player MadLifeGrinder does not show cards.Bets: 0. Collects: 0. Wins: 0.
Player JoeRockwell does not show cards.Bets: 0.50. Collects: 0. Loses: 0.50.
*Player LloydXmas mucks (does not show cards). Bets: 0.50. Collects: 1. Wins: 0.50.
Player Hakuna_Matata777 does not show cards.Bets: 0. Collects: 0. Wins: 0.
Player IlxxxlI does not show cards.Bets: 0. Collects: 0. Wins: 0.
Game ended at: 2016/11/29 12:59:47

Game started
Game ID: 786962808 1/2 (PRR) Lakhey (Hold'em)
Seat 2 is the button
Seat 1: bfish602 (210).
Seat 2: KingGuciGuci (216.39).
Seat 3: IbetUmuck (714.88).
Seat 4: IlxxxlI (85.27).
Seat 5: MadLifeGrinder (200).
Seat 6: LazyFish (261.70).
Player IbetUmuck has small blind (1)
Player IlxxxlI has big blind (2)
Player IlxxxlI received card: [10c]
Player IlxxxlI received card: [10s]
Player MadLifeGrinder folds
Player LazyFish folds
Player bfish602 folds
Player KingGuciGuci raises (4.40)
Player IbetUmuck folds
Player IlxxxlI raises (9.29)
Player KingGuciGuci folds
Uncalled bet (6.89) returned to IlxxxlI
Player IlxxxlI mucks cards
------ Summary ------
Pot: 9.80. Rake 0
Player bfish602 does not show cards.Bets: 0. Collects: 0. Wins: 0.
Player KingGuciGuci does not show cards.Bets: 4.40. Collects: 0. Loses: 4.40.
Player IbetUmuck does not show cards.Bets: 1. Collects: 0. Loses: 1.
*Player IlxxxlI mucks (does not show cards). Bets: 4.40. Collects: 9.80. Wins: 5.40.
Player MadLifeGrinder does not show cards.Bets: 0. Collects: 0. Wins: 0.
Player LazyFish does not show cards.Bets: 0. Collects: 0. Wins: 0.
Game ended at: 2016/11/29 12:59:45

Game started
Game ID: 786962799 0.25/0.50 (PRR) Gorgons - 2 (Hold'em)
Seat 5 is the button
Seat 1: BHawk12 (52.42).
Seat 2: IlxxxlI (25.98).
Seat 3: flyshark01 (95.36).
Seat 4: Jui Kuen (50).
Seat 5: constant revelation (27.60).
Seat 6: foreseen (50.59).
Player foreseen has small blind (0.25)
Player BHawk12 has big blind (0.50)
Player IlxxxlI received card: [9h]
Player IlxxxlI received card: [3s]
Player IlxxxlI folds
Player flyshark01 raises (1.50)
Player Jui Kuen folds
Player constant revelation folds
Player foreseen folds
Player BHawk12 calls (1)
*** FLOP ***: [5h Js 2s]
Player BHawk12 checks
Player flyshark01 bets (2.06)
Player BHawk12 folds
Uncalled bet (2.06) returned to flyshark01
Player flyshark01 mucks cards
------ Summary ------
Pot: 3.09. Rake 0.12. JP fee 0.04
Board: [5h Js 2s]
Player BHawk12 does not show cards.Bets: 1.50. Collects: 0. Loses: 1.50.
Player IlxxxlI does not show cards.Bets: 0. Collects: 0. Wins: 0.
*Player flyshark01 mucks (does not show cards). Bets: 1.50. Collects: 3.09. Wins: 1.59.
Player Jui Kuen does not show cards.Bets: 0. Collects: 0. Wins: 0.
Player constant revelation does not show cards.Bets: 0. Collects: 0. Wins: 0.
Player foreseen does not show cards.Bets: 0.25. Collects: 0. Loses: 0.25.
Game ended at: 2016/11/29 12:59:52

Game started
Game ID: 786962636 0.50/1 (PRR) Kraken - 7 (Hold'em)
Seat 5 is the button
Seat 1: gust (43.08).
Seat 2: WeakAndWeary (101.22).
Seat 3: Beep_Beep (104.13).
Seat 4: IlxxxlI (40.50).
Seat 5: Im Don King (100).
Seat 6: MadLifeGrinder (104.84).
Player MadLifeGrinder has small blind (0.50)
Player gust has big blind (1)
Player IlxxxlI received card: [Jc]
Player IlxxxlI received card: [8c]
Player WeakAndWeary folds
Player Beep_Beep folds
Player IlxxxlI raises (2.40)
Player Im Don King raises (5)
Player MadLifeGrinder folds
Player gust folds
Player IlxxxlI calls (2.60)
*** FLOP ***: [8s 2c 5h]
Player IlxxxlI checks
Player Im Don King checks
*** TURN ***: [8s 2c 5h] [Qh]
Player IlxxxlI checks
Player Im Don King checks
*** RIVER ***: [8s 2c 5h Qh] [Ah]
Player IlxxxlI checks
Player Im Don King checks
Player IlxxxlI mucks cards
------ Summary ------
Pot: 10.93. Rake 0.39. JP fee 0.18
Board: [8s 2c 5h Qh Ah]
Player gust does not show cards.Bets: 1. Collects: 0. Loses: 1.
Player WeakAndWeary does not show cards.Bets: 0. Collects: 0. Wins: 0.
Player Beep_Beep does not show cards.Bets: 0. Collects: 0. Wins: 0.
Player IlxxxlI mucks (does not show: [Jc 8c]). Bets: 5. Collects: 0. Loses: 5.
*Player Im Don King shows: One pair of As [Ad 7d]. Bets: 5. Collects: 10.93. Wins: 5.93.
Player MadLifeGrinder does not show cards.Bets: 0.50. Collects: 0. Loses: 0.50.
Game ended at: 2016/11/29 13:0:38

Game started
Game ID: 786962541 0.50/1 (PRR) Kraken (Hold'em)
Seat 1 is the button
Seat 1: WeakAndWeary (126.96).
Seat 2: MadLifeGrinder (118.06).
Seat 3: JoeRockwell (26.62).
Seat 4: LloydXmas (136.28).
Seat 5: Hakuna_Matata777 (100).
Seat 6: IlxxxlI (43.18).
Player MadLifeGrinder has small blind (0.50)
Player JoeRockwell has big blind (1)
Player IlxxxlI received card: [4s]
Player IlxxxlI received card: [7h]
Player LloydXmas folds
Player Hakuna_Matata777 folds
Player IlxxxlI folds
Player WeakAndWeary folds
Player MadLifeGrinder raises (2.50)
Player JoeRockwell calls (2)
*** FLOP ***: [7d 7c Qc]
Player MadLifeGrinder bets (2.85)
Player JoeRockwell folds
Uncalled bet (2.85) returned to MadLifeGrinder
Player MadLifeGrinder mucks cards
------ Summary ------
Pot: 5.70. Rake 0.20. JP fee 0.10
Board: [7d 7c Qc]
Player WeakAndWeary does not show cards.Bets: 0. Collects: 0. Wins: 0.
*Player MadLifeGrinder mucks (does not show cards). Bets: 3. Collects: 5.70. Wins: 2.70.
Player JoeRockwell does not show cards.Bets: 3. Collects: 0. Loses: 3.
Player LloydXmas does not show cards.Bets: 0. Collects: 0. Wins: 0.
Player Hakuna_Matata777 does not show cards.Bets: 0. Collects: 0. Wins: 0.
Player IlxxxlI does not show cards.Bets: 0. Collects: 0. Wins: 0.
Game ended at: 2016/11/29 12:59:14

Game started
Game ID: 786962520 0.50/1 (PRR) Kraken - 9 (Hold'em)
Seat 6 is the button
Seat 1: WeakAndWeary (111.55).
Seat 2: LloydXmas (105).
Seat 3: GagaPoker (100).
Seat 4: Beep_Beep (100).
Seat 5: MadLifeGrinder (100).
Seat 6: IlxxxlI (62.23).
Player WeakAndWeary has small blind (0.50)
Player LloydXmas has big blind (1)
Player IlxxxlI received card: [8h]
Player IlxxxlI received card: [5c]
Player GagaPoker raises (2)
Player Beep_Beep folds
Player MadLifeGrinder folds
Player IlxxxlI folds
Player WeakAndWeary folds
Player LloydXmas calls (1)
*** FLOP ***: [Qs 8s 6d]
Player LloydXmas checks
Player GagaPoker bets (1.42)
Player LloydXmas calls (1.42)
*** TURN ***: [Qs 8s 6d] [9c]
Player LloydXmas checks
Player GagaPoker bets (11)
Player LloydXmas folds
Uncalled bet (11) returned to GagaPoker
Player GagaPoker mucks cards
------ Summary ------
Pot: 6.98. Rake 0.24. JP fee 0.12
Board: [Qs 8s 6d 9c]
Player WeakAndWeary does not show cards.Bets: 0.50. Collects: 0. Loses: 0.50.
Player LloydXmas does not show cards.Bets: 3.42. Collects: 0. Loses: 3.42.
*Player GagaPoker mucks (does not show cards). Bets: 3.42. Collects: 6.98. Wins: 3.56.
Player Beep_Beep does not show cards.Bets: 0. Collects: 0. Wins: 0.
Player MadLifeGrinder does not show cards.Bets: 0. Collects: 0. Wins: 0.
Player IlxxxlI does not show cards.Bets: 0. Collects: 0. Wins: 0.
Game ended at: 2016/11/29 13:0:20

Game started
Game ID: 786962515 0.25/0.50 (PRR) Garuda - 4 (Hold'em)
Seat 1 is the button
Seat 1: wrongcolorchip (155.58).
Seat 2: IlxxxlI (25.27).
Seat 3: kid4life (61.41).
Seat 4: MortalLock (50).
Seat 6: Spagetti1 (24).
Seat 7: Hakuna_Matata777 (93.92).
Seat 8: arito02 (49.67).
Seat 9: constant revelation (22.92).
Player IlxxxlI has small blind (0.25)
Player kid4life has big blind (0.50)
Player IlxxxlI received card: [Jh]
Player IlxxxlI received card: [5h]
Player MortalLock folds
Player Spagetti1 raises (1.50)
Player Hakuna_Matata777 folds
Player arito02 calls (1.50)
Player constant revelation calls (1.50)
Player wrongcolorchip folds
Player IlxxxlI folds
Player kid4life calls (1)
*** FLOP ***: [6c 9c 2h]
Player kid4life checks
Player Spagetti1 checks
Player arito02 bets (2.97)
Player constant revelation folds
Player kid4life calls (2.97)
Player Spagetti1 folds
*** TURN ***: [6c 9c 2h] [5s]
Player kid4life checks
Player arito02 bets (7.72)
Player kid4life raises (23.16)
Player arito02 calls (15.44)
*** RIVER ***: [6c 9c 2h 5s] [10d]
Player kid4life allin (33.78)
Player arito02 allin (22.04)
Uncalled bet (11.74) returned to kid4life
------ Summary ------
Pot: 99.59. Rake 2.76. JP fee 0.24
Board: [6c 9c 2h 5s 10d]
Player wrongcolorchip does not show cards.Bets: 0. Collects: 0. Wins: 0.
Player IlxxxlI does not show cards.Bets: 0.25. Collects: 0. Loses: 0.25.
*Player kid4life shows: Three Of Kind of 6s [6s 6d]. Bets: 49.67. Collects: 99.59. Wins: 49.92.
Player MortalLock does not show cards.Bets: 0. Collects: 0. Wins: 0.
Player Spagetti1 does not show cards.Bets: 1.50. Collects: 0. Loses: 1.50.
Player Hakuna_Matata777 does not show cards.Bets: 0. Collects: 0. Wins: 0.
Player arito02 shows: One pair of 9s [Jd 9h]. Bets: 49.67. Collects: 0. Loses: 49.67.
Player constant revelation does not show cards.Bets: 1.50. Collects: 0. Loses: 1.50.
Game ended at: 2016/11/29 12:59:59

Game started
Game ID: 786962248 1/2 (PRR) Lakhey (Hold'em)
Seat 1 is the button
Seat 1: bfish602 (210).
Seat 2: KingGuciGuci (216.66).
Seat 3: IbetUmuck (715.14).
Seat 4: IlxxxlI (85.27).
Seat 5: MadLifeGrinder (200).
Seat 6: LazyFish (261.70).
Player KingGuciGuci has small blind (1)
Player IbetUmuck has big blind (2)
Player IlxxxlI received card: [2d]
Player IlxxxlI received card: [Ac]
Player IlxxxlI folds
Player MadLifeGrinder folds
Player LazyFish folds
Player bfish602 folds
Player KingGuciGuci calls (1)
Player IbetUmuck checks
*** FLOP ***: [3d Kh 7s]
Player KingGuciGuci checks
Player IbetUmuck checks
*** TURN ***: [3d Kh 7s] [7d]
Player KingGuciGuci checks
Player IbetUmuck checks
*** RIVER ***: [3d Kh 7s 7d] [Jd]
Player KingGuciGuci bets (3.30)
Player IbetUmuck calls (3.30)
------ Summary ------
Pot: 10.07. Rake 0.37. JP fee 0.16
Board: [3d Kh 7s 7d Jd]
Player bfish602 does not show cards.Bets: 0. Collects: 0. Wins: 0.
*Player KingGuciGuci shows: Two pairs. Js and 7s [Js 5s]. Bets: 5.30. Collects: 5.03. Loses: 0.27.
*Player IbetUmuck shows: Two pairs. Js and 7s [9d Jh]. Bets: 5.30. Collects: 5.04. Loses: 0.26.
Player IlxxxlI does not show cards.Bets: 0. Collects: 0. Wins: 0.
Player MadLifeGrinder does not show cards.Bets: 0. Collects: 0. Wins: 0.
Player LazyFish does not show cards.Bets: 0. Collects: 0. Wins: 0.
Game ended at: 2016/11/29 12:59:6

Game started
Game ID: 786962212 0.25/0.50 (PRR) Gorgons - 2 (Hold'em)
Seat 4 is the button
Seat 1: BHawk12 (52.42).
Seat 2: IlxxxlI (26.98).
Seat 3: flyshark01 (95.36).
Seat 4: Jui Kuen (50).
Seat 5: constant revelation (22.57).
Seat 6: foreseen (51.09).
Player constant revelation has small blind (0.25)
Player foreseen has big blind (0.50)
Player IlxxxlI received card: [9c]
Player IlxxxlI received card: [Jc]
Player BHawk12 folds
Player IlxxxlI raises (1)
Player flyshark01 folds
Player Jui Kuen raises (4)
Player constant revelation calls (3.75)
Player foreseen folds
Player IlxxxlI folds
*** FLOP ***: [6c 7s 7h]
Player constant revelation checks
Player Jui Kuen checks
*** TURN ***: [6c 7s 7h] [7d]
Player constant revelation checks
Player Jui Kuen checks
*** RIVER ***: [6c 7s 7h 7d] [Qh]
Player constant revelation checks
Player Jui Kuen checks
Player Jui Kuen mucks cards
------ Summary ------
Pot: 9.03. Rake 0.33. JP fee 0.14
Board: [6c 7s 7h 7d Qh]
Player BHawk12 does not show cards.Bets: 0. Collects: 0. Wins: 0.
Player IlxxxlI does not show cards.Bets: 1. Collects: 0. Loses: 1.
Player flyshark01 does not show cards.Bets: 0. Collects: 0. Wins: 0.
Player Jui Kuen mucks (does not show cards). Bets: 4. Collects: 0. Loses: 4.
*Player constant revelation shows: Full House (7/6) [5d 6h]. Bets: 4. Collects: 9.03. Wins: 5.03.
Player foreseen does not show cards.Bets: 0.50. Collects: 0. Loses: 0.50.
Game ended at: 2016/11/29 12:59:6

Game started
Game ID: 786962182 0.50/1 (PRR) Kraken - 22 (Hold'em)
Seat 4 is the button
Seat 2: IlxxxlI (40).
Seat 4: gust (41).
Seat 5: MadLifeGrinder (100).
Seat 6: WeakAndWeary (264.81).
Player MadLifeGrinder has small blind (0.50)
Player WeakAndWeary has big blind (1)
Player IlxxxlI received card: [Js]
Player IlxxxlI received card: [3d]
Player IlxxxlI folds
Player gust raises (2)
Player MadLifeGrinder folds
Player WeakAndWeary calls (1)
*** FLOP ***: [7d Qs 7s]
Player WeakAndWeary checks
Player gust bets (2.14)
Player WeakAndWeary calls (2.14)
*** TURN ***: [7d Qs 7s] [Jc]
Player WeakAndWeary checks
Player gust bets (5.56)
Player WeakAndWeary calls (5.56)
*** RIVER ***: [7d Qs 7s Jc] [Qc]
Player WeakAndWeary checks
Player gust checks
------ Summary ------
Pot: 18.91. Rake 0.75. JP fee 0.24
Board: [7d Qs 7s Jc Qc]
Player IlxxxlI does not show cards.Bets: 0. Collects: 0. Wins: 0.
Player gust shows: Two pairs. Qs and 7s [10d Kh]. Bets: 9.70. Collects: 0. Loses: 9.70.
Player MadLifeGrinder does not show cards.Bets: 0.50. Collects: 0. Loses: 0.50.
*Player WeakAndWeary shows: Full House (7/Q) [7c 6c]. Bets: 9.70. Collects: 18.91. Wins: 9.21.
Game ended at: 2016/11/29 12:59:35

Game started
Game ID: 786962162 0.25/0.50 (PRR) Garuda - 4 (Hold'em)
Seat 9 is the button
Seat 1: wrongcolorchip (155.83).
Seat 2: IlxxxlI (25.77).
Seat 3: kid4life (63.91).
Seat 4: MortalLock (50).
Seat 6: Spagetti1 (24).
Seat 7: Hakuna_Matata777 (93.92).
Seat 8: arito02 (44.33).
Seat 9: constant revelation (25.42).
Player wrongcolorchip has small blind (0.25)
Player IlxxxlI has big blind (0.50)
Player IlxxxlI received card: [Jh]
Player IlxxxlI received card: [As]
Player kid4life raises (1.50)
Player MortalLock folds
Player Spagetti1 folds
Player Hakuna_Matata777 folds
Player arito02 raises (2.50)
Player constant revelation calls (2.50)
Player wrongcolorchip folds
Player IlxxxlI folds
Player kid4life calls (1)
*** FLOP ***: [4c 2d 3h]
Player kid4life checks
Player arito02 bets (3.92)
Player constant revelation folds
Player kid4life folds
Uncalled bet (3.92) returned to arito02
Player arito02 mucks cards
------ Summary ------
Pot: 7.84. Rake 0.29. JP fee 0.12
Board: [4c 2d 3h]
Player wrongcolorchip does not show cards.Bets: 0.25. Collects: 0. Loses: 0.25.
Player IlxxxlI does not show cards.Bets: 0.50. Collects: 0. Loses: 0.50.
Player kid4life does not show cards.Bets: 2.50. Collects: 0. Loses: 2.50.
Player MortalLock does not show cards.Bets: 0. Collects: 0. Wins: 0.
Player Spagetti1 does not show cards.Bets: 0. Collects: 0. Wins: 0.
Player Hakuna_Matata777 does not show cards.Bets: 0. Collects: 0. Wins: 0.
*Player arito02 mucks (does not show cards). Bets: 2.50. Collects: 7.84. Wins: 5.34.
Player constant revelation does not show cards.Bets: 2.50. Collects: 0. Loses: 2.50.
Game ended at: 2016/11/29 12:58:26

Game started
Game ID: 786962156 0.50/1 (PRR) Kraken (Hold'em)
Seat 6 is the button
Seat 1: WeakAndWeary (127.46).
Seat 2: MadLifeGrinder (121.06).
Seat 3: JoeRockwell (26.62).
Seat 4: LloydXmas (136.28).
Seat 5: Hakuna_Matata777 (100).
Seat 6: IlxxxlI (40).
Player WeakAndWeary has small blind (0.50)
Player MadLifeGrinder has big blind (1)
Player IlxxxlI received card: [10d]
Player IlxxxlI received card: [10c]
Player JoeRockwell folds
Player LloydXmas folds
Player Hakuna_Matata777 folds
Player IlxxxlI raises (3)
Player WeakAndWeary folds
Player MadLifeGrinder calls (2)
*** FLOP ***: [Kd Kc 5c]
Player MadLifeGrinder checks
Player IlxxxlI bets (4.12)
Player MadLifeGrinder folds
Uncalled bet (4.12) returned to IlxxxlI
Player IlxxxlI mucks cards
------ Summary ------
Pot: 6.18. Rake 0.22. JP fee 0.10
Board: [Kd Kc 5c]
Player WeakAndWeary does not show cards.Bets: 0.50. Collects: 0. Loses: 0.50.
Player MadLifeGrinder does not show cards.Bets: 3. Collects: 0. Loses: 3.
Player JoeRockwell does not show cards.Bets: 0. Collects: 0. Wins: 0.
Player LloydXmas does not show cards.Bets: 0. Collects: 0. Wins: 0.
Player Hakuna_Matata777 does not show cards.Bets: 0. Collects: 0. Wins: 0.
*Player IlxxxlI mucks (does not show cards). Bets: 3. Collects: 6.18. Wins: 3.18.
Game ended at: 2016/11/29 12:58:30

Game started
Game ID: 786962003 0.25/0.50 (PRR) Gorgons - 2 (Hold'em)
Seat 3 is the button
Seat 1: BHawk12 (52.42).
Seat 2: IlxxxlI (26.23).
Seat 3: flyshark01 (95.36).
Seat 4: Jui Kuen (50).
Seat 5: constant revelation (23.07).
Seat 6: foreseen (51.09).
Player Jui Kuen has small blind (0.25)
Player constant revelation has big blind (0.50)
Player IlxxxlI received card: [3s]
Player IlxxxlI received card: [As]
Player foreseen folds
Player BHawk12 folds
Player IlxxxlI raises (1.20)
Player flyshark01 folds
Player Jui Kuen folds
Player constant revelation folds
Uncalled bet (0.70) returned to IlxxxlI
Player IlxxxlI mucks cards
------ Summary ------
Pot: 1.25. Rake 0
Player BHawk12 does not show cards.Bets: 0. Collects: 0. Wins: 0.
*Player IlxxxlI mucks (does not show cards). Bets: 0.50. Collects: 1.25. Wins: 0.75.
Player flyshark01 does not show cards.Bets: 0. Collects: 0. Wins: 0.
Player Jui Kuen does not show cards.Bets: 0.25. Collects: 0. Loses: 0.25.
Player constant revelation does not show cards.Bets: 0.50. Collects: 0. Loses: 0.50.
Player foreseen does not show cards.Bets: 0. Collects: 0. Wins: 0.
Game ended at: 2016/11/29 12:57:40

Game started
Game ID: 786962007 0.50/1 (PRR) Kraken - 7 (Hold'em)
Seat 4 is the button
Seat 1: gust (47.93).
Seat 2: WeakAndWeary (101.22).
Seat 3: Beep_Beep (104.13).
Seat 4: IlxxxlI (40.50).
Seat 5: Im Don King (100.50).
Seat 6: MadLifeGrinder (100).
Player Im Don King has small blind (0.50)
Player MadLifeGrinder has big blind (1)
Player IlxxxlI received card: [Qc]
Player IlxxxlI received card: [2c]
Player gust raises (2)
Player WeakAndWeary folds
Player Beep_Beep folds
Player IlxxxlI folds
Player Im Don King folds
Player MadLifeGrinder calls (1)
*** FLOP ***: [2h Kd 5h]
Player MadLifeGrinder checks
Player gust bets (2.85)
Player MadLifeGrinder calls (2.85)
*** TURN ***: [2h Kd 5h] [10h]
Player MadLifeGrinder checks
Player gust checks
*** RIVER ***: [2h Kd 5h 10h] [7c]
Player MadLifeGrinder checks
Player gust checks
Player gust mucks cards
------ Summary ------
Pot: 9.69. Rake 0.35. JP fee 0.16
Board: [2h Kd 5h 10h 7c]
Player gust mucks (does not show cards). Bets: 4.85. Collects: 0. Loses: 4.85.
Player WeakAndWeary does not show cards.Bets: 0. Collects: 0. Wins: 0.
Player Beep_Beep does not show cards.Bets: 0. Collects: 0. Wins: 0.
Player IlxxxlI does not show cards.Bets: 0. Collects: 0. Wins: 0.
Player Im Don King does not show cards.Bets: 0.50. Collects: 0. Loses: 0.50.
*Player MadLifeGrinder shows: One pair of Ks [Ks Jd]. Bets: 4.85. Collects: 9.69. Wins: 4.84.
Game ended at: 2016/11/29 12:58:43

Game started
Game ID: 786961870 0.50/1 (PRR) Kraken - 22 (Hold'em)
Seat 2 is the button
Seat 2: IlxxxlI (40).
Seat 4: gust (41.50).
Seat 5: MadLifeGrinder (100).
Seat 6: WeakAndWeary (263.31).
Player gust has small blind (0.50)
Player MadLifeGrinder has big blind (1)
Player IlxxxlI received card: [6s]
Player IlxxxlI received card: [8d]
Player WeakAndWeary raises (3)
Player IlxxxlI folds
Player gust folds
Player MadLifeGrinder folds
Uncalled bet (2) returned to WeakAndWeary
Player WeakAndWeary mucks cards
------ Summary ------
Pot: 2.50. Rake 0
Player IlxxxlI does not show cards.Bets: 0. Collects: 0. Wins: 0.
Player gust does not show cards.Bets: 0.50. Collects: 0. Loses: 0.50.
Player MadLifeGrinder does not show cards.Bets: 1. Collects: 0. Loses: 1.
*Player WeakAndWeary mucks (does not show cards). Bets: 1. Collects: 2.50. Wins: 1.50.
Game ended at: 2016/11/29 12:57:36

Game started
Game ID: 786961796 0.50/1 (PRR) Kraken - 9 (Hold'em)
Seat 5 is the button
Seat 1: WeakAndWeary (112.55).
Seat 2: LloydXmas (105).
Seat 3: GagaPoker (100).
Seat 4: Beep_Beep (100).
Seat 5: MadLifeGrinder (100).
Seat 6: IlxxxlI (56.68).
Player IlxxxlI has small blind (0.50)
Player WeakAndWeary has big blind (1)
Player IlxxxlI received card: [7d]
Player IlxxxlI received card: [7s]
Player LloydXmas folds
Player GagaPoker raises (2)
Player Beep_Beep folds
Player MadLifeGrinder calls (2)
Player IlxxxlI calls (1.50)
Player WeakAndWeary folds
*** FLOP ***: [Ac Ah 6c]
Player IlxxxlI bets (1)
Player GagaPoker calls (1)
Player MadLifeGrinder folds
*** TURN ***: [Ac Ah 6c] [4h]
Player IlxxxlI checks
Player GagaPoker checks
*** RIVER ***: [Ac Ah 6c 4h] [Kd]
Player IlxxxlI checks
Player GagaPoker checks
Player GagaPoker mucks cards
------ Summary ------
Pot: 8.55. Rake 0.31. JP fee 0.14
Board: [Ac Ah 6c 4h Kd]
Player WeakAndWeary does not show cards.Bets: 1. Collects: 0. Loses: 1.
Player LloydXmas does not show cards.Bets: 0. Collects: 0. Wins: 0.
Player GagaPoker mucks (does not show cards). Bets: 3. Collects: 0. Loses: 3.
Player Beep_Beep does not show cards.Bets: 0. Collects: 0. Wins: 0.
Player MadLifeGrinder does not show cards.Bets: 2. Collects: 0. Loses: 2.
*Player IlxxxlI shows: Two pairs. As and 7s [7d 7s]. Bets: 3. Collects: 8.55. Wins: 5.55.
Game ended at: 2016/11/29 12:58:25

Game started
Game ID: 786961700 0.50/1 (PRR) Kraken - 7 (Hold'em)
Seat 3 is the button
Seat 1: gust (47.93).
Seat 2: WeakAndWeary (101.22).
Seat 3: Beep_Beep (104.13).
Seat 4: IlxxxlI (41).
Seat 5: Im Don King (100).
Seat 6: MadLifeGrinder (100).
Player IlxxxlI has small blind (0.50)
Player Im Don King has big blind (1)
Player IlxxxlI received card: [6s]
Player IlxxxlI received card: [8c]
Player MadLifeGrinder folds
Player gust folds
Player WeakAndWeary folds
Player Beep_Beep folds
Player IlxxxlI folds
Uncalled bet (0.50) returned to Im Don King
Player Im Don King mucks cards
------ Summary ------
Pot: 1. Rake 0
Player gust does not show cards.Bets: 0. Collects: 0. Wins: 0.
Player WeakAndWeary does not show cards.Bets: 0. Collects: 0. Wins: 0.
Player Beep_Beep does not show cards.Bets: 0. Collects: 0. Wins: 0.
Player IlxxxlI does not show cards.Bets: 0.50. Collects: 0. Loses: 0.50.
*Player Im Don King mucks (does not show cards). Bets: 0.50. Collects: 1. Wins: 0.50.
Player MadLifeGrinder does not show cards.Bets: 0. Collects: 0. Wins: 0.
Game ended at: 2016/11/29 12:57:6

Game started
Game ID: 786961690 1/2 (PRR) Lakhey (Hold'em)
Seat 6 is the button
Seat 1: bfish602 (200).
Seat 2: KingGuciGuci (218.66).
Seat 3: IbetUmuck (715.14).
Seat 4: IlxxxlI (85.27).
Seat 5: MadLifeGrinder (200).
Seat 6: LazyFish (270.70).
Player bfish602 has small blind (1)
Player KingGuciGuci has big blind (2)
Player IlxxxlI received card: [7h]
Player IlxxxlI received card: [8s]
Player IbetUmuck folds
Player IlxxxlI folds
Player MadLifeGrinder folds
Player LazyFish raises (5)
Player bfish602 calls (4)
Player KingGuciGuci folds
*** FLOP ***: [Jd 8c 8h]
Player bfish602 checks
Player LazyFish bets (4)
Player bfish602 calls (4)
*** TURN ***: [Jd 8c 8h] [Ac]
Player bfish602 checks
Player LazyFish checks
*** RIVER ***: [Jd 8c 8h Ac] [3d]
Player bfish602 bets (12.66)
Player LazyFish folds
Uncalled bet (12.66) returned to bfish602
Player bfish602 mucks cards
------ Summary ------
Pot: 19. Rake 0.76. JP fee 0.24
Board: [Jd 8c 8h Ac 3d]
*Player bfish602 mucks (does not show cards). Bets: 9. Collects: 19. Wins: 10.
Player KingGuciGuci does not show cards.Bets: 2. Collects: 0. Loses: 2.
Player IbetUmuck does not show cards.Bets: 0. Collects: 0. Wins: 0.
Player IlxxxlI does not show cards.Bets: 0. Collects: 0. Wins: 0.
Player MadLifeGrinder does not show cards.Bets: 0. Collects: 0. Wins: 0.
Player LazyFish does not show cards.Bets: 9. Collects: 0. Loses: 9.
Game ended at: 2016/11/29 12:57:47

Game started
Game ID: 786961666 0.25/0.50 (PRR) Gorgons - 2 (Hold'em)
Seat 2 is the button
Seat 1: BHawk12 (52.42).
Seat 2: IlxxxlI (26.23).
Seat 3: flyshark01 (95.61).
Seat 4: Jui Kuen (50).
Seat 5: constant revelation (22.32).
Seat 6: foreseen (51.09).
Player flyshark01 has small blind (0.25)
Player Jui Kuen has big blind (0.50)
Player IlxxxlI received card: [6s]
Player IlxxxlI received card: [7s]
Player constant revelation raises (1.50)
Player foreseen folds
Player BHawk12 folds
Player IlxxxlI folds
Player flyshark01 folds
Player Jui Kuen folds
Uncalled bet (1) returned to constant revelation
Player constant revelation mucks cards
------ Summary ------
Pot: 1.25. Rake 0
Player BHawk12 does not show cards.Bets: 0. Collects: 0. Wins: 0.
Player IlxxxlI does not show cards.Bets: 0. Collects: 0. Wins: 0.
Player flyshark01 does not show cards.Bets: 0.25. Collects: 0. Loses: 0.25.
Player Jui Kuen does not show cards.Bets: 0.50. Collects: 0. Loses: 0.50.
*Player constant revelation mucks (does not show cards). Bets: 0.50. Collects: 1.25. Wins: 0.75.
Player foreseen does not show cards.Bets: 0. Collects: 0. Wins: 0.
Game ended at: 2016/11/29 12:57:6

Game started
Game ID: 786961540 0.50/1 (PRR) Kraken - 7 (Hold'em)
Seat 2 is the button
Seat 1: gust (47.93).
Seat 2: WeakAndWeary (101.22).
Seat 3: Beep_Beep (104.63).
Seat 4: IlxxxlI (40.50).
Seat 6: MadLifeGrinder (100).
Player Beep_Beep has small blind (0.50)
Player IlxxxlI has big blind (1)
Player IlxxxlI received card: [Ad]
Player IlxxxlI received card: [6d]
Player MadLifeGrinder folds
Player gust folds
Player WeakAndWeary folds
Player Beep_Beep folds
Uncalled bet (0.50) returned to IlxxxlI
Player IlxxxlI mucks cards
------ Summary ------
Pot: 1. Rake 0
Player gust does not show cards.Bets: 0. Collects: 0. Wins: 0.
Player WeakAndWeary does not show cards.Bets: 0. Collects: 0. Wins: 0.
Player Beep_Beep does not show cards.Bets: 0.50. Collects: 0. Loses: 0.50.
*Player IlxxxlI mucks (does not show cards). Bets: 0.50. Collects: 1. Wins: 0.50.
Player MadLifeGrinder does not show cards.Bets: 0. Collects: 0. Wins: 0.
Game ended at: 2016/11/29 12:56:21

Game started
Game ID: 786961468 0.25/0.50 (PRR) Garuda - 4 (Hold'em)
Seat 8 is the button
Seat 1: wrongcolorchip (156.33).
Seat 2: IlxxxlI (25.77).
Seat 3: kid4life (45.62).
Seat 4: MortalLock (50).
Seat 6: Spagetti1 (24).
Seat 7: Hakuna_Matata777 (93.92).
Seat 8: arito02 (60.95).
Seat 9: constant revelation (16.92).
Player constant revelation has small blind (0.25)
Player wrongcolorchip has big blind (0.50)
Player IlxxxlI received card: [10c]
Player IlxxxlI received card: [9d]
Player IlxxxlI folds
Player kid4life raises (1.50)
Player MortalLock calls (1.50)
Player Spagetti1 folds
Player Hakuna_Matata777 folds
Player arito02 calls (1.50)
Player constant revelation calls (1.25)
Player wrongcolorchip folds
*** FLOP ***: [8d 2c Qc]
Player constant revelation checks
Player kid4life bets (3.09)
Player MortalLock folds
Player arito02 calls (3.09)
Player constant revelation folds
*** TURN ***: [8d 2c Qc] [Jh]
Player kid4life checks
Player arito02 bets (4.01)
Player kid4life raises (12.03)
Player arito02 calls (8.02)
*** RIVER ***: [8d 2c Qc Jh] [Kh]
Player kid4life allin (29)
Player arito02 folds
Uncalled bet (29) returned to kid4life
Player kid4life mucks cards
------ Summary ------
Pot: 34.91. Rake 1.59. JP fee 0.24
Board: [8d 2c Qc Jh Kh]
Player wrongcolorchip does not show cards.Bets: 0.50. Collects: 0. Loses: 0.50.
Player IlxxxlI does not show cards.Bets: 0. Collects: 0. Wins: 0.
*Player kid4life mucks (does not show cards). Bets: 16.62. Collects: 34.91. Wins: 18.29.
Player MortalLock does not show cards.Bets: 1.50. Collects: 0. Loses: 1.50.
Player Spagetti1 does not show cards.Bets: 0. Collects: 0. Wins: 0.
Player Hakuna_Matata777 does not show cards.Bets: 0. Collects: 0. Wins: 0.
Player arito02 does not show cards.Bets: 16.62. Collects: 0. Loses: 16.62.
Player constant revelation does not show cards.Bets: 1.50. Collects: 0. Loses: 1.50.
Game ended at: 2016/11/29 12:57:33

Game started
Game ID: 786961372 0.50/1 (PRR) Kraken (Hold'em)
Seat 5 is the button
Seat 1: WeakAndWeary (135.77).
Seat 2: MadLifeGrinder (121.06).
Seat 3: JoeRockwell (18.66).
Seat 4: LloydXmas (136.28).
Seat 5: Hakuna_Matata777 (100).
Seat 6: IlxxxlI (40).
Player IlxxxlI has small blind (0.50)
Player WeakAndWeary has big blind (1)
Player IlxxxlI received card: [4c]
Player IlxxxlI received card: [10h]
Player MadLifeGrinder folds
Player JoeRockwell calls (1)
Player LloydXmas folds
Player Hakuna_Matata777 folds
Player IlxxxlI folds
Player WeakAndWeary checks
*** FLOP ***: [Kd Jd 2d]
Player WeakAndWeary checks
Player JoeRockwell bets (1)
Player WeakAndWeary calls (1)
*** TURN ***: [Kd Jd 2d] [9h]
Player WeakAndWeary checks
Player JoeRockwell bets (2.14)
Player WeakAndWeary calls (2.14)
*** RIVER ***: [Kd Jd 2d 9h] [4h]
Player WeakAndWeary checks
Player JoeRockwell bets (4.17)
Player WeakAndWeary calls (4.17)
Player WeakAndWeary mucks cards
------ Summary ------
Pot: 16.27. Rake 0.61. JP fee 0.24
Board: [Kd Jd 2d 9h 4h]
Player WeakAndWeary mucks (does not show cards). Bets: 8.31. Collects: 0. Loses: 8.31.
Player MadLifeGrinder does not show cards.Bets: 0. Collects: 0. Wins: 0.
*Player JoeRockwell shows: One pair of Js [Jh 10d]. Bets: 8.31. Collects: 16.27. Wins: 7.96.
Player LloydXmas does not show cards.Bets: 0. Collects: 0. Wins: 0.
Player Hakuna_Matata777 does not show cards.Bets: 0. Collects: 0. Wins: 0.
Player IlxxxlI does not show cards.Bets: 0.50. Collects: 0. Loses: 0.50.
Game ended at: 2016/11/29 12:57:29

Game started
Game ID: 786961321 0.50/1 (PRR) Kraken - 22 (Hold'em)
Seat 6 is the button
Seat 1: meandkids (68.43).
Seat 2: IlxxxlI (40).
Seat 3: ThxBro (53.86).
Seat 4: gust (41.50).
Seat 5: MadLifeGrinder (100).
Seat 6: WeakAndWeary (196.88).
Player meandkids has small blind (0.50)
Player IlxxxlI has big blind (1)
Player IlxxxlI received card: [Ks]
Player IlxxxlI received card: [2h]
Player ThxBro folds
Player gust folds
Player MadLifeGrinder folds
Player WeakAndWeary raises (3)
Player meandkids raises (12.50)
Player IlxxxlI folds
Player WeakAndWeary allin (193.88)
Player meandkids allin (55.43)
Uncalled bet (128.45) returned to WeakAndWeary
*** FLOP ***: [6d 10d 3h]
*** TURN ***: [6d 10d 3h] [Jh]
*** RIVER ***: [6d 10d 3h Jh] [8c]
------ Summary ------
Pot: 134.86. Rake 2.76. JP fee 0.24
Board: [6d 10d 3h Jh 8c]
Player meandkids shows: High card A [Qh Ad]. Bets: 68.43. Collects: 0. Loses: 68.43.
Player IlxxxlI does not show cards.Bets: 1. Collects: 0. Loses: 1.
Player ThxBro does not show cards.Bets: 0. Collects: 0. Wins: 0.
Player gust does not show cards.Bets: 0. Collects: 0. Wins: 0.
Player MadLifeGrinder does not show cards.Bets: 0. Collects: 0. Wins: 0.
*Player WeakAndWeary shows: High card A (kicker K) [Kc As]. Bets: 68.43. Collects: 134.86. Wins: 66.43.
Game ended at: 2016/11/29 12:56:44

Game started
Game ID: 786961273 1/2 (PRR) Lakhey (Hold'em)
Seat 5 is the button
Seat 1: bfish602 (200).
Seat 2: KingGuciGuci (206).
Seat 3: IbetUmuck (726.04).
Seat 4: IlxxxlI (85.27).
Seat 5: MadLifeGrinder (200).
Seat 6: LazyFish (271.70).
Player LazyFish has small blind (1)
Player bfish602 has big blind (2)
Player IlxxxlI received card: [As]
Player IlxxxlI received card: [8c]
Player KingGuciGuci raises (5)
Player IbetUmuck calls (5)
Player IlxxxlI folds
Player MadLifeGrinder folds
Player LazyFish folds
Player bfish602 folds
*** FLOP ***: [Jh Qd Qh]
Player KingGuciGuci bets (5.90)
Player IbetUmuck calls (5.90)
*** TURN ***: [Jh Qd Qh] [8h]
Player KingGuciGuci checks
Player IbetUmuck checks
*** RIVER ***: [Jh Qd Qh 8h] [Qc]
Player KingGuciGuci bets (9.90)
Player IbetUmuck folds
Uncalled bet (9.90) returned to KingGuciGuci
Player KingGuciGuci mucks cards
------ Summary ------
Pot: 23.56. Rake 1. JP fee 0.24
Board: [Jh Qd Qh 8h Qc]
Player bfish602 does not show cards.Bets: 2. Collects: 0. Loses: 2.
*Player KingGuciGuci mucks (does not show cards). Bets: 10.90. Collects: 23.56. Wins: 12.66.
Player IbetUmuck does not show cards.Bets: 10.90. Collects: 0. Loses: 10.90.
Player IlxxxlI does not show cards.Bets: 0. Collects: 0. Wins: 0.
Player MadLifeGrinder does not show cards.Bets: 0. Collects: 0. Wins: 0.
Player LazyFish does not show cards.Bets: 1. Collects: 0. Loses: 1.
Game ended at: 2016/11/29 12:56:20

Game started
Game ID: 786961178 0.50/1 (PRR) Kraken - 7 (Hold'em)
Seat 1 is the button
Seat 1: gust (46.43).
Seat 2: WeakAndWeary (101.72).
Seat 3: Beep_Beep (105.63).
Seat 4: IlxxxlI (40.50).
Seat 6: MadLifeGrinder (100).
Player WeakAndWeary has small blind (0.50)
Player Beep_Beep has big blind (1)
Player IlxxxlI received card: [8h]
Player IlxxxlI received card: [4s]
Player IlxxxlI folds
Player MadLifeGrinder folds
Player gust raises (2)
Player WeakAndWeary folds
Player Beep_Beep folds
Uncalled bet (1) returned to gust
Player gust mucks cards
------ Summary ------
Pot: 2.50. Rake 0
*Player gust mucks (does not show cards). Bets: 1. Collects: 2.50. Wins: 1.50.
Player WeakAndWeary does not show cards.Bets: 0.50. Collects: 0. Loses: 0.50.
Player Beep_Beep does not show cards.Bets: 1. Collects: 0. Loses: 1.
Player IlxxxlI does not show cards.Bets: 0. Collects: 0. Wins: 0.
Player MadLifeGrinder does not show cards.Bets: 0. Collects: 0. Wins: 0.
Game ended at: 2016/11/29 12:55:53

Game started
Game ID: 786960953 1/2 (PRR) Lakhey (Hold'em)
Seat 4 is the button
Seat 1: bfish602 (200).
Seat 2: KingGuciGuci (206).
Seat 3: IbetUmuck (726.04).
Seat 4: IlxxxlI (82.27).
Seat 5: MadLifeGrinder (200).
Seat 6: LazyFish (273.70).
Player MadLifeGrinder has small blind (1)
Player LazyFish has big blind (2)
Player IlxxxlI received card: [10h]
Player IlxxxlI received card: [10c]
Player bfish602 folds
Player KingGuciGuci folds
Player IbetUmuck folds
Player IlxxxlI raises (6)
Player MadLifeGrinder folds
Player LazyFish folds
Uncalled bet (4) returned to IlxxxlI
Player IlxxxlI mucks cards
------ Summary ------
Pot: 5. Rake 0
Player bfish602 does not show cards.Bets: 0. Collects: 0. Wins: 0.
Player KingGuciGuci does not show cards.Bets: 0. Collects: 0. Wins: 0.
Player IbetUmuck does not show cards.Bets: 0. Collects: 0. Wins: 0.
*Player IlxxxlI mucks (does not show cards). Bets: 2. Collects: 5. Wins: 3.
Player MadLifeGrinder does not show cards.Bets: 1. Collects: 0. Loses: 1.
Player LazyFish does not show cards.Bets: 2. Collects: 0. Loses: 2.
Game ended at: 2016/11/29 12:55:13

Game started
Game ID: 786960931 0.50/1 (PRR) Kraken - 9 (Hold'em)
Seat 4 is the button
Seat 1: WeakAndWeary (112.55).
Seat 2: LloydXmas (105).
Seat 3: GagaPoker (100).
Seat 4: Beep_Beep (102.70).
Seat 5: MadLifeGrinder (100).
Seat 6: IlxxxlI (40).
Player MadLifeGrinder has small blind (0.50)
Player IlxxxlI has big blind (1)
Player IlxxxlI received card: [10s]
Player IlxxxlI received card: [Ad]
Player WeakAndWeary folds
Player LloydXmas folds
Player GagaPoker folds
Player Beep_Beep raises (3)
Player MadLifeGrinder folds
Player IlxxxlI calls (2)
*** FLOP ***: [Ac Kd 8s]
Player IlxxxlI checks
Player Beep_Beep bets (4)
Player IlxxxlI calls (4)
*** TURN ***: [Ac Kd 8s] [4s]
Player IlxxxlI checks
Player Beep_Beep bets (11)
Player IlxxxlI calls (11)
*** RIVER ***: [Ac Kd 8s 4s] [9d]
Player IlxxxlI checks
Player Beep_Beep checks
------ Summary ------
Pot: 34.68. Rake 1.58. JP fee 0.24
Board: [Ac Kd 8s 4s 9d]
Player WeakAndWeary does not show cards.Bets: 0. Collects: 0. Wins: 0.
Player LloydXmas does not show cards.Bets: 0. Collects: 0. Wins: 0.
Player GagaPoker does not show cards.Bets: 0. Collects: 0. Wins: 0.
Player Beep_Beep shows: High card A [Qs 7s]. Bets: 18. Collects: 0. Loses: 18.
Player MadLifeGrinder does not show cards.Bets: 0.50. Collects: 0. Loses: 0.50.
*Player IlxxxlI shows: One pair of As [10s Ad]. Bets: 18. Collects: 34.68. Wins: 16.68.
Game ended at: 2016/11/29 12:56:31

Game started
Game ID: 786960861 0.50/1 (PRR) Kraken (Hold'em)
Seat 4 is the button
Seat 1: WeakAndWeary (135.77).
Seat 2: MadLifeGrinder (121.06).
Seat 3: JoeRockwell (17.28).
Seat 4: LloydXmas (136.28).
Seat 5: Hakuna_Matata777 (100).
Seat 6: IlxxxlI (40).
Player Hakuna_Matata777 has small blind (0.50)
Player IlxxxlI has big blind (1)
Player IlxxxlI received card: [Jd]
Player IlxxxlI received card: [6d]
Player WeakAndWeary folds
Player MadLifeGrinder folds
Player JoeRockwell calls (1)
Player LloydXmas folds
Player Hakuna_Matata777 folds
Player IlxxxlI checks
*** FLOP ***: [Qd 2h 9h]
Player IlxxxlI checks
Player JoeRockwell checks
*** TURN ***: [Qd 2h 9h] [6h]
Player IlxxxlI checks
Player JoeRockwell bets (1)
Player IlxxxlI folds
Uncalled bet (1) returned to JoeRockwell
Player JoeRockwell mucks cards
------ Summary ------
Pot: 2.38. Rake 0.08. JP fee 0.04
Board: [Qd 2h 9h 6h]
Player WeakAndWeary does not show cards.Bets: 0. Collects: 0. Wins: 0.
Player MadLifeGrinder does not show cards.Bets: 0. Collects: 0. Wins: 0.
*Player JoeRockwell mucks (does not show cards). Bets: 1. Collects: 2.38. Wins: 1.38.
Player LloydXmas does not show cards.Bets: 0. Collects: 0. Wins: 0.
Player Hakuna_Matata777 does not show cards.Bets: 0.50. Collects: 0. Loses: 0.50.
Player IlxxxlI does not show cards.Bets: 1. Collects: 0. Loses: 1.
Game ended at: 2016/11/29 12:55:29

Game started
Game ID: 786960786 0.25/0.50 (PRR) Gorgons - 2 (Hold'em)
Seat 1 is the button
Seat 1: BHawk12 (56.67).
Seat 2: IlxxxlI (26.48).
Seat 3: flyshark01 (90.36).
Seat 4: Jui Kuen (50).
Seat 5: constant revelation (22.32).
Seat 6: foreseen (52.34).
Player IlxxxlI has small blind (0.25)
Player flyshark01 has big blind (0.50)
Player IlxxxlI received card: [Jc]
Player IlxxxlI received card: [2s]
Player Jui Kuen folds
Player constant revelation folds
Player foreseen raises (1.25)
Player BHawk12 calls (1.25)
Player IlxxxlI folds
Player flyshark01 calls (0.75)
*** FLOP ***: [9s 6h 10d]
Player flyshark01 checks
Player foreseen checks
Player BHawk12 bets (3)
Player flyshark01 calls (3)
Player foreseen folds
*** TURN ***: [9s 6h 10d] [8h]
Player flyshark01 bets (6.34)
Player BHawk12 folds
Uncalled bet (6.34) returned to flyshark01
Player flyshark01 mucks cards
------ Summary ------
Pot: 9.50. Rake 0.34. JP fee 0.16
Board: [9s 6h 10d 8h]
Player BHawk12 does not show cards.Bets: 4.25. Collects: 0. Loses: 4.25.
Player IlxxxlI does not show cards.Bets: 0.25. Collects: 0. Loses: 0.25.
*Player flyshark01 mucks (does not show cards). Bets: 4.25. Collects: 9.50. Wins: 5.25.
Player Jui Kuen does not show cards.Bets: 0. Collects: 0. Wins: 0.
Player constant revelation does not show cards.Bets: 0. Collects: 0. Wins: 0.
Player foreseen does not show cards.Bets: 1.25. Collects: 0. Loses: 1.25.
Game ended at: 2016/11/29 12:56:15

Game started
Game ID: 786960573 1/2 (PRR) Lakhey (Hold'em)
Seat 3 is the button
Seat 1: bfish602 (200).
Seat 2: KingGuciGuci (203).
Seat 3: IbetUmuck (726.04).
Seat 4: IlxxxlI (83.27).
Seat 5: MadLifeGrinder (200).
Seat 6: LazyFish (273.70).
Player IlxxxlI has small blind (1)
Player MadLifeGrinder has big blind (2)
Player IlxxxlI received card: [7h]
Player IlxxxlI received card: [9s]
Player LazyFish folds
Player bfish602 folds
Player KingGuciGuci raises (4.40)
Player IbetUmuck folds
Player IlxxxlI folds
Player MadLifeGrinder folds
Uncalled bet (2.40) returned to KingGuciGuci
Player KingGuciGuci mucks cards
------ Summary ------
Pot: 5. Rake 0
Player bfish602 does not show cards.Bets: 0. Collects: 0. Wins: 0.
*Player KingGuciGuci mucks (does not show cards). Bets: 2. Collects: 5. Wins: 3.
Player IbetUmuck does not show cards.Bets: 0. Collects: 0. Wins: 0.
Player IlxxxlI does not show cards.Bets: 1. Collects: 0. Loses: 1.
Player MadLifeGrinder does not show cards.Bets: 2. Collects: 0. Loses: 2.
Player LazyFish does not show cards.Bets: 0. Collects: 0. Wins: 0.
Game ended at: 2016/11/29 12:54:36

Game started
Game ID: 786960467 0.25/0.50 (PRR) Garuda - 4 (Hold'em)
Seat 7 is the button
Seat 1: wrongcolorchip (156.33).
Seat 2: IlxxxlI (25.77).
Seat 3: kid4life (47.12).
Seat 4: MortalLock (50).
Seat 5: slick07lx (38.39).
Seat 6: Spagetti1 (24).
Seat 7: Hakuna_Matata777 (55.03).
Seat 8: arito02 (62.45).
Seat 9: constant revelation (17.42).
Player arito02 has small blind (0.25)
Player constant revelation has big blind (0.50)
Player IlxxxlI received card: [10h]
Player IlxxxlI received card: [4d]
Player wrongcolorchip folds
Player IlxxxlI folds
Player kid4life raises (1.50)
Player MortalLock folds
Player slick07lx calls (1.50)
Player Spagetti1 folds
Player Hakuna_Matata777 calls (1.50)
Player arito02 calls (1.25)
Player constant revelation folds
*** FLOP ***: [3c 8c Ks]
Player arito02 checks
Player kid4life checks
Player slick07lx checks
Player Hakuna_Matata777 checks
*** TURN ***: [3c 8c Ks] [8s]
Player arito02 checks
Player kid4life checks
Player slick07lx bets (4.12)
Player Hakuna_Matata777 raises (15.50)
Player arito02 folds
Player kid4life folds
Player slick07lx allin (32.77)
Player Hakuna_Matata777 calls (21.39)
*** RIVER ***: [3c 8c Ks 8s] [9d]
------ Summary ------
Pot: 77.28. Rake 2.76. JP fee 0.24
Board: [3c 8c Ks 8s 9d]
Player wrongcolorchip does not show cards.Bets: 0. Collects: 0. Wins: 0.
Player IlxxxlI does not show cards.Bets: 0. Collects: 0. Wins: 0.
Player kid4life does not show cards.Bets: 1.50. Collects: 0. Loses: 1.50.
Player MortalLock does not show cards.Bets: 0. Collects: 0. Wins: 0.
Player slick07lx shows: Two pairs. 8s and 3s [Jd 3d]. Bets: 38.39. Collects: 0. Loses: 38.39.
Player Spagetti1 does not show cards.Bets: 0. Collects: 0. Wins: 0.
*Player Hakuna_Matata777 shows: Full House (8/9) [9h 8h]. Bets: 38.39. Collects: 77.28. Wins: 38.89.
Player arito02 does not show cards.Bets: 1.50. Collects: 0. Loses: 1.50.
Player constant revelation does not show cards.Bets: 0.50. Collects: 0. Loses: 0.50.
Game ended at: 2016/11/29 12:55:41

Game started
Game ID: 786960465 0.50/1 (PRR) Kraken - 7 (Hold'em)
Seat 6 is the button
Seat 1: gust (46.93).
Seat 2: WeakAndWeary (102.72).
Seat 3: Beep_Beep (101.50).
Seat 4: IlxxxlI (40.50).
Seat 6: MadLifeGrinder (101.50).
Player gust has small blind (0.50)
Player WeakAndWeary has big blind (1)
Player IlxxxlI received card: [8h]
Player IlxxxlI received card: [Js]
Player Beep_Beep raises (3)
Player IlxxxlI folds
Player MadLifeGrinder calls (3)
Player gust folds
Player WeakAndWeary folds
*** FLOP ***: [5c 9s 6d]
Player Beep_Beep checks
Player MadLifeGrinder checks
*** TURN ***: [5c 9s 6d] [Qc]
Player Beep_Beep bets (5)
Player MadLifeGrinder folds
Uncalled bet (5) returned to Beep_Beep
Player Beep_Beep mucks cards
------ Summary ------
Pot: 7.13. Rake 0.25. JP fee 0.12
Board: [5c 9s 6d Qc]
Player gust does not show cards.Bets: 0.50. Collects: 0. Loses: 0.50.
Player WeakAndWeary does not show cards.Bets: 1. Collects: 0. Loses: 1.
*Player Beep_Beep mucks (does not show cards). Bets: 3. Collects: 7.13. Wins: 4.13.
Player IlxxxlI does not show cards.Bets: 0. Collects: 0. Wins: 0.
Player MadLifeGrinder does not show cards.Bets: 3. Collects: 0. Loses: 3.
Game ended at: 2016/11/29 12:55:0

Game started
Game ID: 786960394 1/2 (PRR) Lakhey (Hold'em)
Seat 2 is the button
Seat 1: bfish602 (200).
Seat 2: KingGuciGuci (200).
Seat 3: IbetUmuck (727.04).
Seat 4: IlxxxlI (85.27).
Seat 5: MadLifeGrinder (200).
Seat 6: LazyFish (273.70).
Player IbetUmuck has small blind (1)
Player IlxxxlI has big blind (2)
Player IlxxxlI received card: [6s]
Player IlxxxlI received card: [10c]
Player MadLifeGrinder folds
Player LazyFish folds
Player bfish602 folds
Player KingGuciGuci raises (4.40)
Player IbetUmuck folds
Player IlxxxlI folds
Uncalled bet (2.40) returned to KingGuciGuci
Player KingGuciGuci mucks cards
------ Summary ------
Pot: 5. Rake 0
Player bfish602 does not show cards.Bets: 0. Collects: 0. Wins: 0.
*Player KingGuciGuci mucks (does not show cards). Bets: 2. Collects: 5. Wins: 3.
Player IbetUmuck does not show cards.Bets: 1. Collects: 0. Loses: 1.
Player IlxxxlI does not show cards.Bets: 2. Collects: 0. Loses: 2.
Player MadLifeGrinder does not show cards.Bets: 0. Collects: 0. Wins: 0.
Player LazyFish does not show cards.Bets: 0. Collects: 0. Wins: 0.
Game ended at: 2016/11/29 12:53:58

Game started
Game ID: 786960288 1/2 (PRR) Lakhey (Hold'em)
Seat 1 is the button
Seat 1: bfish602 (200).
Seat 2: KingGuciGuci (200).
Seat 3: IbetUmuck (726.04).
Seat 4: IlxxxlI (85.27).
Seat 5: MadLifeGrinder (200).
Seat 6: LazyFish (273.70).
Player KingGuciGuci has small blind (1)
Player IbetUmuck has big blind (2)
Player IlxxxlI received card: [4c]
Player IlxxxlI received card: [6d]
Player IlxxxlI folds
Player MadLifeGrinder folds
Player LazyFish folds
Player bfish602 folds
Player KingGuciGuci folds
Uncalled bet (1) returned to IbetUmuck
Player IbetUmuck mucks cards
------ Summary ------
Pot: 2. Rake 0
Player bfish602 does not show cards.Bets: 0. Collects: 0. Wins: 0.
Player KingGuciGuci does not show cards.Bets: 1. Collects: 0. Loses: 1.
*Player IbetUmuck mucks (does not show cards). Bets: 1. Collects: 2. Wins: 1.
Player IlxxxlI does not show cards.Bets: 0. Collects: 0. Wins: 0.
Player MadLifeGrinder does not show cards.Bets: 0. Collects: 0. Wins: 0.
Player LazyFish does not show cards.Bets: 0. Collects: 0. Wins: 0.
Game ended at: 2016/11/29 12:53:39

Game started
Game ID: 786960202 0.25/0.50 (PRR) Gorgons - 2 (Hold'em)
Seat 6 is the button
Seat 1: BHawk12 (60.17).
Seat 2: IlxxxlI (20).
Seat 3: flyshark01 (90.36).
Seat 4: Jui Kuen (50).
Seat 5: constant revelation (25.82).
Seat 6: foreseen (52.34).
Player BHawk12 has small blind (0.25)
Player IlxxxlI has big blind (0.50)
Player IlxxxlI received card: [Qd]
Player IlxxxlI received card: [Jd]
Player flyshark01 folds
Player Jui Kuen folds
Player constant revelation calls (0.50)
Player foreseen folds
Player BHawk12 raises (1.75)
Player IlxxxlI raises (3)
Player constant revelation calls (3)
Player BHawk12 calls (1.50)
*** FLOP ***: [9c 5d 10c]
Player BHawk12 checks
Player IlxxxlI bets (8.50)
Player constant revelation folds
Player BHawk12 folds
Uncalled bet (8.50) returned to IlxxxlI
Player IlxxxlI mucks cards
------ Summary ------
Pot: 9.98. Rake 0.36. JP fee 0.16
Board: [9c 5d 10c]
Player BHawk12 does not show cards.Bets: 3.50. Collects: 0. Loses: 3.50.
*Player IlxxxlI mucks (does not show cards). Bets: 3.50. Collects: 9.98. Wins: 6.48.
Player flyshark01 does not show cards.Bets: 0. Collects: 0. Wins: 0.
Player Jui Kuen does not show cards.Bets: 0. Collects: 0. Wins: 0.
Player constant revelation does not show cards.Bets: 3.50. Collects: 0. Loses: 3.50.
Player foreseen does not show cards.Bets: 0. Collects: 0. Wins: 0.
Game ended at: 2016/11/29 12:54:18

Game started
Game ID: 786960007 0.50/1 (PRR) Kraken - 7 (Hold'em)
Seat 4 is the button
Seat 1: gust (46.43).
Seat 2: WeakAndWeary (102.72).
Seat 3: Beep_Beep (101.50).
Seat 4: IlxxxlI (40.50).
Seat 6: MadLifeGrinder (102).
Player MadLifeGrinder has small blind (0.50)
Player gust has big blind (1)
Player IlxxxlI received card: [7d]
Player IlxxxlI received card: [8s]
Player WeakAndWeary folds
Player Beep_Beep folds
Player IlxxxlI folds
Player MadLifeGrinder folds
Uncalled bet (0.50) returned to gust
Player gust mucks cards
------ Summary ------
Pot: 1. Rake 0
*Player gust mucks (does not show cards). Bets: 0.50. Collects: 1. Wins: 0.50.
Player WeakAndWeary does not show cards.Bets: 0. Collects: 0. Wins: 0.
Player Beep_Beep does not show cards.Bets: 0. Collects: 0. Wins: 0.
Player IlxxxlI does not show cards.Bets: 0. Collects: 0. Wins: 0.
Player MadLifeGrinder does not show cards.Bets: 0.50. Collects: 0. Loses: 0.50.
Game ended at: 2016/11/29 12:53:45

Game started
Game ID: 786959828 0.50/1 (PRR) Kraken - 9 (Hold'em)
Seat 3 is the button
Seat 1: WeakAndWeary (112.55).
Seat 2: LloydXmas (105).
Seat 3: GagaPoker (100).
Seat 4: Beep_Beep (100).
Seat 5: MadLifeGrinder (100).
Seat 6: IlxxxlI (40).
Player Beep_Beep has small blind (0.50)
Player MadLifeGrinder has big blind (1)
Player IlxxxlI received card: [5h]
Player IlxxxlI received card: [10d]
Player IlxxxlI folds
Player WeakAndWeary folds
Player LloydXmas folds
Player GagaPoker folds
Player Beep_Beep raises (2.50)
Player MadLifeGrinder calls (2)
*** FLOP ***: [Qh 8d 2c]
Player Beep_Beep checks
Player MadLifeGrinder checks
*** TURN ***: [Qh 8d 2c] [6c]
Player Beep_Beep checks
Player MadLifeGrinder checks
*** RIVER ***: [Qh 8d 2c 6c] [8h]
Player Beep_Beep checks
Player MadLifeGrinder checks
Player MadLifeGrinder mucks cards
------ Summary ------
Pot: 5.70. Rake 0.20. JP fee 0.10
Board: [Qh 8d 2c 6c 8h]
Player WeakAndWeary does not show cards.Bets: 0. Collects: 0. Wins: 0.
Player LloydXmas does not show cards.Bets: 0. Collects: 0. Wins: 0.
Player GagaPoker does not show cards.Bets: 0. Collects: 0. Wins: 0.
*Player Beep_Beep shows: Two pairs. 8s and 6s [6h Kh]. Bets: 3. Collects: 5.70. Wins: 2.70.
Player MadLifeGrinder mucks (does not show cards). Bets: 3. Collects: 0. Loses: 3.
Player IlxxxlI does not show cards.Bets: 0. Collects: 0. Wins: 0.
Game ended at: 2016/11/29 12:54:31

Game started
Game ID: 786959700 0.50/1 (PRR) Kraken - 7 (Hold'em)
Seat 3 is the button
Seat 1: gust (46.43).
Seat 2: WeakAndWeary (102.72).
Seat 3: Beep_Beep (100).
Seat 4: IlxxxlI (41).
Seat 5: St3p04ka (41.50).
Seat 6: MadLifeGrinder (103).
Player IlxxxlI has small blind (0.50)
Player St3p04ka sitting out
Player MadLifeGrinder has big blind (1)
Player IlxxxlI received card: [2h]
Player IlxxxlI received card: [10c]
Player gust folds
Player WeakAndWeary folds
Player Beep_Beep raises (3)
Player IlxxxlI folds
Player MadLifeGrinder folds
Uncalled bet (2) returned to Beep_Beep
Player Beep_Beep mucks cards
------ Summary ------
Pot: 2.50. Rake 0
Player gust does not show cards.Bets: 0. Collects: 0. Wins: 0.
Player WeakAndWeary does not show cards.Bets: 0. Collects: 0. Wins: 0.
*Player Beep_Beep mucks (does not show cards). Bets: 1. Collects: 2.50. Wins: 1.50.
Player IlxxxlI does not show cards.Bets: 0.50. Collects: 0. Loses: 0.50.
Player St3p04ka does not show cards.Bets: 0. Collects: 0. Wins: 0.
Player MadLifeGrinder does not show cards.Bets: 1. Collects: 0. Loses: 1.
Game ended at: 2016/11/29 12:53:3

Game started
Game ID: 786959647 0.25/0.50 (PRR) Garuda - 4 (Hold'em)
Seat 6 is the button
Seat 1: wrongcolorchip (156.33).
Seat 2: IlxxxlI (25.77).
Seat 3: kid4life (47.12).
Seat 4: MortalLock (50).
Seat 5: slick07lx (38.39).
Seat 6: Spagetti1 (24).
Seat 7: Hakuna_Matata777 (56.03).
Seat 8: arito02 (60.15).
Seat 9: constant revelation (18.92).
Player Hakuna_Matata777 has small blind (0.25)
Player arito02 has big blind (0.50)
Player IlxxxlI received card: [3h]
Player IlxxxlI received card: [4d]
Player constant revelation calls (0.50)
Player wrongcolorchip folds
Player IlxxxlI folds
Player kid4life folds
Player MortalLock folds
Player slick07lx folds
Player Spagetti1 folds
Player Hakuna_Matata777 calls (0.25)
Player arito02 checks
*** FLOP ***: [5h 2s Jc]
Player Hakuna_Matata777 checks
Player arito02 bets (0.50)
Player constant revelation calls (0.50)
Player Hakuna_Matata777 calls (0.50)
*** TURN ***: [5h 2s Jc] [6s]
Player Hakuna_Matata777 checks
Player arito02 bets (0.50)
Player constant revelation calls (0.50)
Player Hakuna_Matata777 folds
*** RIVER ***: [5h 2s Jc 6s] [10h]
Player arito02 bets (1.26)
Player constant revelation folds
Uncalled bet (1.26) returned to arito02
Player arito02 mucks cards
------ Summary ------
Pot: 3.80. Rake 0.14. JP fee 0.06
Board: [5h 2s Jc 6s 10h]
Player wrongcolorchip does not show cards.Bets: 0. Collects: 0. Wins: 0.
Player IlxxxlI does not show cards.Bets: 0. Collects: 0. Wins: 0.
Player kid4life does not show cards.Bets: 0. Collects: 0. Wins: 0.
Player MortalLock does not show cards.Bets: 0. Collects: 0. Wins: 0.
Player slick07lx does not show cards.Bets: 0. Collects: 0. Wins: 0.
Player Spagetti1 does not show cards.Bets: 0. Collects: 0. Wins: 0.
Player Hakuna_Matata777 does not show cards.Bets: 1. Collects: 0. Loses: 1.
*Player arito02 mucks (does not show cards). Bets: 1.50. Collects: 3.80. Wins: 2.30.
Player constant revelation does not show cards.Bets: 1.50. Collects: 0. Loses: 1.50.
Game ended at: 2016/11/29 12:53:45

Game started
Game ID: 786959646 1/2 (PRR) Lakhey (Hold'em)
Seat 6 is the button
Seat 1: bfish602 (200).
Seat 2: KingGuciGuci (200).
Seat 3: IbetUmuck (707.89).
Seat 4: IlxxxlI (85.27).
Seat 5: MadLifeGrinder (200).
Seat 6: LazyFish (290.70).
Player bfish602 has small blind (1)
Player KingGuciGuci has big blind (2)
Player IlxxxlI received card: [5s]
Player IlxxxlI received card: [7d]
Player IbetUmuck raises (5.75)
Player IlxxxlI folds
Player MadLifeGrinder folds
Player LazyFish raises (17)
Player bfish602 folds
Player KingGuciGuci folds
Player IbetUmuck calls (11.25)
*** FLOP ***: [7s 8d 2s]
Player IbetUmuck checks
Player LazyFish checks
*** TURN ***: [7s 8d 2s] [2c]
Player IbetUmuck bets (26.36)
Player LazyFish folds
Uncalled bet (26.36) returned to IbetUmuck
Player IbetUmuck mucks cards
------ Summary ------
Pot: 35.15. Rake 1.61. JP fee 0.24
Board: [7s 8d 2s 2c]
Player bfish602 does not show cards.Bets: 1. Collects: 0. Loses: 1.
Player KingGuciGuci does not show cards.Bets: 2. Collects: 0. Loses: 2.
*Player IbetUmuck mucks (does not show cards). Bets: 17. Collects: 35.15. Wins: 18.15.
Player IlxxxlI does not show cards.Bets: 0. Collects: 0. Wins: 0.
Player MadLifeGrinder does not show cards.Bets: 0. Collects: 0. Wins: 0.
Player LazyFish does not show cards.Bets: 17. Collects: 0. Loses: 17.
Game ended at: 2016/11/29 12:53:29

Game started
Game ID: 786959527 0.50/1 (PRR) Kraken - 9 (Hold'em)
Seat 2 is the button
Seat 1: WeakAndWeary (112.55).
Seat 2: LloydXmas (103.50).
Seat 3: GagaPoker (100).
Seat 4: Beep_Beep (100).
Seat 5: MadLifeGrinder (100).
Seat 6: IlxxxlI (40).
Player GagaPoker has small blind (0.50)
Player Beep_Beep has big blind (1)
Player IlxxxlI received card: [7d]
Player IlxxxlI received card: [Qc]
Player MadLifeGrinder folds
Player IlxxxlI folds
Player WeakAndWeary folds
Player LloydXmas raises (2.25)
Player GagaPoker folds
Player Beep_Beep folds
Uncalled bet (1.25) returned to LloydXmas
Player LloydXmas mucks cards
------ Summary ------
Pot: 2.50. Rake 0
Player WeakAndWeary does not show cards.Bets: 0. Collects: 0. Wins: 0.
*Player LloydXmas mucks (does not show cards). Bets: 1. Collects: 2.50. Wins: 1.50.
Player GagaPoker does not show cards.Bets: 0.50. Collects: 0. Loses: 0.50.
Player Beep_Beep does not show cards.Bets: 1. Collects: 0. Loses: 1.
Player MadLifeGrinder does not show cards.Bets: 0. Collects: 0. Wins: 0.
Player IlxxxlI does not show cards.Bets: 0. Collects: 0. Wins: 0.
Game ended at: 2016/11/29 12:52:46

Game started
Game ID: 786959503 0.25/0.50 (PRR) Gorgons - 2 (Hold'em)
Seat 5 is the button
Seat 1: BHawk12 (60.67).
Seat 2: IlxxxlI (20).
Seat 3: flyshark01 (88.29).
Seat 4: Jui Kuen (50).
Seat 5: constant revelation (27.32).
Seat 6: foreseen (52.59).
Player foreseen has small blind (0.25)
Player BHawk12 has big blind (0.50)
Player IlxxxlI received card: [3h]
Player IlxxxlI received card: [3d]
Player IlxxxlI folds
Player flyshark01 raises (1.50)
Player Jui Kuen folds
Player constant revelation calls (1.50)
Player foreseen folds
Player BHawk12 folds
*** FLOP ***: [Ad Ks 8h]
Player flyshark01 checks
Player constant revelation checks
*** TURN ***: [Ad Ks 8h] [2c]
Player flyshark01 checks
Player constant revelation checks
*** RIVER ***: [Ad Ks 8h 2c] [5h]
Player flyshark01 checks
Player constant revelation checks
Player constant revelation mucks cards
------ Summary ------
Pot: 3.57. Rake 0.12. JP fee 0.06
Board: [Ad Ks 8h 2c 5h]
Player BHawk12 does not show cards.Bets: 0.50. Collects: 0. Loses: 0.50.
Player IlxxxlI does not show cards.Bets: 0. Collects: 0. Wins: 0.
*Player flyshark01 shows: One pair of As [Qh Ac]. Bets: 1.50. Collects: 3.57. Wins: 2.07.
Player Jui Kuen does not show cards.Bets: 0. Collects: 0. Wins: 0.
Player constant revelation mucks (does not show cards). Bets: 1.50. Collects: 0. Loses: 1.50.
Player foreseen does not show cards.Bets: 0.25. Collects: 0. Loses: 0.25.
Game ended at: 2016/11/29 12:53:19

Game started
Game ID: 786959367 1/2 (PRR) Lakhey (Hold'em)
Seat 5 is the button
Seat 1: bfish602 (200).
Seat 2: KingGuciGuci (200).
Seat 3: IbetUmuck (707.89).
Seat 4: IlxxxlI (80).
Seat 5: MadLifeGrinder (200).
Seat 6: LazyFish (291.70).
Player LazyFish has small blind (1)
Player bfish602 has big blind (2)
Player IlxxxlI received card: [Qc]
Player IlxxxlI received card: [10c]
Player KingGuciGuci folds
Player IbetUmuck folds
Player IlxxxlI raises (4.80)
Player MadLifeGrinder folds
Player LazyFish folds
Player bfish602 calls (2.80)
*** FLOP ***: [9s 3h As]
Player bfish602 checks
Player IlxxxlI bets (5.24)
Player bfish602 folds
Uncalled bet (5.24) returned to IlxxxlI
Player IlxxxlI mucks cards
------ Summary ------
Pot: 10.07. Rake 0.37. JP fee 0.16
Board: [9s 3h As]
Player bfish602 does not show cards.Bets: 4.80. Collects: 0. Loses: 4.80.
Player KingGuciGuci does not show cards.Bets: 0. Collects: 0. Wins: 0.
Player IbetUmuck does not show cards.Bets: 0. Collects: 0. Wins: 0.
*Player IlxxxlI mucks (does not show cards). Bets: 4.80. Collects: 10.07. Wins: 5.27.
Player MadLifeGrinder does not show cards.Bets: 0. Collects: 0. Wins: 0.
Player LazyFish does not show cards.Bets: 1. Collects: 0. Loses: 1.
Game ended at: 2016/11/29 12:52:26

Game started
Game ID: 786959366 0.50/1 (PRR) Kraken - 7 (Hold'em)
Seat 2 is the button
Seat 1: gust (46.43).
Seat 2: WeakAndWeary (102.72).
Seat 3: Beep_Beep (100.50).
Seat 4: IlxxxlI (42).
Seat 5: St3p04ka (40).
Seat 6: MadLifeGrinder (103).
Player Beep_Beep has small blind (0.50)
Player IlxxxlI has big blind (1)
Player IlxxxlI received card: [10h]
Player IlxxxlI received card: [Kc]
Player St3p04ka raises (3.10)
Player MadLifeGrinder folds
Player gust folds
Player WeakAndWeary folds
Player Beep_Beep folds
Player IlxxxlI folds
Uncalled bet (2.10) returned to St3p04ka
Player St3p04ka mucks cards
------ Summary ------
Pot: 2.50. Rake 0
Player gust does not show cards.Bets: 0. Collects: 0. Wins: 0.
Player WeakAndWeary does not show cards.Bets: 0. Collects: 0. Wins: 0.
Player Beep_Beep does not show cards.Bets: 0.50. Collects: 0. Loses: 0.50.
Player IlxxxlI does not show cards.Bets: 1. Collects: 0. Loses: 1.
*Player St3p04ka mucks (does not show cards). Bets: 1. Collects: 2.50. Wins: 1.50.
Player MadLifeGrinder does not show cards.Bets: 0. Collects: 0. Wins: 0.
Game ended at: 2016/11/29 12:52:32

Game started
Game ID: 786959227 0.50/1 (PRR) Kraken - 9 (Hold'em)
Seat 1 is the button
Seat 1: WeakAndWeary (111.05).
Seat 2: LloydXmas (104).
Seat 3: GagaPoker (100).
Seat 5: MadLifeGrinder (100).
Seat 6: IlxxxlI (40).
Player LloydXmas has small blind (0.50)
Player GagaPoker has big blind (1)
Player IlxxxlI received card: [9h]
Player IlxxxlI received card: [Qs]
Player MadLifeGrinder folds
Player IlxxxlI folds
Player WeakAndWeary raises (3)
Player LloydXmas folds
Player GagaPoker folds
Uncalled bet (2) returned to WeakAndWeary
Player WeakAndWeary mucks cards
------ Summary ------
Pot: 2.50. Rake 0
*Player WeakAndWeary mucks (does not show cards). Bets: 1. Collects: 2.50. Wins: 1.50.
Player LloydXmas does not show cards.Bets: 0.50. Collects: 0. Loses: 0.50.
Player GagaPoker does not show cards.Bets: 1. Collects: 0. Loses: 1.
Player MadLifeGrinder does not show cards.Bets: 0. Collects: 0. Wins: 0.
Player IlxxxlI does not show cards.Bets: 0. Collects: 0. Wins: 0.
Game ended at: 2016/11/29 12:52:12

Game started
Game ID: 786959073 0.25/0.50 (PRR) Gorgons - 2 (Hold'em)
Seat 4 is the button
Seat 1: BHawk12 (60.67).
Seat 2: IlxxxlI (20).
Seat 3: flyshark01 (87.54).
Seat 4: Jui Kuen (50).
Seat 5: constant revelation (27.57).
Seat 6: foreseen (53.09).
Player constant revelation has small blind (0.25)
Player foreseen has big blind (0.50)
Player IlxxxlI received card: [7s]
Player IlxxxlI received card: [9c]
Player BHawk12 folds
Player IlxxxlI folds
Player flyshark01 raises (1.50)
Player Jui Kuen folds
Player constant revelation folds
Player foreseen folds
Uncalled bet (1) returned to flyshark01
Player flyshark01 mucks cards
------ Summary ------
Pot: 1.25. Rake 0
Player BHawk12 does not show cards.Bets: 0. Collects: 0. Wins: 0.
Player IlxxxlI does not show cards.Bets: 0. Collects: 0. Wins: 0.
*Player flyshark01 mucks (does not show cards). Bets: 0.50. Collects: 1.25. Wins: 0.75.
Player Jui Kuen does not show cards.Bets: 0. Collects: 0. Wins: 0.
Player constant revelation does not show cards.Bets: 0.25. Collects: 0. Loses: 0.25.
Player foreseen does not show cards.Bets: 0.50. Collects: 0. Loses: 0.50.
Game ended at: 2016/11/29 12:52:9

Game started
Game ID: 786959053 0.50/1 (PRR) Kraken - 7 (Hold'em)
Seat 1 is the button
Seat 1: gust (46.43).
Seat 2: WeakAndWeary (103.22).
Seat 3: Beep_Beep (100).
Seat 4: IlxxxlI (42).
Seat 5: St3p04ka (40).
Seat 6: MadLifeGrinder (103).
Player WeakAndWeary has small blind (0.50)
Player Beep_Beep has big blind (1)
Player IlxxxlI received card: [5d]
Player IlxxxlI received card: [9d]
Player IlxxxlI folds
Player St3p04ka folds
Player MadLifeGrinder folds
Player gust folds
Player WeakAndWeary folds
Uncalled bet (0.50) returned to Beep_Beep
Player Beep_Beep mucks cards
------ Summary ------
Pot: 1. Rake 0
Player gust does not show cards.Bets: 0. Collects: 0. Wins: 0.
Player WeakAndWeary does not show cards.Bets: 0.50. Collects: 0. Loses: 0.50.
*Player Beep_Beep mucks (does not show cards). Bets: 0.50. Collects: 1. Wins: 0.50.
Player IlxxxlI does not show cards.Bets: 0. Collects: 0. Wins: 0.
Player St3p04ka does not show cards.Bets: 0. Collects: 0. Wins: 0.
Player MadLifeGrinder does not show cards.Bets: 0. Collects: 0. Wins: 0.
Game ended at: 2016/11/29 12:51:57

Game started
Game ID: 786958923 0.25/0.50 (PRR) Garuda - 4 (Hold'em)
Seat 5 is the button
Seat 1: wrongcolorchip (156.33).
Seat 2: IlxxxlI (25.77).
Seat 3: kid4life (47.12).
Seat 4: MortalLock (50).
Seat 5: slick07lx (38.39).
Seat 6: Spagetti1 (24.50).
Seat 7: Hakuna_Matata777 (50).
Seat 8: arito02 (63.15).
Seat 9: constant revelation (21.92).
Player Spagetti1 has small blind (0.25)
Player Hakuna_Matata777 has big blind (0.50)
Player IlxxxlI received card: [3h]
Player IlxxxlI received card: [9h]
Player arito02 calls (0.50)
Player constant revelation calls (0.50)
Player wrongcolorchip folds
Player IlxxxlI folds
Player kid4life folds
Player MortalLock folds
Player slick07lx folds
Player Spagetti1 calls (0.25)
Player Hakuna_Matata777 raises (2.50)
Player arito02 calls (2.50)
Player constant revelation calls (2.50)
Player Spagetti1 folds
*** FLOP ***: [4c 2s Qc]
Player Hakuna_Matata777 bets (4.51)
Player arito02 folds
Player constant revelation folds
Uncalled bet (4.51) returned to Hakuna_Matata777
Player Hakuna_Matata777 mucks cards
------ Summary ------
Pot: 9.03. Rake 0.33. JP fee 0.14
Board: [4c 2s Qc]
Player wrongcolorchip does not show cards.Bets: 0. Collects: 0. Wins: 0.
Player IlxxxlI does not show cards.Bets: 0. Collects: 0. Wins: 0.
Player kid4life does not show cards.Bets: 0. Collects: 0. Wins: 0.
Player MortalLock does not show cards.Bets: 0. Collects: 0. Wins: 0.
Player slick07lx does not show cards.Bets: 0. Collects: 0. Wins: 0.
Player Spagetti1 does not show cards.Bets: 0.50. Collects: 0. Loses: 0.50.
*Player Hakuna_Matata777 mucks (does not show cards). Bets: 3. Collects: 9.03. Wins: 6.03.
Player arito02 does not show cards.Bets: 3. Collects: 0. Loses: 3.
Player constant revelation does not show cards.Bets: 3. Collects: 0. Loses: 3.
Game ended at: 2016/11/29 12:52:27

Game started
Game ID: 786958669 0.50/1 (PRR) Kraken - 9 (Hold'em)
Seat 6 is the button
Seat 1: WeakAndWeary (107.55).
Seat 2: LloydXmas (105).
Seat 3: GagaPoker (100).
Seat 5: MadLifeGrinder (100).
Seat 6: IlxxxlI (40).
Player WeakAndWeary has small blind (0.50)
Player LloydXmas has big blind (1)
Player IlxxxlI received card: [7s]
Player IlxxxlI received card: [2s]
Player GagaPoker folds
Player MadLifeGrinder raises (2.50)
Player IlxxxlI folds
Player WeakAndWeary raises (9.50)
Player LloydXmas folds
Player MadLifeGrinder folds
Uncalled bet (7.50) returned to WeakAndWeary
Player WeakAndWeary mucks cards
------ Summary ------
Pot: 6. Rake 0
*Player WeakAndWeary mucks (does not show cards). Bets: 2.50. Collects: 6. Wins: 3.50.
Player LloydXmas does not show cards.Bets: 1. Collects: 0. Loses: 1.
Player GagaPoker does not show cards.Bets: 0. Collects: 0. Wins: 0.
Player MadLifeGrinder does not show cards.Bets: 2.50. Collects: 0. Loses: 2.50.
Player IlxxxlI does not show cards.Bets: 0. Collects: 0. Wins: 0.
Game ended at: 2016/11/29 12:51:44

Game started
Game ID: 786958365 0.50/1 (PRR) Kraken - 7 (Hold'em)
Seat 6 is the button
Seat 1: gust (46.93).
Seat 2: WeakAndWeary (102.72).
Seat 4: IlxxxlI (42).
Seat 5: St3p04ka (40).
Seat 6: MadLifeGrinder (103).
Player gust has small blind (0.50)
Player WeakAndWeary has big blind (1)
Player IlxxxlI received card: [7d]
Player IlxxxlI received card: [10h]
Player IlxxxlI folds
Player St3p04ka folds
Player MadLifeGrinder folds
Player gust folds
Uncalled bet (0.50) returned to WeakAndWeary
Player WeakAndWeary mucks cards
------ Summary ------
Pot: 1. Rake 0
Player gust does not show cards.Bets: 0.50. Collects: 0. Loses: 0.50.
*Player WeakAndWeary mucks (does not show cards). Bets: 0.50. Collects: 1. Wins: 0.50.
Player IlxxxlI does not show cards.Bets: 0. Collects: 0. Wins: 0.
Player St3p04ka does not show cards.Bets: 0. Collects: 0. Wins: 0.
Player MadLifeGrinder does not show cards.Bets: 0. Collects: 0. Wins: 0.
Game ended at: 2016/11/29 12:51:24

Game started
Game ID: 786958323 1/2 (PRR) Lakhey (Hold'em)
Seat 4 is the button
Seat 1: bfish602 (200).
Seat 2: KingGuciGuci (200).
Seat 3: IbetUmuck (713.64).
Seat 4: IlxxxlI (80).
Seat 5: MadLifeGrinder (201).
Seat 6: LazyFish (285.57).
Player MadLifeGrinder has small blind (1)
Player LazyFish has big blind (2)
Player IlxxxlI received card: [6h]
Player IlxxxlI received card: [8d]
Player bfish602 folds
Player KingGuciGuci folds
Player IbetUmuck raises (5.75)
Player IlxxxlI folds
Player MadLifeGrinder folds
Player LazyFish calls (3.75)
*** FLOP ***: [Qd 8h Qc]
Player LazyFish checks
Player IbetUmuck checks
*** TURN ***: [Qd 8h Qc] [3c]
Player LazyFish checks
Player IbetUmuck checks
*** RIVER ***: [Qd 8h Qc 3c] [3h]
Player LazyFish bets (8)
Player IbetUmuck folds
Uncalled bet (8) returned to LazyFish
Player LazyFish mucks cards
------ Summary ------
Pot: 11.88. Rake 0.42. JP fee 0.20
Board: [Qd 8h Qc 3c 3h]
Player bfish602 does not show cards.Bets: 0. Collects: 0. Wins: 0.
Player KingGuciGuci does not show cards.Bets: 0. Collects: 0. Wins: 0.
Player IbetUmuck does not show cards.Bets: 5.75. Collects: 0. Loses: 5.75.
Player IlxxxlI does not show cards.Bets: 0. Collects: 0. Wins: 0.
Player MadLifeGrinder does not show cards.Bets: 1. Collects: 0. Loses: 1.
*Player LazyFish mucks (does not show cards). Bets: 5.75. Collects: 11.88. Wins: 6.13.
Game ended at: 2016/11/29 12:51:58

Game started
Game ID: 786958308 0.50/1 (PRR) Kraken - 9 (Hold'em)
Seat 5 is the button
Seat 1: WeakAndWeary (107.05).
Seat 2: LloydXmas (105).
Seat 3: GagaPoker (100).
Seat 5: MadLifeGrinder (100).
Seat 6: IlxxxlI (40).
Player IlxxxlI has small blind (0.50)
Player WeakAndWeary has big blind (1)
Player IlxxxlI received card: [5d]
Player IlxxxlI received card: [10c]
Player LloydXmas folds
Player GagaPoker folds
Player MadLifeGrinder folds
Player IlxxxlI folds
Uncalled bet (0.50) returned to WeakAndWeary
Player WeakAndWeary mucks cards
------ Summary ------
Pot: 1. Rake 0
*Player WeakAndWeary mucks (does not show cards). Bets: 0.50. Collects: 1. Wins: 0.50.
Player LloydXmas does not show cards.Bets: 0. Collects: 0. Wins: 0.
Player GagaPoker does not show cards.Bets: 0. Collects: 0. Wins: 0.
Player MadLifeGrinder does not show cards.Bets: 0. Collects: 0. Wins: 0.
Player IlxxxlI does not show cards.Bets: 0.50. Collects: 0. Loses: 0.50.
Game ended at: 2016/11/29 12:50:46

Game started
Game ID: 786958298 0.25/0.50 (PRR) Gorgons - 2 (Hold'em)
Seat 3 is the button
Seat 1: BHawk12 (62.17).
Seat 2: IlxxxlI (20).
Seat 3: flyshark01 (87.54).
Seat 4: Jui Kuen (50).
Seat 5: constant revelation (25.98).
Seat 6: foreseen (53.09).
Player Jui Kuen has small blind (0.25)
Player constant revelation has big blind (0.50)
Player IlxxxlI received card: [10c]
Player IlxxxlI received card: [7d]
Player foreseen folds
Player BHawk12 raises (1.50)
Player IlxxxlI folds
Player flyshark01 folds
Player Jui Kuen folds
Player constant revelation calls (1)
*** FLOP ***: [4h 5c 5s]
Player constant revelation checks
Player BHawk12 checks
*** TURN ***: [4h 5c 5s] [8s]
Player constant revelation bets (1.54)
Player BHawk12 folds
Uncalled bet (1.54) returned to constant revelation
Player constant revelation mucks cards
------ Summary ------
Pot: 3.09. Rake 0.12. JP fee 0.04
Board: [4h 5c 5s 8s]
Player BHawk12 does not show cards.Bets: 1.50. Collects: 0. Loses: 1.50.
Player IlxxxlI does not show cards.Bets: 0. Collects: 0. Wins: 0.
Player flyshark01 does not show cards.Bets: 0. Collects: 0. Wins: 0.
Player Jui Kuen does not show cards.Bets: 0.25. Collects: 0. Loses: 0.25.
*Player constant revelation mucks (does not show cards). Bets: 1.50. Collects: 3.09. Wins: 1.59.
Player foreseen does not show cards.Bets: 0. Collects: 0. Wins: 0.
Game ended at: 2016/11/29 12:51:28

Game started
Game ID: 786958123 1/2 (PRR) Lakhey (Hold'em)
Seat 3 is the button
Seat 1: bfish602 (200).
Seat 2: KingGuciGuci (200).
Seat 3: IbetUmuck (713.64).
Seat 4: IlxxxlI (80).
Seat 5: MadLifeGrinder (203).
Seat 6: LazyFish (282.57).
Player IlxxxlI has small blind (1)
Player MadLifeGrinder has big blind (2)
Player IlxxxlI received card: [7c]
Player IlxxxlI received card: [6d]
Player LazyFish raises (5)
Player bfish602 folds
Player KingGuciGuci folds
Player IbetUmuck folds
Player IlxxxlI folds
Player MadLifeGrinder folds
Uncalled bet (3) returned to LazyFish
Player LazyFish mucks cards
------ Summary ------
Pot: 5. Rake 0
Player bfish602 does not show cards.Bets: 0. Collects: 0. Wins: 0.
Player KingGuciGuci does not show cards.Bets: 0. Collects: 0. Wins: 0.
Player IbetUmuck does not show cards.Bets: 0. Collects: 0. Wins: 0.
Player IlxxxlI does not show cards.Bets: 1. Collects: 0. Loses: 1.
Player MadLifeGrinder does not show cards.Bets: 2. Collects: 0. Loses: 2.
*Player LazyFish mucks (does not show cards). Bets: 2. Collects: 5. Wins: 3.
Game ended at: 2016/11/29 12:50:15

Game started
Game ID: 786958062 0.50/1 (PRR) Kraken - 7 (Hold'em)
Seat 5 is the button
Seat 1: gust (46.43).
Seat 2: WeakAndWeary (102.72).
Seat 4: IlxxxlI (42).
Seat 5: St3p04ka (40).
Seat 6: MadLifeGrinder (103.50).
Player MadLifeGrinder has small blind (0.50)
Player gust has big blind (1)
Player IlxxxlI received card: [3c]
Player IlxxxlI received card: [Jh]
Player WeakAndWeary folds
Player IlxxxlI folds
Player St3p04ka folds
Player MadLifeGrinder folds
Uncalled bet (0.50) returned to gust
Player gust mucks cards
------ Summary ------
Pot: 1. Rake 0
*Player gust mucks (does not show cards). Bets: 0.50. Collects: 1. Wins: 0.50.
Player WeakAndWeary does not show cards.Bets: 0. Collects: 0. Wins: 0.
Player IlxxxlI does not show cards.Bets: 0. Collects: 0. Wins: 0.
Player St3p04ka does not show cards.Bets: 0. Collects: 0. Wins: 0.
Player MadLifeGrinder does not show cards.Bets: 0.50. Collects: 0. Loses: 0.50.
Game ended at: 2016/11/29 12:50:18

Game started
Game ID: 786958044 0.25/0.50 (PRR) Garuda - 4 (Hold'em)
Seat 4 is the button
Seat 1: wrongcolorchip (156.33).
Seat 2: IlxxxlI (21.66).
Seat 3: kid4life (50.89).
Seat 4: MortalLock (50).
Seat 5: slick07lx (38.64).
Seat 6: Spagetti1 (25).
Seat 8: arito02 (63.15).
Seat 9: constant revelation (21.92).
Player slick07lx has small blind (0.25)
Player Spagetti1 has big blind (0.50)
Player IlxxxlI received card: [Jh]
Player IlxxxlI received card: [As]
Player arito02 folds
Player constant revelation folds
Player wrongcolorchip folds
Player IlxxxlI raises (1.75)
Player kid4life calls (1.75)
Player MortalLock folds
Player slick07lx folds
Player Spagetti1 folds
*** FLOP ***: [5s Ks 3d]
Player IlxxxlI checks
Player kid4life bets (2.02)
Player IlxxxlI raises (4.48)
Player kid4life folds
Uncalled bet (2.46) returned to IlxxxlI
Player IlxxxlI mucks cards
------ Summary ------
Pot: 7.88. Rake 0.29. JP fee 0.12
Board: [5s Ks 3d]
Player wrongcolorchip does not show cards.Bets: 0. Collects: 0. Wins: 0.
*Player IlxxxlI mucks (does not show cards). Bets: 3.77. Collects: 7.88. Wins: 4.11.
Player kid4life does not show cards.Bets: 3.77. Collects: 0. Loses: 3.77.
Player MortalLock does not show cards.Bets: 0. Collects: 0. Wins: 0.
Player slick07lx does not show cards.Bets: 0.25. Collects: 0. Loses: 0.25.
Player Spagetti1 does not show cards.Bets: 0.50. Collects: 0. Loses: 0.50.
Player arito02 does not show cards.Bets: 0. Collects: 0. Wins: 0.
Player constant revelation does not show cards.Bets: 0. Collects: 0. Wins: 0.
Game ended at: 2016/11/29 12:51:15

Game started
Game ID: 786957954 0.50/1 (PRR) Kraken - 9 (Hold'em)
Seat 3 is the button
Seat 1: WeakAndWeary (107.05).
Seat 2: LloydXmas (103.50).
Seat 3: GagaPoker (100).
Seat 5: MadLifeGrinder (100.50).
Seat 6: IlxxxlI (40).
Player MadLifeGrinder has small blind (0.50)
Player IlxxxlI has big blind (1)
Player IlxxxlI received card: [4d]
Player IlxxxlI received card: [6s]
Player WeakAndWeary folds
Player LloydXmas raises (2.88)
Player GagaPoker folds
Player MadLifeGrinder folds
Player IlxxxlI folds
Uncalled bet (1.88) returned to LloydXmas
Player LloydXmas mucks cards
------ Summary ------
Pot: 2.50. Rake 0
Player WeakAndWeary does not show cards.Bets: 0. Collects: 0. Wins: 0.
*Player LloydXmas mucks (does not show cards). Bets: 1. Collects: 2.50. Wins: 1.50.
Player GagaPoker does not show cards.Bets: 0. Collects: 0. Wins: 0.
Player MadLifeGrinder does not show cards.Bets: 0.50. Collects: 0. Loses: 0.50.
Player IlxxxlI does not show cards.Bets: 1. Collects: 0. Loses: 1.
Game ended at: 2016/11/29 12:50:13

Game started
Game ID: 786957824 0.50/1 (PRR) Kraken - 18 (Hold'em)
Seat 4 is the button
Seat 4: IlxxxlI (40).
Seat 5: MadLifeGrinder (100).
Player IlxxxlI has small blind (0.50)
Player MadLifeGrinder has big blind (1)
Player IlxxxlI received card: [Ad]
Player IlxxxlI received card: [Ac]
Player IlxxxlI calls (0.50)
Player MadLifeGrinder checks
*** FLOP ***: [5h Kh 9d]
Player MadLifeGrinder checks
Player IlxxxlI bets (4)
Player MadLifeGrinder folds
Uncalled bet (4) returned to IlxxxlI
Player IlxxxlI mucks cards
------ Summary ------
Pot: 1.90. Rake 0.08. JP fee 0.02
Board: [5h Kh 9d]
*Player IlxxxlI mucks (does not show cards). Bets: 1. Collects: 1.90. Wins: 0.90.
Player MadLifeGrinder does not show cards.Bets: 1. Collects: 0. Loses: 1.
Game ended at: 2016/11/29 12:50:12

Game started
Game ID: 786957770 0.50/1 (PRR) Kraken - 7 (Hold'em)
Seat 4 is the button
Seat 1: gust (46.43).
Seat 2: WeakAndWeary (102.72).
Seat 4: IlxxxlI (42).
Seat 5: St3p04ka (40.50).
Seat 6: MadLifeGrinder (103).
Player St3p04ka has small blind (0.50)
Player MadLifeGrinder has big blind (1)
Player IlxxxlI received card: [7d]
Player IlxxxlI received card: [3c]
Player gust folds
Player WeakAndWeary folds
Player IlxxxlI folds
Player St3p04ka folds
Uncalled bet (0.50) returned to MadLifeGrinder
Player MadLifeGrinder mucks cards
------ Summary ------
Pot: 1. Rake 0
Player gust does not show cards.Bets: 0. Collects: 0. Wins: 0.
Player WeakAndWeary does not show cards.Bets: 0. Collects: 0. Wins: 0.
Player IlxxxlI does not show cards.Bets: 0. Collects: 0. Wins: 0.
Player St3p04ka does not show cards.Bets: 0.50. Collects: 0. Loses: 0.50.
*Player MadLifeGrinder mucks (does not show cards). Bets: 0.50. Collects: 1. Wins: 0.50.
Game ended at: 2016/11/29 12:49:49

Game started
Game ID: 786957354 0.50/1 (PRR) Kraken - 8 (Hold'em)
Seat 4 is the button
Seat 1: MadLifeGrinder (100).
Seat 2: IlxxxlI (59.17).
Seat 3: lordboroda (112.60).
Seat 4: rook_ (143.46).
Seat 5: LloydXmas (100).
Seat 6: quant_theo (100).
Player LloydXmas has small blind (0.50)
Player quant_theo has big blind (1)
Player IlxxxlI received card: [4c]
Player IlxxxlI received card: [2d]
Player MadLifeGrinder folds
Player IlxxxlI folds
Player lordboroda folds
Player rook_ raises (2)
Player LloydXmas folds
Player quant_theo raises (3)
Player rook_ calls (2)
*** FLOP ***: [2c 7h 9c]
Player quant_theo bets (5)
Player rook_ calls (5)
*** TURN ***: [2c 7h 9c] [6s]
Player quant_theo checks
Player rook_ bets (10)
Player quant_theo folds
Uncalled bet (10) returned to rook_
Player rook_ mucks cards
------ Summary ------
Pot: 17.58. Rake 0.68. JP fee 0.24
Board: [2c 7h 9c 6s]
Player MadLifeGrinder does not show cards.Bets: 0. Collects: 0. Wins: 0.
Player IlxxxlI does not show cards.Bets: 0. Collects: 0. Wins: 0.
Player lordboroda does not show cards.Bets: 0. Collects: 0. Wins: 0.
*Player rook_ mucks (does not show cards). Bets: 9. Collects: 17.58. Wins: 8.58.
Player LloydXmas does not show cards.Bets: 0.50. Collects: 0. Loses: 0.50.
Player quant_theo does not show cards.Bets: 9. Collects: 0. Loses: 9.
Game ended at: 2016/11/29 12:49:43

Game started
Game ID: 786957263 0.25/0.50 (PRR) Gorgons - 2 (Hold'em)
Seat 2 is the button
Seat 1: BHawk12 (62.17).
Seat 2: IlxxxlI (20).
Seat 3: flyshark01 (87.79).
Seat 4: Jui Kuen (50).
Seat 5: constant revelation (24.58).
Seat 6: foreseen (53.09).
Player flyshark01 has small blind (0.25)
Player Jui Kuen has big blind (0.50)
Player IlxxxlI received card: [5d]
Player IlxxxlI received card: [Ks]
Player constant revelation calls (0.50)
Player foreseen folds
Player BHawk12 folds
Player IlxxxlI folds
Player flyshark01 folds
Player Jui Kuen checks
*** FLOP ***: [6c Qc 8s]
Player Jui Kuen bets (0.79)
Player constant revelation calls (0.79)
*** TURN ***: [6c Qc 8s] [Qh]
Player Jui Kuen is timed out.
Player Jui Kuen checks
Player constant revelation bets (1.34)
Player Jui Kuen folds
Uncalled bet (1.34) returned to constant revelation
Player constant revelation mucks cards
------ Summary ------
Pot: 2.69. Rake 0.10. JP fee 0.04
Board: [6c Qc 8s Qh]
Player BHawk12 does not show cards.Bets: 0. Collects: 0. Wins: 0.
Player IlxxxlI does not show cards.Bets: 0. Collects: 0. Wins: 0.
Player flyshark01 does not show cards.Bets: 0.25. Collects: 0. Loses: 0.25.
Player Jui Kuen does not show cards.Bets: 1.29. Collects: 0. Loses: 1.29.
*Player constant revelation mucks (does not show cards). Bets: 1.29. Collects: 2.69. Wins: 1.40.
Player foreseen does not show cards.Bets: 0. Collects: 0. Wins: 0.
Game ended at: 2016/11/29 12:50:12

Game started
Game ID: 786957176 0.25/0.50 (PRR) Garuda - 4 (Hold'em)
Seat 3 is the button
Seat 1: wrongcolorchip (156.33).
Seat 2: IlxxxlI (21.66).
Seat 3: kid4life (50.89).
Seat 4: MortalLock (50).
Seat 5: slick07lx (32.97).
Seat 8: arito02 (68.65).
Seat 9: constant revelation (22.42).
Player MortalLock has small blind (0.25)
Player slick07lx has big blind (0.50)
Player IlxxxlI received card: [6h]
Player IlxxxlI received card: [2s]
Player arito02 calls (0.50)
Player constant revelation calls (0.50)
Player wrongcolorchip folds
Player IlxxxlI folds
Player kid4life folds
Player MortalLock folds
Player slick07lx checks
*** FLOP ***: [4d Js 8d]
Player slick07lx bets (1)
Player arito02 calls (1)
Player constant revelation folds
*** TURN ***: [4d Js 8d] [Qd]
Player slick07lx bets (2)
Player arito02 calls (2)
*** RIVER ***: [4d Js 8d Qd] [Ad]
Player slick07lx bets (2)
Player arito02 calls (2)
Player arito02 mucks cards
------ Summary ------
Pot: 11.17. Rake 0.40. JP fee 0.18
Board: [4d Js 8d Qd Ad]
Player wrongcolorchip does not show cards.Bets: 0. Collects: 0. Wins: 0.
Player IlxxxlI does not show cards.Bets: 0. Collects: 0. Wins: 0.
Player kid4life does not show cards.Bets: 0. Collects: 0. Wins: 0.
Player MortalLock does not show cards.Bets: 0.25. Collects: 0. Loses: 0.25.
*Player slick07lx shows: Flush, A high [8c 7d]. Bets: 5.50. Collects: 11.17. Wins: 5.67.
Player arito02 mucks (does not show cards). Bets: 5.50. Collects: 0. Loses: 5.50.
Player constant revelation does not show cards.Bets: 0.50. Collects: 0. Loses: 0.50.
Game ended at: 2016/11/29 12:49:47

Game started
Game ID: 786957138 0.50/1 (PRR) Kraken - 7 (Hold'em)
Seat 2 is the button
Seat 1: gust (46.43).
Seat 2: WeakAndWeary (102.72).
Seat 4: IlxxxlI (42.50).
Seat 5: St3p04ka (41.50).
Seat 6: MadLifeGrinder (101.50).
Player IlxxxlI has small blind (0.50)
Player St3p04ka has big blind (1)
Player IlxxxlI received card: [Kd]
Player IlxxxlI received card: [Qh]
Player MadLifeGrinder raises (2.50)
Player gust folds
Player WeakAndWeary folds
Player IlxxxlI folds
Player St3p04ka folds
Uncalled bet (1.50) returned to MadLifeGrinder
Player MadLifeGrinder mucks cards
------ Summary ------
Pot: 2.50. Rake 0
Player gust does not show cards.Bets: 0. Collects: 0. Wins: 0.
Player WeakAndWeary does not show cards.Bets: 0. Collects: 0. Wins: 0.
Player IlxxxlI does not show cards.Bets: 0.50. Collects: 0. Loses: 0.50.
Player St3p04ka does not show cards.Bets: 1. Collects: 0. Loses: 1.
*Player MadLifeGrinder mucks (does not show cards). Bets: 1. Collects: 2.50. Wins: 1.50.
Game ended at: 2016/11/29 12:49:23

Game started
Game ID: 786956761 0.50/1 (PRR) Kraken - 8 (Hold'em)
Seat 3 is the button
Seat 1: MadLifeGrinder (100).
Seat 2: IlxxxlI (42).
Seat 3: lordboroda (112.60).
Seat 4: rook_ (161.48).
Seat 5: LloydXmas (100).
Player rook_ has small blind (0.50)
Player LloydXmas has big blind (1)
Player IlxxxlI received card: [Ad]
Player IlxxxlI received card: [As]
Player MadLifeGrinder folds
Player IlxxxlI raises (2.40)
Player lordboroda folds
Player rook_ raises (8.50)
Player LloydXmas folds
Player IlxxxlI calls (6.60)
*** FLOP ***: [4s 8c Jc]
Player rook_ bets (9.02)
Player IlxxxlI calls (9.02)
*** TURN ***: [4s 8c Jc] [7c]
Player rook_ checks
Player IlxxxlI allin (23.98)
Player rook_ folds
Uncalled bet (23.98) returned to IlxxxlI
Player IlxxxlI mucks cards
------ Summary ------
Pot: 35.19. Rake 1.61. JP fee 0.24
Board: [4s 8c Jc 7c]
Player MadLifeGrinder does not show cards.Bets: 0. Collects: 0. Wins: 0.
*Player IlxxxlI mucks (does not show cards). Bets: 18.02. Collects: 35.19. Wins: 17.17.
Player lordboroda does not show cards.Bets: 0. Collects: 0. Wins: 0.
Player rook_ does not show cards.Bets: 18.02. Collects: 0. Loses: 18.02.
Player LloydXmas does not show cards.Bets: 1. Collects: 0. Loses: 1.
Game ended at: 2016/11/29 12:48:43

Game started
Game ID: 786956715 0.25/0.50 (PRR) Gorgons - 2 (Hold'em)
Seat 1 is the button
Seat 1: BHawk12 (62.17).
Seat 2: IlxxxlI (20).
Seat 3: flyshark01 (88.29).
Seat 4: Jui Kuen (50).
Seat 5: constant revelation (23.89).
Seat 6: foreseen (53.09).
Player IlxxxlI has small blind (0.25)
Player flyshark01 has big blind (0.50)
Player IlxxxlI received card: [8s]
Player IlxxxlI received card: [4c]
Player Jui Kuen folds
Player constant revelation calls (0.50)
Player foreseen folds
Player BHawk12 folds
Player IlxxxlI folds
Player flyshark01 checks
*** FLOP ***: [5s Jd Ad]
Player flyshark01 checks
Player constant revelation bets (0.59)
Player flyshark01 folds
Uncalled bet (0.59) returned to constant revelation
Player constant revelation mucks cards
------ Summary ------
Pot: 1.19. Rake 0.04. JP fee 0.02
Board: [5s Jd Ad]
Player BHawk12 does not show cards.Bets: 0. Collects: 0. Wins: 0.
Player IlxxxlI does not show cards.Bets: 0.25. Collects: 0. Loses: 0.25.
Player flyshark01 does not show cards.Bets: 0.50. Collects: 0. Loses: 0.50.
Player Jui Kuen does not show cards.Bets: 0. Collects: 0. Wins: 0.
*Player constant revelation mucks (does not show cards). Bets: 0.50. Collects: 1.19. Wins: 0.69.
Player foreseen does not show cards.Bets: 0. Collects: 0. Wins: 0.
Game ended at: 2016/11/29 12:48:34

Game started
Game ID: 786956719 0.50/1 (PRR) Kraken - 7 (Hold'em)
Seat 1 is the button
Seat 1: gust (48.43).
Seat 2: WeakAndWeary (103.22).
Seat 4: IlxxxlI (40).
Seat 5: St3p04ka (41.50).
Seat 6: MadLifeGrinder (101.50).
Player WeakAndWeary has small blind (0.50)
Player IlxxxlI has big blind (1)
Player IlxxxlI received card: [Qd]
Player IlxxxlI received card: [Ad]
Player St3p04ka folds
Player MadLifeGrinder folds
Player gust raises (2)
Player WeakAndWeary folds
Player IlxxxlI raises (4.16)
Player gust folds
Uncalled bet (3.16) returned to IlxxxlI
Player IlxxxlI mucks cards
------ Summary ------
Pot: 4.50. Rake 0
Player gust does not show cards.Bets: 2. Collects: 0. Loses: 2.
Player WeakAndWeary does not show cards.Bets: 0.50. Collects: 0. Loses: 0.50.
*Player IlxxxlI mucks (does not show cards). Bets: 2. Collects: 4.50. Wins: 2.50.
Player St3p04ka does not show cards.Bets: 0. Collects: 0. Wins: 0.
Player MadLifeGrinder does not show cards.Bets: 0. Collects: 0. Wins: 0.
Game ended at: 2016/11/29 12:48:22

Game started
Game ID: 786956498 0.50/1 (PRR) Kraken - 8 (Hold'em)
Seat 2 is the button
Seat 1: MadLifeGrinder (100).
Seat 2: IlxxxlI (42).
Seat 3: lordboroda (113.10).
Seat 4: rook_ (160.98).
Seat 5: LloydXmas (100).
Player lordboroda has small blind (0.50)
Player rook_ has big blind (1)
Player IlxxxlI received card: [Kd]
Player IlxxxlI received card: [3s]
Player LloydXmas folds
Player MadLifeGrinder folds
Player IlxxxlI folds
Player lordboroda folds
Uncalled bet (0.50) returned to rook_
Player rook_ mucks cards
------ Summary ------
Pot: 1. Rake 0
Player MadLifeGrinder does not show cards.Bets: 0. Collects: 0. Wins: 0.
Player IlxxxlI does not show cards.Bets: 0. Collects: 0. Wins: 0.
Player lordboroda does not show cards.Bets: 0.50. Collects: 0. Loses: 0.50.
*Player rook_ mucks (does not show cards). Bets: 0.50. Collects: 1. Wins: 0.50.
Player LloydXmas does not show cards.Bets: 0. Collects: 0. Wins: 0.
Game ended at: 2016/11/29 12:47:46

Game started
Game ID: 786956463 1/2 (PRR) Lakhey (Hold'em)
Seat 2 is the button
Seat 1: bfish602 (200).
Seat 2: KingGuciGuci (229.91).
Seat 3: IbetUmuck (484.73).
Seat 4: IlxxxlI (80).
Seat 5: MadLifeGrinder (203).
Seat 6: LazyFish (282.57).
Player IbetUmuck has small blind (1)
Player IlxxxlI has big blind (2)
Player IlxxxlI received card: [Qd]
Player IlxxxlI received card: [10s]
Player MadLifeGrinder folds
Player LazyFish folds
Player bfish602 folds
Player KingGuciGuci raises (4.40)
Player IbetUmuck raises (11.50)
Player IlxxxlI folds
Player KingGuciGuci raises (26.50)
Player IbetUmuck calls (18.40)
*** FLOP ***: [9d 5c 9h]
Player IbetUmuck bets (30.40)
Player KingGuciGuci calls (30.40)
*** TURN ***: [9d 5c 9h] [5s]
Player IbetUmuck checks
Player KingGuciGuci bets (40.90)
Player IbetUmuck calls (40.90)
*** RIVER ***: [9d 5c 9h 5s] [Kd]
Player IbetUmuck checks
Player KingGuciGuci allin (127.71)
Player IbetUmuck calls (127.71)
------ Summary ------
Pot: 458.82. Rake 2.76. JP fee 0.24
Board: [9d 5c 9h 5s Kd]
Player bfish602 does not show cards.Bets: 0. Collects: 0. Wins: 0.
Player KingGuciGuci shows: Two pairs. 9s and 5s [6c 10c]. Bets: 229.91. Collects: 0. Loses: 229.91.
*Player IbetUmuck shows: Two pairs. Js and 9s [Jc Js]. Bets: 229.91. Collects: 458.82. Wins: 228.91.
Player IlxxxlI does not show cards.Bets: 2. Collects: 0. Loses: 2.
Player MadLifeGrinder does not show cards.Bets: 0. Collects: 0. Wins: 0.
Player LazyFish does not show cards.Bets: 0. Collects: 0. Wins: 0.
Game ended at: 2016/11/29 12:49:54

Game started
Game ID: 786956410 0.50/1 (PRR) Kraken - 8 (Hold'em)
Seat 1 is the button
Seat 1: MadLifeGrinder (100).
Seat 2: IlxxxlI (42.50).
Seat 3: lordboroda (112.60).
Seat 4: rook_ (160.98).
Seat 5: LloydXmas (100).
Player IlxxxlI has small blind (0.50)
Player lordboroda has big blind (1)
Player IlxxxlI received card: [4s]
Player IlxxxlI received card: [6d]
Player rook_ folds
Player LloydXmas folds
Player MadLifeGrinder folds
Player IlxxxlI folds
Uncalled bet (0.50) returned to lordboroda
Player lordboroda mucks cards
------ Summary ------
Pot: 1. Rake 0
Player MadLifeGrinder does not show cards.Bets: 0. Collects: 0. Wins: 0.
Player IlxxxlI does not show cards.Bets: 0.50. Collects: 0. Loses: 0.50.
*Player lordboroda mucks (does not show cards). Bets: 0.50. Collects: 1. Wins: 0.50.
Player rook_ does not show cards.Bets: 0. Collects: 0. Wins: 0.
Player LloydXmas does not show cards.Bets: 0. Collects: 0. Wins: 0.
Game ended at: 2016/11/29 12:47:22

Game started
Game ID: 786956347 0.25/0.50 (PRR) Garuda - 4 (Hold'em)
Seat 2 is the button
Seat 1: wrongcolorchip (156.33).
Seat 2: IlxxxlI (21.66).
Seat 3: kid4life (51.14).
Seat 4: MortalLock (50).
Seat 5: slick07lx (32.97).
Seat 6: Spagetti1 (23.64).
Seat 8: arito02 (45.23).
Seat 9: constant revelation (17.92).
Player kid4life has small blind (0.25)
Player MortalLock has big blind (0.50)
Player IlxxxlI received card: [3c]
Player IlxxxlI received card: [4d]
Player slick07lx folds
Player Spagetti1 raises (1.50)
Player arito02 calls (1.50)
Player constant revelation calls (1.50)
Player wrongcolorchip folds
Player IlxxxlI folds
Player kid4life folds
Player MortalLock folds
*** FLOP ***: [10d 6c 2c]
Player Spagetti1 checks
Player arito02 bets (2.49)
Player constant revelation folds
Player Spagetti1 raises (9.96)
Player arito02 allin (41.24)
Player Spagetti1 allin (12.18)
Uncalled bet (21.59) returned to arito02
*** TURN ***: [10d 6c 2c] [Ac]
*** RIVER ***: [10d 6c 2c Ac] [As]
------ Summary ------
Pot: 47.06. Rake 2.23. JP fee 0.24
Board: [10d 6c 2c Ac As]
Player wrongcolorchip does not show cards.Bets: 0. Collects: 0. Wins: 0.
Player IlxxxlI does not show cards.Bets: 0. Collects: 0. Wins: 0.
Player kid4life does not show cards.Bets: 0.25. Collects: 0. Loses: 0.25.
Player MortalLock does not show cards.Bets: 0.50. Collects: 0. Loses: 0.50.
Player slick07lx does not show cards.Bets: 0. Collects: 0. Wins: 0.
Player Spagetti1 shows: Two pairs. As and Ks [Kh Kc]. Bets: 23.64. Collects: 0. Loses: 23.64.
*Player arito02 shows: Full House (6/A) [6h 6d]. Bets: 23.64. Collects: 47.06. Wins: 23.42.
Player constant revelation does not show cards.Bets: 1.50. Collects: 0. Loses: 1.50.
Game ended at: 2016/11/29 12:48:24

Game started
Game ID: 786956229 0.25/0.50 (PRR) Gorgons - 2 (Hold'em)
Seat 6 is the button
Seat 1: BHawk12 (62.42).
Seat 2: IlxxxlI (20).
Seat 3: flyshark01 (88.29).
Seat 4: Jui Kuen (50).
Seat 5: constant revelation (23.20).
Seat 6: foreseen (53.09).
Player BHawk12 has small blind (0.25)
Player IlxxxlI has big blind (0.50)
Player IlxxxlI received card: [5d]
Player IlxxxlI received card: [8h]
Player flyshark01 folds
Player Jui Kuen folds
Player constant revelation calls (0.50)
Player foreseen folds
Player BHawk12 folds
Player IlxxxlI checks
*** FLOP ***: [2d 6d Jd]
Player IlxxxlI checks
Player constant revelation bets (0.59)
Player IlxxxlI folds
Uncalled bet (0.59) returned to constant revelation
Player constant revelation mucks cards
------ Summary ------
Pot: 1.19. Rake 0.04. JP fee 0.02
Board: [2d 6d Jd]
Player BHawk12 does not show cards.Bets: 0.25. Collects: 0. Loses: 0.25.
Player IlxxxlI does not show cards.Bets: 0.50. Collects: 0. Loses: 0.50.
Player flyshark01 does not show cards.Bets: 0. Collects: 0. Wins: 0.
Player Jui Kuen does not show cards.Bets: 0. Collects: 0. Wins: 0.
*Player constant revelation mucks (does not show cards). Bets: 0.50. Collects: 1.19. Wins: 0.69.
Player foreseen does not show cards.Bets: 0. Collects: 0. Wins: 0.
Game ended at: 2016/11/29 12:47:41

Game started
Game ID: 786955948 0.50/1 (PRR) Kraken - 8 (Hold'em)
Seat 5 is the button
Seat 1: MadLifeGrinder (100).
Seat 2: IlxxxlI (40).
Seat 3: lordboroda (112.60).
Seat 4: rook_ (160.98).
Seat 5: LloydXmas (100).
Player MadLifeGrinder has small blind (0.50)
Player IlxxxlI has big blind (1)
Player IlxxxlI received card: [10c]
Player IlxxxlI received card: [Ks]
Player lordboroda folds
Player rook_ folds
Player LloydXmas raises (2.25)
Player MadLifeGrinder folds
Player IlxxxlI calls (1.25)
*** FLOP ***: [5c 6s Kh]
Player IlxxxlI checks
Player LloydXmas checks
*** TURN ***: [5c 6s Kh] [7c]
Player IlxxxlI bets (4)
Player LloydXmas folds
Uncalled bet (4) returned to IlxxxlI
Player IlxxxlI mucks cards
------ Summary ------
Pot: 4.75. Rake 0.17. JP fee 0.08
Board: [5c 6s Kh 7c]
Player MadLifeGrinder does not show cards.Bets: 0.50. Collects: 0. Loses: 0.50.
*Player IlxxxlI mucks (does not show cards). Bets: 2.25. Collects: 4.75. Wins: 2.50.
Player lordboroda does not show cards.Bets: 0. Collects: 0. Wins: 0.
Player rook_ does not show cards.Bets: 0. Collects: 0. Wins: 0.
Player LloydXmas does not show cards.Bets: 2.25. Collects: 0. Loses: 2.25.
Game ended at: 2016/11/29 12:47:13

Game started
Game ID: 786955934 0.25/0.50 (PRR) Gorgons - 2 (Hold'em)
Seat 5 is the button
Seat 1: BHawk12 (62.17).
Seat 2: IlxxxlI (20).
Seat 3: flyshark01 (88.29).
Seat 4: Jui Kuen (50).
Seat 5: constant revelation (23.20).
Seat 6: foreseen (53.34).
Player foreseen has small blind (0.25)
Player BHawk12 has big blind (0.50)
Player IlxxxlI received card: [10s]
Player IlxxxlI received card: [9c]
Player IlxxxlI folds
Player flyshark01 folds
Player Jui Kuen folds
Player constant revelation folds
Player foreseen folds
Uncalled bet (0.25) returned to BHawk12
Player BHawk12 mucks cards
------ Summary ------
Pot: 0.50. Rake 0
*Player BHawk12 mucks (does not show cards). Bets: 0.25. Collects: 0.50. Wins: 0.25.
Player IlxxxlI does not show cards.Bets: 0. Collects: 0. Wins: 0.
Player flyshark01 does not show cards.Bets: 0. Collects: 0. Wins: 0.
Player Jui Kuen does not show cards.Bets: 0. Collects: 0. Wins: 0.
Player constant revelation does not show cards.Bets: 0. Collects: 0. Wins: 0.
Player foreseen does not show cards.Bets: 0.25. Collects: 0. Loses: 0.25.
Game ended at: 2016/11/29 12:46:58

Game started
Game ID: 786955596 0.25/0.50 (PRR) Garuda - 4 (Hold'em)
Seat 1 is the button
Seat 1: wrongcolorchip (156.33).
Seat 2: IlxxxlI (21.91).
Seat 3: kid4life (50).
Seat 5: slick07lx (32.97).
Seat 6: Spagetti1 (23.64).
Seat 8: arito02 (46.23).
Seat 9: constant revelation (17.92).
Player IlxxxlI has small blind (0.25)
Player kid4life has big blind (0.50)
Player IlxxxlI received card: [8d]
Player IlxxxlI received card: [4d]
Player slick07lx folds
Player Spagetti1 folds
Player arito02 calls (0.50)
Player constant revelation folds
Player wrongcolorchip folds
Player IlxxxlI folds
Player kid4life checks
*** FLOP ***: [Ks 9c Qh]
Player kid4life checks
Player arito02 checks
*** TURN ***: [Ks 9c Qh] [2s]
Player kid4life checks
Player arito02 checks
*** RIVER ***: [Ks 9c Qh 2s] [Jd]
Player kid4life checks
Player arito02 bets (0.50)
Player kid4life calls (0.50)
------ Summary ------
Pot: 2.14. Rake 0.09. JP fee 0.02
Board: [Ks 9c Qh 2s Jd]
Player wrongcolorchip does not show cards.Bets: 0. Collects: 0. Wins: 0.
Player IlxxxlI does not show cards.Bets: 0.25. Collects: 0. Loses: 0.25.
*Player kid4life shows: One pair of Js [Jc 4s]. Bets: 1. Collects: 2.14. Wins: 1.14.
Player slick07lx does not show cards.Bets: 0. Collects: 0. Wins: 0.
Player Spagetti1 does not show cards.Bets: 0. Collects: 0. Wins: 0.
Player arito02 shows: High card K [4c 3c]. Bets: 1. Collects: 0. Loses: 1.
Player constant revelation does not show cards.Bets: 0. Collects: 0. Wins: 0.
Game ended at: 2016/11/29 12:47:5

Game started
Game ID: 786955505 1/2 (PRR) Lakhey (Hold'em)
Seat 1 is the button
Seat 1: bfish602 (200).
Seat 2: KingGuciGuci (230.91).
Seat 3: IbetUmuck (489.73).
Seat 4: IlxxxlI (80).
Seat 5: MadLifeGrinder (203).
Seat 6: LazyFish (272.37).
Player KingGuciGuci has small blind (1)
Player IbetUmuck has big blind (2)
Player IlxxxlI received card: [5s]
Player IlxxxlI received card: [6d]
Player IlxxxlI folds
Player MadLifeGrinder folds
Player LazyFish raises (5)
Player bfish602 calls (5)
Player KingGuciGuci folds
Player IbetUmuck calls (3)
*** FLOP ***: [4d 8s Ah]
Player IbetUmuck checks
Player LazyFish checks
Player bfish602 checks
*** TURN ***: [4d 8s Ah] [10d]
Player IbetUmuck checks
Player LazyFish bets (10.13)
Player bfish602 folds
Player IbetUmuck folds
Uncalled bet (10.13) returned to LazyFish
Player LazyFish mucks cards
------ Summary ------
Pot: 15.20. Rake 0.56. JP fee 0.24
Board: [4d 8s Ah 10d]
Player bfish602 does not show cards.Bets: 5. Collects: 0. Loses: 5.
Player KingGuciGuci does not show cards.Bets: 1. Collects: 0. Loses: 1.
Player IbetUmuck does not show cards.Bets: 5. Collects: 0. Loses: 5.
Player IlxxxlI does not show cards.Bets: 0. Collects: 0. Wins: 0.
Player MadLifeGrinder does not show cards.Bets: 0. Collects: 0. Wins: 0.
*Player LazyFish mucks (does not show cards). Bets: 5. Collects: 15.20. Wins: 10.20.
Game ended at: 2016/11/29 12:47:20

Game started
Game ID: 786955285 1/2 (PRR) Lakhey (Hold'em)
Seat 6 is the button
Seat 1: bfish602 (201).
Seat 2: KingGuciGuci (232.91).
Seat 3: IbetUmuck (489.73).
Seat 4: IlxxxlI (80).
Seat 5: MadLifeGrinder (200).
Seat 6: LazyFish (272.37).
Player bfish602 has small blind (1)
Player KingGuciGuci has big blind (2)
Player IlxxxlI received card: [3s]
Player IlxxxlI received card: [Kc]
Player IbetUmuck folds
Player IlxxxlI folds
Player MadLifeGrinder raises (5)
Player LazyFish folds
Player bfish602 folds
Player KingGuciGuci folds
Uncalled bet (3) returned to MadLifeGrinder
Player MadLifeGrinder mucks cards
------ Summary ------
Pot: 5. Rake 0
Player bfish602 does not show cards.Bets: 1. Collects: 0. Loses: 1.
Player KingGuciGuci does not show cards.Bets: 2. Collects: 0. Loses: 2.
Player IbetUmuck does not show cards.Bets: 0. Collects: 0. Wins: 0.
Player IlxxxlI does not show cards.Bets: 0. Collects: 0. Wins: 0.
*Player MadLifeGrinder mucks (does not show cards). Bets: 2. Collects: 5. Wins: 3.
Player LazyFish does not show cards.Bets: 0. Collects: 0. Wins: 0.
Game ended at: 2016/11/29 12:45:45

Game started
Game ID: 786955220 0.50/1 (PRR) Kraken - 8 (Hold'em)
Seat 3 is the button
Seat 2: IlxxxlI (42.25).
Seat 3: lordboroda (112.60).
Seat 4: rook_ (156.08).
Seat 5: LloydXmas (100).
Seat 6: Qrenor (113.98).
Player rook_ has small blind (0.50)
Player LloydXmas has big blind (1)
Player IlxxxlI received card: [Ah]
Player IlxxxlI received card: [7s]
Player Qrenor folds
Player IlxxxlI raises (2.40)
Player lordboroda folds
Player rook_ raises (8.50)
Player LloydXmas folds
Player IlxxxlI folds
Uncalled bet (6.60) returned to rook_
Player rook_ mucks cards
------ Summary ------
Pot: 5.80. Rake 0
Player IlxxxlI does not show cards.Bets: 2.40. Collects: 0. Loses: 2.40.
Player lordboroda does not show cards.Bets: 0. Collects: 0. Wins: 0.
*Player rook_ mucks (does not show cards). Bets: 2.40. Collects: 5.80. Wins: 3.40.
Player LloydXmas does not show cards.Bets: 1. Collects: 0. Loses: 1.
Player Qrenor does not show cards.Bets: 0. Collects: 0. Wins: 0.
Game ended at: 2016/11/29 12:45:51

Game started
Game ID: 786955013 0.25/0.50 (PRR) Gorgons - 2 (Hold'em)
Seat 4 is the button
Seat 1: BHawk12 (62.17).
Seat 2: IlxxxlI (20).
Seat 3: flyshark01 (88.29).
Seat 4: Jui Kuen (50).
Seat 5: constant revelation (22.75).
Seat 6: foreseen (53.84).
Player constant revelation has small blind (0.25)
Player foreseen has big blind (0.50)
Player IlxxxlI received card: [4s]
Player IlxxxlI received card: [7c]
Player BHawk12 folds
Player IlxxxlI folds
Player flyshark01 folds
Player Jui Kuen folds
Player constant revelation calls (0.25)
Player foreseen checks
*** FLOP ***: [9d Kd Kh]
Player constant revelation checks
Player foreseen checks
*** TURN ***: [9d Kd Kh] [3d]
Player constant revelation checks
Player foreseen checks
*** RIVER ***: [9d Kd Kh 3d] [4h]
Player constant revelation bets (0.50)
Player foreseen folds
Uncalled bet (0.50) returned to constant revelation
Player constant revelation mucks cards
------ Summary ------
Pot: 0.95. Rake 0.05
Board: [9d Kd Kh 3d 4h]
Player BHawk12 does not show cards.Bets: 0. Collects: 0. Wins: 0.
Player IlxxxlI does not show cards.Bets: 0. Collects: 0. Wins: 0.
Player flyshark01 does not show cards.Bets: 0. Collects: 0. Wins: 0.
Player Jui Kuen does not show cards.Bets: 0. Collects: 0. Wins: 0.
*Player constant revelation mucks (does not show cards). Bets: 0.50. Collects: 0.95. Wins: 0.45.
Player foreseen does not show cards.Bets: 0.50. Collects: 0. Loses: 0.50.
Game ended at: 2016/11/29 12:46:30

Game started
Game ID: 786954889 0.25/0.50 (PRR) Garuda - 4 (Hold'em)
Seat 9 is the button
Seat 1: wrongcolorchip (156.58).
Seat 2: IlxxxlI (20).
Seat 5: slick07lx (32.97).
Seat 6: Spagetti1 (23.64).
Seat 8: arito02 (46.73).
Seat 9: constant revelation (19.25).
Player wrongcolorchip has small blind (0.25)
Player IlxxxlI has big blind (0.50)
Player IlxxxlI received card: [4h]
Player IlxxxlI received card: [Qs]
Player slick07lx folds
Player Spagetti1 folds
Player arito02 calls (0.50)
Player constant revelation calls (0.50)
Player wrongcolorchip folds
Player IlxxxlI checks
*** FLOP ***: [Qh 3s 8h]
Player IlxxxlI checks
Player arito02 checks
Player constant revelation bets (0.83)
Player IlxxxlI calls (0.83)
Player arito02 folds
*** TURN ***: [Qh 3s 8h] [6c]
Player IlxxxlI bets (1.78)
Player constant revelation folds
Uncalled bet (1.78) returned to IlxxxlI
Player IlxxxlI mucks cards
------ Summary ------
Pot: 3.24. Rake 0.13. JP fee 0.04
Board: [Qh 3s 8h 6c]
Player wrongcolorchip does not show cards.Bets: 0.25. Collects: 0. Loses: 0.25.
*Player IlxxxlI mucks (does not show cards). Bets: 1.33. Collects: 3.24. Wins: 1.91.
Player slick07lx does not show cards.Bets: 0. Collects: 0. Wins: 0.
Player Spagetti1 does not show cards.Bets: 0. Collects: 0. Wins: 0.
Player arito02 does not show cards.Bets: 0.50. Collects: 0. Loses: 0.50.
Player constant revelation does not show cards.Bets: 1.33. Collects: 0. Loses: 1.33.
Game ended at: 2016/11/29 12:45:54

Game started
Game ID: 786954860 1/2 (PRR) Lakhey (Hold'em)
Seat 5 is the button
Seat 1: bfish602 (200).
Seat 2: KingGuciGuci (232.91).
Seat 3: IbetUmuck (489.73).
Seat 4: IlxxxlI (80).
Seat 5: MadLifeGrinder (200).
Seat 6: LazyFish (273.37).
Player LazyFish has small blind (1)
Player bfish602 has big blind (2)
Player IlxxxlI received card: [9h]
Player IlxxxlI received card: [Qc]
Player KingGuciGuci folds
Player IbetUmuck folds
Player IlxxxlI folds
Player MadLifeGrinder folds
Player LazyFish folds
Uncalled bet (1) returned to bfish602
Player bfish602 mucks cards
------ Summary ------
Pot: 2. Rake 0
*Player bfish602 mucks (does not show cards). Bets: 1. Collects: 2. Wins: 1.
Player KingGuciGuci does not show cards.Bets: 0. Collects: 0. Wins: 0.
Player IbetUmuck does not show cards.Bets: 0. Collects: 0. Wins: 0.
Player IlxxxlI does not show cards.Bets: 0. Collects: 0. Wins: 0.
Player MadLifeGrinder does not show cards.Bets: 0. Collects: 0. Wins: 0.
Player LazyFish does not show cards.Bets: 1. Collects: 0. Loses: 1.
Game ended at: 2016/11/29 12:45:24

Game started
Game ID: 786954739 0.25/0.50 (PRR) Gorgons - 2 (Hold'em)
Seat 3 is the button
Seat 1: BHawk12 (62.17).
Seat 2: IlxxxlI (20).
Seat 3: flyshark01 (87.54).
Seat 4: Jui Kuen (50).
Seat 5: constant revelation (23.25).
Seat 6: foreseen (53.84).
Player Jui Kuen has small blind (0.25)
Player constant revelation has big blind (0.50)
Player IlxxxlI received card: [10s]
Player IlxxxlI received card: [6c]
Player foreseen folds
Player BHawk12 folds
Player IlxxxlI folds
Player flyshark01 raises (1.50)
Player Jui Kuen folds
Player constant revelation folds
Uncalled bet (1) returned to flyshark01
Player flyshark01 mucks cards
------ Summary ------
Pot: 1.25. Rake 0
Player BHawk12 does not show cards.Bets: 0. Collects: 0. Wins: 0.
Player IlxxxlI does not show cards.Bets: 0. Collects: 0. Wins: 0.
*Player flyshark01 mucks (does not show cards). Bets: 0.50. Collects: 1.25. Wins: 0.75.
Player Jui Kuen does not show cards.Bets: 0.25. Collects: 0. Loses: 0.25.
Player constant revelation does not show cards.Bets: 0.50. Collects: 0. Loses: 0.50.
Player foreseen does not show cards.Bets: 0. Collects: 0. Wins: 0.
Game ended at: 2016/11/29 12:45:0

Game started
Game ID: 786954590 1/2 (PRR) Lakhey (Hold'em)
Seat 4 is the button
Seat 2: KingGuciGuci (217.76).
Seat 3: IbetUmuck (489.73).
Seat 4: IlxxxlI (80).
Seat 5: MadLifeGrinder (200).
Seat 6: LazyFish (275.37).
Player MadLifeGrinder has small blind (1)
Player LazyFish has big blind (2)
Player IlxxxlI received card: [8s]
Player IlxxxlI received card: [10s]
Player KingGuciGuci raises (5)
Player IbetUmuck folds
Player IlxxxlI raises (12.15)
Player MadLifeGrinder folds
Player LazyFish folds
Player KingGuciGuci allin (212.76)
Player IlxxxlI folds
Uncalled bet (205.61) returned to KingGuciGuci
Player KingGuciGuci mucks cards
------ Summary ------
Pot: 27.30. Rake 0
*Player KingGuciGuci mucks (does not show cards). Bets: 12.15. Collects: 27.30. Wins: 15.15.
Player IbetUmuck does not show cards.Bets: 0. Collects: 0. Wins: 0.
Player IlxxxlI does not show cards.Bets: 12.15. Collects: 0. Loses: 12.15.
Player MadLifeGrinder does not show cards.Bets: 1. Collects: 0. Loses: 1.
Player LazyFish does not show cards.Bets: 2. Collects: 0. Loses: 2.
Game ended at: 2016/11/29 12:44:47

Game started
Game ID: 786954226 0.25/0.50 (PRR) Gorgons - 2 (Hold'em)
Seat 2 is the button
Seat 1: BHawk12 (61.42).
Seat 2: IlxxxlI (20).
Seat 3: flyshark01 (87.79).
Seat 4: Jui Kuen (50).
Seat 5: constant revelation (23.25).
Seat 6: foreseen (53.84).
Player flyshark01 has small blind (0.25)
Player Jui Kuen has big blind (0.50)
Player IlxxxlI received card: [8h]
Player IlxxxlI received card: [Jh]
Player constant revelation folds
Player foreseen folds
Player BHawk12 raises (1.50)
Player IlxxxlI folds
Player flyshark01 folds
Player Jui Kuen folds
Uncalled bet (1) returned to BHawk12
Player BHawk12 mucks cards
------ Summary ------
Pot: 1.25. Rake 0
*Player BHawk12 mucks (does not show cards). Bets: 0.50. Collects: 1.25. Wins: 0.75.
Player IlxxxlI does not show cards.Bets: 0. Collects: 0. Wins: 0.
Player flyshark01 does not show cards.Bets: 0.25. Collects: 0. Loses: 0.25.
Player Jui Kuen does not show cards.Bets: 0.50. Collects: 0. Loses: 0.50.
Player constant revelation does not show cards.Bets: 0. Collects: 0. Wins: 0.
Player foreseen does not show cards.Bets: 0. Collects: 0. Wins: 0.
Game ended at: 2016/11/29 12:44:35

Game started
Game ID: 786954097 0.50/1 (PRR) Kraken - 8 (Hold'em)
Seat 2 is the button
Seat 2: IlxxxlI (42.25).
Seat 3: lordboroda (100).
Seat 4: rook_ (170.08).
Seat 5: LloydXmas (100).
Seat 6: Qrenor (113.98).
Player lordboroda has small blind (0.50)
Player rook_ has big blind (1)
Player IlxxxlI received card: [3h]
Player IlxxxlI received card: [9c]
Player LloydXmas folds
Player Qrenor folds
Player IlxxxlI folds
Player lordboroda raises (2.50)
Player rook_ calls (2)
*** FLOP ***: [9s 5h As]
Player lordboroda bets (3)
Player rook_ calls (3)
*** TURN ***: [9s 5h As] [Kd]
Player lordboroda bets (8)
Player rook_ calls (8)
*** RIVER ***: [9s 5h As Kd] [Qd]
Player lordboroda checks
Player rook_ checks
Player rook_ mucks cards
------ Summary ------
Pot: 26.60. Rake 1.16. JP fee 0.24
Board: [9s 5h As Kd Qd]
Player IlxxxlI does not show cards.Bets: 0. Collects: 0. Wins: 0.
*Player lordboroda shows: One pair of As [Ac Js]. Bets: 14. Collects: 26.60. Wins: 12.60.
Player rook_ mucks (does not show cards). Bets: 14. Collects: 0. Loses: 14.
Player LloydXmas does not show cards.Bets: 0. Collects: 0. Wins: 0.
Player Qrenor does not show cards.Bets: 0. Collects: 0. Wins: 0.
Game ended at: 2016/11/29 12:45:16

Game started
Game ID: 786953894 1/2 (PRR) Lakhey (Hold'em)
Seat 3 is the button
Seat 2: KingGuciGuci (217.76).
Seat 3: IbetUmuck (486.73).
Seat 4: IlxxxlI (80).
Seat 5: MadLifeGrinder (200).
Seat 6: LazyFish (275.37).
Player IlxxxlI has small blind (1)
Player MadLifeGrinder has big blind (2)
Player IlxxxlI received card: [8c]
Player IlxxxlI received card: [4h]
Player LazyFish folds
Player KingGuciGuci folds
Player IbetUmuck raises (5.75)
Player IlxxxlI folds
Player MadLifeGrinder folds
Uncalled bet (3.75) returned to IbetUmuck
Player IbetUmuck mucks cards
------ Summary ------
Pot: 5. Rake 0
Player KingGuciGuci does not show cards.Bets: 0. Collects: 0. Wins: 0.
*Player IbetUmuck mucks (does not show cards). Bets: 2. Collects: 5. Wins: 3.
Player IlxxxlI does not show cards.Bets: 1. Collects: 0. Loses: 1.
Player MadLifeGrinder does not show cards.Bets: 2. Collects: 0. Loses: 2.
Player LazyFish does not show cards.Bets: 0. Collects: 0. Wins: 0.
Game ended at: 2016/11/29 12:44:21

Game started
Game ID: 786953626 0.25/0.50 (PRR) Gorgons - 2 (Hold'em)
Seat 1 is the button
Seat 1: BHawk12 (61.42).
Seat 2: IlxxxlI (20).
Seat 3: flyshark01 (87.10).
Seat 4: Jui Kuen (50).
Seat 5: constant revelation (23.75).
Seat 6: foreseen (53.84).
Player IlxxxlI has small blind (0.25)
Player flyshark01 has big blind (0.50)
Player IlxxxlI received card: [Kc]
Player IlxxxlI received card: [9s]
Player Jui Kuen folds
Player constant revelation calls (0.50)
Player foreseen folds
Player BHawk12 folds
Player IlxxxlI folds
Player flyshark01 checks
*** FLOP ***: [10d 3d Ks]
Player flyshark01 checks
Player constant revelation checks
*** TURN ***: [10d 3d Ks] [Qs]
Player flyshark01 bets (0.79)
Player constant revelation folds
Uncalled bet (0.79) returned to flyshark01
Player flyshark01 mucks cards
------ Summary ------
Pot: 1.19. Rake 0.04. JP fee 0.02
Board: [10d 3d Ks Qs]
Player BHawk12 does not show cards.Bets: 0. Collects: 0. Wins: 0.
Player IlxxxlI does not show cards.Bets: 0.25. Collects: 0. Loses: 0.25.
*Player flyshark01 mucks (does not show cards). Bets: 0.50. Collects: 1.19. Wins: 0.69.
Player Jui Kuen does not show cards.Bets: 0. Collects: 0. Wins: 0.
Player constant revelation does not show cards.Bets: 0.50. Collects: 0. Loses: 0.50.
Player foreseen does not show cards.Bets: 0. Collects: 0. Wins: 0.
Game ended at: 2016/11/29 12:43:47

Game started
Game ID: 786953379 1/2 (PRR) Lakhey (Hold'em)
Seat 2 is the button
Seat 2: KingGuciGuci (217.76).
Seat 3: IbetUmuck (487.73).
Seat 4: IlxxxlI (80).
Seat 6: LazyFish (269.92).
Player IbetUmuck has small blind (1)
Player IlxxxlI has big blind (2)
Player IlxxxlI received card: [2c]
Player IlxxxlI received card: [Kc]
Player LazyFish raises (5)
Player KingGuciGuci folds
Player IbetUmuck folds
Player IlxxxlI calls (3)
*** FLOP ***: [4h 10d 3s]
Player IlxxxlI checks
Player LazyFish checks
*** TURN ***: [4h 10d 3s] [5h]
Player IlxxxlI checks
Player LazyFish checks
*** RIVER ***: [4h 10d 3s 5h] [5s]
Player IlxxxlI checks
Player LazyFish checks
Player IlxxxlI mucks cards
------ Summary ------
Pot: 10.45. Rake 0.37. JP fee 0.18
Board: [4h 10d 3s 5h 5s]
Player KingGuciGuci does not show cards.Bets: 0. Collects: 0. Wins: 0.
Player IbetUmuck does not show cards.Bets: 1. Collects: 0. Loses: 1.
Player IlxxxlI mucks (does not show: [2c Kc]). Bets: 5. Collects: 0. Loses: 5.
*Player LazyFish shows: One pair of 5s [Ah Kd]. Bets: 5. Collects: 10.45. Wins: 5.45.
Game ended at: 2016/11/29 12:43:14

Game started
Game ID: 786953299 0.50/1 (PRR) Kraken - 8 (Hold'em)
Seat 6 is the button
Seat 2: IlxxxlI (42.75).
Seat 3: lordboroda (101.50).
Seat 5: LloydXmas (100).
Seat 6: Qrenor (100).
Player IlxxxlI has small blind (0.50)
Player lordboroda has big blind (1)
Player IlxxxlI received card: [5s]
Player IlxxxlI received card: [Jc]
Player LloydXmas folds
Player Qrenor raises (2)
Player IlxxxlI folds
Player lordboroda raises (8)
Player Qrenor calls (7)
*** FLOP ***: [Js Ac 7s]
Player lordboroda bets (6)
Player Qrenor raises (18)
Player lordboroda folds
Uncalled bet (12) returned to Qrenor
Player Qrenor mucks cards
------ Summary ------
Pot: 28.98. Rake 1.28. JP fee 0.24
Board: [Js Ac 7s]
Player IlxxxlI does not show cards.Bets: 0.50. Collects: 0. Loses: 0.50.
Player lordboroda does not show cards.Bets: 15. Collects: 0. Loses: 15.
Player LloydXmas does not show cards.Bets: 0. Collects: 0. Wins: 0.
*Player Qrenor mucks (does not show cards). Bets: 15. Collects: 28.98. Wins: 13.98.
Game ended at: 2016/11/29 12:43:33

Game started
Game ID: 786953279 1/2 (PRR) Lakhey (Hold'em)
Seat 6 is the button
Seat 2: KingGuciGuci (218.76).
Seat 3: IbetUmuck (489.73).
Seat 4: IlxxxlI (80).
Seat 6: LazyFish (266.92).
Player KingGuciGuci has small blind (1)
Player IbetUmuck has big blind (2)
Player IlxxxlI received card: [6d]
Player IlxxxlI received card: [2d]
Player IlxxxlI folds
Player LazyFish raises (5)
Player KingGuciGuci folds
Player IbetUmuck folds
Uncalled bet (3) returned to LazyFish
Player LazyFish mucks cards
------ Summary ------
Pot: 5. Rake 0
Player KingGuciGuci does not show cards.Bets: 1. Collects: 0. Loses: 1.
Player IbetUmuck does not show cards.Bets: 2. Collects: 0. Loses: 2.
Player IlxxxlI does not show cards.Bets: 0. Collects: 0. Wins: 0.
*Player LazyFish mucks (does not show cards). Bets: 2. Collects: 5. Wins: 3.
Game ended at: 2016/11/29 12:42:28

Game started
Game ID: 786953169 0.25/0.50 (PRR) Gorgons - 2 (Hold'em)
Seat 6 is the button
Seat 1: BHawk12 (61.67).
Seat 2: IlxxxlI (20.14).
Seat 3: flyshark01 (86.35).
Seat 4: Jui Kuen (50).
Seat 5: constant revelation (23.75).
Seat 6: foreseen (53.84).
Player BHawk12 has small blind (0.25)
Player IlxxxlI has big blind (0.50)
Player IlxxxlI received card: [4c]
Player IlxxxlI received card: [As]
Player flyshark01 raises (1.50)
Player Jui Kuen folds
Player constant revelation folds
Player foreseen folds
Player BHawk12 folds
Player IlxxxlI folds
Uncalled bet (1) returned to flyshark01
Player flyshark01 mucks cards
------ Summary ------
Pot: 1.25. Rake 0
Player BHawk12 does not show cards.Bets: 0.25. Collects: 0. Loses: 0.25.
Player IlxxxlI does not show cards.Bets: 0.50. Collects: 0. Loses: 0.50.
*Player flyshark01 mucks (does not show cards). Bets: 0.50. Collects: 1.25. Wins: 0.75.
Player Jui Kuen does not show cards.Bets: 0. Collects: 0. Wins: 0.
Player constant revelation does not show cards.Bets: 0. Collects: 0. Wins: 0.
Player foreseen does not show cards.Bets: 0. Collects: 0. Wins: 0.
Game ended at: 2016/11/29 12:42:51

Game started
Game ID: 786952978 1/2 (PRR) Longana (Short) (Hold'em)
Seat 4 is the button
Seat 3: VegetablesArentYummy (101.50).
Seat 4: 89_suited (84).
Seat 5: IlxxxlI (40).
Player IlxxxlI has small blind (1)
Player VegetablesArentYummy has big blind (2)
Player IlxxxlI received card: [6h]
Player IlxxxlI received card: [2c]
Player 89_suited raises (6)
Player IlxxxlI folds
Player VegetablesArentYummy folds
Uncalled bet (4) returned to 89_suited
Player 89_suited mucks cards
------ Summary ------
Pot: 5. Rake 0
Player VegetablesArentYummy does not show cards.Bets: 2. Collects: 0. Loses: 2.
*Player 89_suited mucks (does not show cards). Bets: 2. Collects: 5. Wins: 3.
Player IlxxxlI does not show cards.Bets: 1. Collects: 0. Loses: 1.
Game ended at: 2016/11/29 12:42:5

Game started
Game ID: 786952988 0.50/1 (PRR) Kraken - 8 (Hold'em)
Seat 5 is the button
Seat 2: IlxxxlI (40).
Seat 3: lordboroda (101.50).
Seat 5: LloydXmas (101.50).
Seat 6: Qrenor (100.50).
Player Qrenor has small blind (0.50)
Player IlxxxlI has big blind (1)
Player IlxxxlI received card: [9s]
Player IlxxxlI received card: [9d]
Player lordboroda folds
Player LloydXmas raises (2.25)
Player Qrenor folds
Player IlxxxlI raises (4.77)
Player LloydXmas folds
Uncalled bet (3.52) returned to IlxxxlI
Player IlxxxlI mucks cards
------ Summary ------
Pot: 5. Rake 0
*Player IlxxxlI mucks (does not show cards). Bets: 2.25. Collects: 5. Wins: 2.75.
Player lordboroda does not show cards.Bets: 0. Collects: 0. Wins: 0.
Player LloydXmas does not show cards.Bets: 2.25. Collects: 0. Loses: 2.25.
Player Qrenor does not show cards.Bets: 0.50. Collects: 0. Loses: 0.50.
Game ended at: 2016/11/29 12:42:20

Game started
Game ID: 786952827 1/2 (PRR) Lakhey (Hold'em)
Seat 4 is the button
Seat 2: KingGuciGuci (203.50).
Seat 3: IbetUmuck (489.73).
Seat 4: IlxxxlI (80).
Seat 6: LazyFish (267.92).
Player LazyFish has small blind (1)
Player KingGuciGuci has big blind (2)
Player IlxxxlI received card: [10s]
Player IlxxxlI received card: [10d]
Player IbetUmuck folds
Player IlxxxlI raises (6)
Player LazyFish folds
Player KingGuciGuci raises (8)
Player IlxxxlI calls (4)
*** FLOP ***: [Ah 4d Jh]
Player KingGuciGuci bets (5.90)
Player IlxxxlI calls (5.90)
*** TURN ***: [Ah 4d Jh] [Kd]
Player KingGuciGuci bets (21.90)
Player IlxxxlI folds
Uncalled bet (21.90) returned to KingGuciGuci
Player KingGuciGuci mucks cards
------ Summary ------
Pot: 31.16. Rake 1.40. JP fee 0.24
Board: [Ah 4d Jh Kd]
*Player KingGuciGuci mucks (does not show cards). Bets: 15.90. Collects: 31.16. Wins: 15.26.
Player IbetUmuck does not show cards.Bets: 0. Collects: 0. Wins: 0.
Player IlxxxlI does not show cards.Bets: 15.90. Collects: 0. Loses: 15.90.
Player LazyFish does not show cards.Bets: 1. Collects: 0. Loses: 1.
Game ended at: 2016/11/29 12:42:19

Game started
Game ID: 786952777 0.50/1 (PRR) Kraken - 8 (Hold'em)
Seat 3 is the button
Seat 2: IlxxxlI (40).
Seat 3: lordboroda (100).
Seat 5: LloydXmas (102).
Seat 6: Qrenor (101.50).
Player LloydXmas has small blind (0.50)
Player Qrenor has big blind (1)
Player IlxxxlI received card: [Kh]
Player IlxxxlI received card: [9d]
Player IlxxxlI folds
Player lordboroda raises (2.50)
Player LloydXmas folds
Player Qrenor folds
Uncalled bet (1.50) returned to lordboroda
Player lordboroda mucks cards
------ Summary ------
Pot: 2.50. Rake 0
Player IlxxxlI does not show cards.Bets: 0. Collects: 0. Wins: 0.
*Player lordboroda mucks (does not show cards). Bets: 1. Collects: 2.50. Wins: 1.50.
Player LloydXmas does not show cards.Bets: 0.50. Collects: 0. Loses: 0.50.
Player Qrenor does not show cards.Bets: 1. Collects: 0. Loses: 1.
Game ended at: 2016/11/29 12:41:52

Game started
Game ID: 786952731 1/2 (PRR) Longana (Short) (Hold'em)
Seat 3 is the button
Seat 3: VegetablesArentYummy (105.50).
Seat 4: 89_suited (78).
Seat 5: IlxxxlI (40).
Player 89_suited has small blind (1)
Player IlxxxlI has big blind (2)
Player IlxxxlI received card: [10c]
Player IlxxxlI received card: [Kd]
Player VegetablesArentYummy raises (4)
Player 89_suited raises (13)
Player IlxxxlI folds
Player VegetablesArentYummy folds
Uncalled bet (10) returned to 89_suited
Player 89_suited mucks cards
------ Summary ------
Pot: 10. Rake 0
Player VegetablesArentYummy does not show cards.Bets: 4. Collects: 0. Loses: 4.
*Player 89_suited mucks (does not show cards). Bets: 4. Collects: 10. Wins: 6.
Player IlxxxlI does not show cards.Bets: 2. Collects: 0. Loses: 2.
Game ended at: 2016/11/29 12:41:51

Game started
Game ID: 786952650 0.50/1 (PRR) Kraken - 8 (Hold'em)
Seat 2 is the button
Seat 2: IlxxxlI (40).
Seat 3: lordboroda (100).
Seat 4: rook_ (170.08).
Seat 5: LloydXmas (103).
Seat 6: Qrenor (100).
Player lordboroda has small blind (0.50)
Player rook_ sitting out
Player LloydXmas has big blind (1)
Player IlxxxlI received card: [3h]
Player IlxxxlI received card: [Ac]
Player Qrenor raises (2.50)
Player IlxxxlI folds
Player lordboroda folds
Player LloydXmas folds
Uncalled bet (1.50) returned to Qrenor
Player Qrenor mucks cards
------ Summary ------
Pot: 2.50. Rake 0
Player IlxxxlI does not show cards.Bets: 0. Collects: 0. Wins: 0.
Player lordboroda does not show cards.Bets: 0.50. Collects: 0. Loses: 0.50.
Player rook_ does not show cards.Bets: 0. Collects: 0. Wins: 0.
Player LloydXmas does not show cards.Bets: 1. Collects: 0. Loses: 1.
*Player Qrenor mucks (does not show cards). Bets: 1. Collects: 2.50. Wins: 1.50.
Game ended at: 2016/11/29 12:41:33

Game started
Game ID: 786952519 1/2 (PRR) Lakhey (Hold'em)
Seat 3 is the button
Seat 2: KingGuciGuci (203.50).
Seat 3: IbetUmuck (495.48).
Seat 4: IlxxxlI (80).
Seat 6: LazyFish (261.17).
Player IlxxxlI has small blind (1)
Player LazyFish has big blind (2)
Player IlxxxlI received card: [5c]
Player IlxxxlI received card: [2c]
Player KingGuciGuci folds
Player IbetUmuck raises (5.75)
Player IlxxxlI folds
Player LazyFish raises (17)
Player IbetUmuck folds
Uncalled bet (13.25) returned to LazyFish
Player LazyFish mucks cards
------ Summary ------
Pot: 12.50. Rake 0
Player KingGuciGuci does not show cards.Bets: 0. Collects: 0. Wins: 0.
Player IbetUmuck does not show cards.Bets: 5.75. Collects: 0. Loses: 5.75.
Player IlxxxlI does not show cards.Bets: 1. Collects: 0. Loses: 1.
*Player LazyFish mucks (does not show cards). Bets: 5.75. Collects: 12.50. Wins: 6.75.
Game ended at: 2016/11/29 12:41:39

Game started
Game ID: 786952462 1/2 (PRR) Longana (Short) (Hold'em)
Seat 5 is the button
Seat 3: VegetablesArentYummy (101).
Seat 4: 89_suited (83).
Seat 5: IlxxxlI (40).
Player VegetablesArentYummy has small blind (1)
Player 89_suited has big blind (2)
Player IlxxxlI received card: [3c]
Player IlxxxlI received card: [Jd]
Player IlxxxlI folds
Player VegetablesArentYummy raises (4)
Player 89_suited calls (3)
*** FLOP ***: [Js 4d 9c]
Player VegetablesArentYummy bets (3.75)
Player 89_suited folds
Uncalled bet (3.75) returned to VegetablesArentYummy
Player VegetablesArentYummy mucks cards
------ Summary ------
Pot: 9.50. Rake 0.42. JP fee 0.08
Board: [Js 4d 9c]
*Player VegetablesArentYummy mucks (does not show cards). Bets: 5. Collects: 9.50. Wins: 4.50.
Player 89_suited does not show cards.Bets: 5. Collects: 0. Loses: 5.
Player IlxxxlI does not show cards.Bets: 0. Collects: 0. Wins: 0.
Game ended at: 2016/11/29 12:41:30

Game started
Game ID: 786952353 1/2 (PRR) Longana (Short) (Hold'em)
Seat 4 is the button
Seat 1: Gronkowski69 (129.50).
Seat 3: VegetablesArentYummy (100).
Seat 4: 89_suited (83).
Seat 5: IlxxxlI (41).
Seat 9: SuperMarioFold (100).
Player IlxxxlI has small blind (1)
Player SuperMarioFold sitting out
Player Gronkowski69 sitting out
Player VegetablesArentYummy has big blind (2)
Player IlxxxlI received card: [5c]
Player IlxxxlI received card: [Js]
Player 89_suited folds
Player IlxxxlI folds
Uncalled bet (1) returned to VegetablesArentYummy
Player VegetablesArentYummy mucks cards
------ Summary ------
Pot: 2. Rake 0
Player Gronkowski69 does not show cards.Bets: 0. Collects: 0. Wins: 0.
*Player VegetablesArentYummy mucks (does not show cards). Bets: 1. Collects: 2. Wins: 1.
Player 89_suited does not show cards.Bets: 0. Collects: 0. Wins: 0.
Player IlxxxlI does not show cards.Bets: 1. Collects: 0. Loses: 1.
Player SuperMarioFold does not show cards.Bets: 0. Collects: 0. Wins: 0.
Game ended at: 2016/11/29 12:41:4

Game started
Game ID: 786952354 1/2 (PRR) Lakhey (Hold'em)
Seat 2 is the button
Seat 2: KingGuciGuci (203.50).
Seat 3: IbetUmuck (496.48).
Seat 4: IlxxxlI (80).
Seat 6: LazyFish (258.17).
Player IbetUmuck has small blind (1)
Player IlxxxlI has big blind (2)
Player IlxxxlI received card: [9s]
Player IlxxxlI received card: [6h]
Player LazyFish raises (5)
Player KingGuciGuci folds
Player IbetUmuck folds
Player IlxxxlI folds
Uncalled bet (3) returned to LazyFish
Player LazyFish mucks cards
------ Summary ------
Pot: 5. Rake 0
Player KingGuciGuci does not show cards.Bets: 0. Collects: 0. Wins: 0.
Player IbetUmuck does not show cards.Bets: 1. Collects: 0. Loses: 1.
Player IlxxxlI does not show cards.Bets: 2. Collects: 0. Loses: 2.
*Player LazyFish mucks (does not show cards). Bets: 2. Collects: 5. Wins: 3.
Game ended at: 2016/11/29 12:41:10

Game started
Game ID: 786952362 0.50/1 (PRR) Kraken - 8 (Hold'em)
Seat 6 is the button
Seat 2: IlxxxlI (40).
Seat 3: lordboroda (100).
Seat 4: rook_ (170.08).
Seat 5: LloydXmas (101.50).
Seat 6: Qrenor (100).
Player IlxxxlI has small blind (0.50)
Player lordboroda has big blind (1)
Player IlxxxlI received card: [10s]
Player IlxxxlI received card: [7h]
Player rook_ folds
Player LloydXmas raises (2.88)
Player Qrenor folds
Player IlxxxlI folds
Player lordboroda folds
Uncalled bet (1.88) returned to LloydXmas
Player LloydXmas mucks cards
------ Summary ------
Pot: 2.50. Rake 0
Player IlxxxlI does not show cards.Bets: 0.50. Collects: 0. Loses: 0.50.
Player lordboroda does not show cards.Bets: 1. Collects: 0. Loses: 1.
Player rook_ does not show cards.Bets: 0. Collects: 0. Wins: 0.
*Player LloydXmas mucks (does not show cards). Bets: 1. Collects: 2.50. Wins: 1.50.
Player Qrenor does not show cards.Bets: 0. Collects: 0. Wins: 0.
Game ended at: 2016/11/29 12:41:21

Game started
Game ID: 786952184 1/2 (PRR) Longana (Short) (Hold'em)
Seat 3 is the button
Seat 1: Gronkowski69 (129.50).
Seat 3: VegetablesArentYummy (100).
Seat 4: 89_suited (84).
Seat 5: IlxxxlI (40).
Seat 9: SuperMarioFold (100).
Player 89_suited has small blind (1)
Player IlxxxlI has big blind (2)
Player IlxxxlI received card: [7d]
Player IlxxxlI received card: [Kd]
Player SuperMarioFold folds
Player Gronkowski69 folds
Player VegetablesArentYummy folds
Player 89_suited folds
Uncalled bet (1) returned to IlxxxlI
Player IlxxxlI mucks cards
------ Summary ------
Pot: 2. Rake 0
Player Gronkowski69 does not show cards.Bets: 0. Collects: 0. Wins: 0.
Player VegetablesArentYummy does not show cards.Bets: 0. Collects: 0. Wins: 0.
Player 89_suited does not show cards.Bets: 1. Collects: 0. Loses: 1.
*Player IlxxxlI mucks (does not show cards). Bets: 1. Collects: 2. Wins: 1.
Player SuperMarioFold does not show cards.Bets: 0. Collects: 0. Wins: 0.
Game ended at: 2016/11/29 12:40:55

Game started
Game ID: 786952121 0.50/1 (PRR) Kraken - 8 (Hold'em)
Seat 5 is the button
Seat 2: IlxxxlI (40).
Seat 4: rook_ (170.08).
Seat 5: LloydXmas (100).
Seat 6: Qrenor (100.50).
Player Qrenor has small blind (0.50)
Player IlxxxlI has big blind (1)
Player IlxxxlI received card: [2d]
Player IlxxxlI received card: [6h]
Player rook_ folds
Player LloydXmas raises (2.25)
Player Qrenor folds
Player IlxxxlI folds
Uncalled bet (1.25) returned to LloydXmas
Player LloydXmas mucks cards
------ Summary ------
Pot: 2.50. Rake 0
Player IlxxxlI does not show cards.Bets: 1. Collects: 0. Loses: 1.
Player rook_ does not show cards.Bets: 0. Collects: 0. Wins: 0.
*Player LloydXmas mucks (does not show cards). Bets: 1. Collects: 2.50. Wins: 1.50.
Player Qrenor does not show cards.Bets: 0.50. Collects: 0. Loses: 0.50.
Game ended at: 2016/11/29 12:40:54

Game started
Game ID: 786951737 0.25/0.50 (PRR) Gorgons - 2 (Hold'em)
Seat 5 is the button
Seat 1: BHawk12 (54.62).
Seat 2: IlxxxlI (20.14).
Seat 3: flyshark01 (86.35).
Seat 4: Jui Kuen (51.50).
Seat 5: constant revelation (23.75).
Seat 6: foreseen (54.09).
Player foreseen has small blind (0.25)
Player BHawk12 has big blind (0.50)
Player IlxxxlI received card: [9d]
Player IlxxxlI received card: [Kh]
Player IlxxxlI folds
Player flyshark01 folds
Player Jui Kuen raises (1.50)
Player constant revelation folds
Player foreseen folds
Player BHawk12 calls (1)
*** FLOP ***: [6s Jh 6h]
Player BHawk12 checks
Player Jui Kuen bets (2.06)
Player BHawk12 calls (2.06)
*** TURN ***: [6s Jh 6h] [Kc]
Player BHawk12 checks
Player Jui Kuen bets (4)
Player BHawk12 raises (11.50)
Player Jui Kuen folds
Uncalled bet (7.50) returned to BHawk12
Player BHawk12 mucks cards
------ Summary ------
Pot: 14.61. Rake 0.52. JP fee 0.24
Board: [6s Jh 6h Kc]
*Player BHawk12 mucks (does not show cards). Bets: 7.56. Collects: 14.61. Wins: 7.05.
Player IlxxxlI does not show cards.Bets: 0. Collects: 0. Wins: 0.
Player flyshark01 does not show cards.Bets: 0. Collects: 0. Wins: 0.
Player Jui Kuen does not show cards.Bets: 7.56. Collects: 0. Loses: 7.56.
Player constant revelation does not show cards.Bets: 0. Collects: 0. Wins: 0.
Player foreseen does not show cards.Bets: 0.25. Collects: 0. Loses: 0.25.
Game ended at: 2016/11/29 12:42:9

Game started
Game ID: 786951012 0.25/0.50 (PRR) Gorgons - 2 (Hold'em)
Seat 4 is the button
Seat 1: BHawk12 (51.84).
Seat 2: IlxxxlI (20.14).
Seat 3: flyshark01 (86.35).
Seat 4: Jui Kuen (51.50).
Seat 5: constant revelation (25.25).
Seat 6: foreseen (55.59).
Player constant revelation has small blind (0.25)
Player foreseen has big blind (0.50)
Player IlxxxlI received card: [2c]
Player IlxxxlI received card: [3s]
Player BHawk12 raises (1.50)
Player IlxxxlI folds
Player flyshark01 folds
Player Jui Kuen folds
Player constant revelation calls (1.25)
Player foreseen calls (1)
*** FLOP ***: [Qs 4d Jh]
Player constant revelation checks
Player foreseen checks
Player BHawk12 checks
*** TURN ***: [Qs 4d Jh] [5d]
Player constant revelation checks
Player foreseen checks
Player BHawk12 bets (2.85)
Player constant revelation folds
Player foreseen folds
Uncalled bet (2.85) returned to BHawk12
Player BHawk12 mucks cards
------ Summary ------
Pot: 4.28. Rake 0.16. JP fee 0.06
Board: [Qs 4d Jh 5d]
*Player BHawk12 mucks (does not show cards). Bets: 1.50. Collects: 4.28. Wins: 2.78.
Player IlxxxlI does not show cards.Bets: 0. Collects: 0. Wins: 0.
Player flyshark01 does not show cards.Bets: 0. Collects: 0. Wins: 0.
Player Jui Kuen does not show cards.Bets: 0. Collects: 0. Wins: 0.
Player constant revelation does not show cards.Bets: 1.50. Collects: 0. Loses: 1.50.
Player foreseen does not show cards.Bets: 1.50. Collects: 0. Loses: 1.50.
Game ended at: 2016/11/29 12:40:0

Game started
Game ID: 786950461 0.25/0.50 (PRR) Gorgons - 2 (Hold'em)
Seat 3 is the button
Seat 1: BHawk12 (51.84).
Seat 2: IlxxxlI (20.14).
Seat 3: flyshark01 (86.35).
Seat 4: Jui Kuen (51.75).
Seat 5: constant revelation (25).
Seat 6: foreseen (55.59).
Player Jui Kuen has small blind (0.25)
Player constant revelation has big blind (0.50)
Player IlxxxlI received card: [As]
Player IlxxxlI received card: [8d]
Player foreseen folds
Player BHawk12 folds
Player IlxxxlI folds
Player flyshark01 folds
Player Jui Kuen folds
Uncalled bet (0.25) returned to constant revelation
Player constant revelation mucks cards
------ Summary ------
Pot: 0.50. Rake 0
Player BHawk12 does not show cards.Bets: 0. Collects: 0. Wins: 0.
Player IlxxxlI does not show cards.Bets: 0. Collects: 0. Wins: 0.
Player flyshark01 does not show cards.Bets: 0. Collects: 0. Wins: 0.
Player Jui Kuen does not show cards.Bets: 0.25. Collects: 0. Loses: 0.25.
*Player constant revelation mucks (does not show cards). Bets: 0.25. Collects: 0.50. Wins: 0.25.
Player foreseen does not show cards.Bets: 0. Collects: 0. Wins: 0.
Game ended at: 2016/11/29 12:38:55

Game started
Game ID: 786949888 0.25/0.50 (PRR) Gorgons - 2 (Hold'em)
Seat 2 is the button
Seat 1: BHawk12 (51.84).
Seat 2: IlxxxlI (20.14).
Seat 3: flyshark01 (85.85).
Seat 4: Jui Kuen (52.25).
Seat 6: foreseen (55.59).
Player flyshark01 has small blind (0.25)
Player Jui Kuen has big blind (0.50)
Player IlxxxlI received card: [4h]
Player IlxxxlI received card: [7d]
Player foreseen folds
Player BHawk12 folds
Player IlxxxlI folds
Player flyshark01 raises (1.25)
Player Jui Kuen is timed out.
Player Jui Kuen folds
Uncalled bet (1) returned to flyshark01
Player flyshark01 mucks cards
------ Summary ------
Pot: 1. Rake 0
Player BHawk12 does not show cards.Bets: 0. Collects: 0. Wins: 0.
Player IlxxxlI does not show cards.Bets: 0. Collects: 0. Wins: 0.
*Player flyshark01 mucks (does not show cards). Bets: 0.50. Collects: 1. Wins: 0.50.
Player Jui Kuen does not show cards.Bets: 0.50. Collects: 0. Loses: 0.50.
Player foreseen does not show cards.Bets: 0. Collects: 0. Wins: 0.
Game ended at: 2016/11/29 12:38:6

Game started
Game ID: 786949195 0.25/0.50 (PRR) Gorgons - 2 (Hold'em)
Seat 1 is the button
Seat 1: BHawk12 (50).
Seat 2: IlxxxlI (20.39).
Seat 3: flyshark01 (86.35).
Seat 4: Jui Kuen (52.25).
Seat 6: foreseen (56.84).
Player IlxxxlI has small blind (0.25)
Player flyshark01 has big blind (0.50)
Player IlxxxlI received card: [7c]
Player IlxxxlI received card: [As]
Player Jui Kuen folds
Player foreseen raises (1.25)
Player BHawk12 calls (1.25)
Player IlxxxlI folds
Player flyshark01 folds
*** FLOP ***: [10h 5d 9s]
Player foreseen checks
Player BHawk12 checks
*** TURN ***: [10h 5d 9s] [6c]
Player foreseen checks
Player BHawk12 bets (2.06)
Player foreseen folds
Uncalled bet (2.06) returned to BHawk12
Player BHawk12 mucks cards
------ Summary ------
Pot: 3.09. Rake 0.12. JP fee 0.04
Board: [10h 5d 9s 6c]
*Player BHawk12 mucks (does not show cards). Bets: 1.25. Collects: 3.09. Wins: 1.84.
Player IlxxxlI does not show cards.Bets: 0.25. Collects: 0. Loses: 0.25.
Player flyshark01 does not show cards.Bets: 0.50. Collects: 0. Loses: 0.50.
Player Jui Kuen does not show cards.Bets: 0. Collects: 0. Wins: 0.
Player foreseen does not show cards.Bets: 1.25. Collects: 0. Loses: 1.25.
Game ended at: 2016/11/29 12:37:17

Game started
Game ID: 786948878 0.25/0.50 (PRR) Gorgons - 2 (Hold'em)
Seat 6 is the button
Seat 1: BHawk12 (50.25).
Seat 2: IlxxxlI (20.89).
Seat 3: flyshark01 (86.35).
Seat 4: Jui Kuen (51.50).
Seat 6: foreseen (56.84).
Player BHawk12 has small blind (0.25)
Player IlxxxlI has big blind (0.50)
Player IlxxxlI received card: [7d]
Player IlxxxlI received card: [Jh]
Player flyshark01 folds
Player Jui Kuen raises (1.50)
Player foreseen folds
Player BHawk12 folds
Player IlxxxlI folds
Uncalled bet (1) returned to Jui Kuen
Player Jui Kuen mucks cards
------ Summary ------
Pot: 1.25. Rake 0
Player BHawk12 does not show cards.Bets: 0.25. Collects: 0. Loses: 0.25.
Player IlxxxlI does not show cards.Bets: 0.50. Collects: 0. Loses: 0.50.
Player flyshark01 does not show cards.Bets: 0. Collects: 0. Wins: 0.
*Player Jui Kuen mucks (does not show cards). Bets: 0.50. Collects: 1.25. Wins: 0.75.
Player foreseen does not show cards.Bets: 0. Collects: 0. Wins: 0.
Game ended at: 2016/11/29 12:36:15

Game started
Game ID: 786948394 0.25/0.50 (PRR) Gorgons - 2 (Hold'em)
Seat 4 is the button
Seat 1: BHawk12 (50).
Seat 2: IlxxxlI (20.89).
Seat 3: flyshark01 (86.35).
Seat 4: Jui Kuen (51.50).
Seat 6: foreseen (57.09).
Player foreseen has small blind (0.25)
Player BHawk12 has big blind (0.50)
Player IlxxxlI received card: [Ac]
Player IlxxxlI received card: [6s]
Player IlxxxlI folds
Player flyshark01 folds
Player Jui Kuen folds
Player foreseen folds
Uncalled bet (0.25) returned to BHawk12
Player BHawk12 mucks cards
------ Summary ------
Pot: 0.50. Rake 0
*Player BHawk12 mucks (does not show cards). Bets: 0.25. Collects: 0.50. Wins: 0.25.
Player IlxxxlI does not show cards.Bets: 0. Collects: 0. Wins: 0.
Player flyshark01 does not show cards.Bets: 0. Collects: 0. Wins: 0.
Player Jui Kuen does not show cards.Bets: 0. Collects: 0. Wins: 0.
Player foreseen does not show cards.Bets: 0.25. Collects: 0. Loses: 0.25.
Game ended at: 2016/11/29 12:35:48

Game started
Game ID: 786948136 0.25/0.50 (PRR) Gorgons - 2 (Hold'em)
Seat 3 is the button
Seat 2: IlxxxlI (20.89).
Seat 3: flyshark01 (86.35).
Seat 4: Jui Kuen (51.75).
Seat 6: foreseen (56.84).
Player Jui Kuen has small blind (0.25)
Player foreseen has big blind (0.50)
Player IlxxxlI received card: [3h]
Player IlxxxlI received card: [8d]
Player IlxxxlI folds
Player flyshark01 folds
Player Jui Kuen folds
Uncalled bet (0.25) returned to foreseen
Player foreseen mucks cards
------ Summary ------
Pot: 0.50. Rake 0
Player IlxxxlI does not show cards.Bets: 0. Collects: 0. Wins: 0.
Player flyshark01 does not show cards.Bets: 0. Collects: 0. Wins: 0.
Player Jui Kuen does not show cards.Bets: 0.25. Collects: 0. Loses: 0.25.
*Player foreseen mucks (does not show cards). Bets: 0.25. Collects: 0.50. Wins: 0.25.
Game ended at: 2016/11/29 12:35:6

Game started
Game ID: 786947760 0.25/0.50 (PRR) Gorgons - 2 (Hold'em)
Seat 2 is the button
Seat 2: IlxxxlI (20.89).
Seat 3: flyshark01 (86.60).
Seat 4: Jui Kuen (51.50).
Seat 5: Hakuna_Matata777 (50).
Seat 6: foreseen (56.84).
Player flyshark01 has small blind (0.25)
Player Jui Kuen has big blind (0.50)
Player IlxxxlI received card: [7s]
Player IlxxxlI received card: [Ac]
Player Hakuna_Matata777 folds
Player foreseen folds
Player IlxxxlI folds
Player flyshark01 folds
Uncalled bet (0.25) returned to Jui Kuen
Player Jui Kuen mucks cards
------ Summary ------
Pot: 0.50. Rake 0
Player IlxxxlI does not show cards.Bets: 0. Collects: 0. Wins: 0.
Player flyshark01 does not show cards.Bets: 0.25. Collects: 0. Loses: 0.25.
*Player Jui Kuen mucks (does not show cards). Bets: 0.25. Collects: 0.50. Wins: 0.25.
Player Hakuna_Matata777 does not show cards.Bets: 0. Collects: 0. Wins: 0.
Player foreseen does not show cards.Bets: 0. Collects: 0. Wins: 0.
Game ended at: 2016/11/29 12:34:45

Game started
Game ID: 786947421 0.25/0.50 (PRR) Gorgons - 2 (Hold'em)
Seat 6 is the button
Seat 2: IlxxxlI (21.14).
Seat 3: flyshark01 (87.10).
Seat 4: Jui Kuen (51.50).
Seat 5: Hakuna_Matata777 (50).
Seat 6: foreseen (56.09).
Player IlxxxlI has small blind (0.25)
Player flyshark01 has big blind (0.50)
Player IlxxxlI received card: [7d]
Player IlxxxlI received card: [5c]
Player Jui Kuen folds
Player Hakuna_Matata777 folds
Player foreseen raises (1.75)
Player IlxxxlI folds
Player flyshark01 folds
Uncalled bet (1.25) returned to foreseen
Player foreseen mucks cards
------ Summary ------
Pot: 1.25. Rake 0
Player IlxxxlI does not show cards.Bets: 0.25. Collects: 0. Loses: 0.25.
Player flyshark01 does not show cards.Bets: 0.50. Collects: 0. Loses: 0.50.
Player Jui Kuen does not show cards.Bets: 0. Collects: 0. Wins: 0.
Player Hakuna_Matata777 does not show cards.Bets: 0. Collects: 0. Wins: 0.
*Player foreseen mucks (does not show cards). Bets: 0.50. Collects: 1.25. Wins: 0.75.
Game ended at: 2016/11/29 12:34:14

Game started
Game ID: 786947067 0.50/1 (PRR) Kraken - 15 (Hold'em)
Seat 5 is the button
Seat 2: Rut-Roh (100).
Seat 5: IlxxxlI (42.50).
Player IlxxxlI has small blind (0.50)
Player Rut-Roh has big blind (1)
Player IlxxxlI received card: [8s]
Player IlxxxlI received card: [6s]
Player IlxxxlI calls (0.50)
Player Rut-Roh checks
*** FLOP ***: [3h 3s Qh]
Player Rut-Roh checks
Player IlxxxlI bets (1)
Player Rut-Roh folds
Uncalled bet (1) returned to IlxxxlI
Player IlxxxlI mucks cards
------ Summary ------
Pot: 1.90. Rake 0.08. JP fee 0.02
Board: [3h 3s Qh]
Player Rut-Roh does not show cards.Bets: 1. Collects: 0. Loses: 1.
*Player IlxxxlI mucks (does not show cards). Bets: 1. Collects: 1.90. Wins: 0.90.
Game ended at: 2016/11/29 12:33:40

Game started
Game ID: 786946757 0.50/1 (PRR) Kraken - 15 (Hold'em)
Seat 5 is the button
Seat 1: gust (40).
Seat 5: IlxxxlI (41.50).
Player IlxxxlI has small blind (0.50)
Player gust has big blind (1)
Player IlxxxlI received card: [Ad]
Player IlxxxlI received card: [8d]
Player IlxxxlI raises (2)
Player gust folds
Uncalled bet (1.50) returned to IlxxxlI
Player IlxxxlI mucks cards
------ Summary ------
Pot: 2. Rake 0
Player gust does not show cards.Bets: 1. Collects: 0. Loses: 1.
*Player IlxxxlI mucks (does not show cards). Bets: 1. Collects: 2. Wins: 1.
Game ended at: 2016/11/29 12:33:11

Game started
Game ID: 786946608 0.50/1 (PRR) Kraken - 15 (Hold'em)
Seat 1 is the button
Seat 1: Qrenor (127.48).
Seat 5: IlxxxlI (41).
Player Qrenor has small blind (0.50)
Player IlxxxlI has big blind (1)
Player IlxxxlI received card: [Kh]
Player IlxxxlI received card: [3d]
Player Qrenor is timed out.
Player Qrenor folds
Uncalled bet (0.50) returned to IlxxxlI
Player IlxxxlI mucks cards
------ Summary ------
Pot: 1. Rake 0
Player Qrenor does not show cards.Bets: 0.50. Collects: 0. Loses: 0.50.
*Player IlxxxlI mucks (does not show cards). Bets: 0.50. Collects: 1. Wins: 0.50.
Game ended at: 2016/11/29 12:32:43

Game started
Game ID: 786946422 0.25/0.50 (PRR) Gorgons - 2 (Hold'em)
Seat 5 is the button
Seat 1: Maria_Pia (20.75).
Seat 2: IlxxxlI (20).
Seat 3: flyshark01 (87.10).
Seat 4: Jui Kuen (51.50).
Seat 5: Hakuna_Matata777 (50).
Seat 6: foreseen (56.34).
Player foreseen has small blind (0.25)
Player Maria_Pia sitting out
Player IlxxxlI has big blind (0.50)
Player IlxxxlI received card: [4h]
Player IlxxxlI received card: [4s]
Player flyshark01 folds
Player Jui Kuen folds
Player Hakuna_Matata777 raises (1)
Player foreseen folds
Player IlxxxlI calls (0.50)
*** FLOP ***: [8d 9h 5d]
Player IlxxxlI checks
Player Hakuna_Matata777 checks
*** TURN ***: [8d 9h 5d] [Jh]
Player IlxxxlI checks
Player Hakuna_Matata777 checks
*** RIVER ***: [8d 9h 5d Jh] [2h]
Player IlxxxlI checks
Player Hakuna_Matata777 checks
Player Hakuna_Matata777 mucks cards
------ Summary ------
Pot: 2.14. Rake 0.09. JP fee 0.02
Board: [8d 9h 5d Jh 2h]
Player Maria_Pia does not show cards.Bets: 0. Collects: 0. Wins: 0.
*Player IlxxxlI shows: One pair of 4s [4h 4s]. Bets: 1. Collects: 2.14. Wins: 1.14.
Player flyshark01 does not show cards.Bets: 0. Collects: 0. Wins: 0.
Player Jui Kuen does not show cards.Bets: 0. Collects: 0. Wins: 0.
Player Hakuna_Matata777 mucks (does not show cards). Bets: 1. Collects: 0. Loses: 1.
Player foreseen does not show cards.Bets: 0.25. Collects: 0. Loses: 0.25.
Game ended at: 2016/11/29 12:33:43

Game started
Game ID: 786946160 0.50/1 (PRR) Kraken - 15 (Hold'em)
Seat 5 is the button
Seat 1: Qrenor (126.48).
Seat 5: IlxxxlI (42).
Player IlxxxlI has small blind (0.50)
Player Qrenor has big blind (1)
Player IlxxxlI received card: [Jc]
Player IlxxxlI received card: [6c]
Player IlxxxlI calls (0.50)
Player Qrenor raises (2.50)
Player IlxxxlI folds
Uncalled bet (2.50) returned to Qrenor
Player Qrenor mucks cards
------ Summary ------
Pot: 2. Rake 0
*Player Qrenor mucks (does not show cards). Bets: 1. Collects: 2. Wins: 1.
Player IlxxxlI does not show cards.Bets: 1. Collects: 0. Loses: 1.
Game ended at: 2016/11/29 12:32:34

Game started
Game ID: 786946079 0.25/0.50 (PRR) Gorgons - 2 (Hold'em)
Seat 4 is the button
Seat 1: Maria_Pia (20.75).
Seat 2: IlxxxlI (20).
Seat 3: flyshark01 (87.10).
Seat 4: Jui Kuen (50.75).
Seat 5: Hakuna_Matata777 (50).
Seat 6: foreseen (56.84).
Player Hakuna_Matata777 has small blind (0.25)
Player foreseen has big blind (0.50)
Player IlxxxlI received card: [6s]
Player IlxxxlI received card: [Jh]
Player Maria_Pia folds
Player IlxxxlI folds
Player flyshark01 folds
Player Jui Kuen raises (1)
Player Hakuna_Matata777 folds
Player foreseen folds
Uncalled bet (0.50) returned to Jui Kuen
Player Jui Kuen mucks cards
------ Summary ------
Pot: 1.25. Rake 0
Player Maria_Pia does not show cards.Bets: 0. Collects: 0. Wins: 0.
Player IlxxxlI does not show cards.Bets: 0. Collects: 0. Wins: 0.
Player flyshark01 does not show cards.Bets: 0. Collects: 0. Wins: 0.
*Player Jui Kuen mucks (does not show cards). Bets: 0.50. Collects: 1.25. Wins: 0.75.
Player Hakuna_Matata777 does not show cards.Bets: 0.25. Collects: 0. Loses: 0.25.
Player foreseen does not show cards.Bets: 0.50. Collects: 0. Loses: 0.50.
Game ended at: 2016/11/29 12:32:23

Game started
Game ID: 786945990 0.50/1 (PRR) Kraken - 15 (Hold'em)
Seat 1 is the button
Seat 1: Qrenor (126.98).
Seat 5: IlxxxlI (41.50).
Player Qrenor has small blind (0.50)
Player IlxxxlI has big blind (1)
Player IlxxxlI received card: [Ac]
Player IlxxxlI received card: [2d]
Player Qrenor folds
Uncalled bet (0.50) returned to IlxxxlI
Player IlxxxlI mucks cards
------ Summary ------
Pot: 1. Rake 0
Player Qrenor does not show cards.Bets: 0.50. Collects: 0. Loses: 0.50.
*Player IlxxxlI mucks (does not show cards). Bets: 0.50. Collects: 1. Wins: 0.50.
Game ended at: 2016/11/29 12:32:0

Game started
Game ID: 786945624 0.25/0.50 (PRR) Gorgons - 2 (Hold'em)
Seat 3 is the button
Seat 1: Maria_Pia (20).
Seat 2: IlxxxlI (20).
Seat 3: flyshark01 (87.10).
Seat 4: Jui Kuen (51).
Seat 5: Hakuna_Matata777 (50).
Seat 6: foreseen (56.84).
Player Jui Kuen has small blind (0.25)
Player Hakuna_Matata777 has big blind (0.50)
Player IlxxxlI received card: [7s]
Player IlxxxlI received card: [Jh]
Player foreseen folds
Player Maria_Pia raises (1.10)
Player IlxxxlI folds
Player flyshark01 folds
Player Jui Kuen folds
Player Hakuna_Matata777 folds
Uncalled bet (0.60) returned to Maria_Pia
Player Maria_Pia mucks cards
------ Summary ------
Pot: 1.25. Rake 0
*Player Maria_Pia mucks (does not show cards). Bets: 0.50. Collects: 1.25. Wins: 0.75.
Player IlxxxlI does not show cards.Bets: 0. Collects: 0. Wins: 0.
Player flyshark01 does not show cards.Bets: 0. Collects: 0. Wins: 0.
Player Jui Kuen does not show cards.Bets: 0.25. Collects: 0. Loses: 0.25.
Player Hakuna_Matata777 does not show cards.Bets: 0.50. Collects: 0. Loses: 0.50.
Player foreseen does not show cards.Bets: 0. Collects: 0. Wins: 0.
Game ended at: 2016/11/29 12:31:54

Game started
Game ID: 786945474 0.50/1 (PRR) Kraken - 15 (Hold'em)
Seat 5 is the button
Seat 1: Qrenor (127.98).
Seat 5: IlxxxlI (41.50).
Seat 6: GagaPoker (140.68).
Player GagaPoker has small blind (0.50)
Player Qrenor has big blind (1)
Player IlxxxlI received card: [Jc]
Player IlxxxlI received card: [6h]
Player IlxxxlI folds
Player GagaPoker raises (2.50)
Player Qrenor folds
Uncalled bet (2) returned to GagaPoker
Player GagaPoker mucks cards
------ Summary ------
Pot: 2. Rake 0
Player Qrenor does not show cards.Bets: 1. Collects: 0. Loses: 1.
Player IlxxxlI does not show cards.Bets: 0. Collects: 0. Wins: 0.
*Player GagaPoker mucks (does not show cards). Bets: 1. Collects: 2. Wins: 1.
Game ended at: 2016/11/29 12:31:43

Game started
Game ID: 786945358 0.25/0.50 (PRR) Gorgons - 2 (Hold'em)
Seat 2 is the button
Seat 1: Maria_Pia (20).
Seat 2: IlxxxlI (20).
Seat 3: flyshark01 (87.35).
Seat 4: Jui Kuen (50.75).
Seat 6: foreseen (56.84).
Player flyshark01 has small blind (0.25)
Player Jui Kuen has big blind (0.50)
Player IlxxxlI received card: [8s]
Player IlxxxlI received card: [3d]
Player foreseen folds
Player Maria_Pia folds
Player IlxxxlI folds
Player flyshark01 folds
Uncalled bet (0.25) returned to Jui Kuen
Player Jui Kuen mucks cards
------ Summary ------
Pot: 0.50. Rake 0
Player Maria_Pia does not show cards.Bets: 0. Collects: 0. Wins: 0.
Player IlxxxlI does not show cards.Bets: 0. Collects: 0. Wins: 0.
Player flyshark01 does not show cards.Bets: 0.25. Collects: 0. Loses: 0.25.
*Player Jui Kuen mucks (does not show cards). Bets: 0.25. Collects: 0.50. Wins: 0.25.
Player foreseen does not show cards.Bets: 0. Collects: 0. Wins: 0.
Game ended at: 2016/11/29 12:31:15

Game started
Game ID: 786945084 0.50/1 (PRR) Kraken - 15 (Hold'em)
Seat 1 is the button
Seat 1: Qrenor (127.98).
Seat 5: IlxxxlI (40.50).
Seat 6: GagaPoker (141.68).
Player IlxxxlI has small blind (0.50)
Player GagaPoker has big blind (1)
Player IlxxxlI received card: [Qd]
Player IlxxxlI received card: [Kd]
Player Qrenor folds
Player IlxxxlI raises (2)
Player GagaPoker folds
Uncalled bet (1.50) returned to IlxxxlI
Player IlxxxlI mucks cards
------ Summary ------
Pot: 2. Rake 0
Player Qrenor does not show cards.Bets: 0. Collects: 0. Wins: 0.
*Player IlxxxlI mucks (does not show cards). Bets: 1. Collects: 2. Wins: 1.
Player GagaPoker does not show cards.Bets: 1. Collects: 0. Loses: 1.
Game ended at: 2016/11/29 12:31:3

Game started
Game ID: 786944972 0.25/0.50 (PRR) Gorgons - 2 (Hold'em)
Seat 1 is the button
Seat 1: Maria_Pia (20).
Seat 2: IlxxxlI (20).
Seat 3: flyshark01 (87.85).
Seat 4: Jui Kuen (50.75).
Seat 6: foreseen (56.09).
Player IlxxxlI has small blind (0.25)
Player flyshark01 has big blind (0.50)
Player IlxxxlI received card: [9c]
Player IlxxxlI received card: [7h]
Player Jui Kuen folds
Player foreseen raises (1.25)
Player Maria_Pia folds
Player IlxxxlI folds
Player flyshark01 folds
Uncalled bet (0.75) returned to foreseen
Player foreseen mucks cards
------ Summary ------
Pot: 1.25. Rake 0
Player Maria_Pia does not show cards.Bets: 0. Collects: 0. Wins: 0.
Player IlxxxlI does not show cards.Bets: 0.25. Collects: 0. Loses: 0.25.
Player flyshark01 does not show cards.Bets: 0.50. Collects: 0. Loses: 0.50.
Player Jui Kuen does not show cards.Bets: 0. Collects: 0. Wins: 0.
*Player foreseen mucks (does not show cards). Bets: 0.50. Collects: 1.25. Wins: 0.75.
Game ended at: 2016/11/29 12:30:54

Game started
Game ID: 786944892 0.50/1 (PRR) Kraken - 15 (Hold'em)
Seat 6 is the button
Seat 1: Qrenor (128.48).
Seat 5: IlxxxlI (40).
Seat 6: GagaPoker (141.68).
Player Qrenor has small blind (0.50)
Player IlxxxlI has big blind (1)
Player IlxxxlI received card: [2c]
Player IlxxxlI received card: [Ad]
Player GagaPoker folds
Player Qrenor folds
Uncalled bet (0.50) returned to IlxxxlI
Player IlxxxlI mucks cards
------ Summary ------
Pot: 1. Rake 0
Player Qrenor does not show cards.Bets: 0.50. Collects: 0. Loses: 0.50.
*Player IlxxxlI mucks (does not show cards). Bets: 0.50. Collects: 1. Wins: 0.50.
Player GagaPoker does not show cards.Bets: 0. Collects: 0. Wins: 0.
Game ended at: 2016/11/29 12:30:31

Game started
Game ID: 786943880 0.25/0.50 (PRR) Gorgons - 2 (Hold'em)
Seat 6 is the button
Seat 1: Maria_Pia (20).
Seat 2: IlxxxlI (20).
Seat 3: flyshark01 (86.02).
Seat 4: Jui Kuen (50.75).
Seat 6: foreseen (56.09).
Player Maria_Pia has small blind (0.25)
Player IlxxxlI has big blind (0.50)
Player IlxxxlI received card: [3s]
Player IlxxxlI received card: [5c]
Player flyshark01 raises (1.50)
Player Jui Kuen folds
Player foreseen folds
Player Maria_Pia calls (1.25)
Player IlxxxlI folds
*** FLOP ***: [8c 2s Qh]
Player Maria_Pia checks
Player flyshark01 bets (2.22)
Player Maria_Pia folds
Uncalled bet (2.22) returned to flyshark01
Player flyshark01 mucks cards
------ Summary ------
Pot: 3.33. Rake 0.13. JP fee 0.04
Board: [8c 2s Qh]
Player Maria_Pia does not show cards.Bets: 1.50. Collects: 0. Loses: 1.50.
Player IlxxxlI does not show cards.Bets: 0.50. Collects: 0. Loses: 0.50.
*Player flyshark01 mucks (does not show cards). Bets: 1.50. Collects: 3.33. Wins: 1.83.
Player Jui Kuen does not show cards.Bets: 0. Collects: 0. Wins: 0.
Player foreseen does not show cards.Bets: 0. Collects: 0. Wins: 0.
Game ended at: 2016/11/29 12:30:23

Game started
Game ID: 786942325 0.25/0.50 (PRR) Gorgons - 2 (Hold'em)
Seat 4 is the button
Seat 1: Maria_Pia (20).
Seat 2: IlxxxlI (20).
Seat 3: flyshark01 (86.02).
Seat 4: Jui Kuen (50.75).
Seat 6: foreseen (50.24).
Player foreseen has small blind (0.25)
Player Maria_Pia has big blind (0.50)
Player IlxxxlI received card: [3c]
Player IlxxxlI received card: [5s]
Player IlxxxlI folds
Player flyshark01 folds
Player Jui Kuen folds
Player foreseen calls (0.25)
Player Maria_Pia raises (1)
Player foreseen calls (1)
*** FLOP ***: [9s As Qd]
Player foreseen checks
Player Maria_Pia bets (1.50)
Player foreseen calls (1.50)
*** TURN ***: [9s As Qd] [3s]
Player foreseen checks
Player Maria_Pia checks
*** RIVER ***: [9s As Qd 3s] [Jd]
Player foreseen checks
Player Maria_Pia bets (3.50)
Player foreseen allin (47.24)
Player Maria_Pia folds
Uncalled bet (43.74) returned to foreseen
Player foreseen mucks cards
------ Summary ------
Pot: 12.35. Rake 0.45. JP fee 0.20
Board: [9s As Qd 3s Jd]
Player Maria_Pia does not show cards.Bets: 6.50. Collects: 0. Loses: 6.50.
Player IlxxxlI does not show cards.Bets: 0. Collects: 0. Wins: 0.
Player flyshark01 does not show cards.Bets: 0. Collects: 0. Wins: 0.
Player Jui Kuen does not show cards.Bets: 0. Collects: 0. Wins: 0.
*Player foreseen mucks (does not show cards). Bets: 6.50. Collects: 12.35. Wins: 5.85.
Game ended at: 2016/11/29 12:28:54

Game started
Game ID: 786941898 0.25/0.50 (PRR) Gorgons - 2 (Hold'em)
Seat 3 is the button
Seat 2: IlxxxlI (20).
Seat 3: flyshark01 (85.27).
Seat 4: Jui Kuen (51).
Seat 5: QDevilQ (79.58).
Seat 6: foreseen (50.74).
Player Jui Kuen has small blind (0.25)
Player QDevilQ sitting out
Player foreseen has big blind (0.50)
Player IlxxxlI received card: [7c]
Player IlxxxlI received card: [6c]
Player IlxxxlI folds
Player flyshark01 raises (1.50)
Player Jui Kuen folds
Player foreseen folds
Uncalled bet (1) returned to flyshark01
Player flyshark01 mucks cards
------ Summary ------
Pot: 1.25. Rake 0
Player IlxxxlI does not show cards.Bets: 0. Collects: 0. Wins: 0.
*Player flyshark01 mucks (does not show cards). Bets: 0.50. Collects: 1.25. Wins: 0.75.
Player Jui Kuen does not show cards.Bets: 0.25. Collects: 0. Loses: 0.25.
Player QDevilQ does not show cards.Bets: 0. Collects: 0. Wins: 0.
Player foreseen does not show cards.Bets: 0.50. Collects: 0. Loses: 0.50.
Game ended at: 2016/11/29 12:26:46

Game started
Game ID: 786941513 0.25/0.50 (PRR) Gorgons - 2 (Hold'em)
Seat 2 is the button
Seat 2: IlxxxlI (20).
Seat 3: flyshark01 (85.52).
Seat 4: Jui Kuen (50.75).
Seat 5: QDevilQ (79.58).
Seat 6: foreseen (50.74).
Player flyshark01 has small blind (0.25)
Player Jui Kuen has big blind (0.50)
Player IlxxxlI received card: [5h]
Player IlxxxlI received card: [Kd]
Player QDevilQ folds
Player foreseen folds
Player IlxxxlI folds
Player flyshark01 folds
Uncalled bet (0.25) returned to Jui Kuen
Player Jui Kuen mucks cards
------ Summary ------
Pot: 0.50. Rake 0
Player IlxxxlI does not show cards.Bets: 0. Collects: 0. Wins: 0.
Player flyshark01 does not show cards.Bets: 0.25. Collects: 0. Loses: 0.25.
*Player Jui Kuen mucks (does not show cards). Bets: 0.25. Collects: 0.50. Wins: 0.25.
Player QDevilQ does not show cards.Bets: 0. Collects: 0. Wins: 0.
Player foreseen does not show cards.Bets: 0. Collects: 0. Wins: 0.
Game ended at: 2016/11/29 12:26:12

Game started
Game ID: 786941132 0.25/0.50 (PRR) Gorgons - 2 (Hold'em)
Seat 6 is the button
Seat 2: IlxxxlI (20).
Seat 3: flyshark01 (86.02).
Seat 4: Jui Kuen (50).
Seat 5: QDevilQ (79.58).
Seat 6: foreseen (50.74).
Player IlxxxlI has small blind (0.25)
Player flyshark01 has big blind (0.50)
Player IlxxxlI received card: [10c]
Player IlxxxlI received card: [6c]
Player Jui Kuen raises (1.50)
Player QDevilQ folds
Player foreseen folds
Player IlxxxlI folds
Player flyshark01 folds
Uncalled bet (1) returned to Jui Kuen
Player Jui Kuen mucks cards
------ Summary ------
Pot: 1.25. Rake 0
Player IlxxxlI does not show cards.Bets: 0.25. Collects: 0. Loses: 0.25.
Player flyshark01 does not show cards.Bets: 0.50. Collects: 0. Loses: 0.50.
*Player Jui Kuen mucks (does not show cards). Bets: 0.50. Collects: 1.25. Wins: 0.75.
Player QDevilQ does not show cards.Bets: 0. Collects: 0. Wins: 0.
Player foreseen does not show cards.Bets: 0. Collects: 0. Wins: 0.
Game ended at: 2016/11/29 12:25:42

Game started
Game ID: 786940920 0.25/0.50 (PRR) Gorgons - 7 (Hold'em)
Seat 6 is the button
Seat 1: flyshark01 (48.67).
Seat 2: xROCKETMANx (31.34).
Seat 4: Remi1738 (44.48).
Seat 5: IlxxxlI (38.24).
Seat 6: foreseen (97.74).
Player flyshark01 has small blind (0.25)
Player xROCKETMANx has big blind (0.50)
Player IlxxxlI received card: [10c]
Player IlxxxlI received card: [Jc]
Player Remi1738 folds
Player IlxxxlI raises (1.20)
Player foreseen folds
Player flyshark01 folds
Player xROCKETMANx folds
Uncalled bet (0.70) returned to IlxxxlI
Player IlxxxlI mucks cards
------ Summary ------
Pot: 1.25. Rake 0
Player flyshark01 does not show cards.Bets: 0.25. Collects: 0. Loses: 0.25.
Player xROCKETMANx does not show cards.Bets: 0.50. Collects: 0. Loses: 0.50.
Player Remi1738 does not show cards.Bets: 0. Collects: 0. Wins: 0.
*Player IlxxxlI mucks (does not show cards). Bets: 0.50. Collects: 1.25. Wins: 0.75.
Player foreseen does not show cards.Bets: 0. Collects: 0. Wins: 0.
Game ended at: 2016/11/29 12:25:25

Game started
Game ID: 786940659 0.25/0.50 (PRR) Gorgons - 7 (Hold'em)
Seat 5 is the button
Seat 1: flyshark01 (48.42).
Seat 2: xROCKETMANx (31.34).
Seat 4: Remi1738 (44.48).
Seat 5: IlxxxlI (38.24).
Seat 6: foreseen (97.99).
Player foreseen has small blind (0.25)
Player flyshark01 has big blind (0.50)
Player IlxxxlI received card: [6s]
Player IlxxxlI received card: [2d]
Player xROCKETMANx folds
Player Remi1738 folds
Player IlxxxlI folds
Player foreseen folds
Uncalled bet (0.25) returned to flyshark01
Player flyshark01 mucks cards
------ Summary ------
Pot: 0.50. Rake 0
*Player flyshark01 mucks (does not show cards). Bets: 0.25. Collects: 0.50. Wins: 0.25.
Player xROCKETMANx does not show cards.Bets: 0. Collects: 0. Wins: 0.
Player Remi1738 does not show cards.Bets: 0. Collects: 0. Wins: 0.
Player IlxxxlI does not show cards.Bets: 0. Collects: 0. Wins: 0.
Player foreseen does not show cards.Bets: 0.25. Collects: 0. Loses: 0.25.
Game ended at: 2016/11/29 12:24:56

Game started
Game ID: 786939702 0.25/0.50 (PRR) Gorgons - 7 (Hold'em)
Seat 4 is the button
Seat 1: flyshark01 (48.42).
Seat 2: xROCKETMANx (29.75).
Seat 4: Remi1738 (44.48).
Seat 5: IlxxxlI (38.49).
Seat 6: foreseen (99.49).
Player IlxxxlI has small blind (0.25)
Player foreseen has big blind (0.50)
Player IlxxxlI received card: [6d]
Player IlxxxlI received card: [8d]
Player flyshark01 folds
Player xROCKETMANx raises (1.50)
Player Remi1738 folds
Player IlxxxlI folds
Player foreseen calls (1)
*** FLOP ***: [4s Js Kd]
Player foreseen checks
Player xROCKETMANx bets (2.06)
Player foreseen folds
Uncalled bet (2.06) returned to xROCKETMANx
Player xROCKETMANx mucks cards
------ Summary ------
Pot: 3.09. Rake 0.12. JP fee 0.04
Board: [4s Js Kd]
Player flyshark01 does not show cards.Bets: 0. Collects: 0. Wins: 0.
*Player xROCKETMANx mucks (does not show cards). Bets: 1.50. Collects: 3.09. Wins: 1.59.
Player Remi1738 does not show cards.Bets: 0. Collects: 0. Wins: 0.
Player IlxxxlI does not show cards.Bets: 0.25. Collects: 0. Loses: 0.25.
Player foreseen does not show cards.Bets: 1.50. Collects: 0. Loses: 1.50.
Game ended at: 2016/11/29 12:24:34

Game started
Game ID: 786939679 0.25/0.50 (PRR) Gorgons - 2 (Hold'em)
Seat 5 is the button
Seat 1: KWCTHROWER (22.08).
Seat 2: IlxxxlI (20).
Seat 3: flyshark01 (87.52).
Seat 4: Jui Kuen (50).
Seat 5: QDevilQ (58.04).
Seat 6: foreseen (50.99).
Player foreseen has small blind (0.25)
Player KWCTHROWER has big blind (0.50)
Player IlxxxlI received card: [8s]
Player IlxxxlI received card: [Qh]
Player IlxxxlI folds
Player flyshark01 raises (1.50)
Player Jui Kuen folds
Player QDevilQ calls (1.50)
Player foreseen folds
Player KWCTHROWER raises (4)
Player flyshark01 folds
Player QDevilQ calls (3)
*** FLOP ***: [4h 10s 8d]
Player KWCTHROWER bets (5.11)
Player QDevilQ raises (25.55)
Player KWCTHROWER allin (12.47)
Uncalled bet (7.97) returned to QDevilQ
*** TURN ***: [4h 10s 8d] [4d]
*** RIVER ***: [4h 10s 8d 4d] [2s]
------ Summary ------
Pot: 43.62. Rake 2.05. JP fee 0.24
Board: [4h 10s 8d 4d 2s]
Player KWCTHROWER shows: One pair of 4s [Ks As]. Bets: 22.08. Collects: 0. Loses: 22.08.
Player IlxxxlI does not show cards.Bets: 0. Collects: 0. Wins: 0.
Player flyshark01 does not show cards.Bets: 1.50. Collects: 0. Loses: 1.50.
Player Jui Kuen does not show cards.Bets: 0. Collects: 0. Wins: 0.
*Player QDevilQ shows: Two pairs. 10s and 4s [9d 10d]. Bets: 22.08. Collects: 43.62. Wins: 21.54.
Player foreseen does not show cards.Bets: 0.25. Collects: 0. Loses: 0.25.
Game ended at: 2016/11/29 12:25:11

Game started
Game ID: 786939495 0.25/0.50 (PRR) Gorgons - 7 (Hold'em)
Seat 2 is the button
Seat 1: flyshark01 (48.42).
Seat 2: xROCKETMANx (29.75).
Seat 4: Remi1738 (44.73).
Seat 5: IlxxxlI (38.24).
Seat 6: foreseen (99.49).
Player Remi1738 has small blind (0.25)
Player IlxxxlI has big blind (0.50)
Player IlxxxlI received card: [Jd]
Player IlxxxlI received card: [9s]
Player foreseen folds
Player flyshark01 folds
Player xROCKETMANx folds
Player Remi1738 folds
Uncalled bet (0.25) returned to IlxxxlI
Player IlxxxlI mucks cards
------ Summary ------
Pot: 0.50. Rake 0
Player flyshark01 does not show cards.Bets: 0. Collects: 0. Wins: 0.
Player xROCKETMANx does not show cards.Bets: 0. Collects: 0. Wins: 0.
Player Remi1738 does not show cards.Bets: 0.25. Collects: 0. Loses: 0.25.
*Player IlxxxlI mucks (does not show cards). Bets: 0.25. Collects: 0.50. Wins: 0.25.
Player foreseen does not show cards.Bets: 0. Collects: 0. Wins: 0.
Game ended at: 2016/11/29 12:23:20

Game started
Game ID: 786939117 0.25/0.50 (PRR) Gorgons - 7 (Hold'em)
Seat 1 is the button
Seat 1: flyshark01 (48.42).
Seat 2: xROCKETMANx (30).
Seat 3: DonkReaper (160.83).
Seat 4: Remi1738 (45.23).
Seat 5: IlxxxlI (38.24).
Seat 6: foreseen (98.74).
Player xROCKETMANx has small blind (0.25)
Player DonkReaper sitting out
Player Remi1738 has big blind (0.50)
Player IlxxxlI received card: [8s]
Player IlxxxlI received card: [Jc]
Player IlxxxlI folds
Player foreseen raises (1.25)
Player flyshark01 folds
Player xROCKETMANx folds
Player Remi1738 folds
Uncalled bet (0.75) returned to foreseen
Player foreseen mucks cards
------ Summary ------
Pot: 1.25. Rake 0
Player flyshark01 does not show cards.Bets: 0. Collects: 0. Wins: 0.
Player xROCKETMANx does not show cards.Bets: 0.25. Collects: 0. Loses: 0.25.
Player DonkReaper does not show cards.Bets: 0. Collects: 0. Wins: 0.
Player Remi1738 does not show cards.Bets: 0.50. Collects: 0. Loses: 0.50.
Player IlxxxlI does not show cards.Bets: 0. Collects: 0. Wins: 0.
*Player foreseen mucks (does not show cards). Bets: 0.50. Collects: 1.25. Wins: 0.75.
Game ended at: 2016/11/29 12:23:2

Game started
Game ID: 786938981 0.25/0.50 (PRR) Gorgons - 2 (Hold'em)
Seat 4 is the button
Seat 1: KWCTHROWER (23.58).
Seat 2: IlxxxlI (20).
Seat 3: flyshark01 (85.45).
Seat 4: Jui Kuen (50).
Seat 5: QDevilQ (58.29).
Seat 6: foreseen (51.49).
Player QDevilQ has small blind (0.25)
Player foreseen has big blind (0.50)
Player IlxxxlI received card: [10s]
Player IlxxxlI received card: [8s]
Player KWCTHROWER calls (0.50)
Player IlxxxlI folds
Player flyshark01 raises (1.50)
Player Jui Kuen folds
Player QDevilQ folds
Player foreseen folds
Player KWCTHROWER calls (1)
*** FLOP ***: [4c 4d 6c]
Player KWCTHROWER checks
Player flyshark01 bets (2.38)
Player KWCTHROWER folds
Uncalled bet (2.38) returned to flyshark01
Player flyshark01 mucks cards
------ Summary ------
Pot: 3.57. Rake 0.12. JP fee 0.06
Board: [4c 4d 6c]
Player KWCTHROWER does not show cards.Bets: 1.50. Collects: 0. Loses: 1.50.
Player IlxxxlI does not show cards.Bets: 0. Collects: 0. Wins: 0.
*Player flyshark01 mucks (does not show cards). Bets: 1.50. Collects: 3.57. Wins: 2.07.
Player Jui Kuen does not show cards.Bets: 0. Collects: 0. Wins: 0.
Player QDevilQ does not show cards.Bets: 0.25. Collects: 0. Loses: 0.25.
Player foreseen does not show cards.Bets: 0.50. Collects: 0. Loses: 0.50.
Game ended at: 2016/11/29 12:23:18

Game started
Game ID: 786938207 0.25/0.50 (PRR) Gorgons - 7 (Hold'em)
Seat 6 is the button
Seat 1: flyshark01 (48.67).
Seat 2: xROCKETMANx (50).
Seat 3: DonkReaper (160.83).
Seat 4: Remi1738 (45.23).
Seat 5: IlxxxlI (20).
Seat 6: foreseen (98.74).
Player flyshark01 has small blind (0.25)
Player xROCKETMANx has big blind (0.50)
Player IlxxxlI received card: [4s]
Player IlxxxlI received card: [4c]
Player DonkReaper folds
Player Remi1738 folds
Player IlxxxlI raises (1.20)
Player foreseen folds
Player flyshark01 folds
Player xROCKETMANx raises (2.80)
Player IlxxxlI calls (2.10)
*** FLOP ***: [4h 3c 8d]
Player xROCKETMANx bets (4.50)
Player IlxxxlI calls (4.50)
*** TURN ***: [4h 3c 8d] [Qd]
Player xROCKETMANx bets (10.04)
Player IlxxxlI allin (12.20)
Player xROCKETMANx calls (2.16)
*** RIVER ***: [4h 3c 8d Qd] [2c]
------ Summary ------
Pot: 38.24. Rake 1.77. JP fee 0.24
Board: [4h 3c 8d Qd 2c]
Player flyshark01 does not show cards.Bets: 0.25. Collects: 0. Loses: 0.25.
Player xROCKETMANx shows: One pair of 7s [7s 7h]. Bets: 20. Collects: 0. Loses: 20.
Player DonkReaper does not show cards.Bets: 0. Collects: 0. Wins: 0.
Player Remi1738 does not show cards.Bets: 0. Collects: 0. Wins: 0.
*Player IlxxxlI shows: Three Of Kind of 4s [4s 4c]. Bets: 20. Collects: 38.24. Wins: 18.24.
Player foreseen does not show cards.Bets: 0. Collects: 0. Wins: 0.
Game ended at: 2016/11/29 12:22:30

Game started
Game ID: 786937396 0.25/0.50 (PRR) Gorgons - 2 (Hold'em)
Seat 3 is the button
Seat 1: KWCTHROWER (23.58).
Seat 2: IlxxxlI (20).
Seat 3: flyshark01 (85.45).
Seat 4: Jui Kuen (51.75).
Seat 5: QDevilQ (53.79).
Seat 6: foreseen (51.49).
Player Jui Kuen has small blind (0.25)
Player QDevilQ has big blind (0.50)
Player IlxxxlI received card: [5c]
Player IlxxxlI received card: [10h]
Player foreseen folds
Player KWCTHROWER folds
Player IlxxxlI folds
Player flyshark01 folds
Player Jui Kuen raises (1.25)
Player QDevilQ raises (4.50)
Player Jui Kuen calls (3.50)
*** FLOP ***: [Kd Ah 8s]
Player Jui Kuen checks
Player QDevilQ checks
*** TURN ***: [Kd Ah 8s] [5s]
Player Jui Kuen is timed out.
Player Jui Kuen checks
Player QDevilQ bets (4)
Player Jui Kuen is timed out.
Player Jui Kuen folds
Uncalled bet (4) returned to QDevilQ
Player QDevilQ mucks cards
------ Summary ------
Pot: 9.50. Rake 0.34. JP fee 0.16
Board: [Kd Ah 8s 5s]
Player KWCTHROWER does not show cards.Bets: 0. Collects: 0. Wins: 0.
Player IlxxxlI does not show cards.Bets: 0. Collects: 0. Wins: 0.
Player flyshark01 does not show cards.Bets: 0. Collects: 0. Wins: 0.
Player Jui Kuen does not show cards.Bets: 5. Collects: 0. Loses: 5.
*Player QDevilQ mucks (does not show cards). Bets: 5. Collects: 9.50. Wins: 4.50.
Player foreseen does not show cards.Bets: 0. Collects: 0. Wins: 0.
Game ended at: 2016/11/29 12:22:22

Game started
Game ID: 786936945 0.25/0.50 (PRR) Gorgons - 7 (Hold'em)
Seat 5 is the button
Seat 1: flyshark01 (53.18).
Seat 2: xROCKETMANx (50).
Seat 3: DonkReaper (160.83).
Seat 4: Remi1738 (39.50).
Seat 5: IlxxxlI (20.15).
Seat 6: foreseen (98.99).
Player foreseen has small blind (0.25)
Player flyshark01 has big blind (0.50)
Player IlxxxlI received card: [7d]
Player IlxxxlI received card: [7c]
Player xROCKETMANx folds
Player DonkReaper folds
Player Remi1738 raises (1.50)
Player IlxxxlI calls (1.50)
Player foreseen folds
Player flyshark01 calls (1)
*** FLOP ***: [Ah 5h Kd]
Player flyshark01 checks
Player Remi1738 checks
Player IlxxxlI checks
*** TURN ***: [Ah 5h Kd] [6d]
Player flyshark01 checks
Player Remi1738 bets (3.01)
Player IlxxxlI folds
Player flyshark01 calls (3.01)
*** RIVER ***: [Ah 5h Kd 6d] [9d]
Player flyshark01 checks
Player Remi1738 checks
Player flyshark01 mucks cards
------ Summary ------
Pot: 10.24. Rake 0.37. JP fee 0.16
Board: [Ah 5h Kd 6d 9d]
Player flyshark01 mucks (does not show cards). Bets: 4.51. Collects: 0. Loses: 4.51.
Player xROCKETMANx does not show cards.Bets: 0. Collects: 0. Wins: 0.
Player DonkReaper does not show cards.Bets: 0. Collects: 0. Wins: 0.
*Player Remi1738 shows: One pair of Ks [Ks Qs]. Bets: 4.51. Collects: 10.24. Wins: 5.73.
Player IlxxxlI does not show cards.Bets: 1.50. Collects: 0. Loses: 1.50.
Player foreseen does not show cards.Bets: 0.25. Collects: 0. Loses: 0.25.
Game ended at: 2016/11/29 12:21:20

Game started
Game ID: 786936891 0.25/0.50 (PRR) Gorgons - 2 (Hold'em)
Seat 2 is the button
Seat 1: KWCTHROWER (23.58).
Seat 2: IlxxxlI (20).
Seat 3: flyshark01 (85.70).
Seat 4: Jui Kuen (52.25).
Seat 5: QDevilQ (53.04).
Seat 6: foreseen (51.49).
Player flyshark01 has small blind (0.25)
Player Jui Kuen has big blind (0.50)
Player IlxxxlI received card: [2c]
Player IlxxxlI received card: [Kd]
Player QDevilQ raises (1.50)
Player foreseen folds
Player KWCTHROWER folds
Player IlxxxlI folds
Player flyshark01 folds
Player Jui Kuen folds
Uncalled bet (1) returned to QDevilQ
Player QDevilQ mucks cards
------ Summary ------
Pot: 1.25. Rake 0
Player KWCTHROWER does not show cards.Bets: 0. Collects: 0. Wins: 0.
Player IlxxxlI does not show cards.Bets: 0. Collects: 0. Wins: 0.
Player flyshark01 does not show cards.Bets: 0.25. Collects: 0. Loses: 0.25.
Player Jui Kuen does not show cards.Bets: 0.50. Collects: 0. Loses: 0.50.
*Player QDevilQ mucks (does not show cards). Bets: 0.50. Collects: 1.25. Wins: 0.75.
Player foreseen does not show cards.Bets: 0. Collects: 0. Wins: 0.
Game ended at: 2016/11/29 12:20:18

Game started
Game ID: 786936504 0.25/0.50 (PRR) Gorgons - 7 (Hold'em)
Seat 4 is the button
Seat 1: flyshark01 (52.43).
Seat 2: xROCKETMANx (50).
Seat 3: DonkReaper (160.83).
Seat 4: Remi1738 (39.50).
Seat 5: IlxxxlI (20.40).
Seat 6: foreseen (99.49).
Player IlxxxlI has small blind (0.25)
Player foreseen has big blind (0.50)
Player IlxxxlI received card: [Jh]
Player IlxxxlI received card: [5h]
Player flyshark01 raises (1.50)
Player xROCKETMANx folds
Player DonkReaper folds
Player Remi1738 folds
Player IlxxxlI folds
Player foreseen folds
Uncalled bet (1) returned to flyshark01
Player flyshark01 mucks cards
------ Summary ------
Pot: 1.25. Rake 0
*Player flyshark01 mucks (does not show cards). Bets: 0.50. Collects: 1.25. Wins: 0.75.
Player xROCKETMANx does not show cards.Bets: 0. Collects: 0. Wins: 0.
Player DonkReaper does not show cards.Bets: 0. Collects: 0. Wins: 0.
Player Remi1738 does not show cards.Bets: 0. Collects: 0. Wins: 0.
Player IlxxxlI does not show cards.Bets: 0.25. Collects: 0. Loses: 0.25.
Player foreseen does not show cards.Bets: 0.50. Collects: 0. Loses: 0.50.
Game ended at: 2016/11/29 12:19:43

Game started
Game ID: 786935969 0.25/0.50 (PRR) Gorgons - 2 (Hold'em)
Seat 1 is the button
Seat 1: KWCTHROWER (23.58).
Seat 2: IlxxxlI (20).
Seat 3: flyshark01 (83).
Seat 4: Jui Kuen (52.25).
Seat 5: QDevilQ (53.04).
Seat 6: foreseen (51.49).
Player IlxxxlI has small blind (0.25)
Player flyshark01 has big blind (0.50)
Player IlxxxlI received card: [Ac]
Player IlxxxlI received card: [10s]
Player Jui Kuen folds
Player QDevilQ folds
Player foreseen folds
Player KWCTHROWER folds
Player IlxxxlI raises (1)
Player flyshark01 raises (2.50)
Player IlxxxlI calls (1.75)
*** FLOP ***: [2d 4s Qd]
Player IlxxxlI checks
Player flyshark01 bets (2.85)
Player IlxxxlI folds
Uncalled bet (2.85) returned to flyshark01
Player flyshark01 mucks cards
------ Summary ------
Pot: 5.70. Rake 0.20. JP fee 0.10
Board: [2d 4s Qd]
Player KWCTHROWER does not show cards.Bets: 0. Collects: 0. Wins: 0.
Player IlxxxlI does not show cards.Bets: 3. Collects: 0. Loses: 3.
*Player flyshark01 mucks (does not show cards). Bets: 3. Collects: 5.70. Wins: 2.70.
Player Jui Kuen does not show cards.Bets: 0. Collects: 0. Wins: 0.
Player QDevilQ does not show cards.Bets: 0. Collects: 0. Wins: 0.
Player foreseen does not show cards.Bets: 0. Collects: 0. Wins: 0.
Game ended at: 2016/11/29 12:19:39

Game started
Game ID: 786935842 0.25/0.50 (PRR) Gorgons - 7 (Hold'em)
Seat 3 is the button
Seat 1: flyshark01 (51.68).
Seat 2: xROCKETMANx (50).
Seat 3: DonkReaper (160.83).
Seat 4: Remi1738 (39.75).
Seat 5: IlxxxlI (20.90).
Seat 6: foreseen (99.49).
Player Remi1738 has small blind (0.25)
Player IlxxxlI has big blind (0.50)
Player IlxxxlI received card: [2d]
Player IlxxxlI received card: [5h]
Player foreseen folds
Player flyshark01 raises (1.50)
Player xROCKETMANx folds
Player DonkReaper folds
Player Remi1738 folds
Player IlxxxlI folds
Uncalled bet (1) returned to flyshark01
Player flyshark01 mucks cards
------ Summary ------
Pot: 1.25. Rake 0
*Player flyshark01 mucks (does not show cards). Bets: 0.50. Collects: 1.25. Wins: 0.75.
Player xROCKETMANx does not show cards.Bets: 0. Collects: 0. Wins: 0.
Player DonkReaper does not show cards.Bets: 0. Collects: 0. Wins: 0.
Player Remi1738 does not show cards.Bets: 0.25. Collects: 0. Loses: 0.25.
Player IlxxxlI does not show cards.Bets: 0.50. Collects: 0. Loses: 0.50.
Player foreseen does not show cards.Bets: 0. Collects: 0. Wins: 0.
Game ended at: 2016/11/29 12:19:8

Game started
Game ID: 786935585 0.25/0.50 (PRR) Gorgons - 7 (Hold'em)
Seat 2 is the button
Seat 1: flyshark01 (51.68).
Seat 2: xROCKETMANx (50).
Seat 3: DonkReaper (161.08).
Seat 4: Remi1738 (39.50).
Seat 5: IlxxxlI (20.90).
Seat 6: foreseen (99.49).
Player DonkReaper has small blind (0.25)
Player Remi1738 has big blind (0.50)
Player IlxxxlI received card: [6h]
Player IlxxxlI received card: [Ac]
Player IlxxxlI folds
Player foreseen folds
Player flyshark01 folds
Player xROCKETMANx folds
Player DonkReaper folds
Uncalled bet (0.25) returned to Remi1738
Player Remi1738 mucks cards
------ Summary ------
Pot: 0.50. Rake 0
Player flyshark01 does not show cards.Bets: 0. Collects: 0. Wins: 0.
Player xROCKETMANx does not show cards.Bets: 0. Collects: 0. Wins: 0.
Player DonkReaper does not show cards.Bets: 0.25. Collects: 0. Loses: 0.25.
*Player Remi1738 mucks (does not show cards). Bets: 0.25. Collects: 0.50. Wins: 0.25.
Player IlxxxlI does not show cards.Bets: 0. Collects: 0. Wins: 0.
Player foreseen does not show cards.Bets: 0. Collects: 0. Wins: 0.
Game ended at: 2016/11/29 12:18:17

Game started
Game ID: 786935204 0.25/0.50 (PRR) Gorgons - 2 (Hold'em)
Seat 6 is the button
Seat 1: KWCTHROWER (24.70).
Seat 2: IlxxxlI (20).
Seat 3: flyshark01 (83).
Seat 4: Jui Kuen (52.25).
Seat 5: QDevilQ (53.04).
Seat 6: foreseen (50).
Player KWCTHROWER has small blind (0.25)
Player IlxxxlI has big blind (0.50)
Player IlxxxlI received card: [7c]
Player IlxxxlI received card: [6s]
Player flyshark01 folds
Player Jui Kuen folds
Player QDevilQ folds
Player foreseen raises (1.12)
Player KWCTHROWER calls (0.87)
Player IlxxxlI folds
*** FLOP ***: [5c 9h Ah]
Player KWCTHROWER checks
Player foreseen bets (0.86)
Player KWCTHROWER folds
Uncalled bet (0.86) returned to foreseen
Player foreseen mucks cards
------ Summary ------
Pot: 2.61. Rake 0.09. JP fee 0.04
Board: [5c 9h Ah]
Player KWCTHROWER does not show cards.Bets: 1.12. Collects: 0. Loses: 1.12.
Player IlxxxlI does not show cards.Bets: 0.50. Collects: 0. Loses: 0.50.
Player flyshark01 does not show cards.Bets: 0. Collects: 0. Wins: 0.
Player Jui Kuen does not show cards.Bets: 0. Collects: 0. Wins: 0.
Player QDevilQ does not show cards.Bets: 0. Collects: 0. Wins: 0.
*Player foreseen mucks (does not show cards). Bets: 1.12. Collects: 2.61. Wins: 1.49.
Game ended at: 2016/11/29 12:18:28

Game started
Game ID: 786934814 0.25/0.50 (PRR) Gorgons - 2 (Hold'em)
Seat 5 is the button
Seat 1: KWCTHROWER (25.20).
Seat 2: IlxxxlI (20).
Seat 3: flyshark01 (83).
Seat 4: Jui Kuen (52.25).
Seat 5: QDevilQ (52.29).
Seat 6: foreseen (50).
Player foreseen has small blind (0.25)
Player KWCTHROWER has big blind (0.50)
Player IlxxxlI received card: [3h]
Player IlxxxlI received card: [10c]
Player IlxxxlI folds
Player flyshark01 folds
Player Jui Kuen folds
Player QDevilQ raises (1.50)
Player foreseen folds
Player KWCTHROWER folds
Uncalled bet (1) returned to QDevilQ
Player QDevilQ mucks cards
------ Summary ------
Pot: 1.25. Rake 0
Player KWCTHROWER does not show cards.Bets: 0.50. Collects: 0. Loses: 0.50.
Player IlxxxlI does not show cards.Bets: 0. Collects: 0. Wins: 0.
Player flyshark01 does not show cards.Bets: 0. Collects: 0. Wins: 0.
Player Jui Kuen does not show cards.Bets: 0. Collects: 0. Wins: 0.
*Player QDevilQ mucks (does not show cards). Bets: 0.50. Collects: 1.25. Wins: 0.75.
Player foreseen does not show cards.Bets: 0.25. Collects: 0. Loses: 0.25.
Game ended at: 2016/11/29 12:17:27

Game started
Game ID: 786934487 0.25/0.50 (PRR) Gorgons - 7 (Hold'em)
Seat 1 is the button
Seat 1: flyshark01 (55.68).
Seat 2: xROCKETMANx (50.25).
Seat 3: DonkReaper (157.24).
Seat 4: Remi1738 (39.50).
Seat 5: IlxxxlI (20.90).
Seat 6: foreseen (99.49).
Player xROCKETMANx has small blind (0.25)
Player DonkReaper has big blind (0.50)
Player IlxxxlI received card: [8c]
Player IlxxxlI received card: [5h]
Player Remi1738 folds
Player IlxxxlI folds
Player foreseen folds
Player flyshark01 raises (1.50)
Player xROCKETMANx folds
Player DonkReaper raises (3.50)
Player flyshark01 calls (2.50)
*** FLOP ***: [2d Ah 4d]
Player DonkReaper bets (5.22)
Player flyshark01 folds
Uncalled bet (5.22) returned to DonkReaper
Player DonkReaper mucks cards
------ Summary ------
Pot: 7.84. Rake 0.29. JP fee 0.12
Board: [2d Ah 4d]
Player flyshark01 does not show cards.Bets: 4. Collects: 0. Loses: 4.
Player xROCKETMANx does not show cards.Bets: 0.25. Collects: 0. Loses: 0.25.
*Player DonkReaper mucks (does not show cards). Bets: 4. Collects: 7.84. Wins: 3.84.
Player Remi1738 does not show cards.Bets: 0. Collects: 0. Wins: 0.
Player IlxxxlI does not show cards.Bets: 0. Collects: 0. Wins: 0.
Player foreseen does not show cards.Bets: 0. Collects: 0. Wins: 0.
Game ended at: 2016/11/29 12:17:58

Game started
Game ID: 786934295 0.25/0.50 (PRR) Gorgons - 2 (Hold'em)
Seat 4 is the button
Seat 1: KWCTHROWER (25.20).
Seat 2: IlxxxlI (20).
Seat 3: flyshark01 (83).
Seat 4: Jui Kuen (51.50).
Seat 5: QDevilQ (52.54).
Seat 6: foreseen (50).
Player QDevilQ has small blind (0.25)
Player foreseen has big blind (0.50)
Player IlxxxlI received card: [7h]
Player IlxxxlI received card: [2h]
Player KWCTHROWER folds
Player IlxxxlI folds
Player flyshark01 folds
Player Jui Kuen raises (1)
Player QDevilQ folds
Player foreseen folds
Uncalled bet (0.50) returned to Jui Kuen
Player Jui Kuen mucks cards
------ Summary ------
Pot: 1.25. Rake 0
Player KWCTHROWER does not show cards.Bets: 0. Collects: 0. Wins: 0.
Player IlxxxlI does not show cards.Bets: 0. Collects: 0. Wins: 0.
Player flyshark01 does not show cards.Bets: 0. Collects: 0. Wins: 0.
*Player Jui Kuen mucks (does not show cards). Bets: 0.50. Collects: 1.25. Wins: 0.75.
Player QDevilQ does not show cards.Bets: 0.25. Collects: 0. Loses: 0.25.
Player foreseen does not show cards.Bets: 0.50. Collects: 0. Loses: 0.50.
Game ended at: 2016/11/29 12:16:57

Game started
Game ID: 786933996 0.25/0.50 (PRR) Gorgons - 7 (Hold'em)
Seat 6 is the button
Seat 1: flyshark01 (55.93).
Seat 2: xROCKETMANx (50).
Seat 3: DonkReaper (157.24).
Seat 4: Remi1738 (39.50).
Seat 5: IlxxxlI (20.90).
Seat 6: foreseen (99.49).
Player flyshark01 has small blind (0.25)
Player xROCKETMANx has big blind (0.50)
Player IlxxxlI received card: [2h]
Player IlxxxlI received card: [8d]
Player DonkReaper folds
Player Remi1738 folds
Player IlxxxlI folds
Player foreseen folds
Player flyshark01 folds
Uncalled bet (0.25) returned to xROCKETMANx
Player xROCKETMANx mucks cards
------ Summary ------
Pot: 0.50. Rake 0
Player flyshark01 does not show cards.Bets: 0.25. Collects: 0. Loses: 0.25.
*Player xROCKETMANx mucks (does not show cards). Bets: 0.25. Collects: 0.50. Wins: 0.25.
Player DonkReaper does not show cards.Bets: 0. Collects: 0. Wins: 0.
Player Remi1738 does not show cards.Bets: 0. Collects: 0. Wins: 0.
Player IlxxxlI does not show cards.Bets: 0. Collects: 0. Wins: 0.
Player foreseen does not show cards.Bets: 0. Collects: 0. Wins: 0.
Game ended at: 2016/11/29 12:16:31

Game started
Game ID: 786933672 0.25/0.50 (PRR) Gorgons - 7 (Hold'em)
Seat 5 is the button
Seat 1: flyshark01 (56.43).
Seat 3: DonkReaper (157.24).
Seat 4: Remi1738 (38.75).
Seat 5: IlxxxlI (20.90).
Seat 6: foreseen (99.74).
Player foreseen has small blind (0.25)
Player flyshark01 has big blind (0.50)
Player IlxxxlI received card: [Jh]
Player IlxxxlI received card: [8d]
Player DonkReaper folds
Player Remi1738 raises (1.50)
Player IlxxxlI folds
Player foreseen folds
Player flyshark01 folds
Uncalled bet (1) returned to Remi1738
Player Remi1738 mucks cards
------ Summary ------
Pot: 1.25. Rake 0
Player flyshark01 does not show cards.Bets: 0.50. Collects: 0. Loses: 0.50.
Player DonkReaper does not show cards.Bets: 0. Collects: 0. Wins: 0.
*Player Remi1738 mucks (does not show cards). Bets: 0.50. Collects: 1.25. Wins: 0.75.
Player IlxxxlI does not show cards.Bets: 0. Collects: 0. Wins: 0.
Player foreseen does not show cards.Bets: 0.25. Collects: 0. Loses: 0.25.
Game ended at: 2016/11/29 12:15:55

Game started
Game ID: 786932895 0.25/0.50 (PRR) Gorgons - 2 (Hold'em)
Seat 3 is the button
Seat 1: KWCTHROWER (52.29).
Seat 2: IlxxxlI (20).
Seat 3: flyshark01 (53.15).
Seat 4: Jui Kuen (51.75).
Seat 5: QDevilQ (53.04).
Seat 6: foreseen (51.89).
Player Jui Kuen has small blind (0.25)
Player QDevilQ has big blind (0.50)
Player IlxxxlI received card: [3s]
Player IlxxxlI received card: [3c]
Player foreseen raises (1.25)
Player KWCTHROWER calls (1.25)
Player IlxxxlI folds
Player flyshark01 raises (5)
Player Jui Kuen folds
Player QDevilQ folds
Player foreseen calls (3.75)
Player KWCTHROWER calls (3.75)
*** FLOP ***: [6c As 7c]
Player foreseen checks
Player KWCTHROWER checks
Player flyshark01 bets (7.49)
Player foreseen folds
Player KWCTHROWER calls (7.49)
*** TURN ***: [6c As 7c] [Jc]
Player KWCTHROWER checks
Player flyshark01 checks
*** RIVER ***: [6c As 7c Jc] [3h]
Player KWCTHROWER bets (14.60)
Player flyshark01 allin (40.66)
Player KWCTHROWER folds
Uncalled bet (26.06) returned to flyshark01
Player flyshark01 mucks cards
------ Summary ------
Pot: 56.94. Rake 2.75. JP fee 0.24
Board: [6c As 7c Jc 3h]
Player KWCTHROWER does not show cards.Bets: 27.09. Collects: 0. Loses: 27.09.
Player IlxxxlI does not show cards.Bets: 0. Collects: 0. Wins: 0.
*Player flyshark01 mucks (does not show cards). Bets: 27.09. Collects: 56.94. Wins: 29.85.
Player Jui Kuen does not show cards.Bets: 0.25. Collects: 0. Loses: 0.25.
Player QDevilQ does not show cards.Bets: 0.50. Collects: 0. Loses: 0.50.
Player foreseen does not show cards.Bets: 5. Collects: 0. Loses: 5.
Game ended at: 2016/11/29 12:16:16

Game started
Game ID: 786932790 0.25/0.50 (PRR) Gorgons - 7 (Hold'em)
Seat 4 is the button
Seat 1: flyshark01 (56.43).
Seat 3: DonkReaper (157.24).
Seat 4: Remi1738 (38.75).
Seat 5: IlxxxlI (20).
Seat 6: foreseen (100.74).
Player IlxxxlI has small blind (0.25)
Player foreseen has big blind (0.50)
Player IlxxxlI received card: [7c]
Player IlxxxlI received card: [6c]
Player flyshark01 folds
Player DonkReaper folds
Player Remi1738 folds
Player IlxxxlI calls (0.25)
Player foreseen checks
*** FLOP ***: [2h Kc Ac]
Player IlxxxlI bets (0.50)
Player foreseen calls (0.50)
*** TURN ***: [2h Kc Ac] [2d]
Player IlxxxlI checks
Player foreseen checks
*** RIVER ***: [2h Kc Ac 2d] [10c]
Player IlxxxlI bets (1.50)
Player foreseen folds
Uncalled bet (1.50) returned to IlxxxlI
Player IlxxxlI mucks cards
------ Summary ------
Pot: 1.90. Rake 0.08. JP fee 0.02
Board: [2h Kc Ac 2d 10c]
Player flyshark01 does not show cards.Bets: 0. Collects: 0. Wins: 0.
Player DonkReaper does not show cards.Bets: 0. Collects: 0. Wins: 0.
Player Remi1738 does not show cards.Bets: 0. Collects: 0. Wins: 0.
*Player IlxxxlI mucks (does not show cards). Bets: 1. Collects: 1.90. Wins: 0.90.
Player foreseen does not show cards.Bets: 1. Collects: 0. Loses: 1.
Game ended at: 2016/11/29 12:15:29

Game started
Game ID: 786932487 0.25/0.50 (PRR) Gorgons - 2 (Hold'em)
Seat 2 is the button
Seat 1: KWCTHROWER (52.29).
Seat 2: IlxxxlI (20).
Seat 3: flyshark01 (53.40).
Seat 4: Jui Kuen (50).
Seat 5: QDevilQ (53.04).
Seat 6: foreseen (51.89).
Player flyshark01 has small blind (0.25)
Player Jui Kuen has big blind (0.50)
Player IlxxxlI received card: [Kc]
Player IlxxxlI received card: [6c]
Player QDevilQ folds
Player foreseen folds
Player KWCTHROWER folds
Player IlxxxlI raises (1.50)
Player flyshark01 folds
Player Jui Kuen raises (4)
Player IlxxxlI folds
Uncalled bet (3) returned to Jui Kuen
Player Jui Kuen mucks cards
------ Summary ------
Pot: 3.25. Rake 0
Player KWCTHROWER does not show cards.Bets: 0. Collects: 0. Wins: 0.
Player IlxxxlI does not show cards.Bets: 1.50. Collects: 0. Loses: 1.50.
Player flyshark01 does not show cards.Bets: 0.25. Collects: 0. Loses: 0.25.
*Player Jui Kuen mucks (does not show cards). Bets: 1.50. Collects: 3.25. Wins: 1.75.
Player QDevilQ does not show cards.Bets: 0. Collects: 0. Wins: 0.
Player foreseen does not show cards.Bets: 0. Collects: 0. Wins: 0.
Game ended at: 2016/11/29 12:14:28

Game started
Game ID: 786932342 0.25/0.50 (PRR) Gorgons - 2 (Hold'em)
Seat 1 is the button
Seat 1: KWCTHROWER (52.29).
Seat 2: IlxxxlI (20.25).
Seat 3: flyshark01 (53.15).
Seat 5: QDevilQ (53.04).
Seat 6: foreseen (51.89).
Player IlxxxlI has small blind (0.25)
Player flyshark01 has big blind (0.50)
Player IlxxxlI received card: [Kh]
Player IlxxxlI received card: [3c]
Player QDevilQ folds
Player foreseen folds
Player KWCTHROWER folds
Player IlxxxlI folds
Uncalled bet (0.25) returned to flyshark01
Player flyshark01 mucks cards
------ Summary ------
Pot: 0.50. Rake 0
Player KWCTHROWER does not show cards.Bets: 0. Collects: 0. Wins: 0.
Player IlxxxlI does not show cards.Bets: 0.25. Collects: 0. Loses: 0.25.
*Player flyshark01 mucks (does not show cards). Bets: 0.25. Collects: 0.50. Wins: 0.25.
Player QDevilQ does not show cards.Bets: 0. Collects: 0. Wins: 0.
Player foreseen does not show cards.Bets: 0. Collects: 0. Wins: 0.
Game ended at: 2016/11/29 12:13:57

Game started
Game ID: 786932344 0.25/0.50 (PRR) Gorgons - 7 (Hold'em)
Seat 3 is the button
Seat 1: flyshark01 (56.43).
Seat 3: DonkReaper (156.49).
Seat 4: Remi1738 (39).
Seat 5: IlxxxlI (20).
Seat 6: foreseen (100.74).
Player Remi1738 has small blind (0.25)
Player IlxxxlI has big blind (0.50)
Player IlxxxlI received card: [Ks]
Player IlxxxlI received card: [9c]
Player foreseen folds
Player flyshark01 folds
Player DonkReaper raises (1.50)
Player Remi1738 folds
Player IlxxxlI folds
Uncalled bet (1) returned to DonkReaper
Player DonkReaper mucks cards
------ Summary ------
Pot: 1.25. Rake 0
Player flyshark01 does not show cards.Bets: 0. Collects: 0. Wins: 0.
*Player DonkReaper mucks (does not show cards). Bets: 0.50. Collects: 1.25. Wins: 0.75.
Player Remi1738 does not show cards.Bets: 0.25. Collects: 0. Loses: 0.25.
Player IlxxxlI does not show cards.Bets: 0.50. Collects: 0. Loses: 0.50.
Player foreseen does not show cards.Bets: 0. Collects: 0. Wins: 0.
Game ended at: 2016/11/29 12:14:21

Game started
Game ID: 786932089 0.25/0.50 (PRR) Gorgons - 2 (Hold'em)
Seat 6 is the button
Seat 1: KWCTHROWER (52.54).
Seat 2: IlxxxlI (20).
Seat 3: flyshark01 (53.15).
Seat 5: QDevilQ (53.04).
Seat 6: foreseen (51.89).
Player KWCTHROWER has small blind (0.25)
Player IlxxxlI has big blind (0.50)
Player IlxxxlI received card: [Ah]
Player IlxxxlI received card: [9d]
Player flyshark01 folds
Player QDevilQ folds
Player foreseen folds
Player KWCTHROWER folds
Uncalled bet (0.25) returned to IlxxxlI
Player IlxxxlI mucks cards
------ Summary ------
Pot: 0.50. Rake 0
Player KWCTHROWER does not show cards.Bets: 0.25. Collects: 0. Loses: 0.25.
*Player IlxxxlI mucks (does not show cards). Bets: 0.25. Collects: 0.50. Wins: 0.25.
Player flyshark01 does not show cards.Bets: 0. Collects: 0. Wins: 0.
Player QDevilQ does not show cards.Bets: 0. Collects: 0. Wins: 0.
Player foreseen does not show cards.Bets: 0. Collects: 0. Wins: 0.
Game ended at: 2016/11/29 12:13:46

Game started
Game ID: 786927584 0.25/0.50 (PRR) Gorgons - 8 (Hold'em)
Seat 3 is the button
Seat 1: kidpokerak (107.30).
Seat 2: IlxxxlI (27.50).
Seat 3: foreseen (70.67).
Seat 4: QDevilQ (102.61).
Seat 5: imperceptible (15.86).
Player QDevilQ has small blind (0.25)
Player imperceptible has big blind (0.50)
Player IlxxxlI received card: [6c]
Player IlxxxlI received card: [9c]
Player kidpokerak folds
Player IlxxxlI folds
Player foreseen raises (1.12)
Player QDevilQ folds
Player imperceptible folds
Uncalled bet (0.62) returned to foreseen
Player foreseen mucks cards
------ Summary ------
Pot: 1.25. Rake 0
Player kidpokerak does not show cards.Bets: 0. Collects: 0. Wins: 0.
Player IlxxxlI does not show cards.Bets: 0. Collects: 0. Wins: 0.
*Player foreseen mucks (does not show cards). Bets: 0.50. Collects: 1.25. Wins: 0.75.
Player QDevilQ does not show cards.Bets: 0.25. Collects: 0. Loses: 0.25.
Player imperceptible does not show cards.Bets: 0.50. Collects: 0. Loses: 0.50.
Game ended at: 2016/11/29 12:7:53

Game started
Game ID: 786927106 0.25/0.50 (PRR) Gorgons - 8 (Hold'em)
Seat 2 is the button
Seat 1: kidpokerak (108.80).
Seat 2: IlxxxlI (27.50).
Seat 3: foreseen (70.92).
Seat 4: QDevilQ (100.86).
Seat 5: imperceptible (15.86).
Player foreseen has small blind (0.25)
Player QDevilQ has big blind (0.50)
Player IlxxxlI received card: [Ah]
Player IlxxxlI received card: [5c]
Player imperceptible folds
Player kidpokerak raises (1.50)
Player IlxxxlI folds
Player foreseen folds
Player QDevilQ raises (5)
Player kidpokerak folds
Uncalled bet (4) returned to QDevilQ
Player QDevilQ mucks cards
------ Summary ------
Pot: 3.25. Rake 0
Player kidpokerak does not show cards.Bets: 1.50. Collects: 0. Loses: 1.50.
Player IlxxxlI does not show cards.Bets: 0. Collects: 0. Wins: 0.
Player foreseen does not show cards.Bets: 0.25. Collects: 0. Loses: 0.25.
*Player QDevilQ mucks (does not show cards). Bets: 1.50. Collects: 3.25. Wins: 1.75.
Player imperceptible does not show cards.Bets: 0. Collects: 0. Wins: 0.
Game ended at: 2016/11/29 12:7:30

Game started
Game ID: 786926272 0.25/0.50 (PRR) Gorgons - 8 (Hold'em)
Seat 1 is the button
Seat 1: kidpokerak (114.30).
Seat 2: IlxxxlI (20).
Seat 3: foreseen (71.42).
Seat 4: QDevilQ (102.36).
Seat 5: imperceptible (15.86).
Player IlxxxlI has small blind (0.25)
Player foreseen has big blind (0.50)
Player IlxxxlI received card: [Qs]
Player IlxxxlI received card: [Qd]
Player QDevilQ raises (1.50)
Player imperceptible folds
Player kidpokerak raises (5.50)
Player IlxxxlI allin (19.75)
Player foreseen folds
Player QDevilQ folds
Player kidpokerak folds
Uncalled bet (14.50) returned to IlxxxlI
Player IlxxxlI mucks cards
------ Summary ------
Pot: 13. Rake 0
Player kidpokerak does not show cards.Bets: 5.50. Collects: 0. Loses: 5.50.
*Player IlxxxlI mucks (does not show cards). Bets: 5.50. Collects: 13. Wins: 7.50.
Player foreseen does not show cards.Bets: 0.50. Collects: 0. Loses: 0.50.
Player QDevilQ does not show cards.Bets: 1.50. Collects: 0. Loses: 1.50.
Player imperceptible does not show cards.Bets: 0. Collects: 0. Wins: 0.
Game ended at: 2016/11/29 12:6:54

Game started
Game ID: 786926051 0.25/0.50 (PRR) Gorgons - 8 (Hold'em)
Seat 5 is the button
Seat 1: kidpokerak (114.55).
Seat 2: IlxxxlI (20).
Seat 3: foreseen (70.67).
Seat 4: QDevilQ (102.36).
Seat 5: imperceptible (15.86).
Player kidpokerak has small blind (0.25)
Player IlxxxlI has big blind (0.50)
Player IlxxxlI received card: [Kh]
Player IlxxxlI received card: [8d]
Player foreseen raises (1.25)
Player QDevilQ folds
Player imperceptible folds
Player kidpokerak folds
Player IlxxxlI folds
Uncalled bet (0.75) returned to foreseen
Player foreseen mucks cards
------ Summary ------
Pot: 1.25. Rake 0
Player kidpokerak does not show cards.Bets: 0.25. Collects: 0. Loses: 0.25.
Player IlxxxlI does not show cards.Bets: 0.50. Collects: 0. Loses: 0.50.
*Player foreseen mucks (does not show cards). Bets: 0.50. Collects: 1.25. Wins: 0.75.
Player QDevilQ does not show cards.Bets: 0. Collects: 0. Wins: 0.
Player imperceptible does not show cards.Bets: 0. Collects: 0. Wins: 0.
Game ended at: 2016/11/29 12:5:54

Game started
Game ID: 786925697 0.25/0.50 (PRR) Gorgons - 8 (Hold'em)
Seat 4 is the button
Seat 1: kidpokerak (115.05).
Seat 2: IlxxxlI (20).
Seat 3: foreseen (70.67).
Seat 4: QDevilQ (101.61).
Seat 5: imperceptible (16.11).
Player imperceptible has small blind (0.25)
Player kidpokerak has big blind (0.50)
Player IlxxxlI received card: [6c]
Player IlxxxlI received card: [8s]
Player IlxxxlI folds
Player foreseen folds
Player QDevilQ raises (1.50)
Player imperceptible folds
Player kidpokerak folds
Uncalled bet (1) returned to QDevilQ
Player QDevilQ mucks cards
------ Summary ------
Pot: 1.25. Rake 0
Player kidpokerak does not show cards.Bets: 0.50. Collects: 0. Loses: 0.50.
Player IlxxxlI does not show cards.Bets: 0. Collects: 0. Wins: 0.
Player foreseen does not show cards.Bets: 0. Collects: 0. Wins: 0.
*Player QDevilQ mucks (does not show cards). Bets: 0.50. Collects: 1.25. Wins: 0.75.
Player imperceptible does not show cards.Bets: 0.25. Collects: 0. Loses: 0.25.
Game ended at: 2016/11/29 12:5:38

Game started
Game ID: 786925234 0.25/0.50 (PRR) Gorgons - 8 (Hold'em)
Seat 3 is the button
Seat 1: kidpokerak (114.30).
Seat 2: IlxxxlI (20).
Seat 3: foreseen (70.67).
Seat 4: QDevilQ (101.86).
Seat 5: imperceptible (16.61).
Player QDevilQ has small blind (0.25)
Player imperceptible has big blind (0.50)
Player IlxxxlI received card: [5d]
Player IlxxxlI received card: [5c]
Player kidpokerak raises (1.50)
Player IlxxxlI folds
Player foreseen folds
Player QDevilQ folds
Player imperceptible folds
Uncalled bet (1) returned to kidpokerak
Player kidpokerak mucks cards
------ Summary ------
Pot: 1.25. Rake 0
*Player kidpokerak mucks (does not show cards). Bets: 0.50. Collects: 1.25. Wins: 0.75.
Player IlxxxlI does not show cards.Bets: 0. Collects: 0. Wins: 0.
Player foreseen does not show cards.Bets: 0. Collects: 0. Wins: 0.
Player QDevilQ does not show cards.Bets: 0.25. Collects: 0. Loses: 0.25.
Player imperceptible does not show cards.Bets: 0.50. Collects: 0. Loses: 0.50.
Game ended at: 2016/11/29 12:5:10

Game started
Game ID: 786924833 0.25/0.50 (PRR) Gorgons - 8 (Hold'em)
Seat 2 is the button
Seat 1: kidpokerak (113.55).
Seat 2: IlxxxlI (20).
Seat 3: foreseen (70.92).
Seat 4: QDevilQ (102.36).
Seat 5: imperceptible (16.61).
Player foreseen has small blind (0.25)
Player QDevilQ has big blind (0.50)
Player IlxxxlI received card: [9d]
Player IlxxxlI received card: [8d]
Player imperceptible folds
Player kidpokerak raises (1.50)
Player IlxxxlI folds
Player foreseen folds
Player QDevilQ folds
Uncalled bet (1) returned to kidpokerak
Player kidpokerak mucks cards
------ Summary ------
Pot: 1.25. Rake 0
*Player kidpokerak mucks (does not show cards). Bets: 0.50. Collects: 1.25. Wins: 0.75.
Player IlxxxlI does not show cards.Bets: 0. Collects: 0. Wins: 0.
Player foreseen does not show cards.Bets: 0.25. Collects: 0. Loses: 0.25.
Player QDevilQ does not show cards.Bets: 0.50. Collects: 0. Loses: 0.50.
Player imperceptible does not show cards.Bets: 0. Collects: 0. Wins: 0.
Game ended at: 2016/11/29 12:4:37

Game started
Game ID: 786924397 0.25/0.50 (PRR) Gorgons - 8 (Hold'em)
Seat 1 is the button
Seat 1: kidpokerak (112.80).
Seat 2: IlxxxlI (20).
Seat 3: foreseen (71.42).
Seat 4: QDevilQ (102.36).
Seat 5: imperceptible (16.61).
Player IlxxxlI has small blind (0.25)
Player foreseen has big blind (0.50)
Player IlxxxlI received card: [8s]
Player IlxxxlI received card: [4c]
Player QDevilQ folds
Player imperceptible folds
Player kidpokerak raises (1.50)
Player IlxxxlI folds
Player foreseen folds
Uncalled bet (1) returned to kidpokerak
Player kidpokerak mucks cards
------ Summary ------
Pot: 1.25. Rake 0
*Player kidpokerak mucks (does not show cards). Bets: 0.50. Collects: 1.25. Wins: 0.75.
Player IlxxxlI does not show cards.Bets: 0.25. Collects: 0. Loses: 0.25.
Player foreseen does not show cards.Bets: 0.50. Collects: 0. Loses: 0.50.
Player QDevilQ does not show cards.Bets: 0. Collects: 0. Wins: 0.
Player imperceptible does not show cards.Bets: 0. Collects: 0. Wins: 0.
Game ended at: 2016/11/29 12:4:5

Game started
Game ID: 786923844 0.25/0.50 (PRR) Gorgons - 8 (Hold'em)
Seat 5 is the button
Seat 1: kidpokerak (110.80).
Seat 2: IlxxxlI (20).
Seat 3: foreseen (71.42).
Seat 4: QDevilQ (103.86).
Seat 5: imperceptible (16.61).
Player kidpokerak has small blind (0.25)
Player IlxxxlI has big blind (0.50)
Player IlxxxlI received card: [Jh]
Player IlxxxlI received card: [6c]
Player foreseen folds
Player QDevilQ raises (1.50)
Player imperceptible folds
Player kidpokerak raises (5.25)
Player IlxxxlI folds
Player QDevilQ folds
Uncalled bet (4) returned to kidpokerak
Player kidpokerak mucks cards
------ Summary ------
Pot: 3.50. Rake 0
*Player kidpokerak mucks (does not show cards). Bets: 1.50. Collects: 3.50. Wins: 2.
Player IlxxxlI does not show cards.Bets: 0.50. Collects: 0. Loses: 0.50.
Player foreseen does not show cards.Bets: 0. Collects: 0. Wins: 0.
Player QDevilQ does not show cards.Bets: 1.50. Collects: 0. Loses: 1.50.
Player imperceptible does not show cards.Bets: 0. Collects: 0. Wins: 0.
Game ended at: 2016/11/29 12:3:32

Game started
Game ID: 786923175 0.25/0.50 (PRR) Gorgons - 8 (Hold'em)
Seat 4 is the button
Seat 1: kidpokerak (112.30).
Seat 2: IlxxxlI (20).
Seat 3: foreseen (71.42).
Seat 4: QDevilQ (102.27).
Seat 5: imperceptible (16.86).
Player imperceptible has small blind (0.25)
Player kidpokerak has big blind (0.50)
Player IlxxxlI received card: [10h]
Player IlxxxlI received card: [5c]
Player IlxxxlI folds
Player foreseen folds
Player QDevilQ raises (1.50)
Player imperceptible folds
Player kidpokerak calls (1)
*** FLOP ***: [Qs 6h Kd]
Player kidpokerak checks
Player QDevilQ bets (1.03)
Player kidpokerak folds
Uncalled bet (1.03) returned to QDevilQ
Player QDevilQ mucks cards
------ Summary ------
Pot: 3.09. Rake 0.12. JP fee 0.04
Board: [Qs 6h Kd]
Player kidpokerak does not show cards.Bets: 1.50. Collects: 0. Loses: 1.50.
Player IlxxxlI does not show cards.Bets: 0. Collects: 0. Wins: 0.
Player foreseen does not show cards.Bets: 0. Collects: 0. Wins: 0.
*Player QDevilQ mucks (does not show cards). Bets: 1.50. Collects: 3.09. Wins: 1.59.
Player imperceptible does not show cards.Bets: 0.25. Collects: 0. Loses: 0.25.
Game ended at: 2016/11/29 12:2:48

Game started
Game ID: 786922885 0.25/0.50 (PRR) Gorgons - 8 (Hold'em)
Seat 3 is the button
Seat 1: kidpokerak (112.30).
Seat 2: IlxxxlI (20).
Seat 3: foreseen (70.67).
Seat 4: QDevilQ (102.52).
Seat 5: imperceptible (17.36).
Player QDevilQ has small blind (0.25)
Player imperceptible has big blind (0.50)
Player IlxxxlI received card: [2d]
Player IlxxxlI received card: [2h]
Player kidpokerak folds
Player IlxxxlI folds
Player foreseen raises (1.12)
Player QDevilQ folds
Player imperceptible folds
Uncalled bet (0.62) returned to foreseen
Player foreseen mucks cards
------ Summary ------
Pot: 1.25. Rake 0
Player kidpokerak does not show cards.Bets: 0. Collects: 0. Wins: 0.
Player IlxxxlI does not show cards.Bets: 0. Collects: 0. Wins: 0.
*Player foreseen mucks (does not show cards). Bets: 0.50. Collects: 1.25. Wins: 0.75.
Player QDevilQ does not show cards.Bets: 0.25. Collects: 0. Loses: 0.25.
Player imperceptible does not show cards.Bets: 0.50. Collects: 0. Loses: 0.50.
Game ended at: 2016/11/29 12:1:55

Game started
Game ID: 786921348 0.25/0.50 (PRR) Gorgons - 8 (Hold'em)
Seat 2 is the button
Seat 1: kidpokerak (124.85).
Seat 2: IlxxxlI (20).
Seat 3: foreseen (56.77).
Seat 4: QDevilQ (103.02).
Seat 5: imperceptible (17.36).
Seat 6: Xobkcul (50.84).
Player foreseen has small blind (0.25)
Player QDevilQ has big blind (0.50)
Player IlxxxlI received card: [6c]
Player IlxxxlI received card: [6s]
Player imperceptible folds
Player Xobkcul raises (1.12)
Player kidpokerak calls (1.12)
Player IlxxxlI calls (1.12)
Player foreseen calls (0.87)
Player QDevilQ folds
*** FLOP ***: [7s 4s 2h]
Player foreseen checks
Player Xobkcul checks
Player kidpokerak bets (3.16)
Player IlxxxlI folds
Player foreseen calls (3.16)
Player Xobkcul folds
*** TURN ***: [7s 4s 2h] [Qc]
Player foreseen checks
Player kidpokerak checks
*** RIVER ***: [7s 4s 2h Qc] [Jc]
Player foreseen bets (8.27)
Player kidpokerak calls (8.27)
Player kidpokerak mucks cards
------ Summary ------
Pot: 26.45. Rake 1.15. JP fee 0.24
Board: [7s 4s 2h Qc Jc]
Player kidpokerak mucks (does not show cards). Bets: 12.55. Collects: 0. Loses: 12.55.
Player IlxxxlI does not show cards.Bets: 1.12. Collects: 0. Loses: 1.12.
*Player foreseen shows: One pair of 5s [5c 5d]. Bets: 12.55. Collects: 26.45. Wins: 13.90.
Player QDevilQ does not show cards.Bets: 0.50. Collects: 0. Loses: 0.50.
Player imperceptible does not show cards.Bets: 0. Collects: 0. Wins: 0.
Player Xobkcul does not show cards.Bets: 1.12. Collects: 0. Loses: 1.12.
Game ended at: 2016/11/29 12:1:29

Game started
Game ID: 786920951 0.25/0.50 (PRR) Gorgons - 8 (Hold'em)
Seat 1 is the button
Seat 1: kidpokerak (125.97).
Seat 2: IlxxxlI (20).
Seat 3: foreseen (54.28).
Seat 4: QDevilQ (103.02).
Seat 5: imperceptible (17.36).
Seat 6: Xobkcul (51.96).
Player IlxxxlI has small blind (0.25)
Player foreseen has big blind (0.50)
Player IlxxxlI received card: [Kc]
Player IlxxxlI received card: [Jd]
Player QDevilQ folds
Player imperceptible folds
Player Xobkcul raises (1.12)
Player kidpokerak calls (1.12)
Player IlxxxlI folds
Player foreseen raises (5.85)
Player Xobkcul folds
Player kidpokerak folds
Uncalled bet (5.23) returned to foreseen
Player foreseen mucks cards
------ Summary ------
Pot: 3.61. Rake 0
Player kidpokerak does not show cards.Bets: 1.12. Collects: 0. Loses: 1.12.
Player IlxxxlI does not show cards.Bets: 0.25. Collects: 0. Loses: 0.25.
*Player foreseen mucks (does not show cards). Bets: 1.12. Collects: 3.61. Wins: 2.49.
Player QDevilQ does not show cards.Bets: 0. Collects: 0. Wins: 0.
Player imperceptible does not show cards.Bets: 0. Collects: 0. Wins: 0.
Player Xobkcul does not show cards.Bets: 1.12. Collects: 0. Loses: 1.12.
Game ended at: 2016/11/29 11:59:6

Game started
Game ID: 786920634 0.25/0.50 (PRR) Gorgons - 8 (Hold'em)
Seat 6 is the button
Seat 1: kidpokerak (125.52).
Seat 2: IlxxxlI (20).
Seat 3: foreseen (54.28).
Seat 4: QDevilQ (103.02).
Seat 5: imperceptible (17.36).
Seat 6: Xobkcul (51.96).
Player kidpokerak has small blind (0.25)
Player IlxxxlI has big blind (0.50)
Player IlxxxlI received card: [5d]
Player IlxxxlI received card: [Qc]
Player foreseen folds
Player QDevilQ folds
Player imperceptible folds
Player Xobkcul folds
Player kidpokerak calls (0.25)
Player IlxxxlI checks
*** FLOP ***: [6h 8d 9s]
Player kidpokerak bets (0.50)
Player IlxxxlI folds
Uncalled bet (0.50) returned to kidpokerak
Player kidpokerak mucks cards
------ Summary ------
Pot: 0.95. Rake 0.05
Board: [6h 8d 9s]
*Player kidpokerak mucks (does not show cards). Bets: 0.50. Collects: 0.95. Wins: 0.45.
Player IlxxxlI does not show cards.Bets: 0.50. Collects: 0. Loses: 0.50.
Player foreseen does not show cards.Bets: 0. Collects: 0. Wins: 0.
Player QDevilQ does not show cards.Bets: 0. Collects: 0. Wins: 0.
Player imperceptible does not show cards.Bets: 0. Collects: 0. Wins: 0.
Player Xobkcul does not show cards.Bets: 0. Collects: 0. Wins: 0.
Game ended at: 2016/11/29 11:58:16

Game started
Game ID: 786919454 0.25/0.50 (PRR) Gorgons - 13 (Hold'em)
Seat 3 is the button
Seat 1: IlxxxlI (40.13).
Seat 3: xROCKETMANx (48.75).
Seat 5: foreseen (88.32).
Seat 6: 38979 (50).
Player foreseen has small blind (0.25)
Player 38979 has big blind (0.50)
Player IlxxxlI received card: [2h]
Player IlxxxlI received card: [6d]
Player IlxxxlI folds
Player xROCKETMANx folds
Player foreseen raises (1.39)
Player 38979 calls (1.14)
*** FLOP ***: [Jc 4d Js]
Player foreseen checks
Player 38979 bets (2.08)
Player foreseen calls (2.08)
*** TURN ***: [Jc 4d Js] [2c]
Player foreseen checks
Player 38979 bets (5)
Player foreseen folds
Uncalled bet (5) returned to 38979
Player 38979 mucks cards
------ Summary ------
Pot: 7.07. Rake 0.25. JP fee 0.12
Board: [Jc 4d Js 2c]
Player IlxxxlI does not show cards.Bets: 0. Collects: 0. Wins: 0.
Player xROCKETMANx does not show cards.Bets: 0. Collects: 0. Wins: 0.
Player foreseen does not show cards.Bets: 3.72. Collects: 0. Loses: 3.72.
*Player 38979 mucks (does not show cards). Bets: 3.72. Collects: 7.07. Wins: 3.35.
Game ended at: 2016/11/29 11:56:18

Game started
Game ID: 786918969 0.25/0.50 (PRR) Gorgons (Short) - 3 (Hold'em)
Seat 2 is the button
Seat 2: IlxxxlI (10.67).
Seat 6: 38979 (25.25).
Player IlxxxlI has small blind (0.25)
Player 38979 has big blind (0.50)
Player IlxxxlI received card: [9c]
Player IlxxxlI received card: [3s]
Player IlxxxlI folds
Uncalled bet (0.25) returned to 38979
Player 38979 mucks cards
------ Summary ------
Pot: 0.50. Rake 0
Player IlxxxlI does not show cards.Bets: 0.25. Collects: 0. Loses: 0.25.
*Player 38979 mucks (does not show cards). Bets: 0.25. Collects: 0.50. Wins: 0.25.
Game ended at: 2016/11/29 11:54:38

Game started
Game ID: 786918870 0.25/0.50 (PRR) Gorgons (Short) - 3 (Hold'em)
Seat 6 is the button
Seat 2: IlxxxlI (10.92).
Seat 3: BiGFck (11.75).
Seat 6: 38979 (25).
Player IlxxxlI has small blind (0.25)
Player BiGFck sitting out
Player 38979 has big blind (0.50)
Player IlxxxlI received card: [6s]
Player IlxxxlI received card: [7h]
Player IlxxxlI folds
Uncalled bet (0.25) returned to 38979
Player 38979 mucks cards
------ Summary ------
Pot: 0.50. Rake 0
Player IlxxxlI does not show cards.Bets: 0.25. Collects: 0. Loses: 0.25.
Player BiGFck does not show cards.Bets: 0. Collects: 0. Wins: 0.
*Player 38979 mucks (does not show cards). Bets: 0.25. Collects: 0.50. Wins: 0.25.
Game ended at: 2016/11/29 11:54:19

Game started
Game ID: 786918723 0.25/0.50 (PRR) Gorgons (Short) - 3 (Hold'em)
Seat 3 is the button
Seat 2: IlxxxlI (10.67).
Seat 3: BiGFck (11.75).
Seat 6: 38979 (25).
Player 38979 has small blind (0.25)
Player IlxxxlI has big blind (0.50)
Player IlxxxlI received card: [Jd]
Player IlxxxlI received card: [9h]
Player BiGFck folds
Player 38979 folds
Uncalled bet (0.25) returned to IlxxxlI
Player IlxxxlI mucks cards
------ Summary ------
Pot: 0.50. Rake 0
*Player IlxxxlI mucks (does not show cards). Bets: 0.25. Collects: 0.50. Wins: 0.25.
Player BiGFck does not show cards.Bets: 0. Collects: 0. Wins: 0.
Player 38979 does not show cards.Bets: 0.25. Collects: 0. Loses: 0.25.
Game ended at: 2016/11/29 11:54:11

Game started
Game ID: 786918554 0.25/0.50 (PRR) Gorgons (Short) - 3 (Hold'em)
Seat 2 is the button
Seat 2: IlxxxlI (10.67).
Seat 3: BiGFck (11.25).
Seat 5: imperceptible (31.80).
Seat 6: 38979 (25).
Player BiGFck has small blind (0.25)
Player imperceptible sitting out
Player 38979 has big blind (0.50)
Player IlxxxlI received card: [5c]
Player IlxxxlI received card: [4s]
Player IlxxxlI folds
Player BiGFck raises (0.75)
Player 38979 folds
Uncalled bet (0.50) returned to BiGFck
Player BiGFck mucks cards
------ Summary ------
Pot: 1. Rake 0
Player IlxxxlI does not show cards.Bets: 0. Collects: 0. Wins: 0.
*Player BiGFck mucks (does not show cards). Bets: 0.50. Collects: 1. Wins: 0.50.
Player imperceptible does not show cards.Bets: 0. Collects: 0. Wins: 0.
Player 38979 does not show cards.Bets: 0.50. Collects: 0. Loses: 0.50.
Game ended at: 2016/11/29 11:53:57

Game started
Game ID: 786918351 0.25/0.50 (PRR) Gorgons - 13 (Hold'em)
Seat 1 is the button
Seat 1: IlxxxlI (21.59).
Seat 2: EEL-iminator (17.50).
Seat 3: xROCKETMANx (49.25).
Seat 5: foreseen (88.32).
Seat 6: 38979 (50).
Player EEL-iminator has small blind (0.25)
Player xROCKETMANx has big blind (0.50)
Player IlxxxlI received card: [10h]
Player IlxxxlI received card: [10d]
Player foreseen folds
Player 38979 raises (1)
Player IlxxxlI raises (2.43)
Player EEL-iminator calls (2.18)
Player xROCKETMANx folds
Player 38979 calls (1.43)
*** FLOP ***: [8c 4s 5s]
Player EEL-iminator checks
Player 38979 checks
Player IlxxxlI bets (3.70)
Player EEL-iminator calls (3.70)
Player 38979 folds
*** TURN ***: [8c 4s 5s] [3c]
Player EEL-iminator checks
Player IlxxxlI allin (15.46)
Player EEL-iminator allin (11.37)
Uncalled bet (4.09) returned to IlxxxlI
*** RIVER ***: [8c 4s 5s 3c] [9h]
------ Summary ------
Pot: 36.04. Rake 1.65. JP fee 0.24
Board: [8c 4s 5s 3c 9h]
*Player IlxxxlI shows: One pair of 10s [10h 10d]. Bets: 17.50. Collects: 36.04. Wins: 18.54.
Player EEL-iminator shows: High card K [Qs Ks]. Bets: 17.50. Collects: 0. Loses: 17.50.
Player xROCKETMANx does not show cards.Bets: 0.50. Collects: 0. Loses: 0.50.
Player foreseen does not show cards.Bets: 0. Collects: 0. Wins: 0.
Player 38979 does not show cards.Bets: 2.43. Collects: 0. Loses: 2.43.
Game ended at: 2016/11/29 11:55:0

Game started
Game ID: 786918235 0.25/0.50 (PRR) Gorgons (Short) - 3 (Hold'em)
Seat 6 is the button
Seat 2: IlxxxlI (10.92).
Seat 3: BiGFck (10).
Seat 5: imperceptible (31.80).
Seat 6: 38979 (25).
Player IlxxxlI has small blind (0.25)
Player BiGFck has big blind (0.50)
Player IlxxxlI received card: [4s]
Player IlxxxlI received card: [2s]
Player imperceptible folds
Player 38979 raises (1)
Player IlxxxlI folds
Player BiGFck allin (9.50)
Player 38979 folds
Uncalled bet (9) returned to BiGFck
Player BiGFck mucks cards
------ Summary ------
Pot: 2.25. Rake 0
Player IlxxxlI does not show cards.Bets: 0.25. Collects: 0. Loses: 0.25.
*Player BiGFck mucks (does not show cards). Bets: 1. Collects: 2.25. Wins: 1.25.
Player imperceptible does not show cards.Bets: 0. Collects: 0. Wins: 0.
Player 38979 does not show cards.Bets: 1. Collects: 0. Loses: 1.
Game ended at: 2016/11/29 11:53:45

Game started
Game ID: 786917983 0.25/0.50 (PRR) Gorgons (Short) - 3 (Hold'em)
Seat 5 is the button
Seat 1: Parcker (28.38).
Seat 2: IlxxxlI (10.67).
Seat 5: imperceptible (31.80).
Seat 6: 38979 (25.25).
Player 38979 has small blind (0.25)
Player Parcker sitting out
Player IlxxxlI has big blind (0.50)
Player IlxxxlI received card: [2s]
Player IlxxxlI received card: [4d]
Player imperceptible folds
Player 38979 folds
Uncalled bet (0.25) returned to IlxxxlI
Player IlxxxlI mucks cards
------ Summary ------
Pot: 0.50. Rake 0
Player Parcker does not show cards.Bets: 0. Collects: 0. Wins: 0.
*Player IlxxxlI mucks (does not show cards). Bets: 0.25. Collects: 0.50. Wins: 0.25.
Player imperceptible does not show cards.Bets: 0. Collects: 0. Wins: 0.
Player 38979 does not show cards.Bets: 0.25. Collects: 0. Loses: 0.25.
Game ended at: 2016/11/29 11:53:20

Game started
Game ID: 786917919 0.25/0.50 (PRR) Gorgons - 13 (Hold'em)
Seat 6 is the button
Seat 1: IlxxxlI (21.84).
Seat 2: EEL-iminator (17.25).
Seat 3: xROCKETMANx (49.25).
Seat 5: foreseen (88.32).
Seat 6: 38979 (50).
Player IlxxxlI has small blind (0.25)
Player EEL-iminator has big blind (0.50)
Player IlxxxlI received card: [6c]
Player IlxxxlI received card: [Kh]
Player xROCKETMANx folds
Player foreseen folds
Player 38979 folds
Player IlxxxlI folds
Uncalled bet (0.25) returned to EEL-iminator
Player EEL-iminator mucks cards
------ Summary ------
Pot: 0.50. Rake 0
Player IlxxxlI does not show cards.Bets: 0.25. Collects: 0. Loses: 0.25.
*Player EEL-iminator mucks (does not show cards). Bets: 0.25. Collects: 0.50. Wins: 0.25.
Player xROCKETMANx does not show cards.Bets: 0. Collects: 0. Wins: 0.
Player foreseen does not show cards.Bets: 0. Collects: 0. Wins: 0.
Player 38979 does not show cards.Bets: 0. Collects: 0. Wins: 0.
Game ended at: 2016/11/29 11:53:28

Game started
Game ID: 786917541 0.25/0.50 (PRR) Gorgons (Short) - 3 (Hold'em)
Seat 2 is the button
Seat 1: Parcker (28.38).
Seat 2: IlxxxlI (10.67).
Seat 5: imperceptible (31.30).
Seat 6: 38979 (25.75).
Player imperceptible has small blind (0.25)
Player 38979 has big blind (0.50)
Player IlxxxlI received card: [10h]
Player IlxxxlI received card: [6h]
Player Parcker folds
Player IlxxxlI folds
Player imperceptible raises (0.75)
Player 38979 folds
Uncalled bet (0.50) returned to imperceptible
Player imperceptible mucks cards
------ Summary ------
Pot: 1. Rake 0
Player Parcker does not show cards.Bets: 0. Collects: 0. Wins: 0.
Player IlxxxlI does not show cards.Bets: 0. Collects: 0. Wins: 0.
*Player imperceptible mucks (does not show cards). Bets: 0.50. Collects: 1. Wins: 0.50.
Player 38979 does not show cards.Bets: 0.50. Collects: 0. Loses: 0.50.
Game ended at: 2016/11/29 11:53:0

Game started
Game ID: 786917530 0.25/0.50 (PRR) Gorgons - 13 (Hold'em)
Seat 5 is the button
Seat 1: IlxxxlI (22.34).
Seat 2: EEL-iminator (17.25).
Seat 3: xROCKETMANx (49.25).
Seat 5: foreseen (87.57).
Seat 6: 38979 (50).
Player 38979 has small blind (0.25)
Player IlxxxlI has big blind (0.50)
Player IlxxxlI received card: [10d]
Player IlxxxlI received card: [2h]
Player EEL-iminator folds
Player xROCKETMANx folds
Player foreseen raises (1.12)
Player 38979 folds
Player IlxxxlI folds
Uncalled bet (0.62) returned to foreseen
Player foreseen mucks cards
------ Summary ------
Pot: 1.25. Rake 0
Player IlxxxlI does not show cards.Bets: 0.50. Collects: 0. Loses: 0.50.
Player EEL-iminator does not show cards.Bets: 0. Collects: 0. Wins: 0.
Player xROCKETMANx does not show cards.Bets: 0. Collects: 0. Wins: 0.
*Player foreseen mucks (does not show cards). Bets: 0.50. Collects: 1.25. Wins: 0.75.
Player 38979 does not show cards.Bets: 0.25. Collects: 0. Loses: 0.25.
Game ended at: 2016/11/29 11:52:54

Game started
Game ID: 786917306 0.25/0.50 (PRR) Gorgons (Short) - 3 (Hold'em)
Seat 1 is the button
Seat 1: Parcker (28.38).
Seat 2: IlxxxlI (10.92).
Seat 5: imperceptible (31.80).
Seat 6: 38979 (25).
Player IlxxxlI has small blind (0.25)
Player imperceptible has big blind (0.50)
Player IlxxxlI received card: [As]
Player IlxxxlI received card: [2d]
Player 38979 raises (1)
Player Parcker folds
Player IlxxxlI folds
Player imperceptible folds
Uncalled bet (0.50) returned to 38979
Player 38979 mucks cards
------ Summary ------
Pot: 1.25. Rake 0
Player Parcker does not show cards.Bets: 0. Collects: 0. Wins: 0.
Player IlxxxlI does not show cards.Bets: 0.25. Collects: 0. Loses: 0.25.
Player imperceptible does not show cards.Bets: 0.50. Collects: 0. Loses: 0.50.
*Player 38979 mucks (does not show cards). Bets: 0.50. Collects: 1.25. Wins: 0.75.
Game ended at: 2016/11/29 11:52:23

Game started
Game ID: 786917096 0.25/0.50 (PRR) Gorgons (Short) - 3 (Hold'em)
Seat 6 is the button
Seat 1: Parcker (28.63).
Seat 2: IlxxxlI (11.42).
Seat 3: beachrog (61.78).
Seat 4: ijhAA (9.25).
Seat 5: imperceptible (31.05).
Seat 6: 38979 (25).
Player Parcker has small blind (0.25)
Player IlxxxlI has big blind (0.50)
Player IlxxxlI received card: [3s]
Player IlxxxlI received card: [Js]
Player beachrog folds
Player ijhAA folds
Player imperceptible raises (1)
Player 38979 folds
Player Parcker folds
Player IlxxxlI folds
Uncalled bet (0.50) returned to imperceptible
Player imperceptible mucks cards
------ Summary ------
Pot: 1.25. Rake 0
Player Parcker does not show cards.Bets: 0.25. Collects: 0. Loses: 0.25.
Player IlxxxlI does not show cards.Bets: 0.50. Collects: 0. Loses: 0.50.
Player beachrog does not show cards.Bets: 0. Collects: 0. Wins: 0.
Player ijhAA does not show cards.Bets: 0. Collects: 0. Wins: 0.
*Player imperceptible mucks (does not show cards). Bets: 0.50. Collects: 1.25. Wins: 0.75.
Player 38979 does not show cards.Bets: 0. Collects: 0. Wins: 0.
Game ended at: 2016/11/29 11:52:5

Game started
Game ID: 786916444 0.25/0.50 (PRR) Gorgons - 13 (Hold'em)
Seat 4 is the button
Seat 1: IlxxxlI (22.34).
Seat 2: EEL-iminator (22.25).
Seat 3: xROCKETMANx (49.25).
Seat 4: 528 Hertz (90.95).
Seat 5: foreseen (82.59).
Seat 6: 38979 (50).
Player foreseen has small blind (0.25)
Player 38979 has big blind (0.50)
Player IlxxxlI received card: [Jd]
Player IlxxxlI received card: [8d]
Player IlxxxlI folds
Player EEL-iminator calls (0.50)
Player xROCKETMANx folds
Player 528 Hertz folds
Player foreseen raises (2.26)
Player 38979 folds
Player EEL-iminator calls (2.01)
*** FLOP ***: [Ks 2d 6h]
Player foreseen bets (2.49)
Player EEL-iminator calls (2.49)
*** TURN ***: [Ks 2d 6h] [9s]
Player foreseen checks
Player EEL-iminator checks
*** RIVER ***: [Ks 2d 6h 9s] [9h]
Player foreseen checks
Player EEL-iminator checks
Player EEL-iminator mucks cards
------ Summary ------
Pot: 9.98. Rake 0.36. JP fee 0.16
Board: [Ks 2d 6h 9s 9h]
Player IlxxxlI does not show cards.Bets: 0. Collects: 0. Wins: 0.
Player EEL-iminator mucks (does not show cards). Bets: 5. Collects: 0. Loses: 5.
Player xROCKETMANx does not show cards.Bets: 0. Collects: 0. Wins: 0.
Player 528 Hertz does not show cards.Bets: 0. Collects: 0. Wins: 0.
*Player foreseen shows: One pair of 9s [Ac Jh]. Bets: 5. Collects: 9.98. Wins: 4.98.
Player 38979 does not show cards.Bets: 0.50. Collects: 0. Loses: 0.50.
Game ended at: 2016/11/29 11:52:19

Game started
Game ID: 786916376 0.25/0.50 (PRR) Gorgons (Short) - 3 (Hold'em)
Seat 5 is the button
Seat 1: Parcker (29.13).
Seat 2: IlxxxlI (12.42).
Seat 3: beachrog (60.03).
Seat 4: ijhAA (9.25).
Seat 5: imperceptible (31.05).
Seat 6: 38979 (25).
Player 38979 has small blind (0.25)
Player Parcker has big blind (0.50)
Player IlxxxlI received card: [10h]
Player IlxxxlI received card: [As]
Player IlxxxlI raises (1)
Player beachrog raises (3.50)
Player ijhAA folds
Player imperceptible folds
Player 38979 folds
Player Parcker folds
Player IlxxxlI folds
Uncalled bet (2.50) returned to beachrog
Player beachrog mucks cards
------ Summary ------
Pot: 2.75. Rake 0
Player Parcker does not show cards.Bets: 0.50. Collects: 0. Loses: 0.50.
Player IlxxxlI does not show cards.Bets: 1. Collects: 0. Loses: 1.
*Player beachrog mucks (does not show cards). Bets: 1. Collects: 2.75. Wins: 1.75.
Player ijhAA does not show cards.Bets: 0. Collects: 0. Wins: 0.
Player imperceptible does not show cards.Bets: 0. Collects: 0. Wins: 0.
Player 38979 does not show cards.Bets: 0.25. Collects: 0. Loses: 0.25.
Game ended at: 2016/11/29 11:51:47

Game started
Game ID: 786916184 0.25/0.50 (PRR) Gorgons (Short) - 3 (Hold'em)
Seat 4 is the button
Seat 2: IlxxxlI (12.42).
Seat 3: beachrog (59.28).
Seat 4: ijhAA (9.25).
Seat 5: imperceptible (31.30).
Seat 6: 38979 (25).
Player imperceptible has small blind (0.25)
Player 38979 has big blind (0.50)
Player IlxxxlI received card: [Qc]
Player IlxxxlI received card: [8h]
Player IlxxxlI folds
Player beachrog raises (1.50)
Player ijhAA folds
Player imperceptible folds
Player 38979 folds
Uncalled bet (1) returned to beachrog
Player beachrog mucks cards
------ Summary ------
Pot: 1.25. Rake 0
Player IlxxxlI does not show cards.Bets: 0. Collects: 0. Wins: 0.
*Player beachrog mucks (does not show cards). Bets: 0.50. Collects: 1.25. Wins: 0.75.
Player ijhAA does not show cards.Bets: 0. Collects: 0. Wins: 0.
Player imperceptible does not show cards.Bets: 0.25. Collects: 0. Loses: 0.25.
Player 38979 does not show cards.Bets: 0.50. Collects: 0. Loses: 0.50.
Game ended at: 2016/11/29 11:50:51

Game started
Game ID: 786915751 0.25/0.50 (PRR) Gorgons (Short) - 3 (Hold'em)
Seat 3 is the button
Seat 2: IlxxxlI (12.42).
Seat 3: beachrog (59.28).
Seat 4: ijhAA (9.50).
Seat 5: imperceptible (31.05).
Player ijhAA has small blind (0.25)
Player imperceptible has big blind (0.50)
Player IlxxxlI received card: [8h]
Player IlxxxlI received card: [9h]
Player IlxxxlI folds
Player beachrog folds
Player ijhAA folds
Uncalled bet (0.25) returned to imperceptible
Player imperceptible mucks cards
------ Summary ------
Pot: 0.50. Rake 0
Player IlxxxlI does not show cards.Bets: 0. Collects: 0. Wins: 0.
Player beachrog does not show cards.Bets: 0. Collects: 0. Wins: 0.
Player ijhAA does not show cards.Bets: 0.25. Collects: 0. Loses: 0.25.
*Player imperceptible mucks (does not show cards). Bets: 0.25. Collects: 0.50. Wins: 0.25.
Game ended at: 2016/11/29 11:50:35

Game started
Game ID: 786915509 0.25/0.50 (PRR) Gorgons (Short) - 3 (Hold'em)
Seat 2 is the button
Seat 2: IlxxxlI (11.67).
Seat 3: beachrog (59.53).
Seat 4: ijhAA (10).
Seat 5: imperceptible (31.05).
Player beachrog has small blind (0.25)
Player ijhAA has big blind (0.50)
Player IlxxxlI received card: [6h]
Player IlxxxlI received card: [6d]
Player imperceptible folds
Player IlxxxlI allin (11.67)
Player beachrog folds
Player ijhAA folds
Uncalled bet (11.17) returned to IlxxxlI
Player IlxxxlI mucks cards
------ Summary ------
Pot: 1.25. Rake 0
*Player IlxxxlI mucks (does not show cards). Bets: 0.50. Collects: 1.25. Wins: 0.75.
Player beachrog does not show cards.Bets: 0.25. Collects: 0. Loses: 0.25.
Player ijhAA does not show cards.Bets: 0.50. Collects: 0. Loses: 0.50.
Player imperceptible does not show cards.Bets: 0. Collects: 0. Wins: 0.
Game ended at: 2016/11/29 11:50:3

Game started
Game ID: 786915243 0.25/0.50 (PRR) Gorgons - 13 (Hold'em)
Seat 3 is the button
Seat 1: IlxxxlI (22.34).
Seat 2: EEL-iminator (20).
Seat 3: xROCKETMANx (49.25).
Seat 4: 528 Hertz (91.20).
Seat 5: foreseen (84.82).
Seat 6: 38979 (50).
Player 528 Hertz has small blind (0.25)
Player foreseen has big blind (0.50)
Player EEL-iminator posts (0.50)
Player IlxxxlI received card: [5d]
Player IlxxxlI received card: [2h]
Player 38979 folds
Player IlxxxlI folds
Player EEL-iminator checks
Player xROCKETMANx folds
Player 528 Hertz folds
Player foreseen checks
*** FLOP ***: [7s Ad 9d]
Player foreseen checks
Player EEL-iminator bets (0.50)
Player foreseen calls (0.50)
*** TURN ***: [7s Ad 9d] [As]
Player foreseen checks
Player EEL-iminator checks
*** RIVER ***: [7s Ad 9d As] [7h]
Player foreseen bets (1.23)
Player EEL-iminator raises (3)
Player foreseen folds
Uncalled bet (1.77) returned to EEL-iminator
Player EEL-iminator mucks cards
------ Summary ------
Pot: 4.48. Rake 0.17. JP fee 0.06
Board: [7s Ad 9d As 7h]
Player IlxxxlI does not show cards.Bets: 0. Collects: 0. Wins: 0.
*Player EEL-iminator mucks (does not show cards). Bets: 2.23. Collects: 4.48. Wins: 2.25.
Player xROCKETMANx does not show cards.Bets: 0. Collects: 0. Wins: 0.
Player 528 Hertz does not show cards.Bets: 0.25. Collects: 0. Loses: 0.25.
Player foreseen does not show cards.Bets: 2.23. Collects: 0. Loses: 2.23.
Player 38979 does not show cards.Bets: 0. Collects: 0. Wins: 0.
Game ended at: 2016/11/29 11:50:56

Game started
Game ID: 786914933 0.25/0.50 (PRR) Gorgons - 13 (Hold'em)
Seat 1 is the button
Seat 1: IlxxxlI (22.34).
Seat 3: xROCKETMANx (49.50).
Seat 4: 528 Hertz (90.95).
Seat 5: foreseen (84.82).
Seat 6: 38979 (50).
Player xROCKETMANx has small blind (0.25)
Player 528 Hertz has big blind (0.50)
Player IlxxxlI received card: [Jd]
Player IlxxxlI received card: [10h]
Player foreseen folds
Player 38979 folds
Player IlxxxlI folds
Player xROCKETMANx folds
Uncalled bet (0.25) returned to 528 Hertz
Player 528 Hertz mucks cards
------ Summary ------
Pot: 0.50. Rake 0
Player IlxxxlI does not show cards.Bets: 0. Collects: 0. Wins: 0.
Player xROCKETMANx does not show cards.Bets: 0.25. Collects: 0. Loses: 0.25.
*Player 528 Hertz mucks (does not show cards). Bets: 0.25. Collects: 0.50. Wins: 0.25.
Player foreseen does not show cards.Bets: 0. Collects: 0. Wins: 0.
Player 38979 does not show cards.Bets: 0. Collects: 0. Wins: 0.
Game ended at: 2016/11/29 11:49:23

Game started
Game ID: 786914543 0.25/0.50 (PRR) Gorgons (Short) - 3 (Hold'em)
Seat 5 is the button
Seat 2: IlxxxlI (10.75).
Seat 3: beachrog (60.55).
Seat 5: imperceptible (31.05).
Player IlxxxlI has small blind (0.25)
Player beachrog has big blind (0.50)
Player IlxxxlI received card: [3d]
Player IlxxxlI received card: [6d]
Player imperceptible folds
Player IlxxxlI calls (0.25)
Player beachrog checks
*** FLOP ***: [6c 7s 2c]
Player IlxxxlI checks
Player beachrog checks
*** TURN ***: [6c 7s 2c] [4h]
Player IlxxxlI bets (0.52)
Player beachrog calls (0.52)
*** RIVER ***: [6c 7s 2c 4h] [7c]
Player IlxxxlI checks
Player beachrog checks
Player beachrog mucks cards
------ Summary ------
Pot: 1.94. Rake 0.08. JP fee 0.02
Board: [6c 7s 2c 4h 7c]
*Player IlxxxlI shows: Two pairs. 7s and 6s [3d 6d]. Bets: 1.02. Collects: 1.94. Wins: 0.92.
Player beachrog mucks (does not show cards). Bets: 1.02. Collects: 0. Loses: 1.02.
Player imperceptible does not show cards.Bets: 0. Collects: 0. Wins: 0.
Game ended at: 2016/11/29 11:49:42

Game started
Game ID: 786914145 0.25/0.50 (PRR) Gorgons - 13 (Hold'em)
Seat 6 is the button
Seat 1: IlxxxlI (22.59).
Seat 3: xROCKETMANx (50).
Seat 4: 528 Hertz (90.20).
Seat 5: foreseen (84.82).
Seat 6: 38979 (50).
Player IlxxxlI has small blind (0.25)
Player xROCKETMANx has big blind (0.50)
Player IlxxxlI received card: [5h]
Player IlxxxlI received card: [Qd]
Player 528 Hertz raises (1.75)
Player foreseen folds
Player 38979 folds
Player IlxxxlI folds
Player xROCKETMANx folds
Uncalled bet (1.25) returned to 528 Hertz
Player 528 Hertz mucks cards
------ Summary ------
Pot: 1.25. Rake 0
Player IlxxxlI does not show cards.Bets: 0.25. Collects: 0. Loses: 0.25.
Player xROCKETMANx does not show cards.Bets: 0.50. Collects: 0. Loses: 0.50.
*Player 528 Hertz mucks (does not show cards). Bets: 0.50. Collects: 1.25. Wins: 0.75.
Player foreseen does not show cards.Bets: 0. Collects: 0. Wins: 0.
Player 38979 does not show cards.Bets: 0. Collects: 0. Wins: 0.
Game ended at: 2016/11/29 11:48:59

Game started
Game ID: 786913686 0.25/0.50 (PRR) Gorgons (Short) - 3 (Hold'em)
Seat 3 is the button
Seat 2: IlxxxlI (10.75).
Seat 3: beachrog (35.15).
Seat 4: MEDSat420ish (26.40).
Seat 5: imperceptible (32.05).
Player MEDSat420ish has small blind (0.25)
Player imperceptible has big blind (0.50)
Player IlxxxlI received card: [3s]
Player IlxxxlI received card: [3d]
Player IlxxxlI folds
Player beachrog raises (1)
Player MEDSat420ish calls (0.75)
Player imperceptible calls (0.50)
*** FLOP ***: [2d 9c Qd]
Player MEDSat420ish checks
Player imperceptible checks
Player beachrog bets (1.90)
Player MEDSat420ish raises (5.70)
Player imperceptible folds
Player beachrog calls (3.80)
*** TURN ***: [2d 9c Qd] [3h]
Player MEDSat420ish checks
Player beachrog bets (6.84)
Player MEDSat420ish calls (6.84)
*** RIVER ***: [2d 9c Qd 3h] [2h]
Player MEDSat420ish allin (12.86)
Player beachrog calls (12.86)
------ Summary ------
Pot: 51.80. Rake 1.76. JP fee 0.24
Board: [2d 9c Qd 3h 2h]
Player IlxxxlI does not show cards.Bets: 0. Collects: 0. Wins: 0.
*Player beachrog shows: Two pairs. Qs and 2s [8h Qh]. Bets: 26.40. Collects: 51.80. Wins: 25.40.
Player MEDSat420ish shows: One pair of 2s [Jd 10s]. Bets: 26.40. Collects: 0. Loses: 26.40.
Player imperceptible does not show cards.Bets: 1. Collects: 0. Loses: 1.
Game ended at: 2016/11/29 11:48:27

Game started
Game ID: 786913579 0.25/0.50 (PRR) Gorgons - 13 (Hold'em)
Seat 5 is the button
Seat 1: IlxxxlI (23.71).
Seat 2: Maria_Pia (22.49).
Seat 3: xROCKETMANx (46.84).
Seat 4: 528 Hertz (90.20).
Seat 5: foreseen (83.57).
Seat 6: 38979 (50.25).
Player 38979 has small blind (0.25)
Player IlxxxlI has big blind (0.50)
Player IlxxxlI received card: [4h]
Player IlxxxlI received card: [Ah]
Player Maria_Pia folds
Player xROCKETMANx folds
Player 528 Hertz folds
Player foreseen raises (1.12)
Player 38979 folds
Player IlxxxlI calls (0.62)
*** FLOP ***: [Qd 10s 6s]
Player IlxxxlI checks
Player foreseen bets (1.94)
Player IlxxxlI folds
Uncalled bet (1.94) returned to foreseen
Player foreseen mucks cards
------ Summary ------
Pot: 2.37. Rake 0.08. JP fee 0.04
Board: [Qd 10s 6s]
Player IlxxxlI does not show cards.Bets: 1.12. Collects: 0. Loses: 1.12.
Player Maria_Pia does not show cards.Bets: 0. Collects: 0. Wins: 0.
Player xROCKETMANx does not show cards.Bets: 0. Collects: 0. Wins: 0.
Player 528 Hertz does not show cards.Bets: 0. Collects: 0. Wins: 0.
*Player foreseen mucks (does not show cards). Bets: 1.12. Collects: 2.37. Wins: 1.25.
Player 38979 does not show cards.Bets: 0.25. Collects: 0. Loses: 0.25.
Game ended at: 2016/11/29 11:47:57

Game started
Game ID: 786913212 0.25/0.50 (PRR) Gorgons (Short) - 3 (Hold'em)
Seat 2 is the button
Seat 2: IlxxxlI (10.75).
Seat 3: beachrog (34.65).
Seat 4: MEDSat420ish (26.90).
Seat 5: imperceptible (32.05).
Player beachrog has small blind (0.25)
Player MEDSat420ish has big blind (0.50)
Player IlxxxlI received card: [9h]
Player IlxxxlI received card: [4h]
Player imperceptible folds
Player IlxxxlI folds
Player beachrog raises (0.75)
Player MEDSat420ish folds
Uncalled bet (0.50) returned to beachrog
Player beachrog mucks cards
------ Summary ------
Pot: 1. Rake 0
Player IlxxxlI does not show cards.Bets: 0. Collects: 0. Wins: 0.
*Player beachrog mucks (does not show cards). Bets: 0.50. Collects: 1. Wins: 0.50.
Player MEDSat420ish does not show cards.Bets: 0.50. Collects: 0. Loses: 0.50.
Player imperceptible does not show cards.Bets: 0. Collects: 0. Wins: 0.
Game ended at: 2016/11/29 11:47:22

Game started
Game ID: 786913115 0.25/0.50 (PRR) Gorgons - 13 (Hold'em)
Seat 4 is the button
Seat 1: IlxxxlI (23.71).
Seat 2: Maria_Pia (22.49).
Seat 3: xROCKETMANx (46.84).
Seat 4: 528 Hertz (90.20).
Seat 5: foreseen (83.82).
Seat 6: 38979 (50).
Player foreseen has small blind (0.25)
Player 38979 has big blind (0.50)
Player IlxxxlI received card: [5d]
Player IlxxxlI received card: [2d]
Player IlxxxlI folds
Player Maria_Pia folds
Player xROCKETMANx folds
Player 528 Hertz folds
Player foreseen folds
Uncalled bet (0.25) returned to 38979
Player 38979 mucks cards
------ Summary ------
Pot: 0.50. Rake 0
Player IlxxxlI does not show cards.Bets: 0. Collects: 0. Wins: 0.
Player Maria_Pia does not show cards.Bets: 0. Collects: 0. Wins: 0.
Player xROCKETMANx does not show cards.Bets: 0. Collects: 0. Wins: 0.
Player 528 Hertz does not show cards.Bets: 0. Collects: 0. Wins: 0.
Player foreseen does not show cards.Bets: 0.25. Collects: 0. Loses: 0.25.
*Player 38979 mucks (does not show cards). Bets: 0.25. Collects: 0.50. Wins: 0.25.
Game ended at: 2016/11/29 11:47:13

Game started
Game ID: 786912904 0.25/0.50 (PRR) Gorgons (Short) - 3 (Hold'em)
Seat 5 is the button
Seat 2: IlxxxlI (11).
Seat 3: beachrog (35.15).
Seat 4: MEDSat420ish (26.15).
Seat 5: imperceptible (32.05).
Player IlxxxlI has small blind (0.25)
Player beachrog has big blind (0.50)
Player IlxxxlI received card: [8c]
Player IlxxxlI received card: [4d]
Player MEDSat420ish raises (1.50)
Player imperceptible folds
Player IlxxxlI folds
Player beachrog folds
Uncalled bet (1) returned to MEDSat420ish
Player MEDSat420ish mucks cards
------ Summary ------
Pot: 1.25. Rake 0
Player IlxxxlI does not show cards.Bets: 0.25. Collects: 0. Loses: 0.25.
Player beachrog does not show cards.Bets: 0.50. Collects: 0. Loses: 0.50.
*Player MEDSat420ish mucks (does not show cards). Bets: 0.50. Collects: 1.25. Wins: 0.75.
Player imperceptible does not show cards.Bets: 0. Collects: 0. Wins: 0.
Game ended at: 2016/11/29 11:46:44

Game started
Game ID: 786912525 0.25/0.50 (PRR) Gorgons (Short) - 3 (Hold'em)
Seat 4 is the button
Seat 1: Maria_Pia (22.74).
Seat 2: IlxxxlI (10).
Seat 3: beachrog (35.15).
Seat 4: MEDSat420ish (26.15).
Seat 5: imperceptible (33.05).
Player imperceptible has small blind (0.25)
Player Maria_Pia sitting out
Player IlxxxlI has big blind (0.50)
Player IlxxxlI received card: [As]
Player IlxxxlI received card: [Qd]
Player beachrog folds
Player MEDSat420ish folds
Player imperceptible raises (0.75)
Player IlxxxlI allin (9.50)
Player imperceptible folds
Uncalled bet (9) returned to IlxxxlI
Player IlxxxlI mucks cards
------ Summary ------
Pot: 2. Rake 0
Player Maria_Pia does not show cards.Bets: 0. Collects: 0. Wins: 0.
*Player IlxxxlI mucks (does not show cards). Bets: 1. Collects: 2. Wins: 1.
Player beachrog does not show cards.Bets: 0. Collects: 0. Wins: 0.
Player MEDSat420ish does not show cards.Bets: 0. Collects: 0. Wins: 0.
Player imperceptible does not show cards.Bets: 1. Collects: 0. Loses: 1.
Game ended at: 2016/11/29 11:46:21

Game started
Game ID: 786912234 0.25/0.50 (PRR) Gorgons - 13 (Hold'em)
Seat 3 is the button
Seat 1: IlxxxlI (23.71).
Seat 2: Maria_Pia (22.49).
Seat 3: xROCKETMANx (50).
Seat 4: 528 Hertz (86.88).
Seat 5: foreseen (84.32).
Seat 6: 38979 (50).
Player 528 Hertz has small blind (0.25)
Player foreseen has big blind (0.50)
Player IlxxxlI received card: [3h]
Player IlxxxlI received card: [6c]
Player 38979 folds
Player IlxxxlI folds
Player Maria_Pia folds
Player xROCKETMANx raises (1.50)
Player 528 Hertz calls (1.25)
Player foreseen folds
*** FLOP ***: [7h 10d Ad]
Player 528 Hertz checks
Player xROCKETMANx bets (1.66)
Player 528 Hertz calls (1.66)
*** TURN ***: [7h 10d Ad] [10c]
Player 528 Hertz checks
Player xROCKETMANx checks
*** RIVER ***: [7h 10d Ad 10c] [Qs]
Player 528 Hertz checks
Player xROCKETMANx checks
Player xROCKETMANx mucks cards
------ Summary ------
Pot: 6.48. Rake 0.24. JP fee 0.10
Board: [7h 10d Ad 10c Qs]
Player IlxxxlI does not show cards.Bets: 0. Collects: 0. Wins: 0.
Player Maria_Pia does not show cards.Bets: 0. Collects: 0. Wins: 0.
Player xROCKETMANx mucks (does not show cards). Bets: 3.16. Collects: 0. Loses: 3.16.
*Player 528 Hertz shows: Two pairs. As and 10s [9c Ac]. Bets: 3.16. Collects: 6.48. Wins: 3.32.
Player foreseen does not show cards.Bets: 0.50. Collects: 0. Loses: 0.50.
Player 38979 does not show cards.Bets: 0. Collects: 0. Wins: 0.
Game ended at: 2016/11/29 11:46:35

Game started
Game ID: 786912028 0.25/0.50 (PRR) Gorgons - 13 (Hold'em)
Seat 2 is the button
Seat 1: IlxxxlI (23.71).
Seat 2: Maria_Pia (22.49).
Seat 3: xROCKETMANx (50.25).
Seat 4: 528 Hertz (86.63).
Seat 5: foreseen (84.32).
Seat 6: 38979 (50).
Player xROCKETMANx has small blind (0.25)
Player 528 Hertz has big blind (0.50)
Player IlxxxlI received card: [Jc]
Player IlxxxlI received card: [8c]
Player foreseen folds
Player 38979 folds
Player IlxxxlI folds
Player Maria_Pia folds
Player xROCKETMANx folds
Uncalled bet (0.25) returned to 528 Hertz
Player 528 Hertz mucks cards
------ Summary ------
Pot: 0.50. Rake 0
Player IlxxxlI does not show cards.Bets: 0. Collects: 0. Wins: 0.
Player Maria_Pia does not show cards.Bets: 0. Collects: 0. Wins: 0.
Player xROCKETMANx does not show cards.Bets: 0.25. Collects: 0. Loses: 0.25.
*Player 528 Hertz mucks (does not show cards). Bets: 0.25. Collects: 0.50. Wins: 0.25.
Player foreseen does not show cards.Bets: 0. Collects: 0. Wins: 0.
Player 38979 does not show cards.Bets: 0. Collects: 0. Wins: 0.
Game ended at: 2016/11/29 11:45:29

Game started
Game ID: 786911752 0.25/0.50 (PRR) Gorgons - 13 (Hold'em)
Seat 1 is the button
Seat 1: IlxxxlI (23.71).
Seat 2: Maria_Pia (22.74).
Seat 3: xROCKETMANx (50).
Seat 5: foreseen (84.32).
Seat 6: 38979 (50).
Player Maria_Pia has small blind (0.25)
Player xROCKETMANx has big blind (0.50)
Player IlxxxlI received card: [5c]
Player IlxxxlI received card: [8h]
Player foreseen folds
Player 38979 folds
Player IlxxxlI folds
Player Maria_Pia folds
Uncalled bet (0.25) returned to xROCKETMANx
Player xROCKETMANx mucks cards
------ Summary ------
Pot: 0.50. Rake 0
Player IlxxxlI does not show cards.Bets: 0. Collects: 0. Wins: 0.
Player Maria_Pia does not show cards.Bets: 0.25. Collects: 0. Loses: 0.25.
*Player xROCKETMANx mucks (does not show cards). Bets: 0.25. Collects: 0.50. Wins: 0.25.
Player foreseen does not show cards.Bets: 0. Collects: 0. Wins: 0.
Player 38979 does not show cards.Bets: 0. Collects: 0. Wins: 0.
Game ended at: 2016/11/29 11:45:9

Game started
Game ID: 786911710 0.25/0.50 (PRR) Gorgons (Short) - 3 (Hold'em)
Seat 3 is the button
Seat 1: Maria_Pia (22.74).
Seat 2: IlxxxlI (10).
Seat 3: beachrog (35.15).
Seat 4: MEDSat420ish (25.25).
Seat 5: imperceptible (34.05).
Seat 6: Parcker (29.13).
Player MEDSat420ish has small blind (0.25)
Player imperceptible has big blind (0.50)
Player IlxxxlI received card: [Jd]
Player IlxxxlI received card: [6s]
Player Parcker folds
Player Maria_Pia folds
Player IlxxxlI folds
Player beachrog folds
Player MEDSat420ish calls (0.25)
Player imperceptible checks
*** FLOP ***: [8h 4c 2d]
Player MEDSat420ish checks
Player imperceptible bets (0.50)
Player MEDSat420ish calls (0.50)
*** TURN ***: [8h 4c 2d] [6h]
Player MEDSat420ish checks
Player imperceptible checks
*** RIVER ***: [8h 4c 2d 6h] [3d]
Player MEDSat420ish bets (1.26)
Player imperceptible folds
Uncalled bet (1.26) returned to MEDSat420ish
Player MEDSat420ish mucks cards
------ Summary ------
Pot: 1.90. Rake 0.08. JP fee 0.02
Board: [8h 4c 2d 6h 3d]
Player Maria_Pia does not show cards.Bets: 0. Collects: 0. Wins: 0.
Player IlxxxlI does not show cards.Bets: 0. Collects: 0. Wins: 0.
Player beachrog does not show cards.Bets: 0. Collects: 0. Wins: 0.
*Player MEDSat420ish mucks (does not show cards). Bets: 1. Collects: 1.90. Wins: 0.90.
Player imperceptible does not show cards.Bets: 1. Collects: 0. Loses: 1.
Player Parcker does not show cards.Bets: 0. Collects: 0. Wins: 0.
Game ended at: 2016/11/29 11:45:52

Game started
Game ID: 786911205 0.25/0.50 (PRR) Gorgons - 13 (Hold'em)
Seat 6 is the button
Seat 1: IlxxxlI (23.96).
Seat 2: Maria_Pia (22.49).
Seat 3: xROCKETMANx (50).
Seat 4: 528 Hertz (86.63).
Seat 5: foreseen (84.32).
Seat 6: 38979 (50).
Player IlxxxlI has small blind (0.25)
Player Maria_Pia has big blind (0.50)
Player IlxxxlI received card: [3s]
Player IlxxxlI received card: [10s]
Player xROCKETMANx folds
Player 528 Hertz is timed out.
Player 528 Hertz folds
Player foreseen folds
Player 38979 folds
Player IlxxxlI folds
Uncalled bet (0.25) returned to Maria_Pia
Player Maria_Pia mucks cards
------ Summary ------
Pot: 0.50. Rake 0
Player IlxxxlI does not show cards.Bets: 0.25. Collects: 0. Loses: 0.25.
*Player Maria_Pia mucks (does not show cards). Bets: 0.25. Collects: 0.50. Wins: 0.25.
Player xROCKETMANx does not show cards.Bets: 0. Collects: 0. Wins: 0.
Player 528 Hertz does not show cards.Bets: 0. Collects: 0. Wins: 0.
Player foreseen does not show cards.Bets: 0. Collects: 0. Wins: 0.
Player 38979 does not show cards.Bets: 0. Collects: 0. Wins: 0.
Game ended at: 2016/11/29 11:44:50

Game started
Game ID: 786911057 0.25/0.50 (PRR) Gorgons (Short) - 3 (Hold'em)
Seat 2 is the button
Seat 1: Maria_Pia (22.74).
Seat 2: IlxxxlI (10).
Seat 3: beachrog (34.65).
Seat 4: MEDSat420ish (25.75).
Seat 5: imperceptible (34.05).
Seat 6: Parcker (29.13).
Player beachrog has small blind (0.25)
Player MEDSat420ish has big blind (0.50)
Player IlxxxlI received card: [4c]
Player IlxxxlI received card: [Ah]
Player imperceptible folds
Player Parcker folds
Player Maria_Pia folds
Player IlxxxlI folds
Player beachrog raises (0.75)
Player MEDSat420ish folds
Uncalled bet (0.50) returned to beachrog
Player beachrog mucks cards
------ Summary ------
Pot: 1. Rake 0
Player Maria_Pia does not show cards.Bets: 0. Collects: 0. Wins: 0.
Player IlxxxlI does not show cards.Bets: 0. Collects: 0. Wins: 0.
*Player beachrog mucks (does not show cards). Bets: 0.50. Collects: 1. Wins: 0.50.
Player MEDSat420ish does not show cards.Bets: 0.50. Collects: 0. Loses: 0.50.
Player imperceptible does not show cards.Bets: 0. Collects: 0. Wins: 0.
Player Parcker does not show cards.Bets: 0. Collects: 0. Wins: 0.
Game ended at: 2016/11/29 11:44:47

Game started
Game ID: 786910801 0.25/0.50 (PRR) Gorgons - 13 (Hold'em)
Seat 5 is the button
Seat 1: IlxxxlI (24.46).
Seat 2: Maria_Pia (22.49).
Seat 3: xROCKETMANx (50).
Seat 4: 528 Hertz (86.63).
Seat 5: foreseen (83.57).
Seat 6: 38979 (50).
Player 38979 has small blind (0.25)
Player IlxxxlI has big blind (0.50)
Player IlxxxlI received card: [10h]
Player IlxxxlI received card: [5d]
Player Maria_Pia folds
Player xROCKETMANx folds
Player 528 Hertz folds
Player foreseen raises (1.12)
Player 38979 folds
Player IlxxxlI folds
Uncalled bet (0.62) returned to foreseen
Player foreseen mucks cards
------ Summary ------
Pot: 1.25. Rake 0
Player IlxxxlI does not show cards.Bets: 0.50. Collects: 0. Loses: 0.50.
Player Maria_Pia does not show cards.Bets: 0. Collects: 0. Wins: 0.
Player xROCKETMANx does not show cards.Bets: 0. Collects: 0. Wins: 0.
Player 528 Hertz does not show cards.Bets: 0. Collects: 0. Wins: 0.
*Player foreseen mucks (does not show cards). Bets: 0.50. Collects: 1.25. Wins: 0.75.
Player 38979 does not show cards.Bets: 0.25. Collects: 0. Loses: 0.25.
Game ended at: 2016/11/29 11:44:4

Game started
Game ID: 786910768 0.25/0.50 (PRR) Gorgons (Cap) - 3 (Hold'em)
Seat 4 is the button
Seat 1: mueef (2.72).
Seat 2: IlxxxlI (42.09).
Seat 3: beachrog (30.95).
Seat 4: Maria_Pia (28.03).
Seat 5: DocHoliday87 (21.72).
Seat 6: imperceptible (19.40).
Player DocHoliday87 has small blind (0.25)
Player imperceptible has big blind (0.50)
Player IlxxxlI received card: [6d]
Player IlxxxlI received card: [8d]
Player mueef folds
Player IlxxxlI folds
Player beachrog folds
Player Maria_Pia raises (1)
Player DocHoliday87 calls (0.75)
Player imperceptible folds
*** FLOP ***: [4c Qh Ah]
Player DocHoliday87 checks
Player Maria_Pia bets (1.05)
Player DocHoliday87 calls (1.05)
*** TURN ***: [4c Qh Ah] [9s]
Player DocHoliday87 checks
Player Maria_Pia bets (1.95)
Player DocHoliday87 calls (1.95)
*** RIVER ***: [4c Qh Ah 9s] [Jh]
Player DocHoliday87 caps (11)
Player Maria_Pia folds
Uncalled bet (11) returned to DocHoliday87
Player DocHoliday87 mucks cards
------ Summary ------
Pot: 8.08. Rake 0.28. JP fee 0.14
Board: [4c Qh Ah 9s Jh]
Player mueef does not show cards.Bets: 0. Collects: 0. Wins: 0.
Player IlxxxlI does not show cards.Bets: 0. Collects: 0. Wins: 0.
Player beachrog does not show cards.Bets: 0. Collects: 0. Wins: 0.
Player Maria_Pia does not show cards.Bets: 4. Collects: 0. Loses: 4.
*Player DocHoliday87 mucks (does not show cards). Bets: 4. Collects: 8.08. Wins: 4.08.
Player imperceptible does not show cards.Bets: 0.50. Collects: 0. Loses: 0.50.
Game ended at: 2016/11/29 11:45:4

Game started
Game ID: 786910751 0.25/0.50 (PRR) Gorgons (Short) - 3 (Hold'em)
Seat 1 is the button
Seat 1: Maria_Pia (22.74).
Seat 2: IlxxxlI (10).
Seat 3: beachrog (35.15).
Seat 4: MEDSat420ish (25).
Seat 5: imperceptible (34.05).
Seat 6: Parcker (29.13).
Player IlxxxlI has small blind (0.25)
Player beachrog has big blind (0.50)
Player IlxxxlI received card: [6h]
Player IlxxxlI received card: [10d]
Player MEDSat420ish raises (1)
Player imperceptible folds
Player Parcker folds
Player Maria_Pia folds
Player IlxxxlI folds
Player beachrog folds
Uncalled bet (0.50) returned to MEDSat420ish
Player MEDSat420ish mucks cards
------ Summary ------
Pot: 1.25. Rake 0
Player Maria_Pia does not show cards.Bets: 0. Collects: 0. Wins: 0.
Player IlxxxlI does not show cards.Bets: 0.25. Collects: 0. Loses: 0.25.
Player beachrog does not show cards.Bets: 0.50. Collects: 0. Loses: 0.50.
*Player MEDSat420ish mucks (does not show cards). Bets: 0.50. Collects: 1.25. Wins: 0.75.
Player imperceptible does not show cards.Bets: 0. Collects: 0. Wins: 0.
Player Parcker does not show cards.Bets: 0. Collects: 0. Wins: 0.
Game ended at: 2016/11/29 11:43:53

Game started
Game ID: 786910363 0.25/0.50 (PRR) Gorgons - 13 (Hold'em)
Seat 4 is the button
Seat 1: IlxxxlI (24.46).
Seat 2: Maria_Pia (22.49).
Seat 3: xROCKETMANx (49.25).
Seat 4: 528 Hertz (86.63).
Seat 5: foreseen (83.82).
Seat 6: 38979 (50).
Player foreseen has small blind (0.25)
Player 38979 has big blind (0.50)
Player IlxxxlI received card: [Ks]
Player IlxxxlI received card: [8d]
Player IlxxxlI folds
Player Maria_Pia folds
Player xROCKETMANx raises (1)
Player 528 Hertz folds
Player foreseen folds
Player 38979 folds
Uncalled bet (0.50) returned to xROCKETMANx
Player xROCKETMANx mucks cards
------ Summary ------
Pot: 1.25. Rake 0
Player IlxxxlI does not show cards.Bets: 0. Collects: 0. Wins: 0.
Player Maria_Pia does not show cards.Bets: 0. Collects: 0. Wins: 0.
*Player xROCKETMANx mucks (does not show cards). Bets: 0.50. Collects: 1.25. Wins: 0.75.
Player 528 Hertz does not show cards.Bets: 0. Collects: 0. Wins: 0.
Player foreseen does not show cards.Bets: 0.25. Collects: 0. Loses: 0.25.
Player 38979 does not show cards.Bets: 0.50. Collects: 0. Loses: 0.50.
Game ended at: 2016/11/29 11:43:33

Game started
Game ID: 786910158 0.25/0.50 (PRR) Gorgons - 13 (Hold'em)
Seat 3 is the button
Seat 1: IlxxxlI (24.46).
Seat 2: Maria_Pia (22.49).
Seat 3: xROCKETMANx (49.25).
Seat 4: 528 Hertz (86.88).
Seat 5: foreseen (83.57).
Player 528 Hertz has small blind (0.25)
Player foreseen has big blind (0.50)
Player IlxxxlI received card: [4s]
Player IlxxxlI received card: [5h]
Player IlxxxlI folds
Player Maria_Pia folds
Player xROCKETMANx folds
Player 528 Hertz folds
Uncalled bet (0.25) returned to foreseen
Player foreseen mucks cards
------ Summary ------
Pot: 0.50. Rake 0
Player IlxxxlI does not show cards.Bets: 0. Collects: 0. Wins: 0.
Player Maria_Pia does not show cards.Bets: 0. Collects: 0. Wins: 0.
Player xROCKETMANx does not show cards.Bets: 0. Collects: 0. Wins: 0.
Player 528 Hertz does not show cards.Bets: 0.25. Collects: 0. Loses: 0.25.
*Player foreseen mucks (does not show cards). Bets: 0.25. Collects: 0.50. Wins: 0.25.
Game ended at: 2016/11/29 11:42:57

Game started
Game ID: 786910040 0.25/0.50 (PRR) Gorgons (Short) - 3 (Hold'em)
Seat 6 is the button
Seat 1: Maria_Pia (22.99).
Seat 2: IlxxxlI (10).
Seat 3: beachrog (35.15).
Seat 4: MEDSat420ish (24.25).
Seat 5: imperceptible (34.05).
Seat 6: Parcker (29.13).
Player Maria_Pia has small blind (0.25)
Player IlxxxlI has big blind (0.50)
Player IlxxxlI received card: [7s]
Player IlxxxlI received card: [6h]
Player beachrog folds
Player MEDSat420ish raises (1.50)
Player imperceptible folds
Player Parcker folds
Player Maria_Pia folds
Player IlxxxlI folds
Uncalled bet (1) returned to MEDSat420ish
Player MEDSat420ish mucks cards
------ Summary ------
Pot: 1.25. Rake 0
Player Maria_Pia does not show cards.Bets: 0.25. Collects: 0. Loses: 0.25.
Player IlxxxlI does not show cards.Bets: 0.50. Collects: 0. Loses: 0.50.
Player beachrog does not show cards.Bets: 0. Collects: 0. Wins: 0.
*Player MEDSat420ish mucks (does not show cards). Bets: 0.50. Collects: 1.25. Wins: 0.75.
Player imperceptible does not show cards.Bets: 0. Collects: 0. Wins: 0.
Player Parcker does not show cards.Bets: 0. Collects: 0. Wins: 0.
Game ended at: 2016/11/29 11:43:29

Game started
Game ID: 786910029 0.25/0.50 (PRR) Gorgons (Cap) - 3 (Hold'em)
Seat 3 is the button
Seat 1: mueef (17.72).
Seat 2: IlxxxlI (42.09).
Seat 3: beachrog (16.73).
Seat 4: Maria_Pia (28.28).
Seat 5: DocHoliday87 (22.22).
Seat 6: imperceptible (19.40).
Player Maria_Pia has small blind (0.25)
Player DocHoliday87 has big blind (0.50)
Player IlxxxlI received card: [4d]
Player IlxxxlI received card: [4c]
Player imperceptible folds
Player mueef calls (0.50)
Player IlxxxlI folds
Player beachrog raises (3)
Player Maria_Pia folds
Player DocHoliday87 folds
Player mueef calls (2.50)
*** FLOP ***: [7d 8s 9s]
Player mueef bets (3.21)
Player beachrog caps (12)
Player mueef calls (8.79)
*** TURN ***: [7d 8s 9s] [Qs]
*** RIVER ***: [7d 8s 9s Qs] [Ac]
Player mueef mucks cards
------ Summary ------
Pot: 29.22. Rake 1.29. JP fee 0.24
Board: [7d 8s 9s Qs Ac]
Player mueef mucks (does not show cards). Bets: 15. Collects: 0. Loses: 15.
Player IlxxxlI does not show cards.Bets: 0. Collects: 0. Wins: 0.
*Player beachrog shows: Three Of Kind of 8s [8h 8c]. Bets: 15. Collects: 29.22. Wins: 14.22.
Player Maria_Pia does not show cards.Bets: 0.25. Collects: 0. Loses: 0.25.
Player DocHoliday87 does not show cards.Bets: 0.50. Collects: 0. Loses: 0.50.
Player imperceptible does not show cards.Bets: 0. Collects: 0. Wins: 0.
Game ended at: 2016/11/29 11:43:28

Game started
Game ID: 786909880 0.25/0.50 (PRR) Gorgons - 13 (Hold'em)
Seat 2 is the button
Seat 1: IlxxxlI (24.46).
Seat 2: Maria_Pia (22.49).
Seat 3: xROCKETMANx (49.50).
Seat 4: 528 Hertz (86.63).
Seat 5: foreseen (83.57).
Player xROCKETMANx has small blind (0.25)
Player 528 Hertz has big blind (0.50)
Player IlxxxlI received card: [Qc]
Player IlxxxlI received card: [3s]
Player foreseen folds
Player IlxxxlI folds
Player Maria_Pia folds
Player xROCKETMANx folds
Uncalled bet (0.25) returned to 528 Hertz
Player 528 Hertz mucks cards
------ Summary ------
Pot: 0.50. Rake 0
Player IlxxxlI does not show cards.Bets: 0. Collects: 0. Wins: 0.
Player Maria_Pia does not show cards.Bets: 0. Collects: 0. Wins: 0.
Player xROCKETMANx does not show cards.Bets: 0.25. Collects: 0. Loses: 0.25.
*Player 528 Hertz mucks (does not show cards). Bets: 0.25. Collects: 0.50. Wins: 0.25.
Player foreseen does not show cards.Bets: 0. Collects: 0. Wins: 0.
Game ended at: 2016/11/29 11:42:41

Game started
Game ID: 786909634 0.25/0.50 (PRR) Gorgons - 13 (Hold'em)
Seat 1 is the button
Seat 1: IlxxxlI (24.46).
Seat 2: Maria_Pia (22.74).
Seat 3: xROCKETMANx (50).
Seat 4: 528 Hertz (86.63).
Seat 5: foreseen (82.82).
Player Maria_Pia has small blind (0.25)
Player xROCKETMANx has big blind (0.50)
Player IlxxxlI received card: [4c]
Player IlxxxlI received card: [Jc]
Player 528 Hertz folds
Player foreseen raises (1.25)
Player IlxxxlI folds
Player Maria_Pia folds
Player xROCKETMANx folds
Uncalled bet (0.75) returned to foreseen
Player foreseen mucks cards
------ Summary ------
Pot: 1.25. Rake 0
Player IlxxxlI does not show cards.Bets: 0. Collects: 0. Wins: 0.
Player Maria_Pia does not show cards.Bets: 0.25. Collects: 0. Loses: 0.25.
Player xROCKETMANx does not show cards.Bets: 0.50. Collects: 0. Loses: 0.50.
Player 528 Hertz does not show cards.Bets: 0. Collects: 0. Wins: 0.
*Player foreseen mucks (does not show cards). Bets: 0.50. Collects: 1.25. Wins: 0.75.
Game ended at: 2016/11/29 11:42:17

Game started
Game ID: 786909594 0.25/0.50 (PRR) Gorgons (Cap) - 3 (Hold'em)
Seat 2 is the button
Seat 1: mueef (18.22).
Seat 2: IlxxxlI (44.09).
Seat 3: beachrog (16.98).
Seat 4: Maria_Pia (25.53).
Seat 6: imperceptible (19.40).
Player beachrog has small blind (0.25)
Player Maria_Pia has big blind (0.50)
Player IlxxxlI received card: [Jh]
Player IlxxxlI received card: [Ac]
Player imperceptible folds
Player mueef calls (0.50)
Player IlxxxlI raises (2)
Player beachrog folds
Player Maria_Pia raises (6)
Player mueef folds
Player IlxxxlI folds
Uncalled bet (4.50) returned to Maria_Pia
Player Maria_Pia mucks cards
------ Summary ------
Pot: 4.75. Rake 0
Player mueef does not show cards.Bets: 0.50. Collects: 0. Loses: 0.50.
Player IlxxxlI does not show cards.Bets: 2. Collects: 0. Loses: 2.
Player beachrog does not show cards.Bets: 0.25. Collects: 0. Loses: 0.25.
*Player Maria_Pia mucks (does not show cards). Bets: 2. Collects: 4.75. Wins: 2.75.
Player imperceptible does not show cards.Bets: 0. Collects: 0. Wins: 0.
Game ended at: 2016/11/29 11:42:30

Game started
Game ID: 786909111 0.25/0.50 (PRR) Gorgons - 13 (Hold'em)
Seat 5 is the button
Seat 1: IlxxxlI (22.41).
Seat 2: Maria_Pia (23.24).
Seat 4: 528 Hertz (86.63).
Seat 5: foreseen (84.56).
Player IlxxxlI has small blind (0.25)
Player Maria_Pia has big blind (0.50)
Player IlxxxlI received card: [8s]
Player IlxxxlI received card: [As]
Player 528 Hertz folds
Player foreseen raises (1.12)
Player IlxxxlI raises (1.49)
Player Maria_Pia folds
Player foreseen calls (0.62)
*** FLOP ***: [Kh Ad 7h]
Player IlxxxlI bets (1.97)
Player foreseen folds
Uncalled bet (1.97) returned to IlxxxlI
Player IlxxxlI mucks cards
------ Summary ------
Pot: 3.79. Rake 0.13. JP fee 0.06
Board: [Kh Ad 7h]
*Player IlxxxlI mucks (does not show cards). Bets: 1.74. Collects: 3.79. Wins: 2.05.
Player Maria_Pia does not show cards.Bets: 0.50. Collects: 0. Loses: 0.50.
Player 528 Hertz does not show cards.Bets: 0. Collects: 0. Wins: 0.
Player foreseen does not show cards.Bets: 1.74. Collects: 0. Loses: 1.74.
Game ended at: 2016/11/29 11:41:58

Game started
Game ID: 786908838 0.25/0.50 (PRR) Gorgons - 13 (Hold'em)
Seat 4 is the button
Seat 1: IlxxxlI (22.16).
Seat 2: Maria_Pia (23.24).
Seat 3: imperceptible (20).
Seat 4: 528 Hertz (86.63).
Seat 5: foreseen (84.81).
Player foreseen has small blind (0.25)
Player IlxxxlI has big blind (0.50)
Player imperceptible wait BB
Player IlxxxlI received card: [Qh]
Player IlxxxlI received card: [2s]
Player Maria_Pia folds
Player 528 Hertz folds
Player foreseen folds
Uncalled bet (0.25) returned to IlxxxlI
Player IlxxxlI mucks cards
------ Summary ------
Pot: 0.50. Rake 0
*Player IlxxxlI mucks (does not show cards). Bets: 0.25. Collects: 0.50. Wins: 0.25.
Player Maria_Pia does not show cards.Bets: 0. Collects: 0. Wins: 0.
Player imperceptible does not show cards.Bets: 0. Collects: 0. Wins: 0.
Player 528 Hertz does not show cards.Bets: 0. Collects: 0. Wins: 0.
Player foreseen does not show cards.Bets: 0.25. Collects: 0. Loses: 0.25.
Game ended at: 2016/11/29 11:41:19

Game started
Game ID: 786908815 0.25/0.50 (PRR) Gorgons (Short) - 3 (Hold'em)
Seat 5 is the button
Seat 1: Maria_Pia (23.49).
Seat 2: IlxxxlI (10).
Seat 3: beachrog (25.71).
Seat 4: MEDSat420ish (24.25).
Seat 5: imperceptible (34.05).
Seat 6: Parcker (39.09).
Player Parcker has small blind (0.25)
Player Maria_Pia has big blind (0.50)
Player IlxxxlI received card: [4h]
Player IlxxxlI received card: [3d]
Player IlxxxlI folds
Player beachrog raises (2)
Player MEDSat420ish folds
Player imperceptible folds
Player Parcker raises (5.75)
Player Maria_Pia folds
Player beachrog calls (4)
*** FLOP ***: [3s 2c 9h]
Player Parcker bets (3.96)
Player beachrog calls (3.96)
*** TURN ***: [3s 2c 9h] [2d]
Player Parcker checks
Player beachrog bets (12.93)
Player Parcker folds
Uncalled bet (12.93) returned to beachrog
Player beachrog mucks cards
------ Summary ------
Pot: 19.40. Rake 0.78. JP fee 0.24
Board: [3s 2c 9h 2d]
Player Maria_Pia does not show cards.Bets: 0.50. Collects: 0. Loses: 0.50.
Player IlxxxlI does not show cards.Bets: 0. Collects: 0. Wins: 0.
*Player beachrog mucks (does not show cards). Bets: 9.96. Collects: 19.40. Wins: 9.44.
Player MEDSat420ish does not show cards.Bets: 0. Collects: 0. Wins: 0.
Player imperceptible does not show cards.Bets: 0. Collects: 0. Wins: 0.
Player Parcker does not show cards.Bets: 9.96. Collects: 0. Loses: 9.96.
Game ended at: 2016/11/29 11:42:31

Game started
Game ID: 786908817 0.25/0.50 (PRR) Gorgons (Cap) - 3 (Hold'em)
Seat 1 is the button
Seat 1: mueef (9.46).
Seat 2: IlxxxlI (44.34).
Seat 3: beachrog (26.44).
Seat 4: Maria_Pia (25.53).
Seat 6: imperceptible (19.40).
Player IlxxxlI has small blind (0.25)
Player beachrog has big blind (0.50)
Player IlxxxlI received card: [3h]
Player IlxxxlI received card: [As]
Player Maria_Pia folds
Player imperceptible folds
Player mueef calls (0.50)
Player IlxxxlI folds
Player beachrog checks
*** FLOP ***: [7d 9c Kc]
Player beachrog checks
Player mueef bets (0.50)
Player beachrog calls (0.50)
*** TURN ***: [7d 9c Kc] [10s]
Player beachrog checks
Player mueef bets (1.42)
Player beachrog calls (1.42)
*** RIVER ***: [7d 9c Kc 10s] [2h]
Player beachrog checks
Player mueef allin (7.04)
Player beachrog calls (7.04)
------ Summary ------
Pot: 18.22. Rake 0.71. JP fee 0.24
Board: [7d 9c Kc 10s 2h]
*Player mueef shows: Two pairs. 9s and 7s [9d 7h]. Bets: 9.46. Collects: 18.22. Wins: 8.76.
Player IlxxxlI does not show cards.Bets: 0.25. Collects: 0. Loses: 0.25.
Player beachrog shows: One pair of 10s [6d 10d]. Bets: 9.46. Collects: 0. Loses: 9.46.
Player Maria_Pia does not show cards.Bets: 0. Collects: 0. Wins: 0.
Player imperceptible does not show cards.Bets: 0. Collects: 0. Wins: 0.
Game ended at: 2016/11/29 11:41:54

Game started
Game ID: 786908583 0.25/0.50 (PRR) Gorgons - 13 (Hold'em)
Seat 2 is the button
Seat 1: IlxxxlI (22.16).
Seat 2: Maria_Pia (22.49).
Seat 4: 528 Hertz (86.88).
Seat 5: foreseen (85.31).
Player 528 Hertz has small blind (0.25)
Player foreseen has big blind (0.50)
Player IlxxxlI received card: [6d]
Player IlxxxlI received card: [5c]
Player IlxxxlI folds
Player Maria_Pia raises (1)
Player 528 Hertz folds
Player foreseen folds
Uncalled bet (0.50) returned to Maria_Pia
Player Maria_Pia mucks cards
------ Summary ------
Pot: 1.25. Rake 0
Player IlxxxlI does not show cards.Bets: 0. Collects: 0. Wins: 0.
*Player Maria_Pia mucks (does not show cards). Bets: 0.50. Collects: 1.25. Wins: 0.75.
Player 528 Hertz does not show cards.Bets: 0.25. Collects: 0. Loses: 0.25.
Player foreseen does not show cards.Bets: 0.50. Collects: 0. Loses: 0.50.
Game ended at: 2016/11/29 11:40:59

Game started
Game ID: 786908266 0.25/0.50 (PRR) Gorgons (Short) - 3 (Hold'em)
Seat 4 is the button
Seat 1: Maria_Pia (23.49).
Seat 2: IlxxxlI (10.77).
Seat 3: beachrog (25.71).
Seat 4: MEDSat420ish (22.50).
Seat 5: imperceptible (34.30).
Seat 6: Parcker (39.59).
Player imperceptible has small blind (0.25)
Player Parcker has big blind (0.50)
Player IlxxxlI received card: [Ks]
Player IlxxxlI received card: [10s]
Player Maria_Pia folds
Player IlxxxlI raises (1)
Player beachrog folds
Player MEDSat420ish raises (2.50)
Player imperceptible folds
Player Parcker folds
Player IlxxxlI folds
Uncalled bet (1.50) returned to MEDSat420ish
Player MEDSat420ish mucks cards
------ Summary ------
Pot: 2.75. Rake 0
Player Maria_Pia does not show cards.Bets: 0. Collects: 0. Wins: 0.
Player IlxxxlI does not show cards.Bets: 1. Collects: 0. Loses: 1.
Player beachrog does not show cards.Bets: 0. Collects: 0. Wins: 0.
*Player MEDSat420ish mucks (does not show cards). Bets: 1. Collects: 2.75. Wins: 1.75.
Player imperceptible does not show cards.Bets: 0.25. Collects: 0. Loses: 0.25.
Player Parcker does not show cards.Bets: 0.50. Collects: 0. Loses: 0.50.
Game ended at: 2016/11/29 11:40:58

Game started
Game ID: 786908159 0.25/0.50 (PRR) Gorgons - 13 (Hold'em)
Seat 1 is the button
Seat 1: IlxxxlI (22.16).
Seat 2: Maria_Pia (22.74).
Seat 3: imperceptible (20).
Seat 4: 528 Hertz (86.63).
Seat 5: foreseen (85.31).
Player Maria_Pia has small blind (0.25)
Player imperceptible is timed out.
Player imperceptible sitting out
Player 528 Hertz has big blind (0.50)
Player IlxxxlI received card: [9s]
Player IlxxxlI received card: [2d]
Player foreseen folds
Player IlxxxlI folds
Player Maria_Pia folds
Uncalled bet (0.25) returned to 528 Hertz
Player 528 Hertz mucks cards
------ Summary ------
Pot: 0.50. Rake 0
Player IlxxxlI does not show cards.Bets: 0. Collects: 0. Wins: 0.
Player Maria_Pia does not show cards.Bets: 0.25. Collects: 0. Loses: 0.25.
Player imperceptible does not show cards.Bets: 0. Collects: 0. Wins: 0.
*Player 528 Hertz mucks (does not show cards). Bets: 0.25. Collects: 0.50. Wins: 0.25.
Player foreseen does not show cards.Bets: 0. Collects: 0. Wins: 0.
Game ended at: 2016/11/29 11:40:39

Game started
Game ID: 786907654 0.25/0.50 (PRR) Gorgons (Cap) - 3 (Hold'em)
Seat 6 is the button
Seat 1: mueef (24.46).
Seat 2: IlxxxlI (28.94).
Seat 3: beachrog (27.44).
Seat 4: Maria_Pia (25.53).
Seat 6: imperceptible (20.40).
Player mueef has small blind (0.25)
Player IlxxxlI has big blind (0.50)
Player IlxxxlI received card: [7d]
Player IlxxxlI received card: [Qd]
Player beachrog calls (0.50)
Player Maria_Pia folds
Player imperceptible raises (1)
Player mueef calls (0.75)
Player IlxxxlI calls (0.50)
Player beachrog calls (0.50)
*** FLOP ***: [Qh 2c Ks]
Player mueef checks
Player IlxxxlI checks
Player beachrog checks
Player imperceptible checks
*** TURN ***: [Qh 2c Ks] [7s]
Player mueef bets (1.90)
Player IlxxxlI raises (5.50)
Player beachrog folds
Player imperceptible folds
Player mueef calls (3.60)
*** RIVER ***: [Qh 2c Ks 7s] [8d]
Player mueef checks
Player IlxxxlI caps (8.50)
Player mueef calls (8.50)
Player mueef mucks cards
------ Summary ------
Pot: 30.40. Rake 1.36. JP fee 0.24
Board: [Qh 2c Ks 7s 8d]
Player mueef mucks (does not show cards). Bets: 15. Collects: 0. Loses: 15.
*Player IlxxxlI shows: Two pairs. Qs and 7s [7d Qd]. Bets: 15. Collects: 30.40. Wins: 15.40.
Player beachrog does not show cards.Bets: 1. Collects: 0. Loses: 1.
Player Maria_Pia does not show cards.Bets: 0. Collects: 0. Wins: 0.
Player imperceptible does not show cards.Bets: 1. Collects: 0. Loses: 1.
Game ended at: 2016/11/29 11:40:56

Game started
Game ID: 786907598 0.25/0.50 (PRR) Gorgons - 13 (Hold'em)
Seat 5 is the button
Seat 1: IlxxxlI (22.41).
Seat 2: Maria_Pia (23.24).
Seat 4: 528 Hertz (86.63).
Seat 5: foreseen (84.56).
Player IlxxxlI has small blind (0.25)
Player Maria_Pia has big blind (0.50)
Player IlxxxlI received card: [6c]
Player IlxxxlI received card: [Kd]
Player 528 Hertz folds
Player foreseen raises (1.12)
Player IlxxxlI folds
Player Maria_Pia folds
Uncalled bet (0.62) returned to foreseen
Player foreseen mucks cards
------ Summary ------
Pot: 1.25. Rake 0
Player IlxxxlI does not show cards.Bets: 0.25. Collects: 0. Loses: 0.25.
Player Maria_Pia does not show cards.Bets: 0.50. Collects: 0. Loses: 0.50.
Player 528 Hertz does not show cards.Bets: 0. Collects: 0. Wins: 0.
*Player foreseen mucks (does not show cards). Bets: 0.50. Collects: 1.25. Wins: 0.75.
Game ended at: 2016/11/29 11:40:8

Game started
Game ID: 786907453 0.25/0.50 (PRR) Gorgons (Short) - 3 (Hold'em)
Seat 3 is the button
Seat 1: Maria_Pia (23.49).
Seat 2: IlxxxlI (10.77).
Seat 3: beachrog (25.71).
Seat 4: MEDSat420ish (24).
Seat 5: imperceptible (32.95).
Seat 6: Parcker (39.59).
Player MEDSat420ish has small blind (0.25)
Player imperceptible has big blind (0.50)
Player IlxxxlI received card: [10c]
Player IlxxxlI received card: [Js]
Player Parcker folds
Player Maria_Pia folds
Player IlxxxlI folds
Player beachrog folds
Player MEDSat420ish calls (0.25)
Player imperceptible raises (1)
Player MEDSat420ish calls (1)
*** FLOP ***: [Ks 6c 6s]
Player MEDSat420ish checks
Player imperceptible bets (1.90)
Player MEDSat420ish folds
Uncalled bet (1.90) returned to imperceptible
Player imperceptible mucks cards
------ Summary ------
Pot: 2.85. Rake 0.11. JP fee 0.04
Board: [Ks 6c 6s]
Player Maria_Pia does not show cards.Bets: 0. Collects: 0. Wins: 0.
Player IlxxxlI does not show cards.Bets: 0. Collects: 0. Wins: 0.
Player beachrog does not show cards.Bets: 0. Collects: 0. Wins: 0.
Player MEDSat420ish does not show cards.Bets: 1.50. Collects: 0. Loses: 1.50.
*Player imperceptible mucks (does not show cards). Bets: 1.50. Collects: 2.85. Wins: 1.35.
Player Parcker does not show cards.Bets: 0. Collects: 0. Wins: 0.
Game ended at: 2016/11/29 11:40:17

Game started
Game ID: 786907066 0.25/0.50 (PRR) Gorgons - 13 (Hold'em)
Seat 4 is the button
Seat 1: IlxxxlI (20.77).
Seat 2: Maria_Pia (23.24).
Seat 4: 528 Hertz (86.63).
Seat 5: foreseen (86.20).
Player foreseen has small blind (0.25)
Player IlxxxlI has big blind (0.50)
Player IlxxxlI received card: [10h]
Player IlxxxlI received card: [10d]
Player Maria_Pia folds
Player 528 Hertz folds
Player foreseen raises (1.39)
Player IlxxxlI raises (3.49)
Player foreseen folds
Uncalled bet (2.35) returned to IlxxxlI
Player IlxxxlI mucks cards
------ Summary ------
Pot: 3.28. Rake 0
*Player IlxxxlI mucks (does not show cards). Bets: 1.64. Collects: 3.28. Wins: 1.64.
Player Maria_Pia does not show cards.Bets: 0. Collects: 0. Wins: 0.
Player 528 Hertz does not show cards.Bets: 0. Collects: 0. Wins: 0.
Player foreseen does not show cards.Bets: 1.64. Collects: 0. Loses: 1.64.
Game ended at: 2016/11/29 11:39:25

Game started
Game ID: 786906927 0.25/0.50 (PRR) Gorgons - 13 (Hold'em)
Seat 2 is the button
Seat 1: IlxxxlI (20.77).
Seat 2: Maria_Pia (23.24).
Seat 4: 528 Hertz (86.88).
Seat 5: foreseen (85.95).
Player 528 Hertz has small blind (0.25)
Player foreseen has big blind (0.50)
Player IlxxxlI received card: [7h]
Player IlxxxlI received card: [Jc]
Player IlxxxlI folds
Player Maria_Pia folds
Player 528 Hertz folds
Uncalled bet (0.25) returned to foreseen
Player foreseen mucks cards
------ Summary ------
Pot: 0.50. Rake 0
Player IlxxxlI does not show cards.Bets: 0. Collects: 0. Wins: 0.
Player Maria_Pia does not show cards.Bets: 0. Collects: 0. Wins: 0.
Player 528 Hertz does not show cards.Bets: 0.25. Collects: 0. Loses: 0.25.
*Player foreseen mucks (does not show cards). Bets: 0.25. Collects: 0.50. Wins: 0.25.
Game ended at: 2016/11/29 11:38:45

Game started
Game ID: 786906821 0.25/0.50 (PRR) Gorgons (Cap) - 3 (Hold'em)
Seat 4 is the button
Seat 1: mueef (20).
Seat 2: IlxxxlI (28.94).
Seat 3: beachrog (32.13).
Seat 4: Maria_Pia (25.53).
Seat 6: imperceptible (20.65).
Player imperceptible has small blind (0.25)
Player mueef has big blind (0.50)
Player IlxxxlI received card: [9d]
Player IlxxxlI received card: [Qc]
Player IlxxxlI folds
Player beachrog raises (2)
Player Maria_Pia folds
Player imperceptible folds
Player mueef calls (1.50)
*** FLOP ***: [2c 3d Js]
Player mueef bets (2.69)
Player beachrog calls (2.69)
*** TURN ***: [2c 3d Js] [Jd]
Player mueef caps (10.31)
Player beachrog folds
Uncalled bet (10.31) returned to mueef
Player mueef mucks cards
------ Summary ------
Pot: 9.15. Rake 0.32. JP fee 0.16
Board: [2c 3d Js Jd]
*Player mueef mucks (does not show cards). Bets: 4.69. Collects: 9.15. Wins: 4.46.
Player IlxxxlI does not show cards.Bets: 0. Collects: 0. Wins: 0.
Player beachrog does not show cards.Bets: 4.69. Collects: 0. Loses: 4.69.
Player Maria_Pia does not show cards.Bets: 0. Collects: 0. Wins: 0.
Player imperceptible does not show cards.Bets: 0.25. Collects: 0. Loses: 0.25.
Game ended at: 2016/11/29 11:39:28

Game started
Game ID: 786906455 0.25/0.50 (PRR) Gorgons - 13 (Hold'em)
Seat 1 is the button
Seat 1: IlxxxlI (20.77).
Seat 2: Maria_Pia (23.49).
Seat 4: 528 Hertz (87.38).
Seat 5: foreseen (85.20).
Player Maria_Pia has small blind (0.25)
Player 528 Hertz has big blind (0.50)
Player IlxxxlI received card: [4s]
Player IlxxxlI received card: [7s]
Player foreseen raises (1.25)
Player IlxxxlI folds
Player Maria_Pia folds
Player 528 Hertz folds
Uncalled bet (0.75) returned to foreseen
Player foreseen mucks cards
------ Summary ------
Pot: 1.25. Rake 0
Player IlxxxlI does not show cards.Bets: 0. Collects: 0. Wins: 0.
Player Maria_Pia does not show cards.Bets: 0.25. Collects: 0. Loses: 0.25.
Player 528 Hertz does not show cards.Bets: 0.50. Collects: 0. Loses: 0.50.
*Player foreseen mucks (does not show cards). Bets: 0.50. Collects: 1.25. Wins: 0.75.
Game ended at: 2016/11/29 11:38:32

Game started
Game ID: 786906278 0.25/0.50 (PRR) Gorgons (Short) - 3 (Hold'em)
Seat 2 is the button
Seat 1: Maria_Pia (24.49).
Seat 2: IlxxxlI (10.77).
Seat 3: beachrog (42.30).
Seat 4: MEDSat420ish (24.50).
Seat 5: imperceptible (16.59).
Seat 6: Parcker (39.59).
Player beachrog has small blind (0.25)
Player MEDSat420ish has big blind (0.50)
Player IlxxxlI received card: [8s]
Player IlxxxlI received card: [5s]
Player imperceptible raises (1)
Player Parcker folds
Player Maria_Pia calls (1)
Player IlxxxlI folds
Player beachrog raises (3.25)
Player MEDSat420ish folds
Player imperceptible allin (15.59)
Player Maria_Pia folds
Player beachrog calls (13.09)
*** FLOP ***: [As Kh 6s]
*** TURN ***: [As Kh 6s] [Qc]
*** RIVER ***: [As Kh 6s Qc] [Ah]
------ Summary ------
Pot: 32.95. Rake 1.49. JP fee 0.24
Board: [As Kh 6s Qc Ah]
Player Maria_Pia does not show cards.Bets: 1. Collects: 0. Loses: 1.
Player IlxxxlI does not show cards.Bets: 0. Collects: 0. Wins: 0.
Player beachrog shows: Three Of Kind of As [Ac Js]. Bets: 16.59. Collects: 0. Loses: 16.59.
Player MEDSat420ish does not show cards.Bets: 0.50. Collects: 0. Loses: 0.50.
*Player imperceptible shows: Full House (6/A) [6c 6d]. Bets: 16.59. Collects: 32.95. Wins: 16.36.
Player Parcker does not show cards.Bets: 0. Collects: 0. Wins: 0.
Game ended at: 2016/11/29 11:39:12

Game started
Game ID: 786906160 0.25/0.50 (PRR) Gorgons (Cap) - 3 (Hold'em)
Seat 3 is the button
Seat 2: IlxxxlI (28.94).
Seat 3: beachrog (29.71).
Seat 4: Maria_Pia (25.78).
Seat 6: imperceptible (23.07).
Player Maria_Pia has small blind (0.25)
Player imperceptible has big blind (0.50)
Player IlxxxlI received card: [10c]
Player IlxxxlI received card: [Ks]
Player IlxxxlI folds
Player beachrog raises (1)
Player Maria_Pia folds
Player imperceptible calls (0.50)
*** FLOP ***: [6d Jd Js]
Player imperceptible checks
Player beachrog checks
*** TURN ***: [6d Jd Js] [Ah]
Player imperceptible bets (1.42)
Player beachrog calls (1.42)
*** RIVER ***: [6d Jd Js Ah] [2s]
Player imperceptible checks
Player beachrog checks
------ Summary ------
Pot: 4.84. Rake 0.17. JP fee 0.08
Board: [6d Jd Js Ah 2s]
Player IlxxxlI does not show cards.Bets: 0. Collects: 0. Wins: 0.
*Player beachrog shows: Two pairs. As and Js [Ad 8c]. Bets: 2.42. Collects: 4.84. Wins: 2.42.
Player Maria_Pia does not show cards.Bets: 0.25. Collects: 0. Loses: 0.25.
Player imperceptible shows: One pair of Js [8d 9d]. Bets: 2.42. Collects: 0. Loses: 2.42.
Game ended at: 2016/11/29 11:38:21

Game started
Game ID: 786905879 0.25/0.50 (PRR) Gorgons - 13 (Hold'em)
Seat 5 is the button
Seat 1: IlxxxlI (21.02).
Seat 2: Maria_Pia (23.99).
Seat 4: 528 Hertz (87.38).
Seat 5: foreseen (84.45).
Player IlxxxlI has small blind (0.25)
Player Maria_Pia has big blind (0.50)
Player IlxxxlI received card: [4s]
Player IlxxxlI received card: [8d]
Player 528 Hertz folds
Player foreseen raises (1.25)
Player IlxxxlI folds
Player Maria_Pia folds
Uncalled bet (0.75) returned to foreseen
Player foreseen mucks cards
------ Summary ------
Pot: 1.25. Rake 0
Player IlxxxlI does not show cards.Bets: 0.25. Collects: 0. Loses: 0.25.
Player Maria_Pia does not show cards.Bets: 0.50. Collects: 0. Loses: 0.50.
Player 528 Hertz does not show cards.Bets: 0. Collects: 0. Wins: 0.
*Player foreseen mucks (does not show cards). Bets: 0.50. Collects: 1.25. Wins: 0.75.
Game ended at: 2016/11/29 11:37:55

Game started
Game ID: 786905649 0.25/0.50 (PRR) Gorgons (Short) - 3 (Hold'em)
Seat 1 is the button
Seat 1: Maria_Pia (23.74).
Seat 2: IlxxxlI (11.02).
Seat 3: beachrog (42.80).
Seat 4: MEDSat420ish (24.50).
Seat 5: imperceptible (16.59).
Seat 6: Parcker (39.59).
Player IlxxxlI has small blind (0.25)
Player beachrog has big blind (0.50)
Player IlxxxlI received card: [10s]
Player IlxxxlI received card: [8h]
Player MEDSat420ish folds
Player imperceptible folds
Player Parcker folds
Player Maria_Pia raises (1)
Player IlxxxlI folds
Player beachrog folds
Uncalled bet (0.50) returned to Maria_Pia
Player Maria_Pia mucks cards
------ Summary ------
Pot: 1.25. Rake 0
*Player Maria_Pia mucks (does not show cards). Bets: 0.50. Collects: 1.25. Wins: 0.75.
Player IlxxxlI does not show cards.Bets: 0.25. Collects: 0. Loses: 0.25.
Player beachrog does not show cards.Bets: 0.50. Collects: 0. Loses: 0.50.
Player MEDSat420ish does not show cards.Bets: 0. Collects: 0. Wins: 0.
Player imperceptible does not show cards.Bets: 0. Collects: 0. Wins: 0.
Player Parcker does not show cards.Bets: 0. Collects: 0. Wins: 0.
Game ended at: 2016/11/29 11:37:40

Game started
Game ID: 786905500 0.25/0.50 (PRR) Gorgons - 13 (Hold'em)
Seat 4 is the button
Seat 1: IlxxxlI (20.77).
Seat 2: Maria_Pia (23.99).
Seat 4: 528 Hertz (87.38).
Seat 5: foreseen (84.70).
Player foreseen has small blind (0.25)
Player IlxxxlI has big blind (0.50)
Player IlxxxlI received card: [3s]
Player IlxxxlI received card: [7d]
Player Maria_Pia folds
Player 528 Hertz folds
Player foreseen folds
Uncalled bet (0.25) returned to IlxxxlI
Player IlxxxlI mucks cards
------ Summary ------
Pot: 0.50. Rake 0
*Player IlxxxlI mucks (does not show cards). Bets: 0.25. Collects: 0.50. Wins: 0.25.
Player Maria_Pia does not show cards.Bets: 0. Collects: 0. Wins: 0.
Player 528 Hertz does not show cards.Bets: 0. Collects: 0. Wins: 0.
Player foreseen does not show cards.Bets: 0.25. Collects: 0. Loses: 0.25.
Game ended at: 2016/11/29 11:37:9

Game started
Game ID: 786905326 0.25/0.50 (PRR) Gorgons - 13 (Hold'em)
Seat 2 is the button
Seat 1: IlxxxlI (20.77).
Seat 2: Maria_Pia (23.99).
Seat 4: 528 Hertz (87.63).
Seat 5: foreseen (84.45).
Player 528 Hertz has small blind (0.25)
Player foreseen has big blind (0.50)
Player IlxxxlI received card: [2h]
Player IlxxxlI received card: [Ks]
Player IlxxxlI folds
Player Maria_Pia folds
Player 528 Hertz folds
Uncalled bet (0.25) returned to foreseen
Player foreseen mucks cards
------ Summary ------
Pot: 0.50. Rake 0
Player IlxxxlI does not show cards.Bets: 0. Collects: 0. Wins: 0.
Player Maria_Pia does not show cards.Bets: 0. Collects: 0. Wins: 0.
Player 528 Hertz does not show cards.Bets: 0.25. Collects: 0. Loses: 0.25.
*Player foreseen mucks (does not show cards). Bets: 0.25. Collects: 0.50. Wins: 0.25.
Game ended at: 2016/11/29 11:36:40

Game started
Game ID: 786905286 0.25/0.50 (PRR) Gorgons (Short) - 3 (Hold'em)
Seat 6 is the button
Seat 1: Maria_Pia (23.99).
Seat 2: IlxxxlI (11.52).
Seat 3: beachrog (42.80).
Seat 4: MEDSat420ish (25).
Seat 5: imperceptible (15.34).
Seat 6: Parcker (39.59).
Player Maria_Pia has small blind (0.25)
Player IlxxxlI has big blind (0.50)
Player MEDSat420ish posts (0.50)
Player IlxxxlI received card: [3s]
Player IlxxxlI received card: [8s]
Player beachrog folds
Player MEDSat420ish checks
Player imperceptible raises (2)
Player Parcker folds
Player Maria_Pia folds
Player IlxxxlI folds
Player MEDSat420ish folds
Uncalled bet (1.50) returned to imperceptible
Player imperceptible mucks cards
------ Summary ------
Pot: 1.75. Rake 0
Player Maria_Pia does not show cards.Bets: 0.25. Collects: 0. Loses: 0.25.
Player IlxxxlI does not show cards.Bets: 0.50. Collects: 0. Loses: 0.50.
Player beachrog does not show cards.Bets: 0. Collects: 0. Wins: 0.
Player MEDSat420ish does not show cards.Bets: 0.50. Collects: 0. Loses: 0.50.
*Player imperceptible mucks (does not show cards). Bets: 0.50. Collects: 1.75. Wins: 1.25.
Player Parcker does not show cards.Bets: 0. Collects: 0. Wins: 0.
Game ended at: 2016/11/29 11:36:52

Game started
Game ID: 786905261 0.25/0.50 (PRR) Gorgons (Cap) - 3 (Hold'em)
Seat 2 is the button
Seat 2: IlxxxlI (28.94).
Seat 3: beachrog (34.98).
Seat 4: Maria_Pia (26.28).
Seat 6: imperceptible (17.85).
Player beachrog has small blind (0.25)
Player Maria_Pia has big blind (0.50)
Player IlxxxlI received card: [2h]
Player IlxxxlI received card: [Jh]
Player imperceptible raises (1)
Player IlxxxlI folds
Player beachrog calls (0.75)
Player Maria_Pia folds
*** FLOP ***: [3c 8c 2d]
Player beachrog checks
Player imperceptible bets (1.58)
Player beachrog calls (1.58)
*** TURN ***: [3c 8c 2d] [4h]
Player beachrog bets (2.69)
Player imperceptible caps (12.42)
Player beachrog folds
Uncalled bet (9.73) returned to imperceptible
Player imperceptible mucks cards
------ Summary ------
Pot: 10.49. Rake 0.37. JP fee 0.18
Board: [3c 8c 2d 4h]
Player IlxxxlI does not show cards.Bets: 0. Collects: 0. Wins: 0.
Player beachrog does not show cards.Bets: 5.27. Collects: 0. Loses: 5.27.
Player Maria_Pia does not show cards.Bets: 0.50. Collects: 0. Loses: 0.50.
*Player imperceptible mucks (does not show cards). Bets: 5.27. Collects: 10.49. Wins: 5.22.
Game ended at: 2016/11/29 11:37:31

Game started
Game ID: 786904881 0.25/0.50 (PRR) Gorgons - 13 (Hold'em)
Seat 1 is the button
Seat 1: IlxxxlI (20.77).
Seat 2: Maria_Pia (24.24).
Seat 3: Xobkcul (55.29).
Seat 4: 528 Hertz (87.38).
Seat 5: foreseen (84.45).
Player Maria_Pia has small blind (0.25)
Player Xobkcul sitting out
Player 528 Hertz has big blind (0.50)
Player IlxxxlI received card: [6s]
Player IlxxxlI received card: [2h]
Player foreseen folds
Player IlxxxlI folds
Player Maria_Pia folds
Uncalled bet (0.25) returned to 528 Hertz
Player 528 Hertz mucks cards
------ Summary ------
Pot: 0.50. Rake 0
Player IlxxxlI does not show cards.Bets: 0. Collects: 0. Wins: 0.
Player Maria_Pia does not show cards.Bets: 0.25. Collects: 0. Loses: 0.25.
Player Xobkcul does not show cards.Bets: 0. Collects: 0. Wins: 0.
*Player 528 Hertz mucks (does not show cards). Bets: 0.25. Collects: 0.50. Wins: 0.25.
Player foreseen does not show cards.Bets: 0. Collects: 0. Wins: 0.
Game ended at: 2016/11/29 11:36:27

Game started
Game ID: 786904615 0.25/0.50 (PRR) Gorgons - 13 (Hold'em)
Seat 5 is the button
Seat 1: IlxxxlI (21.02).
Seat 2: Maria_Pia (23.99).
Seat 3: Xobkcul (55.29).
Seat 4: 528 Hertz (87.38).
Seat 5: foreseen (84.45).
Player IlxxxlI has small blind (0.25)
Player Maria_Pia has big blind (0.50)
Player IlxxxlI received card: [6d]
Player IlxxxlI received card: [9c]
Player Xobkcul folds
Player 528 Hertz folds
Player foreseen folds
Player IlxxxlI folds
Uncalled bet (0.25) returned to Maria_Pia
Player Maria_Pia mucks cards
------ Summary ------
Pot: 0.50. Rake 0
Player IlxxxlI does not show cards.Bets: 0.25. Collects: 0. Loses: 0.25.
*Player Maria_Pia mucks (does not show cards). Bets: 0.25. Collects: 0.50. Wins: 0.25.
Player Xobkcul does not show cards.Bets: 0. Collects: 0. Wins: 0.
Player 528 Hertz does not show cards.Bets: 0. Collects: 0. Wins: 0.
Player foreseen does not show cards.Bets: 0. Collects: 0. Wins: 0.
Game ended at: 2016/11/29 11:35:51

Game started
Game ID: 786904294 0.25/0.50 (PRR) Gorgons (Cap) - 3 (Hold'em)
Seat 6 is the button
Seat 2: IlxxxlI (29.45).
Seat 3: beachrog (35.48).
Seat 4: Maria_Pia (26.79).
Seat 6: imperceptible (17.85).
Player IlxxxlI has small blind (0.25)
Player beachrog has big blind (0.50)
Player IlxxxlI received card: [Qh]
Player IlxxxlI received card: [Ad]
Player Maria_Pia raises (1.05)
Player imperceptible folds
Player IlxxxlI raises (2.45)
Player beachrog folds
Player Maria_Pia calls (1.65)
*** FLOP ***: [6c 3s 4h]
Player IlxxxlI checks
Player Maria_Pia checks
*** TURN ***: [6c 3s 4h] [5h]
Player IlxxxlI checks
Player Maria_Pia bets (2.50)
Player IlxxxlI calls (2.50)
*** RIVER ***: [6c 3s 4h 5h] [2h]
Player IlxxxlI checks
Player Maria_Pia caps (9.80)
Player IlxxxlI calls (9.80)
------ Summary ------
Pot: 28.98. Rake 1.28. JP fee 0.24
Board: [6c 3s 4h 5h 2h]
*Player IlxxxlI shows: Straight to 6 [Qh Ad]. Bets: 15. Collects: 14.49. Loses: 0.51.
Player beachrog does not show cards.Bets: 0.50. Collects: 0. Loses: 0.50.
*Player Maria_Pia shows: Straight to 6 [As 8s]. Bets: 15. Collects: 14.49. Loses: 0.51.
Player imperceptible does not show cards.Bets: 0. Collects: 0. Wins: 0.
Game ended at: 2016/11/29 11:36:20

Game started
Game ID: 786904226 0.25/0.50 (PRR) Gorgons - 13 (Hold'em)
Seat 4 is the button
Seat 1: IlxxxlI (21.52).
Seat 2: Maria_Pia (23.99).
Seat 3: Xobkcul (55.29).
Seat 4: 528 Hertz (86.63).
Seat 5: foreseen (84.70).
Player foreseen has small blind (0.25)
Player IlxxxlI has big blind (0.50)
Player IlxxxlI received card: [4s]
Player IlxxxlI received card: [Kd]
Player Maria_Pia folds
Player Xobkcul folds
Player 528 Hertz raises (1.75)
Player foreseen folds
Player IlxxxlI folds
Uncalled bet (1.25) returned to 528 Hertz
Player 528 Hertz mucks cards
------ Summary ------
Pot: 1.25. Rake 0
Player IlxxxlI does not show cards.Bets: 0.50. Collects: 0. Loses: 0.50.
Player Maria_Pia does not show cards.Bets: 0. Collects: 0. Wins: 0.
Player Xobkcul does not show cards.Bets: 0. Collects: 0. Wins: 0.
*Player 528 Hertz mucks (does not show cards). Bets: 0.50. Collects: 1.25. Wins: 0.75.
Player foreseen does not show cards.Bets: 0.25. Collects: 0. Loses: 0.25.
Game ended at: 2016/11/29 11:35:30

Game started
Game ID: 786904098 0.25/0.50 (PRR) Gorgons (Cap) - 3 (Hold'em)
Seat 4 is the button
Seat 2: IlxxxlI (29.20).
Seat 3: beachrog (35.48).
Seat 4: Maria_Pia (26.79).
Seat 6: imperceptible (18.10).
Player imperceptible has small blind (0.25)
Player IlxxxlI has big blind (0.50)
Player IlxxxlI received card: [4d]
Player IlxxxlI received card: [Ah]
Player beachrog folds
Player Maria_Pia folds
Player imperceptible folds
Uncalled bet (0.25) returned to IlxxxlI
Player IlxxxlI mucks cards
------ Summary ------
Pot: 0.50. Rake 0
*Player IlxxxlI mucks (does not show cards). Bets: 0.25. Collects: 0.50. Wins: 0.25.
Player beachrog does not show cards.Bets: 0. Collects: 0. Wins: 0.
Player Maria_Pia does not show cards.Bets: 0. Collects: 0. Wins: 0.
Player imperceptible does not show cards.Bets: 0.25. Collects: 0. Loses: 0.25.
Game ended at: 2016/11/29 11:35:4

Game started
Game ID: 786904026 0.25/0.50 (PRR) Gorgons - 13 (Hold'em)
Seat 3 is the button
Seat 1: IlxxxlI (21.52).
Seat 2: Maria_Pia (23.99).
Seat 3: Xobkcul (54.54).
Seat 4: 528 Hertz (86.88).
Seat 5: foreseen (85.20).
Player 528 Hertz has small blind (0.25)
Player foreseen has big blind (0.50)
Player IlxxxlI received card: [Jd]
Player IlxxxlI received card: [2s]
Player IlxxxlI folds
Player Maria_Pia folds
Player Xobkcul raises (1.12)
Player 528 Hertz folds
Player foreseen folds
Uncalled bet (0.62) returned to Xobkcul
Player Xobkcul mucks cards
------ Summary ------
Pot: 1.25. Rake 0
Player IlxxxlI does not show cards.Bets: 0. Collects: 0. Wins: 0.
Player Maria_Pia does not show cards.Bets: 0. Collects: 0. Wins: 0.
*Player Xobkcul mucks (does not show cards). Bets: 0.50. Collects: 1.25. Wins: 0.75.
Player 528 Hertz does not show cards.Bets: 0.25. Collects: 0. Loses: 0.25.
Player foreseen does not show cards.Bets: 0.50. Collects: 0. Loses: 0.50.
Game ended at: 2016/11/29 11:35:0

Game started
Game ID: 786903879 0.25/0.50 (PRR) Gorgons (Cap) - 3 (Hold'em)
Seat 3 is the button
Seat 2: IlxxxlI (28.45).
Seat 3: beachrog (35.48).
Seat 4: Maria_Pia (27.04).
Seat 6: imperceptible (18.60).
Player Maria_Pia has small blind (0.25)
Player imperceptible has big blind (0.50)
Player IlxxxlI received card: [Ac]
Player IlxxxlI received card: [9d]
Player IlxxxlI raises (1.20)
Player beachrog folds
Player Maria_Pia folds
Player imperceptible folds
Uncalled bet (0.70) returned to IlxxxlI
Player IlxxxlI mucks cards
------ Summary ------
Pot: 1.25. Rake 0
*Player IlxxxlI mucks (does not show cards). Bets: 0.50. Collects: 1.25. Wins: 0.75.
Player beachrog does not show cards.Bets: 0. Collects: 0. Wins: 0.
Player Maria_Pia does not show cards.Bets: 0.25. Collects: 0. Loses: 0.25.
Player imperceptible does not show cards.Bets: 0.50. Collects: 0. Loses: 0.50.
Game ended at: 2016/11/29 11:34:50

Game started
Game ID: 786903750 0.25/0.50 (PRR) Gorgons (Short) - 3 (Hold'em)
Seat 5 is the button
Seat 1: Maria_Pia (20).
Seat 2: IlxxxlI (11.52).
Seat 3: beachrog (42.80).
Seat 5: imperceptible (19.50).
Seat 6: Parcker (39.84).
Player Parcker has small blind (0.25)
Player Maria_Pia has big blind (0.50)
Player IlxxxlI received card: [4d]
Player IlxxxlI received card: [3h]
Player IlxxxlI folds
Player beachrog folds
Player imperceptible raises (1)
Player Parcker folds
Player Maria_Pia calls (0.50)
*** FLOP ***: [Kh Jh 6s]
Player Maria_Pia checks
Player imperceptible bets (1.07)
Player Maria_Pia calls (1.07)
*** TURN ***: [Kh Jh 6s] [10s]
Player Maria_Pia checks
Player imperceptible bets (2.09)
Player Maria_Pia allin (17.93)
Player imperceptible folds
Uncalled bet (15.84) returned to Maria_Pia
Player Maria_Pia mucks cards
------ Summary ------
Pot: 8.15. Rake 0.28. JP fee 0.14
Board: [Kh Jh 6s 10s]
*Player Maria_Pia mucks (does not show cards). Bets: 4.16. Collects: 8.15. Wins: 3.99.
Player IlxxxlI does not show cards.Bets: 0. Collects: 0. Wins: 0.
Player beachrog does not show cards.Bets: 0. Collects: 0. Wins: 0.
Player imperceptible does not show cards.Bets: 4.16. Collects: 0. Loses: 4.16.
Player Parcker does not show cards.Bets: 0.25. Collects: 0. Loses: 0.25.
Game ended at: 2016/11/29 11:36:24

Game started
Game ID: 786903701 0.25/0.50 (PRR) Gorgons - 13 (Hold'em)
Seat 2 is the button
Seat 1: IlxxxlI (21.52).
Seat 2: Maria_Pia (23.24).
Seat 3: Xobkcul (54.79).
Seat 4: 528 Hertz (87.38).
Seat 5: foreseen (85.20).
Player Xobkcul has small blind (0.25)
Player 528 Hertz has big blind (0.50)
Player IlxxxlI received card: [6d]
Player IlxxxlI received card: [Qd]
Player foreseen folds
Player IlxxxlI folds
Player Maria_Pia raises (1)
Player Xobkcul folds
Player 528 Hertz folds
Uncalled bet (0.50) returned to Maria_Pia
Player Maria_Pia mucks cards
------ Summary ------
Pot: 1.25. Rake 0
Player IlxxxlI does not show cards.Bets: 0. Collects: 0. Wins: 0.
*Player Maria_Pia mucks (does not show cards). Bets: 0.50. Collects: 1.25. Wins: 0.75.
Player Xobkcul does not show cards.Bets: 0.25. Collects: 0. Loses: 0.25.
Player 528 Hertz does not show cards.Bets: 0.50. Collects: 0. Loses: 0.50.
Player foreseen does not show cards.Bets: 0. Collects: 0. Wins: 0.
Game ended at: 2016/11/29 11:34:45

Game started
Game ID: 786903345 0.25/0.50 (PRR) Gorgons - 13 (Hold'em)
Seat 1 is the button
Seat 1: IlxxxlI (21.52).
Seat 2: Maria_Pia (23.49).
Seat 3: Xobkcul (55.29).
Seat 4: 528 Hertz (87.38).
Seat 5: foreseen (84.45).
Player Maria_Pia has small blind (0.25)
Player Xobkcul has big blind (0.50)
Player IlxxxlI received card: [8d]
Player IlxxxlI received card: [9d]
Player 528 Hertz folds
Player foreseen raises (1.25)
Player IlxxxlI folds
Player Maria_Pia folds
Player Xobkcul folds
Uncalled bet (0.75) returned to foreseen
Player foreseen mucks cards
------ Summary ------
Pot: 1.25. Rake 0
Player IlxxxlI does not show cards.Bets: 0. Collects: 0. Wins: 0.
Player Maria_Pia does not show cards.Bets: 0.25. Collects: 0. Loses: 0.25.
Player Xobkcul does not show cards.Bets: 0.50. Collects: 0. Loses: 0.50.
Player 528 Hertz does not show cards.Bets: 0. Collects: 0. Wins: 0.
*Player foreseen mucks (does not show cards). Bets: 0.50. Collects: 1.25. Wins: 0.75.
Game ended at: 2016/11/29 11:34:19

Game started
Game ID: 786903323 0.25/0.50 (PRR) Gorgons (Cap) - 3 (Hold'em)
Seat 2 is the button
Seat 2: IlxxxlI (28.45).
Seat 3: beachrog (36.73).
Seat 4: Maria_Pia (28.29).
Seat 6: imperceptible (16.28).
Player beachrog has small blind (0.25)
Player Maria_Pia has big blind (0.50)
Player IlxxxlI received card: [6s]
Player IlxxxlI received card: [7c]
Player imperceptible raises (1.25)
Player IlxxxlI folds
Player beachrog calls (1)
Player Maria_Pia calls (0.75)
*** FLOP ***: [3c Ad 5d]
Player beachrog checks
Player Maria_Pia checks
Player imperceptible bets (1.78)
Player beachrog folds
Player Maria_Pia folds
Uncalled bet (1.78) returned to imperceptible
Player imperceptible mucks cards
------ Summary ------
Pot: 3.57. Rake 0.12. JP fee 0.06
Board: [3c Ad 5d]
Player IlxxxlI does not show cards.Bets: 0. Collects: 0. Wins: 0.
Player beachrog does not show cards.Bets: 1.25. Collects: 0. Loses: 1.25.
Player Maria_Pia does not show cards.Bets: 1.25. Collects: 0. Loses: 1.25.
*Player imperceptible mucks (does not show cards). Bets: 1.25. Collects: 3.57. Wins: 2.32.
Game ended at: 2016/11/29 11:34:34

Game started
Game ID: 786903093 0.25/0.50 (PRR) Gorgons - 13 (Hold'em)
Seat 5 is the button
Seat 1: IlxxxlI (21.77).
Seat 2: Maria_Pia (23.24).
Seat 3: Xobkcul (55.29).
Seat 4: 528 Hertz (87.38).
Seat 5: foreseen (84.45).
Player IlxxxlI has small blind (0.25)
Player Maria_Pia has big blind (0.50)
Player IlxxxlI received card: [5h]
Player IlxxxlI received card: [10c]
Player Xobkcul folds
Player 528 Hertz folds
Player foreseen folds
Player IlxxxlI folds
Uncalled bet (0.25) returned to Maria_Pia
Player Maria_Pia mucks cards
------ Summary ------
Pot: 0.50. Rake 0
Player IlxxxlI does not show cards.Bets: 0.25. Collects: 0. Loses: 0.25.
*Player Maria_Pia mucks (does not show cards). Bets: 0.25. Collects: 0.50. Wins: 0.25.
Player Xobkcul does not show cards.Bets: 0. Collects: 0. Wins: 0.
Player 528 Hertz does not show cards.Bets: 0. Collects: 0. Wins: 0.
Player foreseen does not show cards.Bets: 0. Collects: 0. Wins: 0.
Game ended at: 2016/11/29 11:33:55

Game started
Game ID: 786902747 0.25/0.50 (PRR) Gorgons (Cap) - 3 (Hold'em)
Seat 6 is the button
Seat 2: IlxxxlI (31.64).
Seat 3: beachrog (20.19).
Seat 4: Maria_Pia (28.29).
Seat 6: imperceptible (31.28).
Player IlxxxlI has small blind (0.25)
Player beachrog has big blind (0.50)
Player IlxxxlI received card: [5d]
Player IlxxxlI received card: [5h]
Player Maria_Pia folds
Player imperceptible raises (1.25)
Player IlxxxlI raises (2.94)
Player beachrog calls (2.69)
Player imperceptible caps (13.75)
Player IlxxxlI folds
Player beachrog calls (11.81)
*** FLOP ***: [8h 10h 7s]
*** TURN ***: [8h 10h 7s] [Js]
*** RIVER ***: [8h 10h 7s Js] [6c]
------ Summary ------
Pot: 31.54. Rake 1.41. JP fee 0.24
Board: [8h 10h 7s Js 6c]
Player IlxxxlI does not show cards.Bets: 3.19. Collects: 0. Loses: 3.19.
*Player beachrog shows: Straight to J [8s 9s]. Bets: 15. Collects: 31.54. Wins: 16.54.
Player Maria_Pia does not show cards.Bets: 0. Collects: 0. Wins: 0.
Player imperceptible shows: One pair of Qs [Qh Qs]. Bets: 15. Collects: 0. Loses: 15.
Game ended at: 2016/11/29 11:33:51

Game started
Game ID: 786902729 0.25/0.50 (PRR) Gorgons (Short) - 3 (Hold'em)
Seat 4 is the button
Seat 1: Maria_Pia (20).
Seat 2: IlxxxlI (11.52).
Seat 3: beachrog (40.76).
Seat 4: annaroyer (4.86).
Seat 5: imperceptible (19.75).
Seat 6: Parcker (41.84).
Player imperceptible has small blind (0.25)
Player Parcker has big blind (0.50)
Player IlxxxlI received card: [9c]
Player IlxxxlI received card: [7d]
Player Maria_Pia folds
Player IlxxxlI folds
Player beachrog raises (2)
Player annaroyer folds
Player imperceptible folds
Player Parcker calls (1.50)
*** FLOP ***: [3h 3c 5s]
Player Parcker checks
Player beachrog bets (2.02)
Player Parcker folds
Uncalled bet (2.02) returned to beachrog
Player beachrog mucks cards
------ Summary ------
Pot: 4.04. Rake 0.15. JP fee 0.06
Board: [3h 3c 5s]
Player Maria_Pia does not show cards.Bets: 0. Collects: 0. Wins: 0.
Player IlxxxlI does not show cards.Bets: 0. Collects: 0. Wins: 0.
*Player beachrog mucks (does not show cards). Bets: 2. Collects: 4.04. Wins: 2.04.
Player annaroyer does not show cards.Bets: 0. Collects: 0. Wins: 0.
Player imperceptible does not show cards.Bets: 0.25. Collects: 0. Loses: 0.25.
Player Parcker does not show cards.Bets: 2. Collects: 0. Loses: 2.
Game ended at: 2016/11/29 11:34:24

Game started
Game ID: 786902731 0.25/0.50 (PRR) Gorgons - 13 (Hold'em)
Seat 4 is the button
Seat 1: IlxxxlI (22.27).
Seat 2: Maria_Pia (22.49).
Seat 3: Xobkcul (55.29).
Seat 4: 528 Hertz (87.38).
Seat 5: foreseen (84.70).
Player foreseen has small blind (0.25)
Player IlxxxlI has big blind (0.50)
Player IlxxxlI received card: [2c]
Player IlxxxlI received card: [9h]
Player Maria_Pia raises (1.10)
Player Xobkcul folds
Player 528 Hertz folds
Player foreseen folds
Player IlxxxlI folds
Uncalled bet (0.60) returned to Maria_Pia
Player Maria_Pia mucks cards
------ Summary ------
Pot: 1.25. Rake 0
Player IlxxxlI does not show cards.Bets: 0.50. Collects: 0. Loses: 0.50.
*Player Maria_Pia mucks (does not show cards). Bets: 0.50. Collects: 1.25. Wins: 0.75.
Player Xobkcul does not show cards.Bets: 0. Collects: 0. Wins: 0.
Player 528 Hertz does not show cards.Bets: 0. Collects: 0. Wins: 0.
Player foreseen does not show cards.Bets: 0.25. Collects: 0. Loses: 0.25.
Game ended at: 2016/11/29 11:33:35

Game started
Game ID: 786902578 0.25/0.50 (PRR) Gorgons - 13 (Hold'em)
Seat 3 is the button
Seat 1: IlxxxlI (22.27).
Seat 2: Maria_Pia (22.49).
Seat 3: Xobkcul (55.29).
Seat 4: 528 Hertz (87.63).
Seat 5: foreseen (84.45).
Player 528 Hertz has small blind (0.25)
Player foreseen has big blind (0.50)
Player IlxxxlI received card: [4c]
Player IlxxxlI received card: [6h]
Player IlxxxlI folds
Player Maria_Pia folds
Player Xobkcul folds
Player 528 Hertz folds
Uncalled bet (0.25) returned to foreseen
Player foreseen mucks cards
------ Summary ------
Pot: 0.50. Rake 0
Player IlxxxlI does not show cards.Bets: 0. Collects: 0. Wins: 0.
Player Maria_Pia does not show cards.Bets: 0. Collects: 0. Wins: 0.
Player Xobkcul does not show cards.Bets: 0. Collects: 0. Wins: 0.
Player 528 Hertz does not show cards.Bets: 0.25. Collects: 0. Loses: 0.25.
*Player foreseen mucks (does not show cards). Bets: 0.25. Collects: 0.50. Wins: 0.25.
Game ended at: 2016/11/29 11:33:8

Game started
Game ID: 786902396 0.25/0.50 (PRR) Gorgons - 13 (Hold'em)
Seat 2 is the button
Seat 1: IlxxxlI (22.27).
Seat 2: Maria_Pia (21.74).
Seat 3: Xobkcul (55.54).
Seat 4: 528 Hertz (88.13).
Player Xobkcul has small blind (0.25)
Player 528 Hertz has big blind (0.50)
Player IlxxxlI received card: [Qs]
Player IlxxxlI received card: [2h]
Player IlxxxlI folds
Player Maria_Pia raises (1)
Player Xobkcul folds
Player 528 Hertz folds
Uncalled bet (0.50) returned to Maria_Pia
Player Maria_Pia mucks cards
------ Summary ------
Pot: 1.25. Rake 0
Player IlxxxlI does not show cards.Bets: 0. Collects: 0. Wins: 0.
*Player Maria_Pia mucks (does not show cards). Bets: 0.50. Collects: 1.25. Wins: 0.75.
Player Xobkcul does not show cards.Bets: 0.25. Collects: 0. Loses: 0.25.
Player 528 Hertz does not show cards.Bets: 0.50. Collects: 0. Loses: 0.50.
Game ended at: 2016/11/29 11:32:56

Game started
Game ID: 786902185 0.25/0.50 (PRR) Gorgons - 13 (Hold'em)
Seat 1 is the button
Seat 1: IlxxxlI (22.27).
Seat 2: Maria_Pia (21.99).
Seat 3: Xobkcul (55.29).
Seat 4: 528 Hertz (88.13).
Player Maria_Pia has small blind (0.25)
Player Xobkcul has big blind (0.50)
Player IlxxxlI received card: [As]
Player IlxxxlI received card: [6h]
Player 528 Hertz folds
Player IlxxxlI folds
Player Maria_Pia folds
Uncalled bet (0.25) returned to Xobkcul
Player Xobkcul mucks cards
------ Summary ------
Pot: 0.50. Rake 0
Player IlxxxlI does not show cards.Bets: 0. Collects: 0. Wins: 0.
Player Maria_Pia does not show cards.Bets: 0.25. Collects: 0. Loses: 0.25.
*Player Xobkcul mucks (does not show cards). Bets: 0.25. Collects: 0.50. Wins: 0.25.
Player 528 Hertz does not show cards.Bets: 0. Collects: 0. Wins: 0.
Game ended at: 2016/11/29 11:32:41

Game started
Game ID: 786902145 0.25/0.50 (PRR) Gorgons (Short) - 3 (Hold'em)
Seat 3 is the button
Seat 1: Maria_Pia (20).
Seat 2: IlxxxlI (11.52).
Seat 3: beachrog (40.76).
Seat 4: annaroyer (5.36).
Seat 5: imperceptible (19.30).
Seat 6: Parcker (41.84).
Player annaroyer has small blind (0.25)
Player imperceptible has big blind (0.50)
Player IlxxxlI received card: [Qd]
Player IlxxxlI received card: [5d]
Player Parcker folds
Player Maria_Pia folds
Player IlxxxlI folds
Player beachrog folds
Player annaroyer calls (0.25)
Player imperceptible checks
*** FLOP ***: [7c 3d Kh]
Player annaroyer checks
Player imperceptible bets (1)
Player annaroyer folds
Uncalled bet (1) returned to imperceptible
Player imperceptible mucks cards
------ Summary ------
Pot: 0.95. Rake 0.05
Board: [7c 3d Kh]
Player Maria_Pia does not show cards.Bets: 0. Collects: 0. Wins: 0.
Player IlxxxlI does not show cards.Bets: 0. Collects: 0. Wins: 0.
Player beachrog does not show cards.Bets: 0. Collects: 0. Wins: 0.
Player annaroyer does not show cards.Bets: 0.50. Collects: 0. Loses: 0.50.
*Player imperceptible mucks (does not show cards). Bets: 0.50. Collects: 0.95. Wins: 0.45.
Player Parcker does not show cards.Bets: 0. Collects: 0. Wins: 0.
Game ended at: 2016/11/29 11:33:8

Game started
Game ID: 786901850 0.25/0.50 (PRR) Gorgons (Cap) - 3 (Hold'em)
Seat 4 is the button
Seat 2: IlxxxlI (27.56).
Seat 3: beachrog (21.44).
Seat 4: Maria_Pia (31.24).
Seat 6: imperceptible (31.53).
Player imperceptible has small blind (0.25)
Player IlxxxlI has big blind (0.50)
Player IlxxxlI received card: [Ah]
Player IlxxxlI received card: [10h]
Player beachrog calls (0.50)
Player Maria_Pia raises (1.25)
Player imperceptible folds
Player IlxxxlI calls (0.75)
Player beachrog calls (0.75)
*** FLOP ***: [2s 4h Ad]
Player IlxxxlI checks
Player beachrog checks
Player Maria_Pia bets (1.70)
Player IlxxxlI calls (1.70)
Player beachrog folds
*** TURN ***: [2s 4h Ad] [10c]
Player IlxxxlI checks
Player Maria_Pia checks
*** RIVER ***: [2s 4h Ad 10c] [3c]
Player IlxxxlI bets (3.51)
Player Maria_Pia folds
Uncalled bet (3.51) returned to IlxxxlI
Player IlxxxlI mucks cards
------ Summary ------
Pot: 7.03. Rake 0.25. JP fee 0.12
Board: [2s 4h Ad 10c 3c]
*Player IlxxxlI mucks (does not show cards). Bets: 2.95. Collects: 7.03. Wins: 4.08.
Player beachrog does not show cards.Bets: 1.25. Collects: 0. Loses: 1.25.
Player Maria_Pia does not show cards.Bets: 2.95. Collects: 0. Loses: 2.95.
Player imperceptible does not show cards.Bets: 0.25. Collects: 0. Loses: 0.25.
Game ended at: 2016/11/29 11:33:8

Game started
Game ID: 786901521 0.25/0.50 (PRR) Gorgons (Cap) - 3 (Hold'em)
Seat 3 is the button
Seat 2: IlxxxlI (27.56).
Seat 3: beachrog (22.94).
Seat 4: Maria_Pia (31.49).
Seat 6: imperceptible (29.94).
Player Maria_Pia has small blind (0.25)
Player imperceptible has big blind (0.50)
Player IlxxxlI received card: [Qd]
Player IlxxxlI received card: [9h]
Player IlxxxlI folds
Player beachrog calls (0.50)
Player Maria_Pia folds
Player imperceptible raises (1)
Player beachrog calls (1)
*** FLOP ***: [3s 10h Js]
Player imperceptible bets (1.54)
Player beachrog folds
Uncalled bet (1.54) returned to imperceptible
Player imperceptible mucks cards
------ Summary ------
Pot: 3.09. Rake 0.12. JP fee 0.04
Board: [3s 10h Js]
Player IlxxxlI does not show cards.Bets: 0. Collects: 0. Wins: 0.
Player beachrog does not show cards.Bets: 1.50. Collects: 0. Loses: 1.50.
Player Maria_Pia does not show cards.Bets: 0.25. Collects: 0. Loses: 0.25.
*Player imperceptible mucks (does not show cards). Bets: 1.50. Collects: 3.09. Wins: 1.59.
Game ended at: 2016/11/29 11:32:0

Game started
Game ID: 786901063 0.25/0.50 (PRR) Gorgons (Cap) - 3 (Hold'em)
Seat 2 is the button
Seat 2: IlxxxlI (27.56).
Seat 3: beachrog (23.19).
Seat 4: Maria_Pia (31.99).
Seat 6: imperceptible (29.19).
Player beachrog has small blind (0.25)
Player Maria_Pia has big blind (0.50)
Player IlxxxlI received card: [10h]
Player IlxxxlI received card: [Jc]
Player imperceptible raises (1)
Player IlxxxlI folds
Player beachrog folds
Player Maria_Pia folds
Uncalled bet (0.50) returned to imperceptible
Player imperceptible mucks cards
------ Summary ------
Pot: 1.25. Rake 0
Player IlxxxlI does not show cards.Bets: 0. Collects: 0. Wins: 0.
Player beachrog does not show cards.Bets: 0.25. Collects: 0. Loses: 0.25.
Player Maria_Pia does not show cards.Bets: 0.50. Collects: 0. Loses: 0.50.
*Player imperceptible mucks (does not show cards). Bets: 0.50. Collects: 1.25. Wins: 0.75.
Game ended at: 2016/11/29 11:31:36

Game started
Game ID: 786900732 0.25/0.50 (PRR) Gorgons (Cap) - 3 (Hold'em)
Seat 6 is the button
Seat 2: IlxxxlI (27.81).
Seat 3: beachrog (24.19).
Seat 4: Maria_Pia (31.99).
Seat 6: imperceptible (28.05).
Player IlxxxlI has small blind (0.25)
Player beachrog has big blind (0.50)
Player IlxxxlI received card: [5h]
Player IlxxxlI received card: [6s]
Player Maria_Pia folds
Player imperceptible raises (1)
Player IlxxxlI folds
Player beachrog calls (0.50)
*** FLOP ***: [7h Jd Ac]
Player beachrog checks
Player imperceptible bets (1.42)
Player beachrog folds
Uncalled bet (1.42) returned to imperceptible
Player imperceptible mucks cards
------ Summary ------
Pot: 2.14. Rake 0.09. JP fee 0.02
Board: [7h Jd Ac]
Player IlxxxlI does not show cards.Bets: 0.25. Collects: 0. Loses: 0.25.
Player beachrog does not show cards.Bets: 1. Collects: 0. Loses: 1.
Player Maria_Pia does not show cards.Bets: 0. Collects: 0. Wins: 0.
*Player imperceptible mucks (does not show cards). Bets: 1. Collects: 2.14. Wins: 1.14.
Game ended at: 2016/11/29 11:31:2

Game started
Game ID: 786900722 0.25/0.50 (PRR) Gorgons - 13 (Hold'em)
Seat 4 is the button
Seat 1: IlxxxlI (21.82).
Seat 2: Maria_Pia (21.99).
Seat 3: Xobkcul (55.29).
Seat 4: 528 Hertz (88.13).
Seat 6: rj_2391 (16.46).
Player rj_2391 has small blind (0.25)
Player IlxxxlI has big blind (0.50)
Player IlxxxlI received card: [Qh]
Player IlxxxlI received card: [2c]
Player Maria_Pia folds
Player Xobkcul folds
Player 528 Hertz folds
Player rj_2391 calls (0.25)
Player IlxxxlI checks
*** FLOP ***: [3h 5h 2h]
Player rj_2391 is timed out.
Player rj_2391 checks
Player IlxxxlI bets (0.63)
Player rj_2391 is timed out.
Player rj_2391 folds
Uncalled bet (0.63) returned to IlxxxlI
Player IlxxxlI mucks cards
------ Summary ------
Pot: 0.95. Rake 0.05
Board: [3h 5h 2h]
*Player IlxxxlI mucks (does not show cards). Bets: 0.50. Collects: 0.95. Wins: 0.45.
Player Maria_Pia does not show cards.Bets: 0. Collects: 0. Wins: 0.
Player Xobkcul does not show cards.Bets: 0. Collects: 0. Wins: 0.
Player 528 Hertz does not show cards.Bets: 0. Collects: 0. Wins: 0.
Player rj_2391 does not show cards.Bets: 0.50. Collects: 0. Loses: 0.50.
Game ended at: 2016/11/29 11:32:26

Game started
Game ID: 786900627 0.25/0.50 (PRR) Gorgons (Short) - 3 (Hold'em)
Seat 2 is the button
Seat 1: Maria_Pia (20).
Seat 2: IlxxxlI (11.52).
Seat 3: beachrog (35.06).
Seat 4: annaroyer (10).
Seat 5: imperceptible (19.30).
Seat 6: Parcker (41.84).
Player beachrog has small blind (0.25)
Player annaroyer has big blind (0.50)
Player IlxxxlI received card: [9c]
Player IlxxxlI received card: [Ad]
Player imperceptible folds
Player Parcker folds
Player Maria_Pia raises (1.05)
Player IlxxxlI folds
Player beachrog calls (0.80)
Player annaroyer raises (1.10)
Player Maria_Pia calls (0.55)
Player beachrog calls (0.55)
*** FLOP ***: [9s Js 7s]
Player beachrog checks
Player annaroyer checks
Player Maria_Pia checks
*** TURN ***: [9s Js 7s] [3c]
Player beachrog bets (3.04)
Player annaroyer calls (3.04)
Player Maria_Pia folds
*** RIVER ***: [9s Js 7s 3c] [5h]
Player beachrog bets (6.89)
Player annaroyer folds
Uncalled bet (6.89) returned to beachrog
Player beachrog mucks cards
------ Summary ------
Pot: 10.34. Rake 0.36. JP fee 0.18
Board: [9s Js 7s 3c 5h]
Player Maria_Pia does not show cards.Bets: 1.60. Collects: 0. Loses: 1.60.
Player IlxxxlI does not show cards.Bets: 0. Collects: 0. Wins: 0.
*Player beachrog mucks (does not show cards). Bets: 4.64. Collects: 10.34. Wins: 5.70.
Player annaroyer does not show cards.Bets: 4.64. Collects: 0. Loses: 4.64.
Player imperceptible does not show cards.Bets: 0. Collects: 0. Wins: 0.
Player Parcker does not show cards.Bets: 0. Collects: 0. Wins: 0.
Game ended at: 2016/11/29 11:32:23

Game started
Game ID: 786900126 0.25/0.50 (PRR) Gorgons - 13 (Hold'em)
Seat 3 is the button
Seat 1: IlxxxlI (20).
Seat 2: Maria_Pia (21.99).
Seat 3: Xobkcul (55.29).
Seat 4: 528 Hertz (88.38).
Seat 6: rj_2391 (18.21).
Player 528 Hertz has small blind (0.25)
Player rj_2391 has big blind (0.50)
Player IlxxxlI received card: [Qh]
Player IlxxxlI received card: [Ac]
Player IlxxxlI raises (1.75)
Player Maria_Pia folds
Player Xobkcul folds
Player 528 Hertz folds
Player rj_2391 calls (1.25)
*** FLOP ***: [3h 5d 8c]
Player rj_2391 checks
Player IlxxxlI checks
*** TURN ***: [3h 5d 8c] [Jh]
Player rj_2391 checks
Player IlxxxlI bets (1.19)
Player rj_2391 folds
Uncalled bet (1.19) returned to IlxxxlI
Player IlxxxlI mucks cards
------ Summary ------
Pot: 3.57. Rake 0.12. JP fee 0.06
Board: [3h 5d 8c Jh]
*Player IlxxxlI mucks (does not show cards). Bets: 1.75. Collects: 3.57. Wins: 1.82.
Player Maria_Pia does not show cards.Bets: 0. Collects: 0. Wins: 0.
Player Xobkcul does not show cards.Bets: 0. Collects: 0. Wins: 0.
Player 528 Hertz does not show cards.Bets: 0.25. Collects: 0. Loses: 0.25.
Player rj_2391 does not show cards.Bets: 1.75. Collects: 0. Loses: 1.75.
Game ended at: 2016/11/29 11:30:35

Game started
Game ID: 786899622 0.25/0.50 (PRR) Gorgons (Cap) - 3 (Hold'em)
Seat 4 is the button
Seat 2: IlxxxlI (28.31).
Seat 3: beachrog (27.19).
Seat 4: Maria_Pia (34.99).
Seat 6: imperceptible (22.02).
Player imperceptible has small blind (0.25)
Player IlxxxlI has big blind (0.50)
Player IlxxxlI received card: [2h]
Player IlxxxlI received card: [10c]
Player beachrog raises (1)
Player Maria_Pia calls (1)
Player imperceptible raises (2.75)
Player IlxxxlI folds
Player beachrog calls (2)
Player Maria_Pia calls (2)
*** FLOP ***: [7h Ac As]
Player imperceptible checks
Player beachrog checks
Player Maria_Pia checks
*** TURN ***: [7h Ac As] [2d]
Player imperceptible bets (3.01)
Player beachrog folds
Player Maria_Pia folds
Uncalled bet (3.01) returned to imperceptible
Player imperceptible mucks cards
------ Summary ------
Pot: 9.03. Rake 0.33. JP fee 0.14
Board: [7h Ac As 2d]
Player IlxxxlI does not show cards.Bets: 0.50. Collects: 0. Loses: 0.50.
Player beachrog does not show cards.Bets: 3. Collects: 0. Loses: 3.
Player Maria_Pia does not show cards.Bets: 3. Collects: 0. Loses: 3.
*Player imperceptible mucks (does not show cards). Bets: 3. Collects: 9.03. Wins: 6.03.
Game ended at: 2016/11/29 11:30:36

Game started
Game ID: 786899436 0.25/0.50 (PRR) Gorgons (Short) - 3 (Hold'em)
Seat 1 is the button
Seat 1: Maria_Pia (20.50).
Seat 2: IlxxxlI (11.77).
Seat 3: beachrog (43.56).
Seat 5: imperceptible (8.50).
Seat 6: Parcker (41.84).
Player IlxxxlI has small blind (0.25)
Player beachrog has big blind (0.50)
Player IlxxxlI received card: [8s]
Player IlxxxlI received card: [Js]
Player imperceptible raises (1)
Player Parcker folds
Player Maria_Pia calls (1)
Player IlxxxlI folds
Player beachrog calls (0.50)
*** FLOP ***: [10c As 5s]
Player beachrog checks
Player imperceptible bets (2.06)
Player Maria_Pia calls (2.06)
Player beachrog calls (2.06)
*** TURN ***: [10c As 5s] [Ad]
Player beachrog checks
Player imperceptible checks
Player Maria_Pia checks
*** RIVER ***: [10c As 5s Ad] [6c]
Player beachrog checks
Player imperceptible allin (5.44)
Player Maria_Pia folds
Player beachrog calls (5.44)
------ Summary ------
Pot: 19.30. Rake 0.77. JP fee 0.24
Board: [10c As 5s Ad 6c]
Player Maria_Pia does not show cards.Bets: 3.06. Collects: 0. Loses: 3.06.
Player IlxxxlI does not show cards.Bets: 0.25. Collects: 0. Loses: 0.25.
Player beachrog shows: Two pairs. As and 5s [8h 5h]. Bets: 8.50. Collects: 0. Loses: 8.50.
*Player imperceptible shows: Full House (A/10) [Ah 10h]. Bets: 8.50. Collects: 19.30. Wins: 10.80.
Player Parcker does not show cards.Bets: 0. Collects: 0. Wins: 0.
Game ended at: 2016/11/29 11:30:26

Game started
Game ID: 786898633 0.25/0.50 (PRR) Gorgons - 13 (Hold'em)
Seat 2 is the button
Seat 1: IlxxxlI (20).
Seat 2: Maria_Pia (21.99).
Seat 3: Xobkcul (55.54).
Seat 4: 528 Hertz (87.01).
Seat 5: foreseen (85.70).
Seat 6: rj_2391 (18.21).
Player Xobkcul has small blind (0.25)
Player 528 Hertz has big blind (0.50)
Player IlxxxlI received card: [9h]
Player IlxxxlI received card: [8c]
Player foreseen raises (1.25)
Player rj_2391 folds
Player IlxxxlI folds
Player Maria_Pia folds
Player Xobkcul folds
Player 528 Hertz calls (0.75)
*** FLOP ***: [2h Qd 8h]
Player 528 Hertz checks
Player foreseen is timed out.
Player foreseen checks
*** TURN ***: [2h Qd 8h] [Jc]
Player 528 Hertz bets (2)
Player foreseen is timed out.
Player foreseen folds
Uncalled bet (2) returned to 528 Hertz
Player 528 Hertz mucks cards
------ Summary ------
Pot: 2.62. Rake 0.09. JP fee 0.04
Board: [2h Qd 8h Jc]
Player IlxxxlI does not show cards.Bets: 0. Collects: 0. Wins: 0.
Player Maria_Pia does not show cards.Bets: 0. Collects: 0. Wins: 0.
Player Xobkcul does not show cards.Bets: 0.25. Collects: 0. Loses: 0.25.
*Player 528 Hertz mucks (does not show cards). Bets: 1.25. Collects: 2.62. Wins: 1.37.
Player foreseen does not show cards.Bets: 1.25. Collects: 0. Loses: 1.25.
Player rj_2391 does not show cards.Bets: 0. Collects: 0. Wins: 0.
Game ended at: 2016/11/29 11:29:49

Game started
Game ID: 786898344 0.25/0.50 (PRR) Gorgons - 13 (Hold'em)
Seat 1 is the button
Seat 1: IlxxxlI (20).
Seat 2: Maria_Pia (22.24).
Seat 3: Xobkcul (55.29).
Seat 4: 528 Hertz (87.01).
Seat 5: foreseen (85.70).
Seat 6: rj_2391 (18.21).
Player Maria_Pia has small blind (0.25)
Player Xobkcul has big blind (0.50)
Player IlxxxlI received card: [Qh]
Player IlxxxlI received card: [5d]
Player 528 Hertz folds
Player foreseen folds
Player rj_2391 folds
Player IlxxxlI folds
Player Maria_Pia folds
Uncalled bet (0.25) returned to Xobkcul
Player Xobkcul mucks cards
------ Summary ------
Pot: 0.50. Rake 0
Player IlxxxlI does not show cards.Bets: 0. Collects: 0. Wins: 0.
Player Maria_Pia does not show cards.Bets: 0.25. Collects: 0. Loses: 0.25.
*Player Xobkcul mucks (does not show cards). Bets: 0.25. Collects: 0.50. Wins: 0.25.
Player 528 Hertz does not show cards.Bets: 0. Collects: 0. Wins: 0.
Player foreseen does not show cards.Bets: 0. Collects: 0. Wins: 0.
Player rj_2391 does not show cards.Bets: 0. Collects: 0. Wins: 0.
Game ended at: 2016/11/29 11:27:53

Game started
Game ID: 786898192 0.25/0.50 (PRR) Gorgons (Short) - 3 (Hold'em)
Seat 6 is the button
Seat 1: Maria_Pia (20.75).
Seat 2: IlxxxlI (10).
Seat 3: beachrog (43.56).
Seat 5: imperceptible (8.50).
Seat 6: Parcker (43.54).
Player Maria_Pia has small blind (0.25)
Player IlxxxlI has big blind (0.50)
Player IlxxxlI received card: [10h]
Player IlxxxlI received card: [Js]
Player beachrog folds
Player imperceptible folds
Player Parcker raises (1.20)
Player Maria_Pia folds
Player IlxxxlI calls (0.70)
*** FLOP ***: [8h As 2d]
Player IlxxxlI checks
Player Parcker checks
*** TURN ***: [8h As 2d] [7c]
Player IlxxxlI bets (0.50)
Player Parcker calls (0.50)
*** RIVER ***: [8h As 2d 7c] [Jh]
Player IlxxxlI checks
Player Parcker checks
Player Parcker mucks cards
------ Summary ------
Pot: 3.47. Rake 0.12. JP fee 0.06
Board: [8h As 2d 7c Jh]
Player Maria_Pia does not show cards.Bets: 0.25. Collects: 0. Loses: 0.25.
*Player IlxxxlI shows: One pair of Js [10h Js]. Bets: 1.70. Collects: 3.47. Wins: 1.77.
Player beachrog does not show cards.Bets: 0. Collects: 0. Wins: 0.
Player imperceptible does not show cards.Bets: 0. Collects: 0. Wins: 0.
Player Parcker mucks (does not show cards). Bets: 1.70. Collects: 0. Loses: 1.70.
Game ended at: 2016/11/29 11:28:54

Game started
Game ID: 786897999 0.25/0.50 (PRR) Gorgons (Cap) - 3 (Hold'em)
Seat 3 is the button
Seat 2: IlxxxlI (28.31).
Seat 3: beachrog (30.85).
Seat 4: Maria_Pia (32.50).
Seat 6: imperceptible (21.38).
Player Maria_Pia has small blind (0.25)
Player imperceptible has big blind (0.50)
Player IlxxxlI received card: [4c]
Player IlxxxlI received card: [9c]
Player IlxxxlI folds
Player beachrog folds
Player Maria_Pia folds
Uncalled bet (0.25) returned to imperceptible
Player imperceptible mucks cards
------ Summary ------
Pot: 0.50. Rake 0
Player IlxxxlI does not show cards.Bets: 0. Collects: 0. Wins: 0.
Player beachrog does not show cards.Bets: 0. Collects: 0. Wins: 0.
Player Maria_Pia does not show cards.Bets: 0.25. Collects: 0. Loses: 0.25.
*Player imperceptible mucks (does not show cards). Bets: 0.25. Collects: 0.50. Wins: 0.25.
Game ended at: 2016/11/29 11:27:16

Game started
Game ID: 786897546 0.25/0.50 (PRR) Gorgons (Cap) - 3 (Hold'em)
Seat 2 is the button
Seat 2: IlxxxlI (28.31).
Seat 3: beachrog (31.85).
Seat 4: Maria_Pia (33).
Seat 6: imperceptible (20).
Player beachrog has small blind (0.25)
Player Maria_Pia has big blind (0.50)
Player IlxxxlI received card: [3d]
Player IlxxxlI received card: [9c]
Player imperceptible raises (1)
Player IlxxxlI folds
Player beachrog calls (0.75)
Player Maria_Pia folds
*** FLOP ***: [Jd 2h Qs]
Player beachrog checks
Player imperceptible bets (1.50)
Player beachrog folds
Uncalled bet (1.50) returned to imperceptible
Player imperceptible mucks cards
------ Summary ------
Pot: 2.38. Rake 0.08. JP fee 0.04
Board: [Jd 2h Qs]
Player IlxxxlI does not show cards.Bets: 0. Collects: 0. Wins: 0.
Player beachrog does not show cards.Bets: 1. Collects: 0. Loses: 1.
Player Maria_Pia does not show cards.Bets: 0.50. Collects: 0. Loses: 0.50.
*Player imperceptible mucks (does not show cards). Bets: 1. Collects: 2.38. Wins: 1.38.
Game ended at: 2016/11/29 11:27:4

Game started
Game ID: 786897191 0.25/0.50 (PRR) Gorgons (Cap) - 3 (Hold'em)
Seat 6 is the button
Seat 2: IlxxxlI (28.56).
Seat 3: beachrog (31.60).
Seat 4: Maria_Pia (33).
Seat 6: imperceptible (20).
Player IlxxxlI has small blind (0.25)
Player beachrog has big blind (0.50)
Player IlxxxlI received card: [7d]
Player IlxxxlI received card: [Jc]
Player Maria_Pia folds
Player imperceptible folds
Player IlxxxlI folds
Uncalled bet (0.25) returned to beachrog
Player beachrog mucks cards
------ Summary ------
Pot: 0.50. Rake 0
Player IlxxxlI does not show cards.Bets: 0.25. Collects: 0. Loses: 0.25.
*Player beachrog mucks (does not show cards). Bets: 0.25. Collects: 0.50. Wins: 0.25.
Player Maria_Pia does not show cards.Bets: 0. Collects: 0. Wins: 0.
Player imperceptible does not show cards.Bets: 0. Collects: 0. Wins: 0.
Game ended at: 2016/11/29 11:26:30

Game started
Game ID: 786897181 0.25/0.50 (PRR) Gorgons - 13 (Hold'em)
Seat 6 is the button
Seat 1: IlxxxlI (20).
Seat 2: Maria_Pia (22.74).
Seat 3: Xobkcul (55.29).
Seat 4: 528 Hertz (87.01).
Seat 5: foreseen (85.70).
Seat 6: rj_2391 (17.52).
Player IlxxxlI has small blind (0.25)
Player Maria_Pia has big blind (0.50)
Player IlxxxlI received card: [9h]
Player IlxxxlI received card: [Ks]
Player Xobkcul folds
Player 528 Hertz folds
Player foreseen folds
Player rj_2391 calls (0.50)
Player IlxxxlI folds
Player Maria_Pia checks
*** FLOP ***: [9d Ah 9c]
Player Maria_Pia checks
Player rj_2391 checks
*** TURN ***: [9d Ah 9c] [7d]
Player Maria_Pia checks
Player rj_2391 bets (0.50)
Player Maria_Pia folds
Uncalled bet (0.50) returned to rj_2391
Player rj_2391 mucks cards
------ Summary ------
Pot: 1.19. Rake 0.04. JP fee 0.02
Board: [9d Ah 9c 7d]
Player IlxxxlI does not show cards.Bets: 0.25. Collects: 0. Loses: 0.25.
Player Maria_Pia does not show cards.Bets: 0.50. Collects: 0. Loses: 0.50.
Player Xobkcul does not show cards.Bets: 0. Collects: 0. Wins: 0.
Player 528 Hertz does not show cards.Bets: 0. Collects: 0. Wins: 0.
Player foreseen does not show cards.Bets: 0. Collects: 0. Wins: 0.
*Player rj_2391 mucks (does not show cards). Bets: 0.50. Collects: 1.19. Wins: 0.69.
Game ended at: 2016/11/29 11:27:29

Game started
Game ID: 786896865 0.25/0.50 (PRR) Gorgons (Cap) - 3 (Hold'em)
Seat 4 is the button
Seat 2: IlxxxlI (20).
Seat 3: beachrog (31.60).
Seat 4: Maria_Pia (33).
Seat 6: imperceptible (9.51).
Player imperceptible has small blind (0.25)
Player IlxxxlI has big blind (0.50)
Player IlxxxlI received card: [Kc]
Player IlxxxlI received card: [As]
Player beachrog folds
Player Maria_Pia folds
Player imperceptible allin (9.26)
Player IlxxxlI calls (9.01)
*** FLOP ***: [6d 7d 6h]
*** TURN ***: [6d 7d 6h] [Js]
*** RIVER ***: [6d 7d 6h Js] [6c]
------ Summary ------
Pot: 18.07. Rake 0.71. JP fee 0.24
Board: [6d 7d 6h Js 6c]
*Player IlxxxlI shows: Three Of Kind of 6s (kicker A) [Kc As]. Bets: 9.51. Collects: 18.07. Wins: 8.56.
Player beachrog does not show cards.Bets: 0. Collects: 0. Wins: 0.
Player Maria_Pia does not show cards.Bets: 0. Collects: 0. Wins: 0.
Player imperceptible shows: Three Of Kind of 6s [10s Kd]. Bets: 9.51. Collects: 0. Loses: 9.51.
Game ended at: 2016/11/29 11:26:2

Game started
Game ID: 786896249 0.25/0.50 (PRR) Gorgons - 13 (Hold'em)
Seat 5 is the button
Seat 1: IlxxxlI (20).
Seat 2: Maria_Pia (22.74).
Seat 3: Xobkcul (55.29).
Seat 4: 528 Hertz (87.01).
Seat 5: foreseen (83.44).
Seat 6: rj_2391 (19.50).
Player rj_2391 has small blind (0.25)
Player IlxxxlI has big blind (0.50)
Player IlxxxlI received card: [Ks]
Player IlxxxlI received card: [5d]
Player Maria_Pia folds
Player Xobkcul folds
Player 528 Hertz folds
Player foreseen raises (1.12)
Player rj_2391 calls (0.87)
Player IlxxxlI folds
*** FLOP ***: [Kc Ac Qc]
Player rj_2391 checks
Player foreseen bets (0.86)
Player rj_2391 calls (0.86)
*** TURN ***: [Kc Ac Qc] [4c]
Player rj_2391 checks
Player foreseen checks
*** RIVER ***: [Kc Ac Qc 4c] [8s]
Player rj_2391 checks
Player foreseen checks
Player rj_2391 mucks cards
------ Summary ------
Pot: 4.24. Rake 0.16. JP fee 0.06
Board: [Kc Ac Qc 4c 8s]
Player IlxxxlI does not show cards.Bets: 0.50. Collects: 0. Loses: 0.50.
Player Maria_Pia does not show cards.Bets: 0. Collects: 0. Wins: 0.
Player Xobkcul does not show cards.Bets: 0. Collects: 0. Wins: 0.
Player 528 Hertz does not show cards.Bets: 0. Collects: 0. Wins: 0.
*Player foreseen shows: One pair of As [Ah 6h]. Bets: 1.98. Collects: 4.24. Wins: 2.26.
Player rj_2391 mucks (does not show cards). Bets: 1.98. Collects: 0. Loses: 1.98.
Game ended at: 2016/11/29 11:26:1

Game started
Game ID: 786890407 0.50/1 (PRR) Kraken (short) (Hold'em)
Seat 6 is the button
Seat 2: Gargantuatua (163.14).
Seat 3: AironVega (50).
Seat 4: Ksowas (72.38).
Seat 5: IlxxxlI (20).
Seat 6: 89_suited (106.95).
Player Gargantuatua has small blind (0.50)
Player AironVega has big blind (1)
Player IlxxxlI received card: [9h]
Player IlxxxlI received card: [As]
Player Ksowas folds
Player IlxxxlI folds
Player 89_suited folds
Player Gargantuatua is timed out.
Player Gargantuatua folds
Uncalled bet (0.50) returned to AironVega
Player AironVega mucks cards
------ Summary ------
Pot: 1. Rake 0
Player Gargantuatua does not show cards.Bets: 0.50. Collects: 0. Loses: 0.50.
*Player AironVega mucks (does not show cards). Bets: 0.50. Collects: 1. Wins: 0.50.
Player Ksowas does not show cards.Bets: 0. Collects: 0. Wins: 0.
Player IlxxxlI does not show cards.Bets: 0. Collects: 0. Wins: 0.
Player 89_suited does not show cards.Bets: 0. Collects: 0. Wins: 0.
Game ended at: 2016/11/29 11:17:46

Game started
Game ID: 786889783 0.50/1 (PRR) Kraken (short) (Hold'em)
Seat 5 is the button
Seat 2: Gargantuatua (164.14).
Seat 3: AironVega (50).
Seat 4: Ksowas (70.88).
Seat 5: IlxxxlI (20).
Seat 6: 89_suited (107.45).
Player 89_suited has small blind (0.50)
Player Gargantuatua has big blind (1)
Player IlxxxlI received card: [7d]
Player IlxxxlI received card: [9h]
Player AironVega folds
Player Ksowas raises (2)
Player IlxxxlI folds
Player 89_suited folds
Player Gargantuatua folds
Uncalled bet (1) returned to Ksowas
Player Ksowas mucks cards
------ Summary ------
Pot: 2.50. Rake 0
Player Gargantuatua does not show cards.Bets: 1. Collects: 0. Loses: 1.
Player AironVega does not show cards.Bets: 0. Collects: 0. Wins: 0.
*Player Ksowas mucks (does not show cards). Bets: 1. Collects: 2.50. Wins: 1.50.
Player IlxxxlI does not show cards.Bets: 0. Collects: 0. Wins: 0.
Player 89_suited does not show cards.Bets: 0.50. Collects: 0. Loses: 0.50.
Game ended at: 2016/11/29 11:17:8

Game started
Game ID: 786888970 0.50/1 (PRR) Kraken (short) (Hold'em)
Seat 4 is the button
Seat 2: Gargantuatua (164.14).
Seat 3: AironVega (52.20).
Seat 4: Ksowas (70.88).
Seat 5: IlxxxlI (20).
Seat 6: 89_suited (57.75).
Player IlxxxlI has small blind (0.50)
Player 89_suited has big blind (1)
Player IlxxxlI received card: [2s]
Player IlxxxlI received card: [8h]
Player Gargantuatua folds
Player AironVega raises (2.50)
Player Ksowas folds
Player IlxxxlI folds
Player 89_suited calls (1.50)
*** FLOP ***: [3c Ac 6c]
Player 89_suited bets (5)
Player AironVega calls (5)
*** TURN ***: [3c Ac 6c] [10h]
Player 89_suited checks
Player AironVega bets (9.72)
Player 89_suited allin (50.25)
Player AironVega allin (34.98)
Uncalled bet (5.55) returned to 89_suited
*** RIVER ***: [3c Ac 6c 10h] [Kc]
------ Summary ------
Pot: 101.90. Rake 2.76. JP fee 0.24
Board: [3c Ac 6c 10h Kc]
Player Gargantuatua does not show cards.Bets: 0. Collects: 0. Wins: 0.
Player AironVega shows: Two pairs. As and Ks [As Kh]. Bets: 52.20. Collects: 0. Loses: 52.20.
Player Ksowas does not show cards.Bets: 0. Collects: 0. Wins: 0.
Player IlxxxlI does not show cards.Bets: 0.50. Collects: 0. Loses: 0.50.
*Player 89_suited shows: Flush, A high [9c 7c]. Bets: 52.20. Collects: 101.90. Wins: 49.70.
Game ended at: 2016/11/29 11:16:20

Game started
Game ID: 786888288 0.50/1 (PRR) Kraken (short) (Hold'em)
Seat 3 is the button
Seat 2: Gargantuatua (166.64).
Seat 3: AironVega (52.20).
Seat 4: Ksowas (50.50).
Seat 5: IlxxxlI (20).
Seat 6: 89_suited (57.75).
Player Ksowas has small blind (0.50)
Player IlxxxlI has big blind (1)
Player IlxxxlI received card: [Qs]
Player IlxxxlI received card: [As]
Player 89_suited folds
Player Gargantuatua raises (2.50)
Player AironVega folds
Player Ksowas raises (8.50)
Player IlxxxlI allin (19)
Player Gargantuatua folds
Player Ksowas calls (11)
*** FLOP ***: [Kh 5c 2c]
*** TURN ***: [Kh 5c 2c] [5s]
*** RIVER ***: [Kh 5c 2c 5s] [7c]
------ Summary ------
Pot: 40.38. Rake 1.88. JP fee 0.24
Board: [Kh 5c 2c 5s 7c]
Player Gargantuatua does not show cards.Bets: 2.50. Collects: 0. Loses: 2.50.
Player AironVega does not show cards.Bets: 0. Collects: 0. Wins: 0.
*Player Ksowas shows: Two pairs. Qs and 5s [Qh Qc]. Bets: 20. Collects: 40.38. Wins: 20.38.
Player IlxxxlI shows: One pair of 5s [Qs As]. Bets: 20. Collects: 0. Loses: 20.
Player 89_suited does not show cards.Bets: 0. Collects: 0. Wins: 0.
Game ended at: 2016/11/29 11:15:18

Game started
Game ID: 786812272 0.25/0.50 (PRR) Garuda - 3 (Hold'em)
Seat 5 is the button
Seat 1: IlxxxlI (85.35).
Seat 2: Ice Bank Mice Elf (81.58).
Seat 4: imperceptible (11.56).
Seat 5: HanktheGrey (47.50).
Seat 6: kid4life (126.88).
Seat 7: Tilt-A-Whirl (52.75).
Seat 8: EasyQQ (119.54).
Seat 9: coldkilla (25.13).
Player kid4life has small blind (0.25)
Player Tilt-A-Whirl has big blind (0.50)
Player IlxxxlI received card: [Qd]
Player IlxxxlI received card: [Kc]
Player EasyQQ folds
Player coldkilla folds
Player IlxxxlI raises (1)
Player Ice Bank Mice Elf folds
Player imperceptible folds
Player HanktheGrey folds
Player kid4life folds
Player Tilt-A-Whirl calls (0.50)
*** FLOP ***: [9h 6d Kd]
Player Tilt-A-Whirl checks
Player IlxxxlI bets (1.42)
Player Tilt-A-Whirl calls (1.42)
*** TURN ***: [9h 6d Kd] [2s]
Player Tilt-A-Whirl checks
Player IlxxxlI bets (3.50)
Player Tilt-A-Whirl calls (3.50)
*** RIVER ***: [9h 6d Kd 2s] [8s]
Player Tilt-A-Whirl checks
Player IlxxxlI bets (7)
Player Tilt-A-Whirl folds
Uncalled bet (7) returned to IlxxxlI
Player IlxxxlI mucks cards
------ Summary ------
Pot: 11.49. Rake 0.40. JP fee 0.20
Board: [9h 6d Kd 2s 8s]
*Player IlxxxlI mucks (does not show cards). Bets: 5.92. Collects: 11.49. Wins: 5.57.
Player Ice Bank Mice Elf does not show cards.Bets: 0. Collects: 0. Wins: 0.
Player imperceptible does not show cards.Bets: 0. Collects: 0. Wins: 0.
Player HanktheGrey does not show cards.Bets: 0. Collects: 0. Wins: 0.
Player kid4life does not show cards.Bets: 0.25. Collects: 0. Loses: 0.25.
Player Tilt-A-Whirl does not show cards.Bets: 5.92. Collects: 0. Loses: 5.92.
Player EasyQQ does not show cards.Bets: 0. Collects: 0. Wins: 0.
Player coldkilla does not show cards.Bets: 0. Collects: 0. Wins: 0.
Game ended at: 2016/11/29 9:42:37

Game started
Game ID: 786811817 1/2 (PRR) Longana - 2 (Hold'em)
Seat 6 is the button
Seat 1: IlxxxlI (185.47).
Seat 2: Tilt-A-Whirl (211.50).
Seat 3: IamPhamous (301.16).
Seat 4: PANDAisEVIL (211.32).
Seat 5: Gronkowski69 (230.82).
Seat 6: StephCurry (200).
Seat 7: L4zy_FiSh (250.78).
Seat 8: mr.fargo (104.51).
Seat 9: shokerAAss (238.30).
Player L4zy_FiSh has small blind (1)
Player mr.fargo has big blind (2)
Player IlxxxlI received card: [8s]
Player IlxxxlI received card: [9h]
Player shokerAAss folds
Player IlxxxlI folds
Player Tilt-A-Whirl folds
Player IamPhamous folds
Player PANDAisEVIL raises (6)
Player Gronkowski69 folds
Player StephCurry folds
Player L4zy_FiSh folds
Player mr.fargo folds
Uncalled bet (4) returned to PANDAisEVIL
Player PANDAisEVIL mucks cards
------ Summary ------
Pot: 5. Rake 0
Player IlxxxlI does not show cards.Bets: 0. Collects: 0. Wins: 0.
Player Tilt-A-Whirl does not show cards.Bets: 0. Collects: 0. Wins: 0.
Player IamPhamous does not show cards.Bets: 0. Collects: 0. Wins: 0.
*Player PANDAisEVIL mucks (does not show cards). Bets: 2. Collects: 5. Wins: 3.
Player Gronkowski69 does not show cards.Bets: 0. Collects: 0. Wins: 0.
Player StephCurry does not show cards.Bets: 0. Collects: 0. Wins: 0.
Player L4zy_FiSh does not show cards.Bets: 1. Collects: 0. Loses: 1.
Player mr.fargo does not show cards.Bets: 2. Collects: 0. Loses: 2.
Player shokerAAss does not show cards.Bets: 0. Collects: 0. Wins: 0.
Game ended at: 2016/11/29 9:41:1

Game started
Game ID: 786811221 0.25/0.50 (PRR) Garuda - 3 (Hold'em)
Seat 4 is the button
Seat 1: IlxxxlI (85.35).
Seat 2: Ice Bank Mice Elf (82.83).
Seat 4: imperceptible (9.56).
Seat 5: HanktheGrey (47.75).
Seat 6: kid4life (127.38).
Seat 7: Tilt-A-Whirl (52.75).
Seat 8: EasyQQ (119.54).
Seat 9: coldkilla (25.13).
Player HanktheGrey has small blind (0.25)
Player kid4life has big blind (0.50)
Player IlxxxlI received card: [Ac]
Player IlxxxlI received card: [8c]
Player Tilt-A-Whirl folds
Player EasyQQ folds
Player coldkilla folds
Player IlxxxlI folds
Player Ice Bank Mice Elf raises (1.25)
Player imperceptible allin (9.56)
Player HanktheGrey folds
Player kid4life folds
Player Ice Bank Mice Elf folds
Uncalled bet (8.31) returned to imperceptible
Player imperceptible mucks cards
------ Summary ------
Pot: 3.25. Rake 0
Player IlxxxlI does not show cards.Bets: 0. Collects: 0. Wins: 0.
Player Ice Bank Mice Elf does not show cards.Bets: 1.25. Collects: 0. Loses: 1.25.
*Player imperceptible mucks (does not show cards). Bets: 1.25. Collects: 3.25. Wins: 2.
Player HanktheGrey does not show cards.Bets: 0.25. Collects: 0. Loses: 0.25.
Player kid4life does not show cards.Bets: 0.50. Collects: 0. Loses: 0.50.
Player Tilt-A-Whirl does not show cards.Bets: 0. Collects: 0. Wins: 0.
Player EasyQQ does not show cards.Bets: 0. Collects: 0. Wins: 0.
Player coldkilla does not show cards.Bets: 0. Collects: 0. Wins: 0.
Game ended at: 2016/11/29 9:40:53

Game started
Game ID: 786809794 1/2 (PRR) Longana - 2 (Hold'em)
Seat 5 is the button
Seat 1: IlxxxlI (185.47).
Seat 2: Tilt-A-Whirl (211.50).
Seat 3: IamPhamous (301.16).
Seat 4: PANDAisEVIL (211.32).
Seat 5: Gronkowski69 (202).
Seat 6: StephCurry (206).
Seat 7: L4zy_FiSh (252.78).
Seat 8: mr.fargo (104.51).
Seat 9: shokerAAss (238.30).
Player StephCurry has small blind (1)
Player L4zy_FiSh has big blind (2)
Player IlxxxlI received card: [Jc]
Player IlxxxlI received card: [7h]
Player mr.fargo folds
Player shokerAAss folds
Player IlxxxlI folds
Player Tilt-A-Whirl folds
Player IamPhamous folds
Player PANDAisEVIL folds
Player Gronkowski69 raises (5)
Player StephCurry calls (4)
Player L4zy_FiSh folds
*** FLOP ***: [6h 9s 10h]
Player StephCurry checks
Player Gronkowski69 checks
*** TURN ***: [6h 9s 10h] [7c]
Player StephCurry bets (7.60)
Player Gronkowski69 calls (7.60)
*** RIVER ***: [6h 9s 10h 7c] [2d]
Player StephCurry bets (17.22)
Player Gronkowski69 raises (58)
Player StephCurry folds
Uncalled bet (40.78) returned to Gronkowski69
Player Gronkowski69 mucks cards
------ Summary ------
Pot: 58.64. Rake 2.76. JP fee 0.24
Board: [6h 9s 10h 7c 2d]
Player IlxxxlI does not show cards.Bets: 0. Collects: 0. Wins: 0.
Player Tilt-A-Whirl does not show cards.Bets: 0. Collects: 0. Wins: 0.
Player IamPhamous does not show cards.Bets: 0. Collects: 0. Wins: 0.
Player PANDAisEVIL does not show cards.Bets: 0. Collects: 0. Wins: 0.
*Player Gronkowski69 mucks (does not show cards). Bets: 29.82. Collects: 58.64. Wins: 28.82.
Player StephCurry does not show cards.Bets: 29.82. Collects: 0. Loses: 29.82.
Player L4zy_FiSh does not show cards.Bets: 2. Collects: 0. Loses: 2.
Player mr.fargo does not show cards.Bets: 0. Collects: 0. Wins: 0.
Player shokerAAss does not show cards.Bets: 0. Collects: 0. Wins: 0.
Game ended at: 2016/11/29 9:40:21

Game started
Game ID: 786809153 0.25/0.50 (PRR) Garuda - 3 (Hold'em)
Seat 3 is the button
Seat 1: IlxxxlI (85.35).
Seat 2: Ice Bank Mice Elf (82.83).
Seat 3: tutofu84 (56.70).
Seat 4: imperceptible (22.21).
Seat 5: HanktheGrey (48.25).
Seat 6: kid4life (127.38).
Seat 7: Tilt-A-Whirl (52.75).
Seat 8: EasyQQ (103.40).
Seat 9: coldkilla (25.13).
Player imperceptible has small blind (0.25)
Player HanktheGrey has big blind (0.50)
Player IlxxxlI received card: [10s]
Player IlxxxlI received card: [Jh]
Player kid4life folds
Player Tilt-A-Whirl folds
Player EasyQQ raises (1.50)
Player coldkilla folds
Player IlxxxlI folds
Player Ice Bank Mice Elf folds
Player tutofu84 calls (1.50)
Player imperceptible raises (4.25)
Player HanktheGrey folds
Player EasyQQ calls (3)
Player tutofu84 calls (3)
*** FLOP ***: [As 5c 2c]
Player imperceptible checks
Player EasyQQ bets (6.65)
Player tutofu84 folds
Player imperceptible calls (6.65)
*** TURN ***: [As 5c 2c] [2d]
Player imperceptible checks
Player EasyQQ checks
*** RIVER ***: [As 5c 2c 2d] [2h]
Player imperceptible bets (1.50)
Player EasyQQ raises (9)
Player imperceptible folds
Uncalled bet (7.50) returned to EasyQQ
Player EasyQQ mucks cards
------ Summary ------
Pot: 28.79. Rake 1.27. JP fee 0.24
Board: [As 5c 2c 2d 2h]
Player IlxxxlI does not show cards.Bets: 0. Collects: 0. Wins: 0.
Player Ice Bank Mice Elf does not show cards.Bets: 0. Collects: 0. Wins: 0.
Player tutofu84 does not show cards.Bets: 4.50. Collects: 0. Loses: 4.50.
Player imperceptible does not show cards.Bets: 12.65. Collects: 0. Loses: 12.65.
Player HanktheGrey does not show cards.Bets: 0.50. Collects: 0. Loses: 0.50.
Player kid4life does not show cards.Bets: 0. Collects: 0. Wins: 0.
Player Tilt-A-Whirl does not show cards.Bets: 0. Collects: 0. Wins: 0.
*Player EasyQQ mucks (does not show cards). Bets: 12.65. Collects: 28.79. Wins: 16.14.
Player coldkilla does not show cards.Bets: 0. Collects: 0. Wins: 0.
Game ended at: 2016/11/29 9:39:42

Game started
Game ID: 786809152 1/2 (PRR) Longana - 2 (Hold'em)
Seat 4 is the button
Seat 1: IlxxxlI (185.47).
Seat 2: Tilt-A-Whirl (211.50).
Seat 3: IamPhamous (301.16).
Seat 4: PANDAisEVIL (211.32).
Seat 5: Gronkowski69 (200).
Seat 6: StephCurry (208).
Seat 7: L4zy_FiSh (252.78).
Seat 8: mr.fargo (104.51).
Seat 9: shokerAAss (238.30).
Player Gronkowski69 has small blind (1)
Player StephCurry has big blind (2)
Player IlxxxlI received card: [Jc]
Player IlxxxlI received card: [7s]
Player L4zy_FiSh folds
Player mr.fargo folds
Player shokerAAss folds
Player IlxxxlI folds
Player Tilt-A-Whirl folds
Player IamPhamous folds
Player PANDAisEVIL folds
Player Gronkowski69 raises (5)
Player StephCurry folds
Uncalled bet (4) returned to Gronkowski69
Player Gronkowski69 mucks cards
------ Summary ------
Pot: 4. Rake 0
Player IlxxxlI does not show cards.Bets: 0. Collects: 0. Wins: 0.
Player Tilt-A-Whirl does not show cards.Bets: 0. Collects: 0. Wins: 0.
Player IamPhamous does not show cards.Bets: 0. Collects: 0. Wins: 0.
Player PANDAisEVIL does not show cards.Bets: 0. Collects: 0. Wins: 0.
*Player Gronkowski69 mucks (does not show cards). Bets: 2. Collects: 4. Wins: 2.
Player StephCurry does not show cards.Bets: 2. Collects: 0. Loses: 2.
Player L4zy_FiSh does not show cards.Bets: 0. Collects: 0. Wins: 0.
Player mr.fargo does not show cards.Bets: 0. Collects: 0. Wins: 0.
Player shokerAAss does not show cards.Bets: 0. Collects: 0. Wins: 0.
Game ended at: 2016/11/29 9:38:2

Game started
Game ID: 786808628 0.25/0.50 (PRR) Garuda - 3 (Hold'em)
Seat 2 is the button
Seat 1: IlxxxlI (85.35).
Seat 2: Ice Bank Mice Elf (82.83).
Seat 3: tutofu84 (56.95).
Seat 4: imperceptible (22.71).
Seat 5: HanktheGrey (50.25).
Seat 6: kid4life (127.38).
Seat 7: Tilt-A-Whirl (50).
Seat 8: EasyQQ (103.40).
Seat 9: coldkilla (25.13).
Player tutofu84 has small blind (0.25)
Player imperceptible has big blind (0.50)
Player IlxxxlI received card: [4c]
Player IlxxxlI received card: [7h]
Player HanktheGrey raises (2)
Player kid4life folds
Player Tilt-A-Whirl raises (6)
Player EasyQQ folds
Player coldkilla folds
Player IlxxxlI folds
Player Ice Bank Mice Elf folds
Player tutofu84 folds
Player imperceptible folds
Player HanktheGrey folds
Uncalled bet (4) returned to Tilt-A-Whirl
Player Tilt-A-Whirl mucks cards
------ Summary ------
Pot: 4.75. Rake 0
Player IlxxxlI does not show cards.Bets: 0. Collects: 0. Wins: 0.
Player Ice Bank Mice Elf does not show cards.Bets: 0. Collects: 0. Wins: 0.
Player tutofu84 does not show cards.Bets: 0.25. Collects: 0. Loses: 0.25.
Player imperceptible does not show cards.Bets: 0.50. Collects: 0. Loses: 0.50.
Player HanktheGrey does not show cards.Bets: 2. Collects: 0. Loses: 2.
Player kid4life does not show cards.Bets: 0. Collects: 0. Wins: 0.
*Player Tilt-A-Whirl mucks (does not show cards). Bets: 2. Collects: 4.75. Wins: 2.75.
Player EasyQQ does not show cards.Bets: 0. Collects: 0. Wins: 0.
Player coldkilla does not show cards.Bets: 0. Collects: 0. Wins: 0.
Game ended at: 2016/11/29 9:37:15

Game started
Game ID: 786808070 1/2 (PRR) Longana - 2 (Hold'em)
Seat 3 is the button
Seat 1: IlxxxlI (185.47).
Seat 2: Tilt-A-Whirl (211.50).
Seat 3: IamPhamous (301.16).
Seat 4: PANDAisEVIL (206.82).
Seat 5: Gronkowski69 (200).
Seat 6: StephCurry (208).
Seat 7: L4zy_FiSh (252.78).
Seat 8: mr.fargo (104.51).
Seat 9: shokerAAss (238.30).
Player PANDAisEVIL has small blind (1)
Player Gronkowski69 has big blind (2)
Player IlxxxlI received card: [2s]
Player IlxxxlI received card: [5c]
Player StephCurry folds
Player L4zy_FiSh folds
Player mr.fargo folds
Player shokerAAss folds
Player IlxxxlI folds
Player Tilt-A-Whirl folds
Player IamPhamous folds
Player PANDAisEVIL raises (4)
Player Gronkowski69 calls (3)
*** FLOP ***: [10d Qd 10s]
Player PANDAisEVIL bets (6.33)
Player Gronkowski69 folds
Uncalled bet (6.33) returned to PANDAisEVIL
Player PANDAisEVIL mucks cards
------ Summary ------
Pot: 9.50. Rake 0.34. JP fee 0.16
Board: [10d Qd 10s]
Player IlxxxlI does not show cards.Bets: 0. Collects: 0. Wins: 0.
Player Tilt-A-Whirl does not show cards.Bets: 0. Collects: 0. Wins: 0.
Player IamPhamous does not show cards.Bets: 0. Collects: 0. Wins: 0.
*Player PANDAisEVIL mucks (does not show cards). Bets: 5. Collects: 9.50. Wins: 4.50.
Player Gronkowski69 does not show cards.Bets: 5. Collects: 0. Loses: 5.
Player StephCurry does not show cards.Bets: 0. Collects: 0. Wins: 0.
Player L4zy_FiSh does not show cards.Bets: 0. Collects: 0. Wins: 0.
Player mr.fargo does not show cards.Bets: 0. Collects: 0. Wins: 0.
Player shokerAAss does not show cards.Bets: 0. Collects: 0. Wins: 0.
Game ended at: 2016/11/29 9:37:15

Game started
Game ID: 786806875 0.25/0.50 (PRR) Garuda - 3 (Hold'em)
Seat 1 is the button
Seat 1: IlxxxlI (37.73).
Seat 2: Ice Bank Mice Elf (83.08).
Seat 3: tutofu84 (94.68).
Seat 4: imperceptible (22.71).
Seat 5: HanktheGrey (50.75).
Seat 6: kid4life (127.38).
Seat 7: Tilt-A-Whirl (50).
Seat 8: EasyQQ (115.54).
Seat 9: coldkilla (25.13).
Player Ice Bank Mice Elf has small blind (0.25)
Player tutofu84 has big blind (0.50)
Player IlxxxlI received card: [Kc]
Player IlxxxlI received card: [Ks]
Player imperceptible folds
Player HanktheGrey calls (0.50)
Player kid4life folds
Player Tilt-A-Whirl folds
Player EasyQQ raises (2)
Player coldkilla folds
Player IlxxxlI raises (4.86)
Player Ice Bank Mice Elf folds
Player tutofu84 calls (4.36)
Player HanktheGrey folds
Player EasyQQ calls (2.86)
*** FLOP ***: [7h 7c Jh]
Player tutofu84 checks
Player EasyQQ checks
Player IlxxxlI bets (7.28)
Player tutofu84 calls (7.28)
Player EasyQQ calls (7.28)
*** TURN ***: [7h 7c Jh] [3c]
Player tutofu84 checks
Player EasyQQ checks
Player IlxxxlI allin (25.59)
Player tutofu84 calls (25.59)
Player EasyQQ folds
*** RIVER ***: [7h 7c Jh 3c] [2c]
------ Summary ------
Pot: 85.35. Rake 2.76. JP fee 0.24
Board: [7h 7c Jh 3c 2c]
*Player IlxxxlI shows: Two pairs. Ks and 7s [Kc Ks]. Bets: 37.73. Collects: 85.35. Wins: 47.62.
Player Ice Bank Mice Elf does not show cards.Bets: 0.25. Collects: 0. Loses: 0.25.
Player tutofu84 shows: Two pairs. Qs and 7s [Qd Qc]. Bets: 37.73. Collects: 0. Loses: 37.73.
Player imperceptible does not show cards.Bets: 0. Collects: 0. Wins: 0.
Player HanktheGrey does not show cards.Bets: 0.50. Collects: 0. Loses: 0.50.
Player kid4life does not show cards.Bets: 0. Collects: 0. Wins: 0.
Player Tilt-A-Whirl does not show cards.Bets: 0. Collects: 0. Wins: 0.
Player EasyQQ does not show cards.Bets: 12.14. Collects: 0. Loses: 12.14.
Player coldkilla does not show cards.Bets: 0. Collects: 0. Wins: 0.
Game ended at: 2016/11/29 9:36:35

Game started
Game ID: 786806679 1/2 (PRR) Longana - 2 (Hold'em)
Seat 2 is the button
Seat 1: IlxxxlI (185.47).
Seat 2: Tilt-A-Whirl (215.50).
Seat 3: IamPhamous (293.76).
Seat 4: PANDAisEVIL (210.82).
Seat 6: StephCurry (208).
Seat 7: L4zy_FiSh (252.78).
Seat 8: mr.fargo (104.51).
Seat 9: shokerAAss (238.30).
Player IamPhamous has small blind (1)
Player PANDAisEVIL has big blind (2)
Player IlxxxlI received card: [Jh]
Player IlxxxlI received card: [7c]
Player StephCurry folds
Player L4zy_FiSh folds
Player mr.fargo folds
Player shokerAAss folds
Player IlxxxlI folds
Player Tilt-A-Whirl raises (4)
Player IamPhamous calls (3)
Player PANDAisEVIL calls (2)
*** FLOP ***: [4s 3c 3h]
Player IamPhamous checks
Player PANDAisEVIL checks
Player Tilt-A-Whirl checks
*** TURN ***: [4s 3c 3h] [8h]
Player IamPhamous bets (5.70)
Player PANDAisEVIL folds
Player Tilt-A-Whirl folds
Uncalled bet (5.70) returned to IamPhamous
Player IamPhamous mucks cards
------ Summary ------
Pot: 11.40. Rake 0.40. JP fee 0.20
Board: [4s 3c 3h 8h]
Player IlxxxlI does not show cards.Bets: 0. Collects: 0. Wins: 0.
Player Tilt-A-Whirl does not show cards.Bets: 4. Collects: 0. Loses: 4.
*Player IamPhamous mucks (does not show cards). Bets: 4. Collects: 11.40. Wins: 7.40.
Player PANDAisEVIL does not show cards.Bets: 4. Collects: 0. Loses: 4.
Player StephCurry does not show cards.Bets: 0. Collects: 0. Wins: 0.
Player L4zy_FiSh does not show cards.Bets: 0. Collects: 0. Wins: 0.
Player mr.fargo does not show cards.Bets: 0. Collects: 0. Wins: 0.
Player shokerAAss does not show cards.Bets: 0. Collects: 0. Wins: 0.
Game ended at: 2016/11/29 9:35:59

Game started
Game ID: 786806557 1/2 (PRR) Longana - 4 (Hold'em)
Seat 9 is the button
Seat 1: Iia007 (216.92).
Seat 3: PANDAisEVIL (393.22).
Seat 4: mr.fargo (184.91).
Seat 6: IlxxxlI (80).
Seat 7: VegetablesArentYummy (250).
Seat 8: 322xxx (200).
Seat 9: StephCurry (200).
Player Iia007 has small blind (1)
Player PANDAisEVIL has big blind (2)
Player IlxxxlI received card: [Ac]
Player IlxxxlI received card: [6s]
Player mr.fargo raises (5)
Player IlxxxlI folds
Player VegetablesArentYummy folds
Player 322xxx folds
Player StephCurry folds
Player Iia007 raises (17)
Player PANDAisEVIL folds
Player mr.fargo folds
Uncalled bet (13) returned to Iia007
Player Iia007 mucks cards
------ Summary ------
Pot: 12. Rake 0
*Player Iia007 mucks (does not show cards). Bets: 5. Collects: 12. Wins: 7.
Player PANDAisEVIL does not show cards.Bets: 2. Collects: 0. Loses: 2.
Player mr.fargo does not show cards.Bets: 5. Collects: 0. Loses: 5.
Player IlxxxlI does not show cards.Bets: 0. Collects: 0. Wins: 0.
Player VegetablesArentYummy does not show cards.Bets: 0. Collects: 0. Wins: 0.
Player 322xxx does not show cards.Bets: 0. Collects: 0. Wins: 0.
Player StephCurry does not show cards.Bets: 0. Collects: 0. Wins: 0.
Game ended at: 2016/11/29 9:34:48

Game started
Game ID: 786806007 1/2 (PRR) Longana - 4 (Hold'em)
Seat 8 is the button
Seat 1: Iia007 (218.92).
Seat 3: PANDAisEVIL (390.22).
Seat 4: mr.fargo (184.91).
Seat 6: IlxxxlI (80).
Seat 7: VegetablesArentYummy (250).
Seat 8: 322xxx (200).
Seat 9: StephCurry (200).
Player StephCurry has small blind (1)
Player Iia007 has big blind (2)
Player IlxxxlI received card: [3d]
Player IlxxxlI received card: [Jh]
Player PANDAisEVIL raises (6)
Player mr.fargo folds
Player IlxxxlI folds
Player VegetablesArentYummy folds
Player 322xxx folds
Player StephCurry folds
Player Iia007 folds
Uncalled bet (4) returned to PANDAisEVIL
Player PANDAisEVIL mucks cards
------ Summary ------
Pot: 5. Rake 0
Player Iia007 does not show cards.Bets: 2. Collects: 0. Loses: 2.
*Player PANDAisEVIL mucks (does not show cards). Bets: 2. Collects: 5. Wins: 3.
Player mr.fargo does not show cards.Bets: 0. Collects: 0. Wins: 0.
Player IlxxxlI does not show cards.Bets: 0. Collects: 0. Wins: 0.
Player VegetablesArentYummy does not show cards.Bets: 0. Collects: 0. Wins: 0.
Player 322xxx does not show cards.Bets: 0. Collects: 0. Wins: 0.
Player StephCurry does not show cards.Bets: 1. Collects: 0. Loses: 1.
Game ended at: 2016/11/29 9:34:14

Game started
Game ID: 786805967 0.25/0.50 (PRR) Garuda - 2 (Hold'em)
Seat 2 is the button
Seat 1: Tilt-A-Whirl (50).
Seat 2: apoo11 (54.55).
Seat 3: imperceptible (20.06).
Seat 4: Ice Bank Mice Elf (100.50).
Seat 5: tutofu84 (122.19).
Seat 6: IlxxxlI (20).
Seat 7: coldkilla (20.61).
Seat 8: akbrow (28.75).
Seat 9: kid4life (34.66).
Player imperceptible has small blind (0.25)
Player Ice Bank Mice Elf has big blind (0.50)
Player IlxxxlI received card: [Jc]
Player IlxxxlI received card: [Ks]
Player tutofu84 calls (0.50)
Player IlxxxlI folds
Player coldkilla folds
Player akbrow folds
Player kid4life folds
Player Tilt-A-Whirl folds
Player apoo11 folds
Player imperceptible folds
Player Ice Bank Mice Elf checks
*** FLOP ***: [As 4c Ac]
Player Ice Bank Mice Elf checks
Player tutofu84 checks
*** TURN ***: [As 4c Ac] [9s]
Player Ice Bank Mice Elf checks
Player tutofu84 checks
*** RIVER ***: [As 4c Ac 9s] [6c]
Player Ice Bank Mice Elf checks
Player tutofu84 bets (0.79)
Player Ice Bank Mice Elf folds
Uncalled bet (0.79) returned to tutofu84
Player tutofu84 mucks cards
------ Summary ------
Pot: 1.19. Rake 0.04. JP fee 0.02
Board: [As 4c Ac 9s 6c]
Player Tilt-A-Whirl does not show cards.Bets: 0. Collects: 0. Wins: 0.
Player apoo11 does not show cards.Bets: 0. Collects: 0. Wins: 0.
Player imperceptible does not show cards.Bets: 0.25. Collects: 0. Loses: 0.25.
Player Ice Bank Mice Elf does not show cards.Bets: 0.50. Collects: 0. Loses: 0.50.
*Player tutofu84 mucks (does not show cards). Bets: 0.50. Collects: 1.19. Wins: 0.69.
Player IlxxxlI does not show cards.Bets: 0. Collects: 0. Wins: 0.
Player coldkilla does not show cards.Bets: 0. Collects: 0. Wins: 0.
Player akbrow does not show cards.Bets: 0. Collects: 0. Wins: 0.
Player kid4life does not show cards.Bets: 0. Collects: 0. Wins: 0.
Game ended at: 2016/11/29 9:35:9

Game started
Game ID: 786805688 1/2 (PRR) Longana - 2 (Hold'em)
Seat 1 is the button
Seat 1: IlxxxlI (191.47).
Seat 2: Tilt-A-Whirl (208.20).
Seat 3: IamPhamous (295.76).
Seat 4: PANDAisEVIL (210.82).
Seat 6: StephCurry (208).
Seat 7: L4zy_FiSh (252.78).
Seat 8: mr.fargo (104.51).
Seat 9: shokerAAss (238.30).
Player Tilt-A-Whirl has small blind (1)
Player IamPhamous has big blind (2)
Player IlxxxlI received card: [4s]
Player IlxxxlI received card: [4h]
Player PANDAisEVIL folds
Player StephCurry folds
Player L4zy_FiSh folds
Player mr.fargo folds
Player shokerAAss folds
Player IlxxxlI raises (6)
Player Tilt-A-Whirl calls (5)
Player IamPhamous folds
*** FLOP ***: [9h 6h 8s]
Player Tilt-A-Whirl checks
Player IlxxxlI checks
*** TURN ***: [9h 6h 8s] [Ad]
Player Tilt-A-Whirl checks
Player IlxxxlI checks
*** RIVER ***: [9h 6h 8s Ad] [Qd]
Player Tilt-A-Whirl checks
Player IlxxxlI checks
Player IlxxxlI mucks cards
------ Summary ------
Pot: 13.30. Rake 0.48. JP fee 0.22
Board: [9h 6h 8s Ad Qd]
Player IlxxxlI mucks (does not show: [4s 4h]). Bets: 6. Collects: 0. Loses: 6.
*Player Tilt-A-Whirl shows: One pair of 10s [10s 10d]. Bets: 6. Collects: 13.30. Wins: 7.30.
Player IamPhamous does not show cards.Bets: 2. Collects: 0. Loses: 2.
Player PANDAisEVIL does not show cards.Bets: 0. Collects: 0. Wins: 0.
Player StephCurry does not show cards.Bets: 0. Collects: 0. Wins: 0.
Player L4zy_FiSh does not show cards.Bets: 0. Collects: 0. Wins: 0.
Player mr.fargo does not show cards.Bets: 0. Collects: 0. Wins: 0.
Player shokerAAss does not show cards.Bets: 0. Collects: 0. Wins: 0.
Game ended at: 2016/11/29 9:34:21

Game started
Game ID: 786805549 0.25/0.50 (PRR) Garuda - 3 (Hold'em)
Seat 9 is the button
Seat 1: IlxxxlI (37.98).
Seat 2: Ice Bank Mice Elf (84.23).
Seat 3: tutofu84 (94.68).
Seat 4: imperceptible (22.71).
Seat 5: HanktheGrey (49.47).
Seat 6: kid4life (127.38).
Seat 7: Tilt-A-Whirl (50).
Seat 8: EasyQQ (115.54).
Seat 9: coldkilla (25.13).
Player IlxxxlI has small blind (0.25)
Player Ice Bank Mice Elf has big blind (0.50)
Player IlxxxlI received card: [5s]
Player IlxxxlI received card: [8c]
Player tutofu84 folds
Player imperceptible folds
Player HanktheGrey calls (0.50)
Player kid4life folds
Player Tilt-A-Whirl folds
Player EasyQQ folds
Player coldkilla folds
Player IlxxxlI folds
Player Ice Bank Mice Elf checks
*** FLOP ***: [2d 3s 4s]
Player Ice Bank Mice Elf checks
Player HanktheGrey bets (0.65)
Player Ice Bank Mice Elf calls (0.65)
*** TURN ***: [2d 3s 4s] [Jd]
Player Ice Bank Mice Elf checks
Player HanktheGrey bets (2)
Player Ice Bank Mice Elf folds
Uncalled bet (2) returned to HanktheGrey
Player HanktheGrey mucks cards
------ Summary ------
Pot: 2.43. Rake 0.08. JP fee 0.04
Board: [2d 3s 4s Jd]
Player IlxxxlI does not show cards.Bets: 0.25. Collects: 0. Loses: 0.25.
Player Ice Bank Mice Elf does not show cards.Bets: 1.15. Collects: 0. Loses: 1.15.
Player tutofu84 does not show cards.Bets: 0. Collects: 0. Wins: 0.
Player imperceptible does not show cards.Bets: 0. Collects: 0. Wins: 0.
*Player HanktheGrey mucks (does not show cards). Bets: 1.15. Collects: 2.43. Wins: 1.28.
Player kid4life does not show cards.Bets: 0. Collects: 0. Wins: 0.
Player Tilt-A-Whirl does not show cards.Bets: 0. Collects: 0. Wins: 0.
Player EasyQQ does not show cards.Bets: 0. Collects: 0. Wins: 0.
Player coldkilla does not show cards.Bets: 0. Collects: 0. Wins: 0.
Game ended at: 2016/11/29 9:34:36

Game started
Game ID: 786805345 1/2 (PRR) Longana - 4 (Hold'em)
Seat 7 is the button
Seat 1: Iia007 (218.92).
Seat 3: PANDAisEVIL (390.22).
Seat 4: mr.fargo (184.91).
Seat 6: IlxxxlI (80).
Seat 7: VegetablesArentYummy (247).
Seat 8: 322xxx (200).
Seat 9: StephCurry (200).
Player 322xxx has small blind (1)
Player StephCurry has big blind (2)
Player IlxxxlI received card: [6s]
Player IlxxxlI received card: [Qh]
Player Iia007 folds
Player PANDAisEVIL folds
Player mr.fargo folds
Player IlxxxlI folds
Player VegetablesArentYummy raises (5)
Player 322xxx folds
Player StephCurry folds
Uncalled bet (3) returned to VegetablesArentYummy
Player VegetablesArentYummy mucks cards
------ Summary ------
Pot: 5. Rake 0
Player Iia007 does not show cards.Bets: 0. Collects: 0. Wins: 0.
Player PANDAisEVIL does not show cards.Bets: 0. Collects: 0. Wins: 0.
Player mr.fargo does not show cards.Bets: 0. Collects: 0. Wins: 0.
Player IlxxxlI does not show cards.Bets: 0. Collects: 0. Wins: 0.
*Player VegetablesArentYummy mucks (does not show cards). Bets: 2. Collects: 5. Wins: 3.
Player 322xxx does not show cards.Bets: 1. Collects: 0. Loses: 1.
Player StephCurry does not show cards.Bets: 2. Collects: 0. Loses: 2.
Game ended at: 2016/11/29 9:33:35

Game started
Game ID: 786805099 0.25/0.50 (PRR) Garuda (Hold'em)
Seat 7 is the button
Seat 1: akbrow (21.25).
Seat 2: IlxxxlI (20).
Seat 3: Ice Bank Mice Elf (91.10).
Seat 4: Log_in (19).
Seat 5: Midnight0489 (50.32).
Seat 6: XxDominationxX (96.43).
Seat 7: coldkilla (64.77).
Seat 8: gunnfarm (43.64).
Seat 9: OmEGaKuSh (54.70).
Player gunnfarm has small blind (0.25)
Player OmEGaKuSh has big blind (0.50)
Player IlxxxlI received card: [Ah]
Player IlxxxlI received card: [6c]
Player akbrow folds
Player IlxxxlI folds
Player Ice Bank Mice Elf folds
Player Log_in folds
Player Midnight0489 folds
Player XxDominationxX folds
Player coldkilla folds
Player gunnfarm folds
Uncalled bet (0.25) returned to OmEGaKuSh
Player OmEGaKuSh mucks cards
------ Summary ------
Pot: 0.50. Rake 0
Player akbrow does not show cards.Bets: 0. Collects: 0. Wins: 0.
Player IlxxxlI does not show cards.Bets: 0. Collects: 0. Wins: 0.
Player Ice Bank Mice Elf does not show cards.Bets: 0. Collects: 0. Wins: 0.
Player Log_in does not show cards.Bets: 0. Collects: 0. Wins: 0.
Player Midnight0489 does not show cards.Bets: 0. Collects: 0. Wins: 0.
Player XxDominationxX does not show cards.Bets: 0. Collects: 0. Wins: 0.
Player coldkilla does not show cards.Bets: 0. Collects: 0. Wins: 0.
Player gunnfarm does not show cards.Bets: 0.25. Collects: 0. Loses: 0.25.
*Player OmEGaKuSh mucks (does not show cards). Bets: 0.25. Collects: 0.50. Wins: 0.25.
Game ended at: 2016/11/29 9:33:24

Game started
Game ID: 786804675 0.25/0.50 (PRR) Garuda - 2 (Hold'em)
Seat 1 is the button
Seat 1: Tilt-A-Whirl (50).
Seat 2: apoo11 (54.80).
Seat 3: imperceptible (18.92).
Seat 4: Ice Bank Mice Elf (100.50).
Seat 5: tutofu84 (123.19).
Seat 6: IlxxxlI (20).
Seat 7: coldkilla (20.61).
Seat 8: akbrow (28.75).
Seat 9: kid4life (34.66).
Player apoo11 has small blind (0.25)
Player imperceptible has big blind (0.50)
Player IlxxxlI received card: [Ah]
Player IlxxxlI received card: [9c]
Player Ice Bank Mice Elf folds
Player tutofu84 raises (1)
Player IlxxxlI folds
Player coldkilla folds
Player akbrow folds
Player kid4life folds
Player Tilt-A-Whirl folds
Player apoo11 folds
Player imperceptible calls (0.50)
*** FLOP ***: [Ac 4s Kd]
Player imperceptible checks
Player tutofu84 checks
*** TURN ***: [Ac 4s Kd] [3s]
Player imperceptible checks
Player tutofu84 checks
*** RIVER ***: [Ac 4s Kd 3s] [4c]
Player imperceptible checks
Player tutofu84 checks
Player tutofu84 mucks cards
------ Summary ------
Pot: 2.14. Rake 0.09. JP fee 0.02
Board: [Ac 4s Kd 3s 4c]
Player Tilt-A-Whirl does not show cards.Bets: 0. Collects: 0. Wins: 0.
Player apoo11 does not show cards.Bets: 0.25. Collects: 0. Loses: 0.25.
*Player imperceptible shows: Two pairs. Ks and 4s [10s Kh]. Bets: 1. Collects: 2.14. Wins: 1.14.
Player Ice Bank Mice Elf does not show cards.Bets: 0. Collects: 0. Wins: 0.
Player tutofu84 mucks (does not show cards). Bets: 1. Collects: 0. Loses: 1.
Player IlxxxlI does not show cards.Bets: 0. Collects: 0. Wins: 0.
Player coldkilla does not show cards.Bets: 0. Collects: 0. Wins: 0.
Player akbrow does not show cards.Bets: 0. Collects: 0. Wins: 0.
Player kid4life does not show cards.Bets: 0. Collects: 0. Wins: 0.
Game ended at: 2016/11/29 9:33:30

Game started
Game ID: 786804592 1/2 (PRR) Longana - 2 (Hold'em)
Seat 9 is the button
Seat 1: IlxxxlI (176.97).
Seat 2: Tilt-A-Whirl (210.20).
Seat 3: IamPhamous (295.76).
Seat 4: PANDAisEVIL (210.82).
Seat 6: StephCurry (208).
Seat 7: L4zy_FiSh (252.78).
Seat 8: mr.fargo (104.51).
Seat 9: shokerAAss (252.30).
Player IlxxxlI has small blind (1)
Player Tilt-A-Whirl has big blind (2)
Player IlxxxlI received card: [Ad]
Player IlxxxlI received card: [Kc]
Player IamPhamous folds
Player PANDAisEVIL folds
Player StephCurry folds
Player L4zy_FiSh folds
Player mr.fargo folds
Player shokerAAss raises (5)
Player IlxxxlI raises (13)
Player Tilt-A-Whirl folds
Player shokerAAss calls (9)
*** FLOP ***: [3h Ac 10h]
Player IlxxxlI bets (9.50)
Player shokerAAss folds
Uncalled bet (9.50) returned to IlxxxlI
Player IlxxxlI mucks cards
------ Summary ------
Pot: 28.50. Rake 1.26. JP fee 0.24
Board: [3h Ac 10h]
*Player IlxxxlI mucks (does not show cards). Bets: 14. Collects: 28.50. Wins: 14.50.
Player Tilt-A-Whirl does not show cards.Bets: 2. Collects: 0. Loses: 2.
Player IamPhamous does not show cards.Bets: 0. Collects: 0. Wins: 0.
Player PANDAisEVIL does not show cards.Bets: 0. Collects: 0. Wins: 0.
Player StephCurry does not show cards.Bets: 0. Collects: 0. Wins: 0.
Player L4zy_FiSh does not show cards.Bets: 0. Collects: 0. Wins: 0.
Player mr.fargo does not show cards.Bets: 0. Collects: 0. Wins: 0.
Player shokerAAss does not show cards.Bets: 14. Collects: 0. Loses: 14.
Game ended at: 2016/11/29 9:33:10

Game started
Game ID: 786804535 1/2 (PRR) Longana - 4 (Hold'em)
Seat 6 is the button
Seat 1: Iia007 (218.92).
Seat 3: PANDAisEVIL (390.22).
Seat 4: mr.fargo (180).
Seat 6: IlxxxlI (80).
Seat 7: VegetablesArentYummy (248).
Seat 8: 322xxx (200).
Seat 9: StephCurry (200).
Player VegetablesArentYummy has small blind (1)
Player 322xxx has big blind (2)
Player IlxxxlI received card: [Qd]
Player IlxxxlI received card: [9h]
Player StephCurry folds
Player Iia007 folds
Player PANDAisEVIL folds
Player mr.fargo raises (4.40)
Player IlxxxlI folds
Player VegetablesArentYummy folds
Player 322xxx calls (2.40)
*** FLOP ***: [Js Kd Kh]
Player 322xxx checks
Player mr.fargo bets (5.12)
Player 322xxx folds
Uncalled bet (5.12) returned to mr.fargo
Player mr.fargo mucks cards
------ Summary ------
Pot: 9.31. Rake 0.33. JP fee 0.16
Board: [Js Kd Kh]
Player Iia007 does not show cards.Bets: 0. Collects: 0. Wins: 0.
Player PANDAisEVIL does not show cards.Bets: 0. Collects: 0. Wins: 0.
*Player mr.fargo mucks (does not show cards). Bets: 4.40. Collects: 9.31. Wins: 4.91.
Player IlxxxlI does not show cards.Bets: 0. Collects: 0. Wins: 0.
Player VegetablesArentYummy does not show cards.Bets: 1. Collects: 0. Loses: 1.
Player 322xxx does not show cards.Bets: 4.40. Collects: 0. Loses: 4.40.
Player StephCurry does not show cards.Bets: 0. Collects: 0. Wins: 0.
Game ended at: 2016/11/29 9:32:48

Game started
Game ID: 786804146 1/2 (PRR) Longana - 2 (Hold'em)
Seat 8 is the button
Seat 1: IlxxxlI (178.97).
Seat 2: Tilt-A-Whirl (210.20).
Seat 3: IamPhamous (295.76).
Seat 4: PANDAisEVIL (207.82).
Seat 6: StephCurry (208).
Seat 7: L4zy_FiSh (252.78).
Seat 8: mr.fargo (104.51).
Seat 9: shokerAAss (253.30).
Player shokerAAss has small blind (1)
Player IlxxxlI has big blind (2)
Player IlxxxlI received card: [3d]
Player IlxxxlI received card: [5h]
Player Tilt-A-Whirl folds
Player IamPhamous folds
Player PANDAisEVIL raises (6)
Player StephCurry folds
Player L4zy_FiSh folds
Player mr.fargo folds
Player shokerAAss folds
Player IlxxxlI folds
Uncalled bet (4) returned to PANDAisEVIL
Player PANDAisEVIL mucks cards
------ Summary ------
Pot: 5. Rake 0
Player IlxxxlI does not show cards.Bets: 2. Collects: 0. Loses: 2.
Player Tilt-A-Whirl does not show cards.Bets: 0. Collects: 0. Wins: 0.
Player IamPhamous does not show cards.Bets: 0. Collects: 0. Wins: 0.
*Player PANDAisEVIL mucks (does not show cards). Bets: 2. Collects: 5. Wins: 3.
Player StephCurry does not show cards.Bets: 0. Collects: 0. Wins: 0.
Player L4zy_FiSh does not show cards.Bets: 0. Collects: 0. Wins: 0.
Player mr.fargo does not show cards.Bets: 0. Collects: 0. Wins: 0.
Player shokerAAss does not show cards.Bets: 1. Collects: 0. Loses: 1.
Game ended at: 2016/11/29 9:31:57

Game started
Game ID: 786803891 1/2 (PRR) Longana - 4 (Hold'em)
Seat 4 is the button
Seat 1: Iia007 (218.92).
Seat 3: PANDAisEVIL (390.22).
Seat 4: mr.fargo (177).
Seat 6: IlxxxlI (80).
Seat 7: VegetablesArentYummy (250).
Seat 9: StephCurry (200).
Player IlxxxlI has small blind (1)
Player VegetablesArentYummy has big blind (2)
Player IlxxxlI received card: [9d]
Player IlxxxlI received card: [5h]
Player StephCurry folds
Player Iia007 folds
Player PANDAisEVIL folds
Player mr.fargo raises (4.40)
Player IlxxxlI folds
Player VegetablesArentYummy folds
Uncalled bet (2.40) returned to mr.fargo
Player mr.fargo mucks cards
------ Summary ------
Pot: 5. Rake 0
Player Iia007 does not show cards.Bets: 0. Collects: 0. Wins: 0.
Player PANDAisEVIL does not show cards.Bets: 0. Collects: 0. Wins: 0.
*Player mr.fargo mucks (does not show cards). Bets: 2. Collects: 5. Wins: 3.
Player IlxxxlI does not show cards.Bets: 1. Collects: 0. Loses: 1.
Player VegetablesArentYummy does not show cards.Bets: 2. Collects: 0. Loses: 2.
Player StephCurry does not show cards.Bets: 0. Collects: 0. Wins: 0.
Game ended at: 2016/11/29 9:31:52

Game started
Game ID: 786803684 0.25/0.50 (PRR) Garuda - 2 (Hold'em)
Seat 9 is the button
Seat 1: Tilt-A-Whirl (50).
Seat 2: apoo11 (55.80).
Seat 3: imperceptible (18.92).
Seat 4: Ice Bank Mice Elf (100.50).
Seat 5: tutofu84 (123.19).
Seat 6: IlxxxlI (20).
Seat 7: coldkilla (19.47).
Seat 9: kid4life (34.66).
Player Tilt-A-Whirl has small blind (0.25)
Player apoo11 has big blind (0.50)
Player IlxxxlI received card: [3d]
Player IlxxxlI received card: [9s]
Player imperceptible folds
Player Ice Bank Mice Elf folds
Player tutofu84 folds
Player IlxxxlI folds
Player coldkilla raises (1)
Player kid4life folds
Player Tilt-A-Whirl folds
Player apoo11 calls (0.50)
*** FLOP ***: [7c 2s 10d]
Player apoo11 checks
Player coldkilla bets (1.07)
Player apoo11 folds
Uncalled bet (1.07) returned to coldkilla
Player coldkilla mucks cards
------ Summary ------
Pot: 2.14. Rake 0.09. JP fee 0.02
Board: [7c 2s 10d]
Player Tilt-A-Whirl does not show cards.Bets: 0.25. Collects: 0. Loses: 0.25.
Player apoo11 does not show cards.Bets: 1. Collects: 0. Loses: 1.
Player imperceptible does not show cards.Bets: 0. Collects: 0. Wins: 0.
Player Ice Bank Mice Elf does not show cards.Bets: 0. Collects: 0. Wins: 0.
Player tutofu84 does not show cards.Bets: 0. Collects: 0. Wins: 0.
Player IlxxxlI does not show cards.Bets: 0. Collects: 0. Wins: 0.
*Player coldkilla mucks (does not show cards). Bets: 1. Collects: 2.14. Wins: 1.14.
Player kid4life does not show cards.Bets: 0. Collects: 0. Wins: 0.
Game ended at: 2016/11/29 9:32:2

Game started
Game ID: 786803585 0.25/0.50 (PRR) Garuda - 3 (Hold'em)
Seat 8 is the button
Seat 1: IlxxxlI (38.48).
Seat 2: Ice Bank Mice Elf (84.23).
Seat 3: tutofu84 (94.68).
Seat 4: imperceptible (22.71).
Seat 5: HanktheGrey (49.47).
Seat 6: kid4life (167.43).
Seat 7: Tilt-A-Whirl (50).
Seat 8: EasyQQ (77.74).
Seat 9: coldkilla (25.38).
Player coldkilla has small blind (0.25)
Player IlxxxlI has big blind (0.50)
Player IlxxxlI received card: [8d]
Player IlxxxlI received card: [10c]
Player Ice Bank Mice Elf folds
Player tutofu84 folds
Player imperceptible folds
Player HanktheGrey folds
Player kid4life raises (2)
Player Tilt-A-Whirl folds
Player EasyQQ calls (2)
Player coldkilla folds
Player IlxxxlI folds
*** FLOP ***: [3d 9s 8s]
Player kid4life bets (2.26)
Player EasyQQ calls (2.26)
*** TURN ***: [3d 9s 8s] [10d]
Player kid4life checks
Player EasyQQ bets (4.40)
Player kid4life raises (13.20)
Player EasyQQ calls (8.80)
*** RIVER ***: [3d 9s 8s 10d] [Kc]
Player kid4life bets (22.59)
Player EasyQQ calls (22.59)
------ Summary ------
Pot: 77.85. Rake 2.76. JP fee 0.24
Board: [3d 9s 8s 10d Kc]
Player IlxxxlI does not show cards.Bets: 0.50. Collects: 0. Loses: 0.50.
Player Ice Bank Mice Elf does not show cards.Bets: 0. Collects: 0. Wins: 0.
Player tutofu84 does not show cards.Bets: 0. Collects: 0. Wins: 0.
Player imperceptible does not show cards.Bets: 0. Collects: 0. Wins: 0.
Player HanktheGrey does not show cards.Bets: 0. Collects: 0. Wins: 0.
Player kid4life shows: One pair of 3s [3s As]. Bets: 40.05. Collects: 0. Loses: 40.05.
Player Tilt-A-Whirl does not show cards.Bets: 0. Collects: 0. Wins: 0.
*Player EasyQQ shows: One pair of As [Ah Ad]. Bets: 40.05. Collects: 77.85. Wins: 37.80.
Player coldkilla does not show cards.Bets: 0.25. Collects: 0. Loses: 0.25.
Game ended at: 2016/11/29 9:32:58

Game started
Game ID: 786803445 1/2 (PRR) Longana - 2 (Hold'em)
Seat 7 is the button
Seat 1: IlxxxlI (178.97).
Seat 2: Tilt-A-Whirl (210.20).
Seat 3: IamPhamous (292.76).
Seat 4: PANDAisEVIL (207.82).
Seat 6: StephCurry (208).
Seat 7: L4zy_FiSh (252.78).
Seat 8: mr.fargo (105.51).
Seat 9: shokerAAss (255.30).
Player mr.fargo has small blind (1)
Player shokerAAss has big blind (2)
Player IlxxxlI received card: [8d]
Player IlxxxlI received card: [Jh]
Player IlxxxlI folds
Player Tilt-A-Whirl folds
Player IamPhamous raises (6)
Player PANDAisEVIL folds
Player StephCurry folds
Player L4zy_FiSh folds
Player mr.fargo folds
Player shokerAAss folds
Uncalled bet (4) returned to IamPhamous
Player IamPhamous mucks cards
------ Summary ------
Pot: 5. Rake 0
Player IlxxxlI does not show cards.Bets: 0. Collects: 0. Wins: 0.
Player Tilt-A-Whirl does not show cards.Bets: 0. Collects: 0. Wins: 0.
*Player IamPhamous mucks (does not show cards). Bets: 2. Collects: 5. Wins: 3.
Player PANDAisEVIL does not show cards.Bets: 0. Collects: 0. Wins: 0.
Player StephCurry does not show cards.Bets: 0. Collects: 0. Wins: 0.
Player L4zy_FiSh does not show cards.Bets: 0. Collects: 0. Wins: 0.
Player mr.fargo does not show cards.Bets: 1. Collects: 0. Loses: 1.
Player shokerAAss does not show cards.Bets: 2. Collects: 0. Loses: 2.
Game ended at: 2016/11/29 9:31:28

Game started
Game ID: 786803319 1/2 (PRR) Longana - 4 (Hold'em)
Seat 3 is the button
Seat 1: Iia007 (218.92).
Seat 3: PANDAisEVIL (387.22).
Seat 4: mr.fargo (178).
Seat 5: L4zy_FiSh (400).
Seat 6: IlxxxlI (80).
Seat 7: VegetablesArentYummy (250).
Seat 9: StephCurry (200).
Player mr.fargo has small blind (1)
Player L4zy_FiSh sitting out
Player IlxxxlI has big blind (2)
Player IlxxxlI received card: [6s]
Player IlxxxlI received card: [8c]
Player VegetablesArentYummy folds
Player StephCurry folds
Player Iia007 folds
Player PANDAisEVIL raises (4.40)
Player mr.fargo folds
Player IlxxxlI folds
Uncalled bet (2.40) returned to PANDAisEVIL
Player PANDAisEVIL mucks cards
------ Summary ------
Pot: 5. Rake 0
Player Iia007 does not show cards.Bets: 0. Collects: 0. Wins: 0.
*Player PANDAisEVIL mucks (does not show cards). Bets: 2. Collects: 5. Wins: 3.
Player mr.fargo does not show cards.Bets: 1. Collects: 0. Loses: 1.
Player L4zy_FiSh does not show cards.Bets: 0. Collects: 0. Wins: 0.
Player IlxxxlI does not show cards.Bets: 2. Collects: 0. Loses: 2.
Player VegetablesArentYummy does not show cards.Bets: 0. Collects: 0. Wins: 0.
Player StephCurry does not show cards.Bets: 0. Collects: 0. Wins: 0.
Game ended at: 2016/11/29 9:31:8

Game started
Game ID: 786803106 0.25/0.50 (PRR) Garuda (Hold'em)
Seat 6 is the button
Seat 1: akbrow (21.25).
Seat 2: IlxxxlI (20).
Seat 3: Ice Bank Mice Elf (91.10).
Seat 4: Log_in (19).
Seat 5: Midnight0489 (50.32).
Seat 6: XxDominationxX (96.43).
Seat 7: coldkilla (65.02).
Seat 8: gunnfarm (42.50).
Seat 9: OmEGaKuSh (55.70).
Player coldkilla has small blind (0.25)
Player gunnfarm has big blind (0.50)
Player IlxxxlI received card: [6h]
Player IlxxxlI received card: [3h]
Player OmEGaKuSh raises (1)
Player akbrow is timed out.
Player akbrow folds
Player IlxxxlI folds
Player Ice Bank Mice Elf folds
Player Log_in folds
Player Midnight0489 folds
Player XxDominationxX folds
Player coldkilla folds
Player gunnfarm calls (0.50)
*** FLOP ***: [Qd 8c 3s]
Player gunnfarm checks
Player OmEGaKuSh checks
*** TURN ***: [Qd 8c 3s] [10c]
Player gunnfarm checks
Player OmEGaKuSh checks
*** RIVER ***: [Qd 8c 3s 10c] [3c]
Player gunnfarm checks
Player OmEGaKuSh checks
Player OmEGaKuSh mucks cards
------ Summary ------
Pot: 2.14. Rake 0.09. JP fee 0.02
Board: [Qd 8c 3s 10c 3c]
Player akbrow does not show cards.Bets: 0. Collects: 0. Wins: 0.
Player IlxxxlI does not show cards.Bets: 0. Collects: 0. Wins: 0.
Player Ice Bank Mice Elf does not show cards.Bets: 0. Collects: 0. Wins: 0.
Player Log_in does not show cards.Bets: 0. Collects: 0. Wins: 0.
Player Midnight0489 does not show cards.Bets: 0. Collects: 0. Wins: 0.
Player XxDominationxX does not show cards.Bets: 0. Collects: 0. Wins: 0.
Player coldkilla does not show cards.Bets: 0.25. Collects: 0. Loses: 0.25.
*Player gunnfarm shows: One pair of 3s [Kh Jc]. Bets: 1. Collects: 2.14. Wins: 1.14.
Player OmEGaKuSh mucks (does not show cards). Bets: 1. Collects: 0. Loses: 1.
Game ended at: 2016/11/29 9:32:29

Game started
Game ID: 786802631 1/2 (PRR) Longana - 2 (Hold'em)
Seat 6 is the button
Seat 1: IlxxxlI (178.97).
Seat 2: Tilt-A-Whirl (210.20).
Seat 3: IamPhamous (292.76).
Seat 4: PANDAisEVIL (212.82).
Seat 6: StephCurry (200).
Seat 7: L4zy_FiSh (253.78).
Seat 8: mr.fargo (107.51).
Seat 9: shokerAAss (255.30).
Player L4zy_FiSh has small blind (1)
Player mr.fargo has big blind (2)
Player IlxxxlI received card: [Ac]
Player IlxxxlI received card: [6c]
Player shokerAAss folds
Player IlxxxlI folds
Player Tilt-A-Whirl folds
Player IamPhamous folds
Player PANDAisEVIL raises (5)
Player StephCurry raises (17)
Player L4zy_FiSh folds
Player mr.fargo folds
Player PANDAisEVIL folds
Uncalled bet (12) returned to StephCurry
Player StephCurry mucks cards
------ Summary ------
Pot: 13. Rake 0
Player IlxxxlI does not show cards.Bets: 0. Collects: 0. Wins: 0.
Player Tilt-A-Whirl does not show cards.Bets: 0. Collects: 0. Wins: 0.
Player IamPhamous does not show cards.Bets: 0. Collects: 0. Wins: 0.
Player PANDAisEVIL does not show cards.Bets: 5. Collects: 0. Loses: 5.
*Player StephCurry mucks (does not show cards). Bets: 5. Collects: 13. Wins: 8.
Player L4zy_FiSh does not show cards.Bets: 1. Collects: 0. Loses: 1.
Player mr.fargo does not show cards.Bets: 2. Collects: 0. Loses: 2.
Player shokerAAss does not show cards.Bets: 0. Collects: 0. Wins: 0.
Game ended at: 2016/11/29 9:30:38

Game started
Game ID: 786802559 0.25/0.50 (PRR) Garuda (Hold'em)
Seat 5 is the button
Seat 1: akbrow (21.25).
Seat 2: IlxxxlI (20).
Seat 3: Ice Bank Mice Elf (91.10).
Seat 4: Log_in (19).
Seat 5: Midnight0489 (50.32).
Seat 6: XxDominationxX (96.68).
Seat 7: coldkilla (64.77).
Seat 8: gunnfarm (42.50).
Seat 9: OmEGaKuSh (55.70).
Player XxDominationxX has small blind (0.25)
Player coldkilla has big blind (0.50)
Player IlxxxlI received card: [Ah]
Player IlxxxlI received card: [8d]
Player gunnfarm folds
Player OmEGaKuSh folds
Player akbrow folds
Player IlxxxlI folds
Player Ice Bank Mice Elf folds
Player Log_in folds
Player Midnight0489 folds
Player XxDominationxX folds
Uncalled bet (0.25) returned to coldkilla
Player coldkilla mucks cards
------ Summary ------
Pot: 0.50. Rake 0
Player akbrow does not show cards.Bets: 0. Collects: 0. Wins: 0.
Player IlxxxlI does not show cards.Bets: 0. Collects: 0. Wins: 0.
Player Ice Bank Mice Elf does not show cards.Bets: 0. Collects: 0. Wins: 0.
Player Log_in does not show cards.Bets: 0. Collects: 0. Wins: 0.
Player Midnight0489 does not show cards.Bets: 0. Collects: 0. Wins: 0.
Player XxDominationxX does not show cards.Bets: 0.25. Collects: 0. Loses: 0.25.
*Player coldkilla mucks (does not show cards). Bets: 0.25. Collects: 0.50. Wins: 0.25.
Player gunnfarm does not show cards.Bets: 0. Collects: 0. Wins: 0.
Player OmEGaKuSh does not show cards.Bets: 0. Collects: 0. Wins: 0.
Game ended at: 2016/11/29 9:30:16

Game started
Game ID: 786802546 1/2 (PRR) Longana - 4 (Hold'em)
Seat 1 is the button
Seat 1: Iia007 (218.92).
Seat 3: PANDAisEVIL (388.22).
Seat 4: mr.fargo (180).
Seat 5: L4zy_FiSh (400).
Seat 6: IlxxxlI (80).
Seat 7: VegetablesArentYummy (247).
Seat 9: StephCurry (200).
Player PANDAisEVIL has small blind (1)
Player mr.fargo has big blind (2)
Player IlxxxlI received card: [4c]
Player IlxxxlI received card: [4d]
Player L4zy_FiSh folds
Player IlxxxlI folds
Player VegetablesArentYummy raises (5)
Player StephCurry folds
Player Iia007 folds
Player PANDAisEVIL folds
Player mr.fargo folds
Uncalled bet (3) returned to VegetablesArentYummy
Player VegetablesArentYummy mucks cards
------ Summary ------
Pot: 5. Rake 0
Player Iia007 does not show cards.Bets: 0. Collects: 0. Wins: 0.
Player PANDAisEVIL does not show cards.Bets: 1. Collects: 0. Loses: 1.
Player mr.fargo does not show cards.Bets: 2. Collects: 0. Loses: 2.
Player L4zy_FiSh does not show cards.Bets: 0. Collects: 0. Wins: 0.
Player IlxxxlI does not show cards.Bets: 0. Collects: 0. Wins: 0.
*Player VegetablesArentYummy mucks (does not show cards). Bets: 2. Collects: 5. Wins: 3.
Player StephCurry does not show cards.Bets: 0. Collects: 0. Wins: 0.
Game ended at: 2016/11/29 9:30:29

Game started
Game ID: 786802510 0.25/0.50 (PRR) Garuda - 2 (Hold'em)
Seat 7 is the button
Seat 1: Tilt-A-Whirl (50).
Seat 2: apoo11 (55.80).
Seat 3: imperceptible (18.92).
Seat 4: Ice Bank Mice Elf (100.50).
Seat 5: tutofu84 (123.19).
Seat 6: IlxxxlI (20).
Seat 7: coldkilla (19.47).
Seat 8: akbrow (29).
Seat 9: kid4life (34.41).
Player akbrow has small blind (0.25)
Player kid4life has big blind (0.50)
Player IlxxxlI received card: [8d]
Player IlxxxlI received card: [4s]
Player Tilt-A-Whirl folds
Player apoo11 folds
Player imperceptible folds
Player Ice Bank Mice Elf folds
Player tutofu84 folds
Player IlxxxlI folds
Player coldkilla folds
Player akbrow is timed out.
Player akbrow folds
Uncalled bet (0.25) returned to kid4life
Player kid4life mucks cards
------ Summary ------
Pot: 0.50. Rake 0
Player Tilt-A-Whirl does not show cards.Bets: 0. Collects: 0. Wins: 0.
Player apoo11 does not show cards.Bets: 0. Collects: 0. Wins: 0.
Player imperceptible does not show cards.Bets: 0. Collects: 0. Wins: 0.
Player Ice Bank Mice Elf does not show cards.Bets: 0. Collects: 0. Wins: 0.
Player tutofu84 does not show cards.Bets: 0. Collects: 0. Wins: 0.
Player IlxxxlI does not show cards.Bets: 0. Collects: 0. Wins: 0.
Player coldkilla does not show cards.Bets: 0. Collects: 0. Wins: 0.
Player akbrow does not show cards.Bets: 0.25. Collects: 0. Loses: 0.25.
*Player kid4life mucks (does not show cards). Bets: 0.25. Collects: 0.50. Wins: 0.25.
Game ended at: 2016/11/29 9:30:55

Game started
Game ID: 786802114 1/2 (PRR) Longana - 4 (Hold'em)
Seat 9 is the button
Seat 1: Iia007 (219.92).
Seat 3: PANDAisEVIL (387.22).
Seat 4: mr.fargo (180).
Seat 5: L4zy_FiSh (400).
Seat 6: IlxxxlI (80).
Seat 7: VegetablesArentYummy (247).
Seat 9: StephCurry (200).
Player Iia007 has small blind (1)
Player PANDAisEVIL has big blind (2)
Player IlxxxlI received card: [8s]
Player IlxxxlI received card: [Qs]
Player mr.fargo folds
Player L4zy_FiSh folds
Player IlxxxlI folds
Player VegetablesArentYummy folds
Player StephCurry folds
Player Iia007 folds
Uncalled bet (1) returned to PANDAisEVIL
Player PANDAisEVIL mucks cards
------ Summary ------
Pot: 2. Rake 0
Player Iia007 does not show cards.Bets: 1. Collects: 0. Loses: 1.
*Player PANDAisEVIL mucks (does not show cards). Bets: 1. Collects: 2. Wins: 1.
Player mr.fargo does not show cards.Bets: 0. Collects: 0. Wins: 0.
Player L4zy_FiSh does not show cards.Bets: 0. Collects: 0. Wins: 0.
Player IlxxxlI does not show cards.Bets: 0. Collects: 0. Wins: 0.
Player VegetablesArentYummy does not show cards.Bets: 0. Collects: 0. Wins: 0.
Player StephCurry does not show cards.Bets: 0. Collects: 0. Wins: 0.
Game ended at: 2016/11/29 9:29:37

Game started
Game ID: 786801665 1/2 (PRR) Longana - 4 (Hold'em)
Seat 7 is the button
Seat 1: Iia007 (221.92).
Seat 2: IAmClueless (175.03).
Seat 3: PANDAisEVIL (387.22).
Seat 4: mr.fargo (180).
Seat 5: L4zy_FiSh (400).
Seat 6: IlxxxlI (80).
Seat 7: VegetablesArentYummy (244).
Seat 9: StephCurry (200).
Player StephCurry has small blind (1)
Player Iia007 has big blind (2)
Player IlxxxlI received card: [2s]
Player IlxxxlI received card: [3h]
Player IAmClueless folds
Player PANDAisEVIL folds
Player mr.fargo folds
Player L4zy_FiSh folds
Player IlxxxlI folds
Player VegetablesArentYummy raises (5)
Player StephCurry folds
Player Iia007 folds
Uncalled bet (3) returned to VegetablesArentYummy
Player VegetablesArentYummy mucks cards
------ Summary ------
Pot: 5. Rake 0
Player Iia007 does not show cards.Bets: 2. Collects: 0. Loses: 2.
Player IAmClueless does not show cards.Bets: 0. Collects: 0. Wins: 0.
Player PANDAisEVIL does not show cards.Bets: 0. Collects: 0. Wins: 0.
Player mr.fargo does not show cards.Bets: 0. Collects: 0. Wins: 0.
Player L4zy_FiSh does not show cards.Bets: 0. Collects: 0. Wins: 0.
Player IlxxxlI does not show cards.Bets: 0. Collects: 0. Wins: 0.
*Player VegetablesArentYummy mucks (does not show cards). Bets: 2. Collects: 5. Wins: 3.
Player StephCurry does not show cards.Bets: 1. Collects: 0. Loses: 1.
Game ended at: 2016/11/29 9:29:8

Game started
Game ID: 786801299 1/2 (PRR) Longana - 2 (Hold'em)
Seat 4 is the button
Seat 1: IlxxxlI (178.97).
Seat 2: Tilt-A-Whirl (210.20).
Seat 3: IamPhamous (292.76).
Seat 4: PANDAisEVIL (212.82).
Seat 6: StephCurry (200).
Seat 7: L4zy_FiSh (255.78).
Seat 8: mr.fargo (112.51).
Seat 9: shokerAAss (247.30).
Player StephCurry has small blind (1)
Player L4zy_FiSh has big blind (2)
Player IlxxxlI received card: [6d]
Player IlxxxlI received card: [Qd]
Player mr.fargo raises (5)
Player shokerAAss raises (17)
Player IlxxxlI folds
Player Tilt-A-Whirl folds
Player IamPhamous folds
Player PANDAisEVIL folds
Player StephCurry folds
Player L4zy_FiSh folds
Player mr.fargo folds
Uncalled bet (12) returned to shokerAAss
Player shokerAAss mucks cards
------ Summary ------
Pot: 13. Rake 0
Player IlxxxlI does not show cards.Bets: 0. Collects: 0. Wins: 0.
Player Tilt-A-Whirl does not show cards.Bets: 0. Collects: 0. Wins: 0.
Player IamPhamous does not show cards.Bets: 0. Collects: 0. Wins: 0.
Player PANDAisEVIL does not show cards.Bets: 0. Collects: 0. Wins: 0.
Player StephCurry does not show cards.Bets: 1. Collects: 0. Loses: 1.
Player L4zy_FiSh does not show cards.Bets: 2. Collects: 0. Loses: 2.
Player mr.fargo does not show cards.Bets: 5. Collects: 0. Loses: 5.
*Player shokerAAss mucks (does not show cards). Bets: 5. Collects: 13. Wins: 8.
Game ended at: 2016/11/29 9:29:42

Game started
Game ID: 786801287 0.25/0.50 (PRR) Garuda (Hold'em)
Seat 4 is the button
Seat 1: akbrow (21.25).
Seat 2: IlxxxlI (20).
Seat 3: Ice Bank Mice Elf (99.85).
Seat 4: Log_in (19).
Seat 5: Midnight0489 (41.25).
Seat 6: XxDominationxX (97.93).
Seat 7: coldkilla (64.77).
Seat 8: gunnfarm (42.50).
Seat 9: OmEGaKuSh (55.70).
Player Midnight0489 has small blind (0.25)
Player XxDominationxX has big blind (0.50)
Player IlxxxlI received card: [Js]
Player IlxxxlI received card: [10d]
Player coldkilla folds
Player gunnfarm folds
Player OmEGaKuSh folds
Player akbrow folds
Player IlxxxlI folds
Player Ice Bank Mice Elf raises (1.25)
Player Log_in folds
Player Midnight0489 calls (1)
Player XxDominationxX calls (0.75)
*** FLOP ***: [4c 5h 10h]
Player Midnight0489 bets (2.50)
Player XxDominationxX folds
Player Ice Bank Mice Elf raises (7.50)
Player Midnight0489 calls (5)
*** TURN ***: [4c 5h 10h] [4s]
Player Midnight0489 bets (10)
Player Ice Bank Mice Elf folds
Uncalled bet (10) returned to Midnight0489
Player Midnight0489 mucks cards
------ Summary ------
Pot: 17.82. Rake 0.69. JP fee 0.24
Board: [4c 5h 10h 4s]
Player akbrow does not show cards.Bets: 0. Collects: 0. Wins: 0.
Player IlxxxlI does not show cards.Bets: 0. Collects: 0. Wins: 0.
Player Ice Bank Mice Elf does not show cards.Bets: 8.75. Collects: 0. Loses: 8.75.
Player Log_in does not show cards.Bets: 0. Collects: 0. Wins: 0.
*Player Midnight0489 mucks (does not show cards). Bets: 8.75. Collects: 17.82. Wins: 9.07.
Player XxDominationxX does not show cards.Bets: 1.25. Collects: 0. Loses: 1.25.
Player coldkilla does not show cards.Bets: 0. Collects: 0. Wins: 0.
Player gunnfarm does not show cards.Bets: 0. Collects: 0. Wins: 0.
Player OmEGaKuSh does not show cards.Bets: 0. Collects: 0. Wins: 0.
Game ended at: 2016/11/29 9:29:38

Game started
Game ID: 786800344 0.25/0.50 (PRR) Garuda (Hold'em)
Seat 3 is the button
Seat 1: akbrow (21.25).
Seat 2: IlxxxlI (20).
Seat 3: Ice Bank Mice Elf (99.85).
Seat 4: Log_in (19.25).
Seat 5: Midnight0489 (41.75).
Seat 6: XxDominationxX (97.93).
Seat 7: coldkilla (64.02).
Seat 8: gunnfarm (42.50).
Seat 9: OmEGaKuSh (55.70).
Player Log_in has small blind (0.25)
Player Midnight0489 has big blind (0.50)
Player IlxxxlI received card: [2s]
Player IlxxxlI received card: [Js]
Player XxDominationxX folds
Player coldkilla raises (1.50)
Player gunnfarm folds
Player OmEGaKuSh folds
Player akbrow folds
Player IlxxxlI folds
Player Ice Bank Mice Elf folds
Player Log_in folds
Player Midnight0489 folds
Uncalled bet (1) returned to coldkilla
Player coldkilla mucks cards
------ Summary ------
Pot: 1.25. Rake 0
Player akbrow does not show cards.Bets: 0. Collects: 0. Wins: 0.
Player IlxxxlI does not show cards.Bets: 0. Collects: 0. Wins: 0.
Player Ice Bank Mice Elf does not show cards.Bets: 0. Collects: 0. Wins: 0.
Player Log_in does not show cards.Bets: 0.25. Collects: 0. Loses: 0.25.
Player Midnight0489 does not show cards.Bets: 0.50. Collects: 0. Loses: 0.50.
Player XxDominationxX does not show cards.Bets: 0. Collects: 0. Wins: 0.
*Player coldkilla mucks (does not show cards). Bets: 0.50. Collects: 1.25. Wins: 0.75.
Player gunnfarm does not show cards.Bets: 0. Collects: 0. Wins: 0.
Player OmEGaKuSh does not show cards.Bets: 0. Collects: 0. Wins: 0.
Game ended at: 2016/11/29 9:28:14

Game started
Game ID: 786800240 0.25/0.50 (PRR) Garuda - 2 (Hold'em)
Seat 6 is the button
Seat 1: Tilt-A-Whirl (50).
Seat 2: apoo11 (27.49).
Seat 3: imperceptible (18.92).
Seat 4: Ice Bank Mice Elf (100.50).
Seat 5: tutofu84 (150.68).
Seat 6: IlxxxlI (20).
Seat 7: coldkilla (19.72).
Seat 8: akbrow (29.50).
Seat 9: kid4life (34.41).
Player coldkilla has small blind (0.25)
Player akbrow has big blind (0.50)
Player IlxxxlI received card: [Ad]
Player IlxxxlI received card: [4d]
Player kid4life folds
Player Tilt-A-Whirl raises (1)
Player apoo11 raises (3)
Player imperceptible folds
Player Ice Bank Mice Elf folds
Player tutofu84 calls (3)
Player IlxxxlI folds
Player coldkilla folds
Player akbrow folds
Player Tilt-A-Whirl calls (2)
*** FLOP ***: [6d 3c 8s]
Player Tilt-A-Whirl checks
Player apoo11 bets (4.63)
Player tutofu84 calls (4.63)
Player Tilt-A-Whirl folds
*** TURN ***: [6d 3c 8s] [7c]
Player apoo11 bets (12.04)
Player tutofu84 calls (12.04)
*** RIVER ***: [6d 3c 8s 7c] [7h]
Player apoo11 allin (7.82)
Player tutofu84 calls (7.82)
------ Summary ------
Pot: 55.80. Rake 2.69. JP fee 0.24
Board: [6d 3c 8s 7c 7h]
Player Tilt-A-Whirl does not show cards.Bets: 3. Collects: 0. Loses: 3.
*Player apoo11 shows: Two pairs. Js and 7s [Jc Jh]. Bets: 27.49. Collects: 55.80. Wins: 28.31.
Player imperceptible does not show cards.Bets: 0. Collects: 0. Wins: 0.
Player Ice Bank Mice Elf does not show cards.Bets: 0. Collects: 0. Wins: 0.
Player tutofu84 shows: Two pairs. 9s and 7s [9s 9d]. Bets: 27.49. Collects: 0. Loses: 27.49.
Player IlxxxlI does not show cards.Bets: 0. Collects: 0. Wins: 0.
Player coldkilla does not show cards.Bets: 0.25. Collects: 0. Loses: 0.25.
Player akbrow does not show cards.Bets: 0.50. Collects: 0. Loses: 0.50.
Player kid4life does not show cards.Bets: 0. Collects: 0. Wins: 0.
Game ended at: 2016/11/29 9:29:33

Game started
Game ID: 786800203 1/2 (PRR) Longana - 2 (Hold'em)
Seat 3 is the button
Seat 1: IlxxxlI (178.97).
Seat 2: Tilt-A-Whirl (210.20).
Seat 3: IamPhamous (281.61).
Seat 4: PANDAisEVIL (217.82).
Seat 5: Iia007 (172.24).
Seat 6: StephCurry (200).
Seat 7: L4zy_FiSh (255.78).
Seat 8: mr.fargo (117.51).
Seat 9: shokerAAss (247.30).
Player PANDAisEVIL has small blind (1)
Player Iia007 sitting out
Player StephCurry has big blind (2)
Player IlxxxlI received card: [10d]
Player IlxxxlI received card: [6s]
Player L4zy_FiSh folds
Player mr.fargo raises (5)
Player shokerAAss folds
Player IlxxxlI folds
Player Tilt-A-Whirl folds
Player IamPhamous calls (5)
Player PANDAisEVIL calls (4)
Player StephCurry folds
*** FLOP ***: [As Jh 8d]
Player PANDAisEVIL checks
Player mr.fargo checks
Player IamPhamous bets (8.07)
Player PANDAisEVIL folds
Player mr.fargo folds
Uncalled bet (8.07) returned to IamPhamous
Player IamPhamous mucks cards
------ Summary ------
Pot: 16.15. Rake 0.61. JP fee 0.24
Board: [As Jh 8d]
Player IlxxxlI does not show cards.Bets: 0. Collects: 0. Wins: 0.
Player Tilt-A-Whirl does not show cards.Bets: 0. Collects: 0. Wins: 0.
*Player IamPhamous mucks (does not show cards). Bets: 5. Collects: 16.15. Wins: 11.15.
Player PANDAisEVIL does not show cards.Bets: 5. Collects: 0. Loses: 5.
Player Iia007 does not show cards.Bets: 0. Collects: 0. Wins: 0.
Player StephCurry does not show cards.Bets: 2. Collects: 0. Loses: 2.
Player L4zy_FiSh does not show cards.Bets: 0. Collects: 0. Wins: 0.
Player mr.fargo does not show cards.Bets: 5. Collects: 0. Loses: 5.
Player shokerAAss does not show cards.Bets: 0. Collects: 0. Wins: 0.
Game ended at: 2016/11/29 9:28:14

Game started
Game ID: 786799985 1/2 (PRR) Longana - 4 (Hold'em)
Seat 6 is the button
Seat 1: Iia007 (221.92).
Seat 2: IAmClueless (375.03).
Seat 3: PANDAisEVIL (387.22).
Seat 4: mr.fargo (180).
Seat 5: L4zy_FiSh (200).
Seat 6: IlxxxlI (80).
Seat 7: VegetablesArentYummy (245).
Seat 8: Gronkowski69 (215.10).
Seat 9: StephCurry (200).
Player VegetablesArentYummy has small blind (1)
Player Gronkowski69 sitting out
Player StephCurry has big blind (2)
Player IlxxxlI received card: [3c]
Player IlxxxlI received card: [6c]
Player Iia007 folds
Player IAmClueless raises (6)
Player PANDAisEVIL folds
Player mr.fargo folds
Player L4zy_FiSh raises (18)
Player IlxxxlI folds
Player VegetablesArentYummy folds
Player StephCurry folds
Player IAmClueless calls (12)
*** FLOP ***: [10s Jh 10c]
Player IAmClueless checks
Player L4zy_FiSh bets (14)
Player IAmClueless calls (14)
*** TURN ***: [10s Jh 10c] [8d]
Player IAmClueless checks
Player L4zy_FiSh bets (38)
Player IAmClueless calls (38)
*** RIVER ***: [10s Jh 10c 8d] [9s]
Player IAmClueless bets (140)
Player L4zy_FiSh allin (130)
Uncalled bet (10) returned to IAmClueless
------ Summary ------
Pot: 400. Rake 2.76. JP fee 0.24
Board: [10s Jh 10c 8d 9s]
Player Iia007 does not show cards.Bets: 0. Collects: 0. Wins: 0.
Player IAmClueless shows: Straight to K [Qh Kh]. Bets: 200. Collects: 0. Loses: 200.
Player PANDAisEVIL does not show cards.Bets: 0. Collects: 0. Wins: 0.
Player mr.fargo does not show cards.Bets: 0. Collects: 0. Wins: 0.
*Player L4zy_FiSh shows: Full House (J/10) [Js Jd]. Bets: 200. Collects: 400. Wins: 200.
Player IlxxxlI does not show cards.Bets: 0. Collects: 0. Wins: 0.
Player VegetablesArentYummy does not show cards.Bets: 1. Collects: 0. Loses: 1.
Player Gronkowski69 does not show cards.Bets: 0. Collects: 0. Wins: 0.
Player StephCurry does not show cards.Bets: 2. Collects: 0. Loses: 2.
Game ended at: 2016/11/29 9:28:37

Game started
Game ID: 786799522 0.25/0.50 (PRR) Gorgons - 7 (Hold'em)
Seat 2 is the button
Seat 1: 528 Hertz (50).
Seat 2: Heksebrygg (52.27).
Seat 3: Dirty4skin (53.68).
Seat 4: FaceMelt (64.98).
Seat 5: Tilt-A-Whirl (56.64).
Seat 6: IlxxxlI (26.14).
Player Dirty4skin has small blind (0.25)
Player FaceMelt has big blind (0.50)
Player IlxxxlI received card: [Qd]
Player IlxxxlI received card: [3h]
Player Tilt-A-Whirl raises (1)
Player IlxxxlI folds
Player 528 Hertz folds
Player Heksebrygg folds
Player Dirty4skin calls (0.75)
Player FaceMelt calls (0.50)
*** FLOP ***: [3s Jc Ks]
Player Dirty4skin bets (1.90)
Player FaceMelt calls (1.90)
Player Tilt-A-Whirl calls (1.90)
*** TURN ***: [3s Jc Ks] [10s]
Player Dirty4skin bets (5.51)
Player FaceMelt folds
Player Tilt-A-Whirl calls (5.51)
*** RIVER ***: [3s Jc Ks 10s] [Qc]
Player Dirty4skin bets (12.49)
Player Tilt-A-Whirl folds
Uncalled bet (12.49) returned to Dirty4skin
Player Dirty4skin mucks cards
------ Summary ------
Pot: 18.74. Rake 0.74. JP fee 0.24
Board: [3s Jc Ks 10s Qc]
Player 528 Hertz does not show cards.Bets: 0. Collects: 0. Wins: 0.
Player Heksebrygg does not show cards.Bets: 0. Collects: 0. Wins: 0.
*Player Dirty4skin mucks (does not show cards). Bets: 8.41. Collects: 18.74. Wins: 10.33.
Player FaceMelt does not show cards.Bets: 2.90. Collects: 0. Loses: 2.90.
Player Tilt-A-Whirl does not show cards.Bets: 8.41. Collects: 0. Loses: 8.41.
Player IlxxxlI does not show cards.Bets: 0. Collects: 0. Wins: 0.
Game ended at: 2016/11/29 9:27:53

Game started
Game ID: 786798981 1/2 (PRR) Longana - 2 (Hold'em)
Seat 2 is the button
Seat 1: IlxxxlI (178.97).
Seat 2: Tilt-A-Whirl (200).
Seat 3: IamPhamous (282.61).
Seat 4: PANDAisEVIL (222.82).
Seat 5: Iia007 (172.24).
Seat 6: StephCurry (200).
Seat 7: L4zy_FiSh (255.78).
Seat 8: mr.fargo (122.51).
Seat 9: shokerAAss (247.30).
Player IamPhamous has small blind (1)
Player PANDAisEVIL has big blind (2)
Player IlxxxlI received card: [10s]
Player IlxxxlI received card: [Kd]
Player Iia007 folds
Player StephCurry folds
Player L4zy_FiSh folds
Player mr.fargo raises (5)
Player shokerAAss folds
Player IlxxxlI folds
Player Tilt-A-Whirl calls (5)
Player IamPhamous folds
Player PANDAisEVIL calls (3)
*** FLOP ***: [2c Js 9d]
Player PANDAisEVIL checks
Player mr.fargo checks
Player Tilt-A-Whirl bets (7.60)
Player PANDAisEVIL folds
Player mr.fargo folds
Uncalled bet (7.60) returned to Tilt-A-Whirl
Player Tilt-A-Whirl mucks cards
------ Summary ------
Pot: 15.20. Rake 0.56. JP fee 0.24
Board: [2c Js 9d]
Player IlxxxlI does not show cards.Bets: 0. Collects: 0. Wins: 0.
*Player Tilt-A-Whirl mucks (does not show cards). Bets: 5. Collects: 15.20. Wins: 10.20.
Player IamPhamous does not show cards.Bets: 1. Collects: 0. Loses: 1.
Player PANDAisEVIL does not show cards.Bets: 5. Collects: 0. Loses: 5.
Player Iia007 does not show cards.Bets: 0. Collects: 0. Wins: 0.
Player StephCurry does not show cards.Bets: 0. Collects: 0. Wins: 0.
Player L4zy_FiSh does not show cards.Bets: 0. Collects: 0. Wins: 0.
Player mr.fargo does not show cards.Bets: 5. Collects: 0. Loses: 5.
Player shokerAAss does not show cards.Bets: 0. Collects: 0. Wins: 0.
Game ended at: 2016/11/29 9:27:1

Game started
Game ID: 786798536 0.25/0.50 (PRR) Garuda - 2 (Hold'em)
Seat 5 is the button
Seat 1: Tilt-A-Whirl (50).
Seat 2: apoo11 (30.99).
Seat 3: imperceptible (19.92).
Seat 4: Ice Bank Mice Elf (100.50).
Seat 5: tutofu84 (150.68).
Seat 6: IlxxxlI (20).
Seat 7: coldkilla (14.67).
Seat 8: akbrow (29.50).
Seat 9: kid4life (34.41).
Player IlxxxlI has small blind (0.25)
Player coldkilla has big blind (0.50)
Player IlxxxlI received card: [5c]
Player IlxxxlI received card: [5d]
Player akbrow folds
Player kid4life folds
Player Tilt-A-Whirl folds
Player apoo11 raises (1)
Player imperceptible calls (1)
Player Ice Bank Mice Elf folds
Player tutofu84 folds
Player IlxxxlI calls (0.75)
Player coldkilla raises (3)
Player apoo11 calls (2.50)
Player imperceptible folds
Player IlxxxlI folds
*** FLOP ***: [4h 3s Kc]
Player coldkilla bets (4.27)
Player apoo11 folds
Uncalled bet (4.27) returned to coldkilla
Player coldkilla mucks cards
------ Summary ------
Pot: 8.55. Rake 0.31. JP fee 0.14
Board: [4h 3s Kc]
Player Tilt-A-Whirl does not show cards.Bets: 0. Collects: 0. Wins: 0.
Player apoo11 does not show cards.Bets: 3.50. Collects: 0. Loses: 3.50.
Player imperceptible does not show cards.Bets: 1. Collects: 0. Loses: 1.
Player Ice Bank Mice Elf does not show cards.Bets: 0. Collects: 0. Wins: 0.
Player tutofu84 does not show cards.Bets: 0. Collects: 0. Wins: 0.
Player IlxxxlI does not show cards.Bets: 1. Collects: 0. Loses: 1.
*Player coldkilla mucks (does not show cards). Bets: 3.50. Collects: 8.55. Wins: 5.05.
Player akbrow does not show cards.Bets: 0. Collects: 0. Wins: 0.
Player kid4life does not show cards.Bets: 0. Collects: 0. Wins: 0.
Game ended at: 2016/11/29 9:27:3

Game started
Game ID: 786798321 0.25/0.50 (PRR) Gorgons - 7 (Hold'em)
Seat 1 is the button
Seat 1: 528 Hertz (50).
Seat 2: Heksebrygg (52.52).
Seat 3: Dirty4skin (55.72).
Seat 4: FaceMelt (64.98).
Seat 5: Tilt-A-Whirl (56.64).
Seat 6: IlxxxlI (24.06).
Player Heksebrygg has small blind (0.25)
Player Dirty4skin has big blind (0.50)
Player IlxxxlI received card: [Ks]
Player IlxxxlI received card: [Jh]
Player FaceMelt folds
Player Tilt-A-Whirl folds
Player IlxxxlI raises (1.20)
Player 528 Hertz folds
Player Heksebrygg is timed out.
Player Heksebrygg folds
Player Dirty4skin calls (0.70)
*** FLOP ***: [2s 2c 3c]
Player Dirty4skin checks
Player IlxxxlI bets (0.84)
Player Dirty4skin calls (0.84)
*** TURN ***: [2s 2c 3c] [8c]
Player Dirty4skin checks
Player IlxxxlI checks
*** RIVER ***: [2s 2c 3c 8c] [Qc]
Player Dirty4skin checks
Player IlxxxlI bets (1.37)
Player Dirty4skin folds
Uncalled bet (1.37) returned to IlxxxlI
Player IlxxxlI mucks cards
------ Summary ------
Pot: 4.12. Rake 0.15. JP fee 0.06
Board: [2s 2c 3c 8c Qc]
Player 528 Hertz does not show cards.Bets: 0. Collects: 0. Wins: 0.
Player Heksebrygg does not show cards.Bets: 0.25. Collects: 0. Loses: 0.25.
Player Dirty4skin does not show cards.Bets: 2.04. Collects: 0. Loses: 2.04.
Player FaceMelt does not show cards.Bets: 0. Collects: 0. Wins: 0.
Player Tilt-A-Whirl does not show cards.Bets: 0. Collects: 0. Wins: 0.
*Player IlxxxlI mucks (does not show cards). Bets: 2.04. Collects: 4.12. Wins: 2.08.
Game ended at: 2016/11/29 9:26:15

Game started
Game ID: 786798277 0.25/0.50 (PRR) Garuda (Hold'em)
Seat 2 is the button
Seat 1: akbrow (21.25).
Seat 2: IlxxxlI (20).
Seat 3: Ice Bank Mice Elf (100.10).
Seat 4: Log_in (19.75).
Seat 5: Midnight0489 (47.25).
Seat 6: XxDominationxX (97.93).
Seat 7: coldkilla (58.35).
Seat 8: gunnfarm (42.50).
Seat 9: OmEGaKuSh (55.70).
Player Ice Bank Mice Elf has small blind (0.25)
Player Log_in has big blind (0.50)
Player IlxxxlI received card: [Jc]
Player IlxxxlI received card: [2c]
Player Midnight0489 raises (1)
Player XxDominationxX folds
Player coldkilla raises (2.50)
Player gunnfarm folds
Player OmEGaKuSh folds
Player akbrow folds
Player IlxxxlI folds
Player Ice Bank Mice Elf folds
Player Log_in folds
Player Midnight0489 calls (1.50)
*** FLOP ***: [8d 2h 8c]
Player Midnight0489 checks
Player coldkilla checks
*** TURN ***: [8d 2h 8c] [Kd]
Player Midnight0489 bets (3)
Player coldkilla calls (3)
*** RIVER ***: [8d 2h 8c Kd] [Ks]
Player Midnight0489 checks
Player coldkilla checks
------ Summary ------
Pot: 11.17. Rake 0.40. JP fee 0.18
Board: [8d 2h 8c Kd Ks]
Player akbrow does not show cards.Bets: 0. Collects: 0. Wins: 0.
Player IlxxxlI does not show cards.Bets: 0. Collects: 0. Wins: 0.
Player Ice Bank Mice Elf does not show cards.Bets: 0.25. Collects: 0. Loses: 0.25.
Player Log_in does not show cards.Bets: 0.50. Collects: 0. Loses: 0.50.
Player Midnight0489 shows: Two pairs. Ks and 8s [7c 7h]. Bets: 5.50. Collects: 0. Loses: 5.50.
Player XxDominationxX does not show cards.Bets: 0. Collects: 0. Wins: 0.
*Player coldkilla shows: Two pairs. Ks and 8s (kicker A) [Ac Qs]. Bets: 5.50. Collects: 11.17. Wins: 5.67.
Player gunnfarm does not show cards.Bets: 0. Collects: 0. Wins: 0.
Player OmEGaKuSh does not show cards.Bets: 0. Collects: 0. Wins: 0.
Game ended at: 2016/11/29 9:27:8

Game started
Game ID: 786798220 1/2 (PRR) Longana - 4 (Hold'em)
Seat 5 is the button
Seat 1: Iia007 (227.92).
Seat 2: IAmClueless (381.03).
Seat 3: PANDAisEVIL (387.22).
Seat 4: mr.fargo (180).
Seat 5: L4zy_FiSh (210.55).
Seat 6: IlxxxlI (80).
Seat 7: VegetablesArentYummy (200).
Seat 8: Gronkowski69 (221.10).
Seat 9: StephCurry (200).
Player IlxxxlI has small blind (1)
Player VegetablesArentYummy has big blind (2)
Player IlxxxlI received card: [Qh]
Player IlxxxlI received card: [7s]
Player Gronkowski69 raises (6)
Player StephCurry folds
Player Iia007 calls (6)
Player IAmClueless calls (6)
Player PANDAisEVIL folds
Player mr.fargo folds
Player L4zy_FiSh raises (26)
Player IlxxxlI folds
Player VegetablesArentYummy raises (52)
Player Gronkowski69 folds
Player Iia007 folds
Player IAmClueless folds
Player L4zy_FiSh folds
Uncalled bet (28) returned to VegetablesArentYummy
Player VegetablesArentYummy mucks cards
------ Summary ------
Pot: 71. Rake 0
Player Iia007 does not show cards.Bets: 6. Collects: 0. Loses: 6.
Player IAmClueless does not show cards.Bets: 6. Collects: 0. Loses: 6.
Player PANDAisEVIL does not show cards.Bets: 0. Collects: 0. Wins: 0.
Player mr.fargo does not show cards.Bets: 0. Collects: 0. Wins: 0.
Player L4zy_FiSh does not show cards.Bets: 26. Collects: 0. Loses: 26.
Player IlxxxlI does not show cards.Bets: 1. Collects: 0. Loses: 1.
*Player VegetablesArentYummy mucks (does not show cards). Bets: 26. Collects: 71. Wins: 45.
Player Gronkowski69 does not show cards.Bets: 6. Collects: 0. Loses: 6.
Player StephCurry does not show cards.Bets: 0. Collects: 0. Wins: 0.
Game ended at: 2016/11/29 9:26:47

Game started
Game ID: 786797676 0.25/0.50 (PRR) Gorgons - 7 (Hold'em)
Seat 6 is the button
Seat 1: 528 Hertz (50).
Seat 2: Heksebrygg (53.02).
Seat 3: Dirty4skin (54.97).
Seat 4: FaceMelt (64.98).
Seat 5: Tilt-A-Whirl (56.64).
Seat 6: IlxxxlI (24.06).
Player 528 Hertz has small blind (0.25)
Player Heksebrygg has big blind (0.50)
Player IlxxxlI received card: [10c]
Player IlxxxlI received card: [Js]
Player Dirty4skin raises (1.50)
Player FaceMelt folds
Player Tilt-A-Whirl folds
Player IlxxxlI folds
Player 528 Hertz folds
Player Heksebrygg folds
Uncalled bet (1) returned to Dirty4skin
Player Dirty4skin mucks cards
------ Summary ------
Pot: 1.25. Rake 0
Player 528 Hertz does not show cards.Bets: 0.25. Collects: 0. Loses: 0.25.
Player Heksebrygg does not show cards.Bets: 0.50. Collects: 0. Loses: 0.50.
*Player Dirty4skin mucks (does not show cards). Bets: 0.50. Collects: 1.25. Wins: 0.75.
Player FaceMelt does not show cards.Bets: 0. Collects: 0. Wins: 0.
Player Tilt-A-Whirl does not show cards.Bets: 0. Collects: 0. Wins: 0.
Player IlxxxlI does not show cards.Bets: 0. Collects: 0. Wins: 0.
Game ended at: 2016/11/29 9:24:56

Game started
Game ID: 786797428 0.25/0.50 (PRR) Gorgons - 7 (Hold'em)
Seat 5 is the button
Seat 1: 528 Hertz (50).
Seat 2: Heksebrygg (52.27).
Seat 3: Dirty4skin (54.97).
Seat 4: FaceMelt (64.98).
Seat 5: Tilt-A-Whirl (56.64).
Seat 6: IlxxxlI (24.31).
Player IlxxxlI has small blind (0.25)
Player 528 Hertz has big blind (0.50)
Player IlxxxlI received card: [4c]
Player IlxxxlI received card: [5c]
Player Heksebrygg raises (1.50)
Player Dirty4skin folds
Player FaceMelt folds
Player Tilt-A-Whirl folds
Player IlxxxlI folds
Player 528 Hertz folds
Uncalled bet (1) returned to Heksebrygg
Player Heksebrygg mucks cards
------ Summary ------
Pot: 1.25. Rake 0
Player 528 Hertz does not show cards.Bets: 0.50. Collects: 0. Loses: 0.50.
*Player Heksebrygg mucks (does not show cards). Bets: 0.50. Collects: 1.25. Wins: 0.75.
Player Dirty4skin does not show cards.Bets: 0. Collects: 0. Wins: 0.
Player FaceMelt does not show cards.Bets: 0. Collects: 0. Wins: 0.
Player Tilt-A-Whirl does not show cards.Bets: 0. Collects: 0. Wins: 0.
Player IlxxxlI does not show cards.Bets: 0.25. Collects: 0. Loses: 0.25.
Game ended at: 2016/11/29 9:24:14

Game started
Game ID: 786797433 1/2 (PRR) Longana - 4 (Hold'em)
Seat 4 is the button
Seat 1: Iia007 (227.92).
Seat 2: IAmClueless (381.03).
Seat 3: PANDAisEVIL (384.22).
Seat 4: mr.fargo (180).
Seat 5: L4zy_FiSh (211.55).
Seat 6: IlxxxlI (80).
Seat 8: Gronkowski69 (221.10).
Seat 9: StephCurry (200).
Player L4zy_FiSh has small blind (1)
Player IlxxxlI has big blind (2)
Player IlxxxlI received card: [Jh]
Player IlxxxlI received card: [6c]
Player Gronkowski69 folds
Player StephCurry folds
Player Iia007 folds
Player IAmClueless folds
Player PANDAisEVIL raises (5)
Player mr.fargo folds
Player L4zy_FiSh folds
Player IlxxxlI folds
Uncalled bet (3) returned to PANDAisEVIL
Player PANDAisEVIL mucks cards
------ Summary ------
Pot: 5. Rake 0
Player Iia007 does not show cards.Bets: 0. Collects: 0. Wins: 0.
Player IAmClueless does not show cards.Bets: 0. Collects: 0. Wins: 0.
*Player PANDAisEVIL mucks (does not show cards). Bets: 2. Collects: 5. Wins: 3.
Player mr.fargo does not show cards.Bets: 0. Collects: 0. Wins: 0.
Player L4zy_FiSh does not show cards.Bets: 1. Collects: 0. Loses: 1.
Player IlxxxlI does not show cards.Bets: 2. Collects: 0. Loses: 2.
Player Gronkowski69 does not show cards.Bets: 0. Collects: 0. Wins: 0.
Player StephCurry does not show cards.Bets: 0. Collects: 0. Wins: 0.
Game ended at: 2016/11/29 9:24:48

Game started
Game ID: 786797335 1/2 (PRR) Longana - 2 (Hold'em)
Seat 1 is the button
Seat 1: IlxxxlI (178.97).
Seat 2: Tilt-A-Whirl (200).
Seat 3: IamPhamous (284.61).
Seat 4: PANDAisEVIL (222.82).
Seat 5: Iia007 (172.24).
Seat 6: StephCurry (200).
Seat 7: L4zy_FiSh (255.78).
Seat 8: mr.fargo (122.51).
Seat 9: shokerAAss (240).
Player Tilt-A-Whirl has small blind (1)
Player IamPhamous has big blind (2)
Player IlxxxlI received card: [6c]
Player IlxxxlI received card: [Qs]
Player PANDAisEVIL folds
Player Iia007 folds
Player StephCurry folds
Player L4zy_FiSh folds
Player mr.fargo folds
Player shokerAAss raises (6)
Player IlxxxlI folds
Player Tilt-A-Whirl calls (5)
Player IamPhamous folds
*** FLOP ***: [5d Kd Jd]
Player Tilt-A-Whirl checks
Player shokerAAss checks
*** TURN ***: [5d Kd Jd] [9c]
Player Tilt-A-Whirl checks
Player shokerAAss bets (6.65)
Player Tilt-A-Whirl folds
Uncalled bet (6.65) returned to shokerAAss
Player shokerAAss mucks cards
------ Summary ------
Pot: 13.30. Rake 0.48. JP fee 0.22
Board: [5d Kd Jd 9c]
Player IlxxxlI does not show cards.Bets: 0. Collects: 0. Wins: 0.
Player Tilt-A-Whirl does not show cards.Bets: 6. Collects: 0. Loses: 6.
Player IamPhamous does not show cards.Bets: 2. Collects: 0. Loses: 2.
Player PANDAisEVIL does not show cards.Bets: 0. Collects: 0. Wins: 0.
Player Iia007 does not show cards.Bets: 0. Collects: 0. Wins: 0.
Player StephCurry does not show cards.Bets: 0. Collects: 0. Wins: 0.
Player L4zy_FiSh does not show cards.Bets: 0. Collects: 0. Wins: 0.
Player mr.fargo does not show cards.Bets: 0. Collects: 0. Wins: 0.
*Player shokerAAss mucks (does not show cards). Bets: 6. Collects: 13.30. Wins: 7.30.
Game ended at: 2016/11/29 9:25:41

Game started
Game ID: 786796944 0.25/0.50 (PRR) Garuda (Hold'em)
Seat 1 is the button
Seat 1: akbrow (21.25).
Seat 2: IlxxxlI (20).
Seat 3: Ice Bank Mice Elf (100.60).
Seat 4: Log_in (19.75).
Seat 5: Midnight0489 (47.25).
Seat 6: XxDominationxX (97.93).
Seat 7: coldkilla (57.60).
Seat 8: gunnfarm (42.50).
Seat 9: OmEGaKuSh (55.70).
Player IlxxxlI has small blind (0.25)
Player Ice Bank Mice Elf has big blind (0.50)
Player IlxxxlI received card: [4d]
Player IlxxxlI received card: [7c]
Player Log_in folds
Player Midnight0489 folds
Player XxDominationxX folds
Player coldkilla raises (1.50)
Player gunnfarm folds
Player OmEGaKuSh folds
Player akbrow folds
Player IlxxxlI folds
Player Ice Bank Mice Elf folds
Uncalled bet (1) returned to coldkilla
Player coldkilla mucks cards
------ Summary ------
Pot: 1.25. Rake 0
Player akbrow does not show cards.Bets: 0. Collects: 0. Wins: 0.
Player IlxxxlI does not show cards.Bets: 0.25. Collects: 0. Loses: 0.25.
Player Ice Bank Mice Elf does not show cards.Bets: 0.50. Collects: 0. Loses: 0.50.
Player Log_in does not show cards.Bets: 0. Collects: 0. Wins: 0.
Player Midnight0489 does not show cards.Bets: 0. Collects: 0. Wins: 0.
Player XxDominationxX does not show cards.Bets: 0. Collects: 0. Wins: 0.
*Player coldkilla mucks (does not show cards). Bets: 0.50. Collects: 1.25. Wins: 0.75.
Player gunnfarm does not show cards.Bets: 0. Collects: 0. Wins: 0.
Player OmEGaKuSh does not show cards.Bets: 0. Collects: 0. Wins: 0.
Game ended at: 2016/11/29 9:24:53

Game started
Game ID: 786796845 0.25/0.50 (PRR) Garuda - 2 (Hold'em)
Seat 4 is the button
Seat 1: Tilt-A-Whirl (50).
Seat 2: apoo11 (30.99).
Seat 3: imperceptible (19.92).
Seat 4: Ice Bank Mice Elf (101.50).
Seat 5: tutofu84 (144.18).
Seat 6: IlxxxlI (24.07).
Seat 7: coldkilla (14.67).
Seat 8: akbrow (29.50).
Seat 9: kid4life (34.41).
Player tutofu84 has small blind (0.25)
Player IlxxxlI has big blind (0.50)
Player IlxxxlI received card: [As]
Player IlxxxlI received card: [7s]
Player coldkilla folds
Player akbrow folds
Player kid4life folds
Player Tilt-A-Whirl folds
Player apoo11 folds
Player imperceptible folds
Player Ice Bank Mice Elf raises (1)
Player tutofu84 calls (0.75)
Player IlxxxlI raises (3.08)
Player Ice Bank Mice Elf folds
Player tutofu84 calls (2.58)
*** FLOP ***: [Kd Qh 2h]
Player tutofu84 checks
Player IlxxxlI bets (2.58)
Player tutofu84 calls (2.58)
*** TURN ***: [Kd Qh 2h] [3h]
Player tutofu84 checks
Player IlxxxlI checks
*** RIVER ***: [Kd Qh 2h 3h] [5s]
Player tutofu84 bets (8.44)
Player IlxxxlI folds
Uncalled bet (8.44) returned to tutofu84
Player tutofu84 mucks cards
------ Summary ------
Pot: 12.66. Rake 0.44. JP fee 0.22
Board: [Kd Qh 2h 3h 5s]
Player Tilt-A-Whirl does not show cards.Bets: 0. Collects: 0. Wins: 0.
Player apoo11 does not show cards.Bets: 0. Collects: 0. Wins: 0.
Player imperceptible does not show cards.Bets: 0. Collects: 0. Wins: 0.
Player Ice Bank Mice Elf does not show cards.Bets: 1. Collects: 0. Loses: 1.
*Player tutofu84 mucks (does not show cards). Bets: 6.16. Collects: 12.66. Wins: 6.50.
Player IlxxxlI does not show cards.Bets: 6.16. Collects: 0. Loses: 6.16.
Player coldkilla does not show cards.Bets: 0. Collects: 0. Wins: 0.
Player akbrow does not show cards.Bets: 0. Collects: 0. Wins: 0.
Player kid4life does not show cards.Bets: 0. Collects: 0. Wins: 0.
Game ended at: 2016/11/29 9:25:10

Game started
Game ID: 786796728 1/2 (PRR) Longana - 4 (Hold'em)
Seat 3 is the button
Seat 1: Iia007 (227.92).
Seat 2: IAmClueless (381.03).
Seat 3: PANDAisEVIL (381.22).
Seat 4: mr.fargo (181).
Seat 5: L4zy_FiSh (213.55).
Seat 6: IlxxxlI (80).
Seat 8: Gronkowski69 (221.10).
Seat 9: StephCurry (200).
Player mr.fargo has small blind (1)
Player L4zy_FiSh has big blind (2)
Player IlxxxlI received card: [10c]
Player IlxxxlI received card: [7c]
Player IlxxxlI folds
Player Gronkowski69 folds
Player StephCurry folds
Player Iia007 folds
Player IAmClueless folds
Player PANDAisEVIL raises (4.40)
Player mr.fargo folds
Player L4zy_FiSh folds
Uncalled bet (2.40) returned to PANDAisEVIL
Player PANDAisEVIL mucks cards
------ Summary ------
Pot: 5. Rake 0
Player Iia007 does not show cards.Bets: 0. Collects: 0. Wins: 0.
Player IAmClueless does not show cards.Bets: 0. Collects: 0. Wins: 0.
*Player PANDAisEVIL mucks (does not show cards). Bets: 2. Collects: 5. Wins: 3.
Player mr.fargo does not show cards.Bets: 1. Collects: 0. Loses: 1.
Player L4zy_FiSh does not show cards.Bets: 2. Collects: 0. Loses: 2.
Player IlxxxlI does not show cards.Bets: 0. Collects: 0. Wins: 0.
Player Gronkowski69 does not show cards.Bets: 0. Collects: 0. Wins: 0.
Player StephCurry does not show cards.Bets: 0. Collects: 0. Wins: 0.
Game ended at: 2016/11/29 9:23:56

Game started
Game ID: 786796650 0.25/0.50 (PRR) Gorgons - 7 (Hold'em)
Seat 4 is the button
Seat 1: 528 Hertz (50).
Seat 2: Heksebrygg (52.27).
Seat 3: Dirty4skin (54.97).
Seat 4: FaceMelt (64.98).
Seat 5: Tilt-A-Whirl (58.27).
Seat 6: IlxxxlI (22.84).
Player Tilt-A-Whirl has small blind (0.25)
Player IlxxxlI has big blind (0.50)
Player IlxxxlI received card: [Qc]
Player IlxxxlI received card: [Jc]
Player 528 Hertz folds
Player Heksebrygg folds
Player Dirty4skin folds
Player FaceMelt folds
Player Tilt-A-Whirl raises (0.75)
Player IlxxxlI calls (0.50)
*** FLOP ***: [3c 3d 7d]
Player Tilt-A-Whirl checks
Player IlxxxlI checks
*** TURN ***: [3c 3d 7d] [5c]
Player Tilt-A-Whirl bets (0.63)
Player IlxxxlI raises (4)
Player Tilt-A-Whirl folds
Uncalled bet (3.37) returned to IlxxxlI
Player IlxxxlI mucks cards
------ Summary ------
Pot: 3.10. Rake 0.12. JP fee 0.04
Board: [3c 3d 7d 5c]
Player 528 Hertz does not show cards.Bets: 0. Collects: 0. Wins: 0.
Player Heksebrygg does not show cards.Bets: 0. Collects: 0. Wins: 0.
Player Dirty4skin does not show cards.Bets: 0. Collects: 0. Wins: 0.
Player FaceMelt does not show cards.Bets: 0. Collects: 0. Wins: 0.
Player Tilt-A-Whirl does not show cards.Bets: 1.63. Collects: 0. Loses: 1.63.
*Player IlxxxlI mucks (does not show cards). Bets: 1.63. Collects: 3.10. Wins: 1.47.
Game ended at: 2016/11/29 9:23:55

Game started
Game ID: 786796235 1/2 (PRR) Longana - 2 (Hold'em)
Seat 9 is the button
Seat 1: IlxxxlI (179.97).
Seat 2: Tilt-A-Whirl (200).
Seat 3: IamPhamous (284.61).
Seat 4: PANDAisEVIL (222.82).
Seat 5: Iia007 (212.24).
Seat 6: StephCurry (200).
Seat 7: L4zy_FiSh (255.78).
Seat 8: mr.fargo (122.51).
Seat 9: shokerAAss (200).
Player IlxxxlI has small blind (1)
Player Tilt-A-Whirl has big blind (2)
Player IlxxxlI received card: [Kh]
Player IlxxxlI received card: [5h]
Player IamPhamous folds
Player PANDAisEVIL folds
Player Iia007 raises (6)
Player StephCurry folds
Player L4zy_FiSh folds
Player mr.fargo folds
Player shokerAAss calls (6)
Player IlxxxlI folds
Player Tilt-A-Whirl folds
*** FLOP ***: [7d Ad 4c]
Player Iia007 checks
Player shokerAAss checks
*** TURN ***: [7d Ad 4c] [6h]
Player Iia007 bets (10)
Player shokerAAss calls (10)
*** RIVER ***: [7d Ad 4c 6h] [Qh]
Player Iia007 bets (24)
Player shokerAAss calls (24)
------ Summary ------
Pot: 80. Rake 2.76. JP fee 0.24
Board: [7d Ad 4c 6h Qh]
Player IlxxxlI does not show cards.Bets: 1. Collects: 0. Loses: 1.
Player Tilt-A-Whirl does not show cards.Bets: 2. Collects: 0. Loses: 2.
Player IamPhamous does not show cards.Bets: 0. Collects: 0. Wins: 0.
Player PANDAisEVIL does not show cards.Bets: 0. Collects: 0. Wins: 0.
Player Iia007 shows: One pair of As [Ah 8h]. Bets: 40. Collects: 0. Loses: 40.
Player StephCurry does not show cards.Bets: 0. Collects: 0. Wins: 0.
Player L4zy_FiSh does not show cards.Bets: 0. Collects: 0. Wins: 0.
Player mr.fargo does not show cards.Bets: 0. Collects: 0. Wins: 0.
*Player shokerAAss shows: Two pairs. As and Qs [Qc As]. Bets: 40. Collects: 80. Wins: 40.
Game ended at: 2016/11/29 9:23:47

Game started
Game ID: 786796051 0.25/0.50 (PRR) Gorgons - 7 (Hold'em)
Seat 3 is the button
Seat 1: 528 Hertz (50).
Seat 2: Heksebrygg (52.27).
Seat 3: Dirty4skin (54.97).
Seat 4: FaceMelt (65.23).
Seat 5: Tilt-A-Whirl (58.02).
Seat 6: IlxxxlI (22.84).
Player FaceMelt has small blind (0.25)
Player Tilt-A-Whirl has big blind (0.50)
Player IlxxxlI received card: [9s]
Player IlxxxlI received card: [8h]
Player IlxxxlI folds
Player 528 Hertz folds
Player Heksebrygg folds
Player Dirty4skin folds
Player FaceMelt folds
Uncalled bet (0.25) returned to Tilt-A-Whirl
Player Tilt-A-Whirl mucks cards
------ Summary ------
Pot: 0.50. Rake 0
Player 528 Hertz does not show cards.Bets: 0. Collects: 0. Wins: 0.
Player Heksebrygg does not show cards.Bets: 0. Collects: 0. Wins: 0.
Player Dirty4skin does not show cards.Bets: 0. Collects: 0. Wins: 0.
Player FaceMelt does not show cards.Bets: 0.25. Collects: 0. Loses: 0.25.
*Player Tilt-A-Whirl mucks (does not show cards). Bets: 0.25. Collects: 0.50. Wins: 0.25.
Player IlxxxlI does not show cards.Bets: 0. Collects: 0. Wins: 0.
Game ended at: 2016/11/29 9:23:2

Game started
Game ID: 786795897 0.25/0.50 (PRR) Garuda - 2 (Hold'em)
Seat 3 is the button
Seat 1: Tilt-A-Whirl (50.10).
Seat 2: apoo11 (30.99).
Seat 3: imperceptible (19.92).
Seat 4: Ice Bank Mice Elf (101.75).
Seat 5: tutofu84 (140.79).
Seat 6: IlxxxlI (24.07).
Seat 7: coldkilla (14.67).
Seat 8: akbrow (29.50).
Seat 9: kid4life (34.41).
Player Ice Bank Mice Elf has small blind (0.25)
Player tutofu84 has big blind (0.50)
Player IlxxxlI received card: [3h]
Player IlxxxlI received card: [Qh]
Player IlxxxlI folds
Player coldkilla folds
Player akbrow folds
Player kid4life folds
Player Tilt-A-Whirl raises (1)
Player apoo11 folds
Player imperceptible folds
Player Ice Bank Mice Elf folds
Player tutofu84 raises (3)
Player Tilt-A-Whirl calls (2.50)
*** FLOP ***: [Ah Js As]
Player tutofu84 bets (4.59)
Player Tilt-A-Whirl folds
Uncalled bet (4.59) returned to tutofu84
Player tutofu84 mucks cards
------ Summary ------
Pot: 6.89. Rake 0.24. JP fee 0.12
Board: [Ah Js As]
Player Tilt-A-Whirl does not show cards.Bets: 3.50. Collects: 0. Loses: 3.50.
Player apoo11 does not show cards.Bets: 0. Collects: 0. Wins: 0.
Player imperceptible does not show cards.Bets: 0. Collects: 0. Wins: 0.
Player Ice Bank Mice Elf does not show cards.Bets: 0.25. Collects: 0. Loses: 0.25.
*Player tutofu84 mucks (does not show cards). Bets: 3.50. Collects: 6.89. Wins: 3.39.
Player IlxxxlI does not show cards.Bets: 0. Collects: 0. Wins: 0.
Player coldkilla does not show cards.Bets: 0. Collects: 0. Wins: 0.
Player akbrow does not show cards.Bets: 0. Collects: 0. Wins: 0.
Player kid4life does not show cards.Bets: 0. Collects: 0. Wins: 0.
Game ended at: 2016/11/29 9:23:15

Game started
Game ID: 786795768 1/2 (PRR) Longana - 2 (Hold'em)
Seat 8 is the button
Seat 1: IlxxxlI (178.97).
Seat 2: Tilt-A-Whirl (200).
Seat 3: IamPhamous (284.61).
Seat 4: PANDAisEVIL (222.82).
Seat 5: Iia007 (212.24).
Seat 6: StephCurry (200).
Seat 7: L4zy_FiSh (255.78).
Seat 8: mr.fargo (122.51).
Seat 9: shokerAAss (200).
Player shokerAAss has small blind (1)
Player IlxxxlI has big blind (2)
Player IlxxxlI received card: [Qd]
Player IlxxxlI received card: [3d]
Player Tilt-A-Whirl folds
Player IamPhamous folds
Player PANDAisEVIL folds
Player Iia007 folds
Player StephCurry folds
Player L4zy_FiSh folds
Player mr.fargo folds
Player shokerAAss folds
Uncalled bet (1) returned to IlxxxlI
Player IlxxxlI mucks cards
------ Summary ------
Pot: 2. Rake 0
*Player IlxxxlI mucks (does not show cards). Bets: 1. Collects: 2. Wins: 1.
Player Tilt-A-Whirl does not show cards.Bets: 0. Collects: 0. Wins: 0.
Player IamPhamous does not show cards.Bets: 0. Collects: 0. Wins: 0.
Player PANDAisEVIL does not show cards.Bets: 0. Collects: 0. Wins: 0.
Player Iia007 does not show cards.Bets: 0. Collects: 0. Wins: 0.
Player StephCurry does not show cards.Bets: 0. Collects: 0. Wins: 0.
Player L4zy_FiSh does not show cards.Bets: 0. Collects: 0. Wins: 0.
Player mr.fargo does not show cards.Bets: 0. Collects: 0. Wins: 0.
Player shokerAAss does not show cards.Bets: 1. Collects: 0. Loses: 1.
Game ended at: 2016/11/29 9:22:36

Game started
Game ID: 786795658 1/2 (PRR) Longana - 4 (Hold'em)
Seat 2 is the button
Seat 1: Iia007 (227.92).
Seat 2: IAmClueless (469.03).
Seat 3: PANDAisEVIL (382.22).
Seat 4: mr.fargo (88).
Seat 5: L4zy_FiSh (213.55).
Seat 6: IlxxxlI (83).
Seat 8: Gronkowski69 (221.10).
Seat 9: StephCurry (200).
Player PANDAisEVIL has small blind (1)
Player mr.fargo has big blind (2)
Player IlxxxlI received card: [Jc]
Player IlxxxlI received card: [As]
Player L4zy_FiSh folds
Player IlxxxlI raises (7)
Player Gronkowski69 folds
Player StephCurry folds
Player Iia007 folds
Player IAmClueless raises (24)
Player PANDAisEVIL folds
Player mr.fargo allin (86)
Player IlxxxlI folds
Player IAmClueless calls (64)
*** FLOP ***: [10s 5c Qs]
*** TURN ***: [10s 5c Qs] [Ad]
*** RIVER ***: [10s 5c Qs Ad] [Jd]
------ Summary ------
Pot: 181. Rake 2.76. JP fee 0.24
Board: [10s 5c Qs Ad Jd]
Player Iia007 does not show cards.Bets: 0. Collects: 0. Wins: 0.
Player IAmClueless shows: Three Of Kind of 10s [10h 10d]. Bets: 88. Collects: 0. Loses: 88.
Player PANDAisEVIL does not show cards.Bets: 1. Collects: 0. Loses: 1.
*Player mr.fargo shows: Straight to A [Kh Kc]. Bets: 88. Collects: 181. Wins: 93.
Player L4zy_FiSh does not show cards.Bets: 0. Collects: 0. Wins: 0.
Player IlxxxlI does not show cards.Bets: 7. Collects: 0. Loses: 7.
Player Gronkowski69 does not show cards.Bets: 0. Collects: 0. Wins: 0.
Player StephCurry does not show cards.Bets: 0. Collects: 0. Wins: 0.
Game ended at: 2016/11/29 9:23:6

Game started
Game ID: 786795525 0.25/0.50 (PRR) Gorgons - 7 (Hold'em)
Seat 2 is the button
Seat 1: 528 Hertz (50).
Seat 2: Heksebrygg (52.27).
Seat 3: Dirty4skin (55.22).
Seat 4: FaceMelt (66.23).
Seat 5: Tilt-A-Whirl (56.88).
Seat 6: IlxxxlI (22.84).
Player Dirty4skin has small blind (0.25)
Player FaceMelt has big blind (0.50)
Player IlxxxlI received card: [7d]
Player IlxxxlI received card: [7c]
Player Tilt-A-Whirl raises (1)
Player IlxxxlI folds
Player 528 Hertz folds
Player Heksebrygg folds
Player Dirty4skin folds
Player FaceMelt calls (0.50)
*** FLOP ***: [Ah Kc 3h]
Player FaceMelt checks
Player Tilt-A-Whirl bets (1.07)
Player FaceMelt folds
Uncalled bet (1.07) returned to Tilt-A-Whirl
Player Tilt-A-Whirl mucks cards
------ Summary ------
Pot: 2.14. Rake 0.09. JP fee 0.02
Board: [Ah Kc 3h]
Player 528 Hertz does not show cards.Bets: 0. Collects: 0. Wins: 0.
Player Heksebrygg does not show cards.Bets: 0. Collects: 0. Wins: 0.
Player Dirty4skin does not show cards.Bets: 0.25. Collects: 0. Loses: 0.25.
Player FaceMelt does not show cards.Bets: 1. Collects: 0. Loses: 1.
*Player Tilt-A-Whirl mucks (does not show cards). Bets: 1. Collects: 2.14. Wins: 1.14.
Player IlxxxlI does not show cards.Bets: 0. Collects: 0. Wins: 0.
Game ended at: 2016/11/29 9:22:23

Game started
Game ID: 786795458 0.25/0.50 (PRR) Garuda (Hold'em)
Seat 9 is the button
Seat 1: akbrow (21.50).
Seat 2: IlxxxlI (20).
Seat 3: Ice Bank Mice Elf (94.20).
Seat 4: Log_in (19.75).
Seat 5: Midnight0489 (48.50).
Seat 6: XxDominationxX (97.93).
Seat 7: coldkilla (62.60).
Seat 8: gunnfarm (42.50).
Seat 9: OmEGaKuSh (55.70).
Player akbrow has small blind (0.25)
Player IlxxxlI has big blind (0.50)
Player IlxxxlI received card: [5d]
Player IlxxxlI received card: [2h]
Player Ice Bank Mice Elf raises (1.25)
Player Log_in folds
Player Midnight0489 calls (1.25)
Player XxDominationxX folds
Player coldkilla raises (5)
Player gunnfarm folds
Player OmEGaKuSh folds
Player akbrow folds
Player IlxxxlI folds
Player Ice Bank Mice Elf calls (3.75)
Player Midnight0489 folds
*** FLOP ***: [9c 3s 10h]
Player Ice Bank Mice Elf checks
Player coldkilla checks
*** TURN ***: [9c 3s 10h] [7s]
Player Ice Bank Mice Elf bets (8.55)
Player coldkilla folds
Uncalled bet (8.55) returned to Ice Bank Mice Elf
Player Ice Bank Mice Elf mucks cards
------ Summary ------
Pot: 11.40. Rake 0.40. JP fee 0.20
Board: [9c 3s 10h 7s]
Player akbrow does not show cards.Bets: 0.25. Collects: 0. Loses: 0.25.
Player IlxxxlI does not show cards.Bets: 0.50. Collects: 0. Loses: 0.50.
*Player Ice Bank Mice Elf mucks (does not show cards). Bets: 5. Collects: 11.40. Wins: 6.40.
Player Log_in does not show cards.Bets: 0. Collects: 0. Wins: 0.
Player Midnight0489 does not show cards.Bets: 1.25. Collects: 0. Loses: 1.25.
Player XxDominationxX does not show cards.Bets: 0. Collects: 0. Wins: 0.
Player coldkilla does not show cards.Bets: 5. Collects: 0. Loses: 5.
Player gunnfarm does not show cards.Bets: 0. Collects: 0. Wins: 0.
Player OmEGaKuSh does not show cards.Bets: 0. Collects: 0. Wins: 0.
Game ended at: 2016/11/29 9:23:22

Game started
Game ID: 786795104 0.25/0.50 (PRR) Gorgons - 7 (Hold'em)
Seat 1 is the button
Seat 1: 528 Hertz (50).
Seat 2: Heksebrygg (52.52).
Seat 3: Dirty4skin (55.72).
Seat 4: FaceMelt (66.23).
Seat 5: Tilt-A-Whirl (56.13).
Seat 6: IlxxxlI (22.84).
Player Heksebrygg has small blind (0.25)
Player Dirty4skin has big blind (0.50)
Player IlxxxlI received card: [9c]
Player IlxxxlI received card: [Qh]
Player FaceMelt folds
Player Tilt-A-Whirl raises (1.50)
Player IlxxxlI folds
Player 528 Hertz folds
Player Heksebrygg folds
Player Dirty4skin folds
Uncalled bet (1) returned to Tilt-A-Whirl
Player Tilt-A-Whirl mucks cards
------ Summary ------
Pot: 1.25. Rake 0
Player 528 Hertz does not show cards.Bets: 0. Collects: 0. Wins: 0.
Player Heksebrygg does not show cards.Bets: 0.25. Collects: 0. Loses: 0.25.
Player Dirty4skin does not show cards.Bets: 0.50. Collects: 0. Loses: 0.50.
Player FaceMelt does not show cards.Bets: 0. Collects: 0. Wins: 0.
*Player Tilt-A-Whirl mucks (does not show cards). Bets: 0.50. Collects: 1.25. Wins: 0.75.
Player IlxxxlI does not show cards.Bets: 0. Collects: 0. Wins: 0.
Game ended at: 2016/11/29 9:21:49

Game started
Game ID: 786795027 0.25/0.50 (PRR) Garuda - 2 (Hold'em)
Seat 2 is the button
Seat 1: Tilt-A-Whirl (50.10).
Seat 2: apoo11 (30.99).
Seat 3: imperceptible (20.17).
Seat 4: Ice Bank Mice Elf (102.25).
Seat 5: tutofu84 (140.79).
Seat 6: IlxxxlI (24.07).
Seat 7: coldkilla (14.67).
Seat 8: akbrow (29.50).
Seat 9: kid4life (33.66).
Player imperceptible has small blind (0.25)
Player Ice Bank Mice Elf has big blind (0.50)
Player IlxxxlI received card: [8c]
Player IlxxxlI received card: [Kc]
Player tutofu84 folds
Player IlxxxlI folds
Player coldkilla folds
Player akbrow folds
Player kid4life raises (2)
Player Tilt-A-Whirl folds
Player apoo11 folds
Player imperceptible folds
Player Ice Bank Mice Elf folds
Uncalled bet (1.50) returned to kid4life
Player kid4life mucks cards
------ Summary ------
Pot: 1.25. Rake 0
Player Tilt-A-Whirl does not show cards.Bets: 0. Collects: 0. Wins: 0.
Player apoo11 does not show cards.Bets: 0. Collects: 0. Wins: 0.
Player imperceptible does not show cards.Bets: 0.25. Collects: 0. Loses: 0.25.
Player Ice Bank Mice Elf does not show cards.Bets: 0.50. Collects: 0. Loses: 0.50.
Player tutofu84 does not show cards.Bets: 0. Collects: 0. Wins: 0.
Player IlxxxlI does not show cards.Bets: 0. Collects: 0. Wins: 0.
Player coldkilla does not show cards.Bets: 0. Collects: 0. Wins: 0.
Player akbrow does not show cards.Bets: 0. Collects: 0. Wins: 0.
*Player kid4life mucks (does not show cards). Bets: 0.50. Collects: 1.25. Wins: 0.75.
Game ended at: 2016/11/29 9:22:14

Game started
Game ID: 786794757 1/2 (PRR) Longana - 4 (Hold'em)
Seat 1 is the button
Seat 1: Iia007 (218.92).
Seat 2: IAmClueless (470.03).
Seat 3: PANDAisEVIL (384.22).
Seat 4: mr.fargo (88).
Seat 5: L4zy_FiSh (213.55).
Seat 6: IlxxxlI (83).
Seat 8: Gronkowski69 (221.10).
Seat 9: StephCurry (200).
Player IAmClueless has small blind (1)
Player PANDAisEVIL has big blind (2)
Player IlxxxlI received card: [3s]
Player IlxxxlI received card: [Kh]
Player mr.fargo folds
Player L4zy_FiSh folds
Player IlxxxlI folds
Player Gronkowski69 folds
Player StephCurry raises (6)
Player Iia007 raises (18)
Player IAmClueless folds
Player PANDAisEVIL folds
Player StephCurry folds
Uncalled bet (12) returned to Iia007
Player Iia007 mucks cards
------ Summary ------
Pot: 15. Rake 0
*Player Iia007 mucks (does not show cards). Bets: 6. Collects: 15. Wins: 9.
Player IAmClueless does not show cards.Bets: 1. Collects: 0. Loses: 1.
Player PANDAisEVIL does not show cards.Bets: 2. Collects: 0. Loses: 2.
Player mr.fargo does not show cards.Bets: 0. Collects: 0. Wins: 0.
Player L4zy_FiSh does not show cards.Bets: 0. Collects: 0. Wins: 0.
Player IlxxxlI does not show cards.Bets: 0. Collects: 0. Wins: 0.
Player Gronkowski69 does not show cards.Bets: 0. Collects: 0. Wins: 0.
Player StephCurry does not show cards.Bets: 6. Collects: 0. Loses: 6.
Game ended at: 2016/11/29 9:21:58

Game started
Game ID: 786794496 0.25/0.50 (PRR) Gorgons - 7 (Hold'em)
Seat 6 is the button
Seat 1: 528 Hertz (50.25).
Seat 2: Heksebrygg (53.02).
Seat 3: Dirty4skin (55.72).
Seat 4: FaceMelt (65.48).
Seat 5: Tilt-A-Whirl (56.13).
Seat 6: IlxxxlI (22.84).
Player 528 Hertz has small blind (0.25)
Player Heksebrygg has big blind (0.50)
Player IlxxxlI received card: [10d]
Player IlxxxlI received card: [6c]
Player Dirty4skin folds
Player FaceMelt raises (1.50)
Player Tilt-A-Whirl folds
Player IlxxxlI folds
Player 528 Hertz folds
Player Heksebrygg folds
Uncalled bet (1) returned to FaceMelt
Player FaceMelt mucks cards
------ Summary ------
Pot: 1.25. Rake 0
Player 528 Hertz does not show cards.Bets: 0.25. Collects: 0. Loses: 0.25.
Player Heksebrygg does not show cards.Bets: 0.50. Collects: 0. Loses: 0.50.
Player Dirty4skin does not show cards.Bets: 0. Collects: 0. Wins: 0.
*Player FaceMelt mucks (does not show cards). Bets: 0.50. Collects: 1.25. Wins: 0.75.
Player Tilt-A-Whirl does not show cards.Bets: 0. Collects: 0. Wins: 0.
Player IlxxxlI does not show cards.Bets: 0. Collects: 0. Wins: 0.
Game ended at: 2016/11/29 9:21:20

Game started
Game ID: 786794394 1/2 (PRR) Longana - 4 (Hold'em)
Seat 9 is the button
Seat 1: Iia007 (219.92).
Seat 2: IAmClueless (472.03).
Seat 3: PANDAisEVIL (384.22).
Seat 4: mr.fargo (88).
Seat 5: L4zy_FiSh (210.55).
Seat 6: IlxxxlI (83).
Seat 8: Gronkowski69 (221.10).
Seat 9: StephCurry (200).
Player Iia007 has small blind (1)
Player IAmClueless has big blind (2)
Player IlxxxlI received card: [Ks]
Player IlxxxlI received card: [9s]
Player PANDAisEVIL folds
Player mr.fargo folds
Player L4zy_FiSh raises (6)
Player IlxxxlI folds
Player Gronkowski69 folds
Player StephCurry folds
Player Iia007 folds
Player IAmClueless folds
Uncalled bet (4) returned to L4zy_FiSh
Player L4zy_FiSh mucks cards
------ Summary ------
Pot: 5. Rake 0
Player Iia007 does not show cards.Bets: 1. Collects: 0. Loses: 1.
Player IAmClueless does not show cards.Bets: 2. Collects: 0. Loses: 2.
Player PANDAisEVIL does not show cards.Bets: 0. Collects: 0. Wins: 0.
Player mr.fargo does not show cards.Bets: 0. Collects: 0. Wins: 0.
*Player L4zy_FiSh mucks (does not show cards). Bets: 2. Collects: 5. Wins: 3.
Player IlxxxlI does not show cards.Bets: 0. Collects: 0. Wins: 0.
Player Gronkowski69 does not show cards.Bets: 0. Collects: 0. Wins: 0.
Player StephCurry does not show cards.Bets: 0. Collects: 0. Wins: 0.
Game ended at: 2016/11/29 9:20:59

Game started
Game ID: 786794228 0.25/0.50 (PRR) Gorgons - 7 (Hold'em)
Seat 5 is the button
Seat 1: 528 Hertz (50).
Seat 2: Heksebrygg (53.02).
Seat 3: Dirty4skin (55.72).
Seat 4: FaceMelt (65.48).
Seat 5: Tilt-A-Whirl (56.13).
Seat 6: IlxxxlI (23.09).
Player IlxxxlI has small blind (0.25)
Player 528 Hertz has big blind (0.50)
Player IlxxxlI received card: [6c]
Player IlxxxlI received card: [3h]
Player Heksebrygg folds
Player Dirty4skin folds
Player FaceMelt folds
Player Tilt-A-Whirl folds
Player IlxxxlI folds
Uncalled bet (0.25) returned to 528 Hertz
Player 528 Hertz mucks cards
------ Summary ------
Pot: 0.50. Rake 0
*Player 528 Hertz mucks (does not show cards). Bets: 0.25. Collects: 0.50. Wins: 0.25.
Player Heksebrygg does not show cards.Bets: 0. Collects: 0. Wins: 0.
Player Dirty4skin does not show cards.Bets: 0. Collects: 0. Wins: 0.
Player FaceMelt does not show cards.Bets: 0. Collects: 0. Wins: 0.
Player Tilt-A-Whirl does not show cards.Bets: 0. Collects: 0. Wins: 0.
Player IlxxxlI does not show cards.Bets: 0.25. Collects: 0. Loses: 0.25.
Game ended at: 2016/11/29 9:20:42

Game started
Game ID: 786794167 0.25/0.50 (PRR) Garuda (Hold'em)
Seat 8 is the button
Seat 1: akbrow (23).
Seat 2: IlxxxlI (20).
Seat 3: Ice Bank Mice Elf (94.20).
Seat 4: Log_in (19.75).
Seat 5: Midnight0489 (48.50).
Seat 6: XxDominationxX (96.34).
Seat 7: coldkilla (62.60).
Seat 8: gunnfarm (42.50).
Seat 9: OmEGaKuSh (55.95).
Player OmEGaKuSh has small blind (0.25)
Player akbrow has big blind (0.50)
Player IlxxxlI received card: [3h]
Player IlxxxlI received card: [6c]
Player IlxxxlI folds
Player Ice Bank Mice Elf folds
Player Log_in folds
Player Midnight0489 folds
Player XxDominationxX raises (1.50)
Player coldkilla folds
Player gunnfarm folds
Player OmEGaKuSh is timed out.
Player OmEGaKuSh folds
Player akbrow calls (1)
*** FLOP ***: [3c 5c Kc]
Player akbrow checks
Player XxDominationxX bets (1.54)
Player akbrow folds
Uncalled bet (1.54) returned to XxDominationxX
Player XxDominationxX mucks cards
------ Summary ------
Pot: 3.09. Rake 0.12. JP fee 0.04
Board: [3c 5c Kc]
Player akbrow does not show cards.Bets: 1.50. Collects: 0. Loses: 1.50.
Player IlxxxlI does not show cards.Bets: 0. Collects: 0. Wins: 0.
Player Ice Bank Mice Elf does not show cards.Bets: 0. Collects: 0. Wins: 0.
Player Log_in does not show cards.Bets: 0. Collects: 0. Wins: 0.
Player Midnight0489 does not show cards.Bets: 0. Collects: 0. Wins: 0.
*Player XxDominationxX mucks (does not show cards). Bets: 1.50. Collects: 3.09. Wins: 1.59.
Player coldkilla does not show cards.Bets: 0. Collects: 0. Wins: 0.
Player gunnfarm does not show cards.Bets: 0. Collects: 0. Wins: 0.
Player OmEGaKuSh does not show cards.Bets: 0.25. Collects: 0. Loses: 0.25.
Game ended at: 2016/11/29 9:21:45

Game started
Game ID: 786793683 1/2 (PRR) Longana - 4 (Hold'em)
Seat 8 is the button
Seat 1: Iia007 (221.92).
Seat 2: IAmClueless (472.03).
Seat 3: PANDAisEVIL (384.22).
Seat 4: mr.fargo (88).
Seat 5: L4zy_FiSh (210.55).
Seat 6: IlxxxlI (80).
Seat 8: Gronkowski69 (221.10).
Seat 9: StephCurry (200).
Player StephCurry has small blind (1)
Player Iia007 has big blind (2)
Player IlxxxlI received card: [4c]
Player IlxxxlI received card: [4h]
Player IAmClueless folds
Player PANDAisEVIL folds
Player mr.fargo folds
Player L4zy_FiSh folds
Player IlxxxlI raises (4.80)
Player Gronkowski69 folds
Player StephCurry folds
Player Iia007 folds
Uncalled bet (2.80) returned to IlxxxlI
Player IlxxxlI mucks cards
------ Summary ------
Pot: 5. Rake 0
Player Iia007 does not show cards.Bets: 2. Collects: 0. Loses: 2.
Player IAmClueless does not show cards.Bets: 0. Collects: 0. Wins: 0.
Player PANDAisEVIL does not show cards.Bets: 0. Collects: 0. Wins: 0.
Player mr.fargo does not show cards.Bets: 0. Collects: 0. Wins: 0.
Player L4zy_FiSh does not show cards.Bets: 0. Collects: 0. Wins: 0.
*Player IlxxxlI mucks (does not show cards). Bets: 2. Collects: 5. Wins: 3.
Player Gronkowski69 does not show cards.Bets: 0. Collects: 0. Wins: 0.
Player StephCurry does not show cards.Bets: 1. Collects: 0. Loses: 1.
Game ended at: 2016/11/29 9:20:36

Game started
Game ID: 786793522 0.25/0.50 (PRR) Garuda - 2 (Hold'em)
Seat 1 is the button
Seat 1: Tilt-A-Whirl (50.10).
Seat 2: apoo11 (31.24).
Seat 3: imperceptible (20.67).
Seat 4: Ice Bank Mice Elf (102.25).
Seat 5: tutofu84 (140.79).
Seat 6: IlxxxlI (22.82).
Seat 7: coldkilla (14.67).
Seat 8: akbrow (30).
Seat 9: kid4life (33.66).
Player apoo11 has small blind (0.25)
Player imperceptible has big blind (0.50)
Player akbrow posts (0.50)
Player IlxxxlI received card: [Ac]
Player IlxxxlI received card: [Qh]
Player Ice Bank Mice Elf folds
Player tutofu84 folds
Player IlxxxlI raises (2.25)
Player coldkilla folds
Player akbrow folds
Player kid4life folds
Player Tilt-A-Whirl folds
Player apoo11 folds
Player imperceptible folds
Uncalled bet (1.75) returned to IlxxxlI
Player IlxxxlI mucks cards
------ Summary ------
Pot: 1.75. Rake 0
Player Tilt-A-Whirl does not show cards.Bets: 0. Collects: 0. Wins: 0.
Player apoo11 does not show cards.Bets: 0.25. Collects: 0. Loses: 0.25.
Player imperceptible does not show cards.Bets: 0.50. Collects: 0. Loses: 0.50.
Player Ice Bank Mice Elf does not show cards.Bets: 0. Collects: 0. Wins: 0.
Player tutofu84 does not show cards.Bets: 0. Collects: 0. Wins: 0.
*Player IlxxxlI mucks (does not show cards). Bets: 0.50. Collects: 1.75. Wins: 1.25.
Player coldkilla does not show cards.Bets: 0. Collects: 0. Wins: 0.
Player akbrow does not show cards.Bets: 0.50. Collects: 0. Loses: 0.50.
Player kid4life does not show cards.Bets: 0. Collects: 0. Wins: 0.
Game ended at: 2016/11/29 9:21:16

Game started
Game ID: 786793482 0.25/0.50 (PRR) Garuda (Hold'em)
Seat 7 is the button
Seat 1: akbrow (23).
Seat 2: IlxxxlI (20).
Seat 3: Ice Bank Mice Elf (94.20).
Seat 4: Log_in (19.75).
Seat 5: Midnight0489 (49).
Seat 6: XxDominationxX (95.09).
Seat 7: coldkilla (62.60).
Seat 8: gunnfarm (42.75).
Seat 9: OmEGaKuSh (56.45).
Player gunnfarm has small blind (0.25)
Player OmEGaKuSh has big blind (0.50)
Player Midnight0489 posts (0.50)
Player IlxxxlI received card: [9s]
Player IlxxxlI received card: [5s]
Player akbrow folds
Player IlxxxlI folds
Player Ice Bank Mice Elf folds
Player Log_in folds
Player Midnight0489 checks
Player XxDominationxX raises (2)
Player coldkilla folds
Player gunnfarm folds
Player OmEGaKuSh folds
Player Midnight0489 folds
Uncalled bet (1.50) returned to XxDominationxX
Player XxDominationxX mucks cards
------ Summary ------
Pot: 1.75. Rake 0
Player akbrow does not show cards.Bets: 0. Collects: 0. Wins: 0.
Player IlxxxlI does not show cards.Bets: 0. Collects: 0. Wins: 0.
Player Ice Bank Mice Elf does not show cards.Bets: 0. Collects: 0. Wins: 0.
Player Log_in does not show cards.Bets: 0. Collects: 0. Wins: 0.
Player Midnight0489 does not show cards.Bets: 0.50. Collects: 0. Loses: 0.50.
*Player XxDominationxX mucks (does not show cards). Bets: 0.50. Collects: 1.75. Wins: 1.25.
Player coldkilla does not show cards.Bets: 0. Collects: 0. Wins: 0.
Player gunnfarm does not show cards.Bets: 0.25. Collects: 0. Loses: 0.25.
Player OmEGaKuSh does not show cards.Bets: 0.50. Collects: 0. Loses: 0.50.
Game ended at: 2016/11/29 9:20:21

Game started
Game ID: 786793223 0.25/0.50 (PRR) Gorgons - 7 (Hold'em)
Seat 4 is the button
Seat 1: 528 Hertz (50).
Seat 2: Heksebrygg (53.02).
Seat 3: Dirty4skin (55.72).
Seat 4: FaceMelt (66.98).
Seat 5: Tilt-A-Whirl (56.38).
Seat 6: IlxxxlI (21.50).
Player Tilt-A-Whirl has small blind (0.25)
Player IlxxxlI has big blind (0.50)
Player IlxxxlI received card: [As]
Player IlxxxlI received card: [5h]
Player 528 Hertz folds
Player Heksebrygg folds
Player Dirty4skin folds
Player FaceMelt raises (1.50)
Player Tilt-A-Whirl folds
Player IlxxxlI calls (1)
*** FLOP ***: [9c 2s 4h]
Player IlxxxlI checks
Player FaceMelt checks
*** TURN ***: [9c 2s 4h] [6h]
Player IlxxxlI checks
Player FaceMelt checks
*** RIVER ***: [9c 2s 4h 6h] [3d]
Player IlxxxlI bets (3)
Player FaceMelt folds
Uncalled bet (3) returned to IlxxxlI
Player IlxxxlI mucks cards
------ Summary ------
Pot: 3.09. Rake 0.12. JP fee 0.04
Board: [9c 2s 4h 6h 3d]
Player 528 Hertz does not show cards.Bets: 0. Collects: 0. Wins: 0.
Player Heksebrygg does not show cards.Bets: 0. Collects: 0. Wins: 0.
Player Dirty4skin does not show cards.Bets: 0. Collects: 0. Wins: 0.
Player FaceMelt does not show cards.Bets: 1.50. Collects: 0. Loses: 1.50.
Player Tilt-A-Whirl does not show cards.Bets: 0.25. Collects: 0. Loses: 0.25.
*Player IlxxxlI mucks (does not show cards). Bets: 1.50. Collects: 3.09. Wins: 1.59.
Game ended at: 2016/11/29 9:20:24

Game started
Game ID: 786792737 1/2 (PRR) Longana - 4 (Hold'em)
Seat 6 is the button
Seat 1: Iia007 (221.92).
Seat 2: IAmClueless (467.48).
Seat 3: PANDAisEVIL (384.22).
Seat 4: mr.fargo (88).
Seat 5: L4zy_FiSh (210.55).
Seat 6: IlxxxlI (80).
Seat 8: Gronkowski69 (222.10).
Seat 9: StephCurry (200).
Player Gronkowski69 has small blind (1)
Player StephCurry has big blind (2)
Player IlxxxlI received card: [9s]
Player IlxxxlI received card: [Kd]
Player Iia007 folds
Player IAmClueless raises (4)
Player PANDAisEVIL folds
Player mr.fargo folds
Player L4zy_FiSh folds
Player IlxxxlI folds
Player Gronkowski69 folds
Player StephCurry calls (2)
*** FLOP ***: [Ah 10c 3c]
Player StephCurry checks
Player IAmClueless bets (6)
Player StephCurry folds
Uncalled bet (6) returned to IAmClueless
Player IAmClueless mucks cards
------ Summary ------
Pot: 8.55. Rake 0.31. JP fee 0.14
Board: [Ah 10c 3c]
Player Iia007 does not show cards.Bets: 0. Collects: 0. Wins: 0.
*Player IAmClueless mucks (does not show cards). Bets: 4. Collects: 8.55. Wins: 4.55.
Player PANDAisEVIL does not show cards.Bets: 0. Collects: 0. Wins: 0.
Player mr.fargo does not show cards.Bets: 0. Collects: 0. Wins: 0.
Player L4zy_FiSh does not show cards.Bets: 0. Collects: 0. Wins: 0.
Player IlxxxlI does not show cards.Bets: 0. Collects: 0. Wins: 0.
Player Gronkowski69 does not show cards.Bets: 1. Collects: 0. Loses: 1.
Player StephCurry does not show cards.Bets: 4. Collects: 0. Loses: 4.
Game ended at: 2016/11/29 9:19:49

Game started
Game ID: 786792268 1/2 (PRR) Longana - 4 (Hold'em)
Seat 5 is the button
Seat 1: Iia007 (227.92).
Seat 2: IAmClueless (467.48).
Seat 3: PANDAisEVIL (384.22).
Seat 4: mr.fargo (88).
Seat 5: L4zy_FiSh (201.55).
Seat 6: IlxxxlI (80).
Seat 7: LazyFish (209).
Seat 8: Gronkowski69 (224.10).
Player IlxxxlI has small blind (1)
Player LazyFish sitting out
Player Gronkowski69 has big blind (2)
Player IlxxxlI received card: [10d]
Player IlxxxlI received card: [Kc]
Player Iia007 raises (6)
Player IAmClueless folds
Player PANDAisEVIL folds
Player mr.fargo folds
Player L4zy_FiSh raises (18)
Player IlxxxlI folds
Player Gronkowski69 folds
Player Iia007 folds
Uncalled bet (12) returned to L4zy_FiSh
Player L4zy_FiSh mucks cards
------ Summary ------
Pot: 15. Rake 0
Player Iia007 does not show cards.Bets: 6. Collects: 0. Loses: 6.
Player IAmClueless does not show cards.Bets: 0. Collects: 0. Wins: 0.
Player PANDAisEVIL does not show cards.Bets: 0. Collects: 0. Wins: 0.
Player mr.fargo does not show cards.Bets: 0. Collects: 0. Wins: 0.
*Player L4zy_FiSh mucks (does not show cards). Bets: 6. Collects: 15. Wins: 9.
Player IlxxxlI does not show cards.Bets: 1. Collects: 0. Loses: 1.
Player LazyFish does not show cards.Bets: 0. Collects: 0. Wins: 0.
Player Gronkowski69 does not show cards.Bets: 2. Collects: 0. Loses: 2.
Game ended at: 2016/11/29 9:18:45

Game started
Game ID: 786792208 0.25/0.50 (PRR) Gorgons - 7 (Hold'em)
Seat 3 is the button
Seat 1: 528 Hertz (50).
Seat 2: Heksebrygg (50).
Seat 3: Dirty4skin (57.22).
Seat 4: FaceMelt (67.23).
Seat 5: Tilt-A-Whirl (57.88).
Seat 6: IlxxxlI (21.50).
Player FaceMelt has small blind (0.25)
Player Tilt-A-Whirl has big blind (0.50)
Player IlxxxlI received card: [3c]
Player IlxxxlI received card: [2h]
Player IlxxxlI folds
Player 528 Hertz folds
Player Heksebrygg raises (1.50)
Player Dirty4skin calls (1.50)
Player FaceMelt folds
Player Tilt-A-Whirl calls (1)
*** FLOP ***: [Qc 10s 4s]
Player Tilt-A-Whirl checks
Player Heksebrygg checks
Player Dirty4skin checks
*** TURN ***: [Qc 10s 4s] [Qh]
Player Tilt-A-Whirl checks
Player Heksebrygg bets (3.01)
Player Dirty4skin folds
Player Tilt-A-Whirl folds
Uncalled bet (3.01) returned to Heksebrygg
Player Heksebrygg mucks cards
------ Summary ------
Pot: 4.52. Rake 0.17. JP fee 0.06
Board: [Qc 10s 4s Qh]
Player 528 Hertz does not show cards.Bets: 0. Collects: 0. Wins: 0.
*Player Heksebrygg mucks (does not show cards). Bets: 1.50. Collects: 4.52. Wins: 3.02.
Player Dirty4skin does not show cards.Bets: 1.50. Collects: 0. Loses: 1.50.
Player FaceMelt does not show cards.Bets: 0.25. Collects: 0. Loses: 0.25.
Player Tilt-A-Whirl does not show cards.Bets: 1.50. Collects: 0. Loses: 1.50.
Player IlxxxlI does not show cards.Bets: 0. Collects: 0. Wins: 0.
Game ended at: 2016/11/29 9:19:17

Game started
Game ID: 786791919 0.25/0.50 (PRR) Garuda - 2 (Hold'em)
Seat 9 is the button
Seat 1: Tilt-A-Whirl (50.35).
Seat 2: apoo11 (31.74).
Seat 3: imperceptible (20.67).
Seat 4: Ice Bank Mice Elf (102.25).
Seat 5: tutofu84 (141.79).
Seat 6: IlxxxlI (22.82).
Seat 7: coldkilla (10.75).
Seat 9: kid4life (36.16).
Player Tilt-A-Whirl has small blind (0.25)
Player apoo11 has big blind (0.50)
Player IlxxxlI received card: [4h]
Player IlxxxlI received card: [Ah]
Player imperceptible folds
Player Ice Bank Mice Elf folds
Player tutofu84 raises (1)
Player IlxxxlI folds
Player coldkilla calls (1)
Player kid4life raises (2.50)
Player Tilt-A-Whirl folds
Player apoo11 folds
Player tutofu84 folds
Player coldkilla calls (1.50)
*** FLOP ***: [7c Qc 7d]
Player coldkilla bets (3.21)
Player kid4life is timed out.
Player kid4life folds
Uncalled bet (3.21) returned to coldkilla
Player coldkilla mucks cards
------ Summary ------
Pot: 6.42. Rake 0.23. JP fee 0.10
Board: [7c Qc 7d]
Player Tilt-A-Whirl does not show cards.Bets: 0.25. Collects: 0. Loses: 0.25.
Player apoo11 does not show cards.Bets: 0.50. Collects: 0. Loses: 0.50.
Player imperceptible does not show cards.Bets: 0. Collects: 0. Wins: 0.
Player Ice Bank Mice Elf does not show cards.Bets: 0. Collects: 0. Wins: 0.
Player tutofu84 does not show cards.Bets: 1. Collects: 0. Loses: 1.
Player IlxxxlI does not show cards.Bets: 0. Collects: 0. Wins: 0.
*Player coldkilla mucks (does not show cards). Bets: 2.50. Collects: 6.42. Wins: 3.92.
Player kid4life does not show cards.Bets: 2.50. Collects: 0. Loses: 2.50.
Game ended at: 2016/11/29 9:19:38

Game started
Game ID: 786791654 0.25/0.50 (PRR) Garuda - 3 (Hold'em)
Seat 7 is the button
Seat 1: IlxxxlI (38.48).
Seat 2: Ice Bank Mice Elf (84.98).
Seat 3: tutofu84 (108.87).
Seat 4: imperceptible (21.71).
Seat 6: kid4life (171.11).
Seat 7: Tilt-A-Whirl (50.81).
Seat 8: EasyQQ (78.77).
Seat 9: coldkilla (20).
Player EasyQQ has small blind (0.25)
Player coldkilla has big blind (0.50)
Player IlxxxlI received card: [5c]
Player IlxxxlI received card: [2c]
Player IlxxxlI folds
Player Ice Bank Mice Elf folds
Player tutofu84 folds
Player imperceptible folds
Player kid4life folds
Player Tilt-A-Whirl folds
Player EasyQQ calls (0.25)
Player coldkilla checks
*** FLOP ***: [4d 2s 9d]
Player EasyQQ bets (0.63)
Player coldkilla raises (1.89)
Player EasyQQ calls (1.26)
*** TURN ***: [4d 2s 9d] [10c]
Player EasyQQ bets (3.03)
Player coldkilla allin (17.61)
Player EasyQQ folds
Uncalled bet (14.58) returned to coldkilla
Player coldkilla mucks cards
------ Summary ------
Pot: 10.30. Rake 0.36. JP fee 0.18
Board: [4d 2s 9d 10c]
Player IlxxxlI does not show cards.Bets: 0. Collects: 0. Wins: 0.
Player Ice Bank Mice Elf does not show cards.Bets: 0. Collects: 0. Wins: 0.
Player tutofu84 does not show cards.Bets: 0. Collects: 0. Wins: 0.
Player imperceptible does not show cards.Bets: 0. Collects: 0. Wins: 0.
Player kid4life does not show cards.Bets: 0. Collects: 0. Wins: 0.
Player Tilt-A-Whirl does not show cards.Bets: 0. Collects: 0. Wins: 0.
Player EasyQQ does not show cards.Bets: 5.42. Collects: 0. Loses: 5.42.
*Player coldkilla mucks (does not show cards). Bets: 5.42. Collects: 10.30. Wins: 4.88.
Game ended at: 2016/11/29 9:19:43

Game started
Game ID: 786791554 1/2 (PRR) Longana - 4 (Hold'em)
Seat 4 is the button
Seat 1: Iia007 (227.92).
Seat 2: IAmClueless (467.48).
Seat 3: PANDAisEVIL (389.22).
Seat 4: mr.fargo (80).
Seat 5: L4zy_FiSh (202.55).
Seat 6: IlxxxlI (80).
Seat 7: LazyFish (209).
Seat 8: Gronkowski69 (224.10).
Player L4zy_FiSh has small blind (1)
Player IlxxxlI has big blind (2)
Player IlxxxlI received card: [6h]
Player IlxxxlI received card: [5h]
Player LazyFish folds
Player Gronkowski69 folds
Player Iia007 folds
Player IAmClueless folds
Player PANDAisEVIL raises (5)
Player mr.fargo raises (14)
Player L4zy_FiSh folds
Player IlxxxlI folds
Player PANDAisEVIL folds
Uncalled bet (9) returned to mr.fargo
Player mr.fargo mucks cards
------ Summary ------
Pot: 13. Rake 0
Player Iia007 does not show cards.Bets: 0. Collects: 0. Wins: 0.
Player IAmClueless does not show cards.Bets: 0. Collects: 0. Wins: 0.
Player PANDAisEVIL does not show cards.Bets: 5. Collects: 0. Loses: 5.
*Player mr.fargo mucks (does not show cards). Bets: 5. Collects: 13. Wins: 8.
Player L4zy_FiSh does not show cards.Bets: 1. Collects: 0. Loses: 1.
Player IlxxxlI does not show cards.Bets: 2. Collects: 0. Loses: 2.
Player LazyFish does not show cards.Bets: 0. Collects: 0. Wins: 0.
Player Gronkowski69 does not show cards.Bets: 0. Collects: 0. Wins: 0.
Game ended at: 2016/11/29 9:18:15

Game started
Game ID: 786791440 0.25/0.50 (PRR) Gorgons - 7 (Hold'em)
Seat 2 is the button
Seat 1: 528 Hertz (50).
Seat 2: Heksebrygg (50).
Seat 3: Dirty4skin (57.47).
Seat 4: FaceMelt (65.98).
Seat 5: Tilt-A-Whirl (58.88).
Seat 6: IlxxxlI (21.50).
Player Dirty4skin has small blind (0.25)
Player FaceMelt has big blind (0.50)
Player IlxxxlI received card: [3d]
Player IlxxxlI received card: [8d]
Player Tilt-A-Whirl raises (1)
Player IlxxxlI folds
Player 528 Hertz folds
Player Heksebrygg folds
Player Dirty4skin folds
Player FaceMelt raises (4)
Player Tilt-A-Whirl folds
Uncalled bet (3.50) returned to FaceMelt
Player FaceMelt mucks cards
------ Summary ------
Pot: 2.25. Rake 0
Player 528 Hertz does not show cards.Bets: 0. Collects: 0. Wins: 0.
Player Heksebrygg does not show cards.Bets: 0. Collects: 0. Wins: 0.
Player Dirty4skin does not show cards.Bets: 0.25. Collects: 0. Loses: 0.25.
*Player FaceMelt mucks (does not show cards). Bets: 1. Collects: 2.25. Wins: 1.25.
Player Tilt-A-Whirl does not show cards.Bets: 1. Collects: 0. Loses: 1.
Player IlxxxlI does not show cards.Bets: 0. Collects: 0. Wins: 0.
Game ended at: 2016/11/29 9:18:10

Game started
Game ID: 786791143 0.25/0.50 (PRR) Garuda (Hold'em)
Seat 6 is the button
Seat 1: akbrow (27.50).
Seat 2: IlxxxlI (20).
Seat 3: Ice Bank Mice Elf (94.20).
Seat 4: Log_in (19.75).
Seat 6: XxDominationxX (95.09).
Seat 7: coldkilla (54.27).
Seat 8: gunnfarm (47.25).
Seat 9: OmEGaKuSh (56.45).
Player coldkilla has small blind (0.25)
Player gunnfarm has big blind (0.50)
Player IlxxxlI received card: [Ad]
Player IlxxxlI received card: [3s]
Player OmEGaKuSh folds
Player akbrow raises (1.50)
Player IlxxxlI folds
Player Ice Bank Mice Elf folds
Player Log_in folds
Player XxDominationxX folds
Player coldkilla calls (1.25)
Player gunnfarm raises (4)
Player akbrow calls (3)
Player coldkilla calls (3)
*** FLOP ***: [3h 6d Kc]
Player coldkilla checks
Player gunnfarm checks
Player akbrow checks
*** TURN ***: [3h 6d Kc] [5h]
Player coldkilla bets (8.55)
Player gunnfarm folds
Player akbrow folds
Uncalled bet (8.55) returned to coldkilla
Player coldkilla mucks cards
------ Summary ------
Pot: 12.83. Rake 0.45. JP fee 0.22
Board: [3h 6d Kc 5h]
Player akbrow does not show cards.Bets: 4.50. Collects: 0. Loses: 4.50.
Player IlxxxlI does not show cards.Bets: 0. Collects: 0. Wins: 0.
Player Ice Bank Mice Elf does not show cards.Bets: 0. Collects: 0. Wins: 0.
Player Log_in does not show cards.Bets: 0. Collects: 0. Wins: 0.
Player XxDominationxX does not show cards.Bets: 0. Collects: 0. Wins: 0.
*Player coldkilla mucks (does not show cards). Bets: 4.50. Collects: 12.83. Wins: 8.33.
Player gunnfarm does not show cards.Bets: 4.50. Collects: 0. Loses: 4.50.
Player OmEGaKuSh does not show cards.Bets: 0. Collects: 0. Wins: 0.
Game ended at: 2016/11/29 9:19:35

Game started
Game ID: 786791045 0.25/0.50 (PRR) Gorgons - 7 (Hold'em)
Seat 1 is the button
Seat 1: 528 Hertz (50).
Seat 2: Heksebrygg (50).
Seat 3: Dirty4skin (57.97).
Seat 4: FaceMelt (65.98).
Seat 5: Tilt-A-Whirl (58.88).
Seat 6: IlxxxlI (20.75).
Player Heksebrygg has small blind (0.25)
Player Dirty4skin has big blind (0.50)
Player IlxxxlI received card: [10c]
Player IlxxxlI received card: [Ah]
Player FaceMelt folds
Player Tilt-A-Whirl folds
Player IlxxxlI raises (1.20)
Player 528 Hertz folds
Player Heksebrygg folds
Player Dirty4skin folds
Uncalled bet (0.70) returned to IlxxxlI
Player IlxxxlI mucks cards
------ Summary ------
Pot: 1.25. Rake 0
Player 528 Hertz does not show cards.Bets: 0. Collects: 0. Wins: 0.
Player Heksebrygg does not show cards.Bets: 0.25. Collects: 0. Loses: 0.25.
Player Dirty4skin does not show cards.Bets: 0.50. Collects: 0. Loses: 0.50.
Player FaceMelt does not show cards.Bets: 0. Collects: 0. Wins: 0.
Player Tilt-A-Whirl does not show cards.Bets: 0. Collects: 0. Wins: 0.
*Player IlxxxlI mucks (does not show cards). Bets: 0.50. Collects: 1.25. Wins: 0.75.
Game ended at: 2016/11/29 9:17:21

Game started
Game ID: 786791017 1/2 (PRR) Longana - 4 (Hold'em)
Seat 3 is the button
Seat 1: Iia007 (227.92).
Seat 2: IAmClueless (467.48).
Seat 3: PANDAisEVIL (389.22).
Seat 4: mr.fargo (80).
Seat 5: L4zy_FiSh (204.55).
Seat 6: IlxxxlI (80).
Seat 7: LazyFish (206).
Seat 8: Gronkowski69 (224.10).
Player mr.fargo has small blind (1)
Player L4zy_FiSh has big blind (2)
Player IlxxxlI received card: [6d]
Player IlxxxlI received card: [2h]
Player IlxxxlI folds
Player LazyFish raises (6)
Player Gronkowski69 folds
Player Iia007 folds
Player IAmClueless folds
Player PANDAisEVIL folds
Player mr.fargo folds
Player L4zy_FiSh folds
Uncalled bet (4) returned to LazyFish
Player LazyFish mucks cards
------ Summary ------
Pot: 5. Rake 0
Player Iia007 does not show cards.Bets: 0. Collects: 0. Wins: 0.
Player IAmClueless does not show cards.Bets: 0. Collects: 0. Wins: 0.
Player PANDAisEVIL does not show cards.Bets: 0. Collects: 0. Wins: 0.
Player mr.fargo does not show cards.Bets: 1. Collects: 0. Loses: 1.
Player L4zy_FiSh does not show cards.Bets: 2. Collects: 0. Loses: 2.
Player IlxxxlI does not show cards.Bets: 0. Collects: 0. Wins: 0.
*Player LazyFish mucks (does not show cards). Bets: 2. Collects: 5. Wins: 3.
Player Gronkowski69 does not show cards.Bets: 0. Collects: 0. Wins: 0.
Game ended at: 2016/11/29 9:17:28

Game started
Game ID: 786790692 1/2 (PRR) Longana - 4 (Hold'em)
Seat 2 is the button
Seat 1: Iia007 (227.92).
Seat 2: IAmClueless (464.48).
Seat 3: PANDAisEVIL (390.22).
Seat 4: mr.fargo (80).
Seat 5: L4zy_FiSh (204.55).
Seat 6: IlxxxlI (80).
Seat 7: LazyFish (206).
Seat 8: Gronkowski69 (224.10).
Player PANDAisEVIL has small blind (1)
Player mr.fargo has big blind (2)
Player IlxxxlI received card: [10c]
Player IlxxxlI received card: [7s]
Player L4zy_FiSh folds
Player IlxxxlI folds
Player LazyFish folds
Player Gronkowski69 folds
Player Iia007 folds
Player IAmClueless raises (4)
Player PANDAisEVIL folds
Player mr.fargo folds
Uncalled bet (2) returned to IAmClueless
Player IAmClueless mucks cards
------ Summary ------
Pot: 5. Rake 0
Player Iia007 does not show cards.Bets: 0. Collects: 0. Wins: 0.
*Player IAmClueless mucks (does not show cards). Bets: 2. Collects: 5. Wins: 3.
Player PANDAisEVIL does not show cards.Bets: 1. Collects: 0. Loses: 1.
Player mr.fargo does not show cards.Bets: 2. Collects: 0. Loses: 2.
Player L4zy_FiSh does not show cards.Bets: 0. Collects: 0. Wins: 0.
Player IlxxxlI does not show cards.Bets: 0. Collects: 0. Wins: 0.
Player LazyFish does not show cards.Bets: 0. Collects: 0. Wins: 0.
Player Gronkowski69 does not show cards.Bets: 0. Collects: 0. Wins: 0.
Game ended at: 2016/11/29 9:16:55

Game started
Game ID: 786790460 0.25/0.50 (PRR) Gorgons - 7 (Hold'em)
Seat 6 is the button
Seat 1: 528 Hertz (50).
Seat 2: Heksebrygg (50).
Seat 3: Dirty4skin (57.97).
Seat 4: FaceMelt (65.98).
Seat 5: Tilt-A-Whirl (58.88).
Seat 6: IlxxxlI (20).
Player 528 Hertz has small blind (0.25)
Player Heksebrygg has big blind (0.50)
Player IlxxxlI received card: [Qd]
Player IlxxxlI received card: [Ks]
Player Dirty4skin folds
Player FaceMelt folds
Player Tilt-A-Whirl folds
Player IlxxxlI raises (1.50)
Player 528 Hertz folds
Player Heksebrygg folds
Uncalled bet (1) returned to IlxxxlI
Player IlxxxlI mucks cards
------ Summary ------
Pot: 1.25. Rake 0
Player 528 Hertz does not show cards.Bets: 0.25. Collects: 0. Loses: 0.25.
Player Heksebrygg does not show cards.Bets: 0.50. Collects: 0. Loses: 0.50.
Player Dirty4skin does not show cards.Bets: 0. Collects: 0. Wins: 0.
Player FaceMelt does not show cards.Bets: 0. Collects: 0. Wins: 0.
Player Tilt-A-Whirl does not show cards.Bets: 0. Collects: 0. Wins: 0.
*Player IlxxxlI mucks (does not show cards). Bets: 0.50. Collects: 1.25. Wins: 0.75.
Game ended at: 2016/11/29 9:16:57

Game started
Game ID: 786790287 1/2 (PRR) Longana - 4 (Hold'em)
Seat 1 is the button
Seat 1: Iia007 (227.92).
Seat 2: IAmClueless (465.48).
Seat 3: PANDAisEVIL (392.22).
Seat 4: mr.fargo (80).
Seat 5: L4zy_FiSh (204.55).
Seat 6: IlxxxlI (80).
Seat 7: LazyFish (203).
Seat 8: Gronkowski69 (224.10).
Player IAmClueless has small blind (1)
Player PANDAisEVIL has big blind (2)
Player IlxxxlI received card: [7d]
Player IlxxxlI received card: [6s]
Player mr.fargo folds
Player L4zy_FiSh folds
Player IlxxxlI folds
Player LazyFish raises (6)
Player Gronkowski69 folds
Player Iia007 folds
Player IAmClueless folds
Player PANDAisEVIL folds
Uncalled bet (4) returned to LazyFish
Player LazyFish mucks cards
------ Summary ------
Pot: 5. Rake 0
Player Iia007 does not show cards.Bets: 0. Collects: 0. Wins: 0.
Player IAmClueless does not show cards.Bets: 1. Collects: 0. Loses: 1.
Player PANDAisEVIL does not show cards.Bets: 2. Collects: 0. Loses: 2.
Player mr.fargo does not show cards.Bets: 0. Collects: 0. Wins: 0.
Player L4zy_FiSh does not show cards.Bets: 0. Collects: 0. Wins: 0.
Player IlxxxlI does not show cards.Bets: 0. Collects: 0. Wins: 0.
*Player LazyFish mucks (does not show cards). Bets: 2. Collects: 5. Wins: 3.
Player Gronkowski69 does not show cards.Bets: 0. Collects: 0. Wins: 0.
Game ended at: 2016/11/29 9:16:32

Game started
Game ID: 786790011 0.25/0.50 (PRR) Gorgons - 7 (Hold'em)
Seat 5 is the button
Seat 1: 528 Hertz (50).
Seat 2: Heksebrygg (50).
Seat 3: Dirty4skin (57.97).
Seat 4: FaceMelt (65.98).
Seat 5: Tilt-A-Whirl (58.13).
Seat 6: IlxxxlI (20).
Player IlxxxlI has small blind (0.25)
Player 528 Hertz has big blind (0.50)
Player IlxxxlI received card: [7h]
Player IlxxxlI received card: [10s]
Player Heksebrygg folds
Player Dirty4skin folds
Player FaceMelt folds
Player Tilt-A-Whirl raises (1.50)
Player IlxxxlI folds
Player 528 Hertz folds
Uncalled bet (1) returned to Tilt-A-Whirl
Player Tilt-A-Whirl mucks cards
------ Summary ------
Pot: 1.25. Rake 0
Player 528 Hertz does not show cards.Bets: 0.50. Collects: 0. Loses: 0.50.
Player Heksebrygg does not show cards.Bets: 0. Collects: 0. Wins: 0.
Player Dirty4skin does not show cards.Bets: 0. Collects: 0. Wins: 0.
Player FaceMelt does not show cards.Bets: 0. Collects: 0. Wins: 0.
*Player Tilt-A-Whirl mucks (does not show cards). Bets: 0.50. Collects: 1.25. Wins: 0.75.
Player IlxxxlI does not show cards.Bets: 0.25. Collects: 0. Loses: 0.25.
Game ended at: 2016/11/29 9:16:16

Game started
Game ID: 786789954 0.25/0.50 (PRR) Garuda (Hold'em)
Seat 4 is the button
Seat 1: akbrow (27.50).
Seat 2: IlxxxlI (20).
Seat 3: Ice Bank Mice Elf (94.20).
Seat 4: Log_in (19.75).
Seat 6: XxDominationxX (97.09).
Seat 7: coldkilla (54.77).
Seat 8: gunnfarm (47.25).
Seat 9: OmEGaKuSh (54.17).
Player XxDominationxX has small blind (0.25)
Player coldkilla has big blind (0.50)
Player IlxxxlI received card: [4c]
Player IlxxxlI received card: [7d]
Player gunnfarm folds
Player OmEGaKuSh calls (0.50)
Player akbrow folds
Player IlxxxlI folds
Player Ice Bank Mice Elf folds
Player Log_in folds
Player XxDominationxX raises (1.75)
Player coldkilla folds
Player OmEGaKuSh calls (1.50)
*** FLOP ***: [4h Jh 2d]
Player XxDominationxX checks
Player OmEGaKuSh checks
*** TURN ***: [4h Jh 2d] [Kc]
Player XxDominationxX checks
Player OmEGaKuSh checks
*** RIVER ***: [4h Jh 2d Kc] [9h]
Player XxDominationxX checks
Player OmEGaKuSh bets (2.14)
Player XxDominationxX folds
Uncalled bet (2.14) returned to OmEGaKuSh
Player OmEGaKuSh mucks cards
------ Summary ------
Pot: 4.28. Rake 0.16. JP fee 0.06
Board: [4h Jh 2d Kc 9h]
Player akbrow does not show cards.Bets: 0. Collects: 0. Wins: 0.
Player IlxxxlI does not show cards.Bets: 0. Collects: 0. Wins: 0.
Player Ice Bank Mice Elf does not show cards.Bets: 0. Collects: 0. Wins: 0.
Player Log_in does not show cards.Bets: 0. Collects: 0. Wins: 0.
Player XxDominationxX does not show cards.Bets: 2. Collects: 0. Loses: 2.
Player coldkilla does not show cards.Bets: 0.50. Collects: 0. Loses: 0.50.
Player gunnfarm does not show cards.Bets: 0. Collects: 0. Wins: 0.
*Player OmEGaKuSh mucks (does not show cards). Bets: 2. Collects: 4.28. Wins: 2.28.
Game ended at: 2016/11/29 9:17:3

Game started
Game ID: 786789898 1/2 (PRR) Longana - 4 (Hold'em)
Seat 8 is the button
Seat 1: Iia007 (228.92).
Seat 2: IAmClueless (467.48).
Seat 3: PANDAisEVIL (392.22).
Seat 4: mr.fargo (80).
Seat 5: L4zy_FiSh (204.55).
Seat 6: IlxxxlI (80).
Seat 7: LazyFish (200).
Seat 8: Gronkowski69 (224.10).
Player Iia007 has small blind (1)
Player IAmClueless has big blind (2)
Player IlxxxlI received card: [6s]
Player IlxxxlI received card: [3c]
Player PANDAisEVIL folds
Player mr.fargo folds
Player L4zy_FiSh folds
Player IlxxxlI folds
Player LazyFish raises (5)
Player Gronkowski69 folds
Player Iia007 folds
Player IAmClueless folds
Uncalled bet (3) returned to LazyFish
Player LazyFish mucks cards
------ Summary ------
Pot: 5. Rake 0
Player Iia007 does not show cards.Bets: 1. Collects: 0. Loses: 1.
Player IAmClueless does not show cards.Bets: 2. Collects: 0. Loses: 2.
Player PANDAisEVIL does not show cards.Bets: 0. Collects: 0. Wins: 0.
Player mr.fargo does not show cards.Bets: 0. Collects: 0. Wins: 0.
Player L4zy_FiSh does not show cards.Bets: 0. Collects: 0. Wins: 0.
Player IlxxxlI does not show cards.Bets: 0. Collects: 0. Wins: 0.
*Player LazyFish mucks (does not show cards). Bets: 2. Collects: 5. Wins: 3.
Player Gronkowski69 does not show cards.Bets: 0. Collects: 0. Wins: 0.
Game ended at: 2016/11/29 9:16:5

Game started
Game ID: 786789509 0.25/0.50 (PRR) Garuda - 2 (Hold'em)
Seat 8 is the button
Seat 1: Tilt-A-Whirl (50.85).
Seat 2: apoo11 (31.74).
Seat 3: imperceptible (20.67).
Seat 4: Ice Bank Mice Elf (102.25).
Seat 5: tutofu84 (93.28).
Seat 6: IlxxxlI (22.82).
Seat 7: coldkilla (10.75).
Seat 8: sinnedKK (20.25).
Seat 9: kid4life (66.92).
Player kid4life has small blind (0.25)
Player Tilt-A-Whirl has big blind (0.50)
Player IlxxxlI received card: [6c]
Player IlxxxlI received card: [As]
Player apoo11 folds
Player imperceptible folds
Player Ice Bank Mice Elf folds
Player tutofu84 raises (1.50)
Player IlxxxlI folds
Player coldkilla folds
Player sinnedKK calls (1.50)
Player kid4life calls (1.25)
Player Tilt-A-Whirl folds
*** FLOP ***: [Js 2h Kh]
Player kid4life checks
Player tutofu84 checks
Player sinnedKK bets (3)
Player kid4life calls (3)
Player tutofu84 raises (9)
Player sinnedKK calls (6)
Player kid4life calls (6)
*** TURN ***: [Js 2h Kh] [7s]
Player kid4life checks
Player tutofu84 bets (20.26)
Player sinnedKK allin (9.75)
Player kid4life calls (20.26)
*** RIVER ***: [Js 2h Kh 7s] [2d]
Player kid4life checks
Player tutofu84 bets (39.63)
Player kid4life folds
Uncalled bet (39.63) returned to tutofu84
------ Summary ------
Pot: 79.27. Rake 2.76. JP fee 0.24
Board: [Js 2h Kh 7s 2d]
Player Tilt-A-Whirl does not show cards.Bets: 0.50. Collects: 0. Loses: 0.50.
Player apoo11 does not show cards.Bets: 0. Collects: 0. Wins: 0.
Player imperceptible does not show cards.Bets: 0. Collects: 0. Wins: 0.
Player Ice Bank Mice Elf does not show cards.Bets: 0. Collects: 0. Wins: 0.
*Player tutofu84 shows: Full House (K/2) [Kc Ks]. Bets: 30.76. Collects: 79.27. Wins: 48.51.
Player IlxxxlI does not show cards.Bets: 0. Collects: 0. Wins: 0.
Player coldkilla does not show cards.Bets: 0. Collects: 0. Wins: 0.
Player sinnedKK shows: One pair of 2s [Qc 10c]. Bets: 20.25. Collects: 0. Loses: 20.25.
Player kid4life does not show cards.Bets: 30.76. Collects: 0. Loses: 30.76.
Game ended at: 2016/11/29 9:17:51

Game started
Game ID: 786789480 0.25/0.50 (PRR) Garuda (Hold'em)
Seat 3 is the button
Seat 1: akbrow (27.50).
Seat 2: IlxxxlI (20).
Seat 3: Ice Bank Mice Elf (94.20).
Seat 4: Log_in (20).
Seat 6: XxDominationxX (97.59).
Seat 7: coldkilla (54.77).
Seat 8: gunnfarm (47.25).
Seat 9: OmEGaKuSh (53.42).
Player Log_in has small blind (0.25)
Player XxDominationxX has big blind (0.50)
Player IlxxxlI received card: [7c]
Player IlxxxlI received card: [4d]
Player coldkilla folds
Player gunnfarm folds
Player OmEGaKuSh raises (2)
Player akbrow folds
Player IlxxxlI folds
Player Ice Bank Mice Elf folds
Player Log_in folds
Player XxDominationxX folds
Uncalled bet (1.50) returned to OmEGaKuSh
Player OmEGaKuSh mucks cards
------ Summary ------
Pot: 1.25. Rake 0
Player akbrow does not show cards.Bets: 0. Collects: 0. Wins: 0.
Player IlxxxlI does not show cards.Bets: 0. Collects: 0. Wins: 0.
Player Ice Bank Mice Elf does not show cards.Bets: 0. Collects: 0. Wins: 0.
Player Log_in does not show cards.Bets: 0.25. Collects: 0. Loses: 0.25.
Player XxDominationxX does not show cards.Bets: 0.50. Collects: 0. Loses: 0.50.
Player coldkilla does not show cards.Bets: 0. Collects: 0. Wins: 0.
Player gunnfarm does not show cards.Bets: 0. Collects: 0. Wins: 0.
*Player OmEGaKuSh mucks (does not show cards). Bets: 0.50. Collects: 1.25. Wins: 0.75.
Game ended at: 2016/11/29 9:15:44

Game started
Game ID: 786789471 0.25/0.50 (PRR) Garuda - 3 (Hold'em)
Seat 6 is the button
Seat 1: IlxxxlI (38.48).
Seat 2: Ice Bank Mice Elf (87.48).
Seat 3: tutofu84 (108.87).
Seat 4: imperceptible (21.71).
Seat 5: HanktheGrey (22.57).
Seat 6: kid4life (171.11).
Seat 7: Tilt-A-Whirl (51.06).
Seat 8: EasyQQ (55.84).
Player Tilt-A-Whirl has small blind (0.25)
Player EasyQQ has big blind (0.50)
Player IlxxxlI received card: [10s]
Player IlxxxlI received card: [Qs]
Player IlxxxlI folds
Player Ice Bank Mice Elf raises (1.25)
Player tutofu84 folds
Player imperceptible folds
Player HanktheGrey raises (2.50)
Player kid4life folds
Player Tilt-A-Whirl folds
Player EasyQQ calls (2)
Player Ice Bank Mice Elf calls (1.25)
*** FLOP ***: [Ad 9c 6d]
Player EasyQQ bets (3.68)
Player Ice Bank Mice Elf folds
Player HanktheGrey calls (3.68)
*** TURN ***: [Ad 9c 6d] [5c]
Player EasyQQ checks
Player HanktheGrey bets (6)
Player EasyQQ calls (6)
*** RIVER ***: [Ad 9c 6d 5c] [As]
Player EasyQQ bets (12.88)
Player HanktheGrey allin (10.39)
Uncalled bet (2.49) returned to EasyQQ
------ Summary ------
Pot: 45.50. Rake 2.15. JP fee 0.24
Board: [Ad 9c 6d 5c As]
Player IlxxxlI does not show cards.Bets: 0. Collects: 0. Wins: 0.
Player Ice Bank Mice Elf does not show cards.Bets: 2.50. Collects: 0. Loses: 2.50.
Player tutofu84 does not show cards.Bets: 0. Collects: 0. Wins: 0.
Player imperceptible does not show cards.Bets: 0. Collects: 0. Wins: 0.
Player HanktheGrey shows: Two pairs. As and Qs [Qh Qc]. Bets: 22.57. Collects: 0. Loses: 22.57.
Player kid4life does not show cards.Bets: 0. Collects: 0. Wins: 0.
Player Tilt-A-Whirl does not show cards.Bets: 0.25. Collects: 0. Loses: 0.25.
*Player EasyQQ shows: Three Of Kind of As [7s Ah]. Bets: 22.57. Collects: 45.50. Wins: 22.93.
Game ended at: 2016/11/29 9:17:34

Game started
Game ID: 786789430 1/2 (PRR) Longana - 4 (Hold'em)
Seat 7 is the button
Seat 1: Iia007 (230.92).
Seat 2: IAmClueless (467.48).
Seat 3: PANDAisEVIL (392.22).
Seat 4: mr.fargo (80).
Seat 5: L4zy_FiSh (201.55).
Seat 6: IlxxxlI (80).
Seat 7: LazyFish (200).
Seat 8: Gronkowski69 (225.10).
Player Gronkowski69 has small blind (1)
Player Iia007 has big blind (2)
Player IlxxxlI received card: [3d]
Player IlxxxlI received card: [3s]
Player IAmClueless folds
Player PANDAisEVIL folds
Player mr.fargo folds
Player L4zy_FiSh raises (6)
Player IlxxxlI folds
Player LazyFish folds
Player Gronkowski69 folds
Player Iia007 folds
Uncalled bet (4) returned to L4zy_FiSh
Player L4zy_FiSh mucks cards
------ Summary ------
Pot: 5. Rake 0
Player Iia007 does not show cards.Bets: 2. Collects: 0. Loses: 2.
Player IAmClueless does not show cards.Bets: 0. Collects: 0. Wins: 0.
Player PANDAisEVIL does not show cards.Bets: 0. Collects: 0. Wins: 0.
Player mr.fargo does not show cards.Bets: 0. Collects: 0. Wins: 0.
*Player L4zy_FiSh mucks (does not show cards). Bets: 2. Collects: 5. Wins: 3.
Player IlxxxlI does not show cards.Bets: 0. Collects: 0. Wins: 0.
Player LazyFish does not show cards.Bets: 0. Collects: 0. Wins: 0.
Player Gronkowski69 does not show cards.Bets: 1. Collects: 0. Loses: 1.
Game ended at: 2016/11/29 9:15:40

Game started
Game ID: 786788732 0.25/0.50 (PRR) Gorgons - 7 (Hold'em)
Seat 4 is the button
Seat 1: 528 Hertz (50).
Seat 2: Heksebrygg (50).
Seat 3: Dirty4skin (57.97).
Seat 4: FaceMelt (53.33).
Seat 5: Tilt-A-Whirl (71.65).
Seat 6: IlxxxlI (20.13).
Player Tilt-A-Whirl has small blind (0.25)
Player IlxxxlI has big blind (0.50)
Player IlxxxlI received card: [Ah]
Player IlxxxlI received card: [2s]
Player 528 Hertz folds
Player Heksebrygg folds
Player Dirty4skin folds
Player FaceMelt raises (1.50)
Player Tilt-A-Whirl raises (4.25)
Player IlxxxlI folds
Player FaceMelt calls (3)
*** FLOP ***: [Jd 8s 7s]
Player Tilt-A-Whirl bets (4.51)
Player FaceMelt raises (9.02)
Player Tilt-A-Whirl calls (4.51)
*** TURN ***: [Jd 8s 7s] [10d]
Player Tilt-A-Whirl checks
Player FaceMelt bets (8.72)
Player Tilt-A-Whirl folds
Uncalled bet (8.72) returned to FaceMelt
Player FaceMelt mucks cards
------ Summary ------
Pot: 26.17. Rake 1.13. JP fee 0.24
Board: [Jd 8s 7s 10d]
Player 528 Hertz does not show cards.Bets: 0. Collects: 0. Wins: 0.
Player Heksebrygg does not show cards.Bets: 0. Collects: 0. Wins: 0.
Player Dirty4skin does not show cards.Bets: 0. Collects: 0. Wins: 0.
*Player FaceMelt mucks (does not show cards). Bets: 13.52. Collects: 26.17. Wins: 12.65.
Player Tilt-A-Whirl does not show cards.Bets: 13.52. Collects: 0. Loses: 13.52.
Player IlxxxlI does not show cards.Bets: 0.50. Collects: 0. Loses: 0.50.
Game ended at: 2016/11/29 9:15:47

Game started
Game ID: 786788436 0.25/0.50 (PRR) Garuda - 2 (Hold'em)
Seat 7 is the button
Seat 1: Tilt-A-Whirl (50.85).
Seat 2: apoo11 (31.74).
Seat 3: imperceptible (19.92).
Seat 4: Ice Bank Mice Elf (102.25).
Seat 5: tutofu84 (93.28).
Seat 6: IlxxxlI (22.82).
Seat 7: coldkilla (10.75).
Seat 8: sinnedKK (18).
Seat 9: kid4life (67.42).
Player sinnedKK has small blind (0.25)
Player kid4life has big blind (0.50)
Player IlxxxlI received card: [7c]
Player IlxxxlI received card: [6h]
Player Tilt-A-Whirl folds
Player apoo11 folds
Player imperceptible raises (1)
Player Ice Bank Mice Elf folds
Player tutofu84 folds
Player IlxxxlI folds
Player coldkilla folds
Player sinnedKK folds
Player kid4life folds
Uncalled bet (0.50) returned to imperceptible
Player imperceptible mucks cards
------ Summary ------
Pot: 1.25. Rake 0
Player Tilt-A-Whirl does not show cards.Bets: 0. Collects: 0. Wins: 0.
Player apoo11 does not show cards.Bets: 0. Collects: 0. Wins: 0.
*Player imperceptible mucks (does not show cards). Bets: 0.50. Collects: 1.25. Wins: 0.75.
Player Ice Bank Mice Elf does not show cards.Bets: 0. Collects: 0. Wins: 0.
Player tutofu84 does not show cards.Bets: 0. Collects: 0. Wins: 0.
Player IlxxxlI does not show cards.Bets: 0. Collects: 0. Wins: 0.
Player coldkilla does not show cards.Bets: 0. Collects: 0. Wins: 0.
Player sinnedKK does not show cards.Bets: 0.25. Collects: 0. Loses: 0.25.
Player kid4life does not show cards.Bets: 0.50. Collects: 0. Loses: 0.50.
Game ended at: 2016/11/29 9:15:15

Game started
Game ID: 786788212 0.25/0.50 (PRR) Garuda (Hold'em)
Seat 2 is the button
Seat 1: akbrow (28).
Seat 2: IlxxxlI (20).
Seat 3: Ice Bank Mice Elf (94.45).
Seat 4: Log_in (10.95).
Seat 6: XxDominationxX (97.59).
Seat 7: coldkilla (54.77).
Seat 8: gunnfarm (47.25).
Seat 9: OmEGaKuSh (52.25).
Player Ice Bank Mice Elf has small blind (0.25)
Player Log_in has big blind (0.50)
Player IlxxxlI received card: [3c]
Player IlxxxlI received card: [2d]
Player XxDominationxX folds
Player coldkilla folds
Player gunnfarm folds
Player OmEGaKuSh calls (0.50)
Player akbrow calls (0.50)
Player IlxxxlI folds
Player Ice Bank Mice Elf folds
Player Log_in checks
*** FLOP ***: [4d Qs Ks]
Player Log_in checks
Player OmEGaKuSh checks
Player akbrow checks
*** TURN ***: [4d Qs Ks] [4s]
Player Log_in checks
Player OmEGaKuSh checks
Player akbrow checks
*** RIVER ***: [4d Qs Ks 4s] [7h]
Player Log_in checks
Player OmEGaKuSh bets (1.11)
Player akbrow folds
Player Log_in folds
Uncalled bet (1.11) returned to OmEGaKuSh
Player OmEGaKuSh mucks cards
------ Summary ------
Pot: 1.67. Rake 0.06. JP fee 0.02
Board: [4d Qs Ks 4s 7h]
Player akbrow does not show cards.Bets: 0.50. Collects: 0. Loses: 0.50.
Player IlxxxlI does not show cards.Bets: 0. Collects: 0. Wins: 0.
Player Ice Bank Mice Elf does not show cards.Bets: 0.25. Collects: 0. Loses: 0.25.
Player Log_in does not show cards.Bets: 0.50. Collects: 0. Loses: 0.50.
Player XxDominationxX does not show cards.Bets: 0. Collects: 0. Wins: 0.
Player coldkilla does not show cards.Bets: 0. Collects: 0. Wins: 0.
Player gunnfarm does not show cards.Bets: 0. Collects: 0. Wins: 0.
*Player OmEGaKuSh mucks (does not show cards). Bets: 0.50. Collects: 1.67. Wins: 1.17.
Game ended at: 2016/11/29 9:15:13

Game started
Game ID: 786788165 0.25/0.50 (PRR) Garuda - 3 (Hold'em)
Seat 5 is the button
Seat 1: IlxxxlI (38.48).
Seat 2: Ice Bank Mice Elf (87.48).
Seat 3: tutofu84 (108.87).
Seat 4: imperceptible (21.71).
Seat 5: HanktheGrey (27.08).
Seat 6: kid4life (171.36).
Seat 7: Tilt-A-Whirl (52.56).
Seat 8: EasyQQ (50.11).
Player kid4life has small blind (0.25)
Player Tilt-A-Whirl has big blind (0.50)
Player IlxxxlI received card: [9h]
Player IlxxxlI received card: [6c]
Player EasyQQ raises (1.50)
Player IlxxxlI folds
Player Ice Bank Mice Elf folds
Player tutofu84 folds
Player imperceptible folds
Player HanktheGrey calls (1.50)
Player kid4life folds
Player Tilt-A-Whirl calls (1)
*** FLOP ***: [Jd 4s 3s]
Player Tilt-A-Whirl checks
Player EasyQQ bets (3.01)
Player HanktheGrey calls (3.01)
Player Tilt-A-Whirl folds
*** TURN ***: [Jd 4s 3s] [2d]
Player EasyQQ bets (6.82)
Player HanktheGrey folds
Uncalled bet (6.82) returned to EasyQQ
Player EasyQQ mucks cards
------ Summary ------
Pot: 10.24. Rake 0.37. JP fee 0.16
Board: [Jd 4s 3s 2d]
Player IlxxxlI does not show cards.Bets: 0. Collects: 0. Wins: 0.
Player Ice Bank Mice Elf does not show cards.Bets: 0. Collects: 0. Wins: 0.
Player tutofu84 does not show cards.Bets: 0. Collects: 0. Wins: 0.
Player imperceptible does not show cards.Bets: 0. Collects: 0. Wins: 0.
Player HanktheGrey does not show cards.Bets: 4.51. Collects: 0. Loses: 4.51.
Player kid4life does not show cards.Bets: 0.25. Collects: 0. Loses: 0.25.
Player Tilt-A-Whirl does not show cards.Bets: 1.50. Collects: 0. Loses: 1.50.
*Player EasyQQ mucks (does not show cards). Bets: 4.51. Collects: 10.24. Wins: 5.73.
Game ended at: 2016/11/29 9:15:12

Game started
Game ID: 786788164 1/2 (PRR) Longana - 4 (Hold'em)
Seat 6 is the button
Seat 1: Iia007 (230.92).
Seat 2: IAmClueless (467.48).
Seat 3: PANDAisEVIL (340.97).
Seat 4: mr.fargo (80).
Seat 5: L4zy_FiSh (201.55).
Seat 6: IlxxxlI (80).
Seat 7: LazyFish (200).
Seat 8: Gronkowski69 (227.10).
Seat 9: pokerforfun1 (44.25).
Player LazyFish has small blind (1)
Player Gronkowski69 has big blind (2)
Player IlxxxlI received card: [6h]
Player IlxxxlI received card: [Qd]
Player pokerforfun1 calls (2)
Player Iia007 folds
Player IAmClueless folds
Player PANDAisEVIL raises (7)
Player mr.fargo calls (7)
Player L4zy_FiSh folds
Player IlxxxlI folds
Player LazyFish folds
Player Gronkowski69 folds
Player pokerforfun1 calls (5)
*** FLOP ***: [Kh 8d 10s]
Player pokerforfun1 checks
Player PANDAisEVIL bets (11.40)
Player mr.fargo folds
Player pokerforfun1 calls (11.40)
*** TURN ***: [Kh 8d 10s] [2s]
Player pokerforfun1 checks
Player PANDAisEVIL bets (27.57)
Player pokerforfun1 allin (25.85)
Uncalled bet (1.72) returned to PANDAisEVIL
*** RIVER ***: [Kh 8d 10s 2s] [2h]
------ Summary ------
Pot: 95.50. Rake 2.76. JP fee 0.24
Board: [Kh 8d 10s 2s 2h]
Player Iia007 does not show cards.Bets: 0. Collects: 0. Wins: 0.
Player IAmClueless does not show cards.Bets: 0. Collects: 0. Wins: 0.
*Player PANDAisEVIL shows: Two pairs. Ks and 2s (kicker A) [Ks Ah]. Bets: 44.25. Collects: 95.50. Wins: 51.25.
Player mr.fargo does not show cards.Bets: 7. Collects: 0. Loses: 7.
Player L4zy_FiSh does not show cards.Bets: 0. Collects: 0. Wins: 0.
Player IlxxxlI does not show cards.Bets: 0. Collects: 0. Wins: 0.
Player LazyFish does not show cards.Bets: 1. Collects: 0. Loses: 1.
Player Gronkowski69 does not show cards.Bets: 2. Collects: 0. Loses: 2.
Player pokerforfun1 shows: Two pairs. Ks and 2s [Kd Jd]. Bets: 44.25. Collects: 0. Loses: 44.25.
Game ended at: 2016/11/29 9:15:7

Game started
Game ID: 786787415 0.25/0.50 (PRR) Garuda - 2 (Hold'em)
Seat 6 is the button
Seat 1: Tilt-A-Whirl (50.85).
Seat 2: apoo11 (31.74).
Seat 3: imperceptible (19.92).
Seat 4: Ice Bank Mice Elf (102.25).
Seat 5: tutofu84 (93.28).
Seat 6: IlxxxlI (22.82).
Seat 7: coldkilla (11).
Seat 8: sinnedKK (20).
Seat 9: kid4life (65.38).
Player coldkilla has small blind (0.25)
Player sinnedKK has big blind (0.50)
Player IlxxxlI received card: [9s]
Player IlxxxlI received card: [3c]
Player kid4life raises (2)
Player Tilt-A-Whirl folds
Player apoo11 folds
Player imperceptible folds
Player Ice Bank Mice Elf folds
Player tutofu84 folds
Player IlxxxlI folds
Player coldkilla folds
Player sinnedKK calls (1.50)
*** FLOP ***: [2d Qs 4h]
Player sinnedKK checks
Player kid4life bets (2.02)
Player sinnedKK folds
Uncalled bet (2.02) returned to kid4life
Player kid4life mucks cards
------ Summary ------
Pot: 4.04. Rake 0.15. JP fee 0.06
Board: [2d Qs 4h]
Player Tilt-A-Whirl does not show cards.Bets: 0. Collects: 0. Wins: 0.
Player apoo11 does not show cards.Bets: 0. Collects: 0. Wins: 0.
Player imperceptible does not show cards.Bets: 0. Collects: 0. Wins: 0.
Player Ice Bank Mice Elf does not show cards.Bets: 0. Collects: 0. Wins: 0.
Player tutofu84 does not show cards.Bets: 0. Collects: 0. Wins: 0.
Player IlxxxlI does not show cards.Bets: 0. Collects: 0. Wins: 0.
Player coldkilla does not show cards.Bets: 0.25. Collects: 0. Loses: 0.25.
Player sinnedKK does not show cards.Bets: 2. Collects: 0. Loses: 2.
*Player kid4life mucks (does not show cards). Bets: 2. Collects: 4.04. Wins: 2.04.
Game ended at: 2016/11/29 9:14:2

Game started
Game ID: 786787353 0.25/0.50 (PRR) Gorgons - 7 (Hold'em)
Seat 3 is the button
Seat 1: 528 Hertz (50).
Seat 2: Heksebrygg (50).
Seat 3: Dirty4skin (57.97).
Seat 4: FaceMelt (50).
Seat 5: Tilt-A-Whirl (75.34).
Seat 6: IlxxxlI (20.13).
Player FaceMelt has small blind (0.25)
Player Tilt-A-Whirl has big blind (0.50)
Player IlxxxlI received card: [10s]
Player IlxxxlI received card: [8c]
Player IlxxxlI folds
Player 528 Hertz folds
Player Heksebrygg folds
Player Dirty4skin folds
Player FaceMelt calls (0.25)
Player Tilt-A-Whirl checks
*** FLOP ***: [5h 3d 7d]
Player FaceMelt bets (0.50)
Player Tilt-A-Whirl calls (0.50)
*** TURN ***: [5h 3d 7d] [Ks]
Player FaceMelt bets (1.26)
Player Tilt-A-Whirl calls (1.26)
*** RIVER ***: [5h 3d 7d Ks] [3s]
Player FaceMelt bets (1.43)
Player Tilt-A-Whirl calls (1.43)
Player Tilt-A-Whirl mucks cards
------ Summary ------
Pot: 7.02. Rake 0.24. JP fee 0.12
Board: [5h 3d 7d Ks 3s]
Player 528 Hertz does not show cards.Bets: 0. Collects: 0. Wins: 0.
Player Heksebrygg does not show cards.Bets: 0. Collects: 0. Wins: 0.
Player Dirty4skin does not show cards.Bets: 0. Collects: 0. Wins: 0.
*Player FaceMelt shows: Two pairs. Ks and 7s [Kc 7c]. Bets: 3.69. Collects: 7.02. Wins: 3.33.
Player Tilt-A-Whirl mucks (does not show cards). Bets: 3.69. Collects: 0. Loses: 3.69.
Player IlxxxlI does not show cards.Bets: 0. Collects: 0. Wins: 0.
Game ended at: 2016/11/29 9:14:21

Game started
Game ID: 786787194 1/2 (PRR) Longana - 2 (Hold'em)
Seat 7 is the button
Seat 1: IlxxxlI (178.97).
Seat 2: Tilt-A-Whirl (200).
Seat 3: IamPhamous (291.16).
Seat 4: PANDAisEVIL (216.47).
Seat 5: Iia007 (212.24).
Seat 6: StephCurry (200).
Seat 7: L4zy_FiSh (202).
Seat 8: mr.fargo (128.51).
Seat 9: shokerAAss (227.11).
Player mr.fargo has small blind (1)
Player shokerAAss has big blind (2)
Player IlxxxlI received card: [8h]
Player IlxxxlI received card: [7c]
Player IlxxxlI folds
Player Tilt-A-Whirl raises (4)
Player IamPhamous calls (4)
Player PANDAisEVIL folds
Player Iia007 folds
Player StephCurry folds
Player L4zy_FiSh folds
Player mr.fargo folds
Player shokerAAss folds
*** FLOP ***: [10c 10s 3c]
Player Tilt-A-Whirl checks
Player IamPhamous bets (5.22)
Player Tilt-A-Whirl folds
Uncalled bet (5.22) returned to IamPhamous
Player IamPhamous mucks cards
------ Summary ------
Pot: 10.45. Rake 0.37. JP fee 0.18
Board: [10c 10s 3c]
Player IlxxxlI does not show cards.Bets: 0. Collects: 0. Wins: 0.
Player Tilt-A-Whirl does not show cards.Bets: 4. Collects: 0. Loses: 4.
*Player IamPhamous mucks (does not show cards). Bets: 4. Collects: 10.45. Wins: 6.45.
Player PANDAisEVIL does not show cards.Bets: 0. Collects: 0. Wins: 0.
Player Iia007 does not show cards.Bets: 0. Collects: 0. Wins: 0.
Player StephCurry does not show cards.Bets: 0. Collects: 0. Wins: 0.
Player L4zy_FiSh does not show cards.Bets: 0. Collects: 0. Wins: 0.
Player mr.fargo does not show cards.Bets: 1. Collects: 0. Loses: 1.
Player shokerAAss does not show cards.Bets: 2. Collects: 0. Loses: 2.
Game ended at: 2016/11/29 9:13:47

Game started
Game ID: 786787195 0.25/0.50 (PRR) Garuda (Hold'em)
Seat 1 is the button
Seat 1: akbrow (28).
Seat 2: IlxxxlI (20).
Seat 3: Ice Bank Mice Elf (94.95).
Seat 4: Log_in (10.95).
Seat 6: XxDominationxX (97.59).
Seat 7: coldkilla (54.77).
Seat 8: gunnfarm (47.25).
Seat 9: OmEGaKuSh (51.56).
Player IlxxxlI has small blind (0.25)
Player Ice Bank Mice Elf has big blind (0.50)
Player IlxxxlI received card: [9c]
Player IlxxxlI received card: [3d]
Player Log_in folds
Player XxDominationxX folds
Player coldkilla folds
Player gunnfarm folds
Player OmEGaKuSh calls (0.50)
Player akbrow folds
Player IlxxxlI folds
Player Ice Bank Mice Elf checks
*** FLOP ***: [8c 2c Qc]
Player Ice Bank Mice Elf checks
Player OmEGaKuSh checks
*** TURN ***: [8c 2c Qc] [6s]
Player Ice Bank Mice Elf checks
Player OmEGaKuSh bets (0.50)
Player Ice Bank Mice Elf folds
Uncalled bet (0.50) returned to OmEGaKuSh
Player OmEGaKuSh mucks cards
------ Summary ------
Pot: 1.19. Rake 0.04. JP fee 0.02
Board: [8c 2c Qc 6s]
Player akbrow does not show cards.Bets: 0. Collects: 0. Wins: 0.
Player IlxxxlI does not show cards.Bets: 0.25. Collects: 0. Loses: 0.25.
Player Ice Bank Mice Elf does not show cards.Bets: 0.50. Collects: 0. Loses: 0.50.
Player Log_in does not show cards.Bets: 0. Collects: 0. Wins: 0.
Player XxDominationxX does not show cards.Bets: 0. Collects: 0. Wins: 0.
Player coldkilla does not show cards.Bets: 0. Collects: 0. Wins: 0.
Player gunnfarm does not show cards.Bets: 0. Collects: 0. Wins: 0.
*Player OmEGaKuSh mucks (does not show cards). Bets: 0.50. Collects: 1.19. Wins: 0.69.
Game ended at: 2016/11/29 9:13:48

Game started
Game ID: 786787172 1/2 (PRR) Longana - 4 (Hold'em)
Seat 5 is the button
Seat 1: Iia007 (220.87).
Seat 2: IAmClueless (467.48).
Seat 3: PANDAisEVIL (340.97).
Seat 4: mr.fargo (80).
Seat 5: L4zy_FiSh (201.55).
Seat 6: IlxxxlI (80).
Seat 7: LazyFish (200).
Seat 8: Gronkowski69 (227.10).
Seat 9: pokerforfun1 (52.25).
Player IlxxxlI has small blind (1)
Player LazyFish has big blind (2)
Player IlxxxlI received card: [3d]
Player IlxxxlI received card: [Jd]
Player Gronkowski69 folds
Player pokerforfun1 calls (2)
Player Iia007 raises (8)
Player IAmClueless folds
Player PANDAisEVIL folds
Player mr.fargo folds
Player L4zy_FiSh folds
Player IlxxxlI folds
Player LazyFish folds
Player pokerforfun1 calls (6)
*** FLOP ***: [Kh 4c Ad]
Player pokerforfun1 checks
Player Iia007 bets (8)
Player pokerforfun1 folds
Uncalled bet (8) returned to Iia007
Player Iia007 mucks cards
------ Summary ------
Pot: 18.05. Rake 0.71. JP fee 0.24
Board: [Kh 4c Ad]
*Player Iia007 mucks (does not show cards). Bets: 8. Collects: 18.05. Wins: 10.05.
Player IAmClueless does not show cards.Bets: 0. Collects: 0. Wins: 0.
Player PANDAisEVIL does not show cards.Bets: 0. Collects: 0. Wins: 0.
Player mr.fargo does not show cards.Bets: 0. Collects: 0. Wins: 0.
Player L4zy_FiSh does not show cards.Bets: 0. Collects: 0. Wins: 0.
Player IlxxxlI does not show cards.Bets: 1. Collects: 0. Loses: 1.
Player LazyFish does not show cards.Bets: 2. Collects: 0. Loses: 2.
Player Gronkowski69 does not show cards.Bets: 0. Collects: 0. Wins: 0.
Player pokerforfun1 does not show cards.Bets: 8. Collects: 0. Loses: 8.
Game ended at: 2016/11/29 9:13:45

Game started
Game ID: 786786594 1/2 (PRR) Longana - 4 (Hold'em)
Seat 4 is the button
Seat 1: Iia007 (217.87).
Seat 2: IAmClueless (467.48).
Seat 3: PANDAisEVIL (340.97).
Seat 4: mr.fargo (80).
Seat 5: L4zy_FiSh (202.55).
Seat 6: IlxxxlI (80).
Seat 7: LazyFish (200).
Seat 8: Gronkowski69 (227.10).
Seat 9: pokerforfun1 (52.25).
Player L4zy_FiSh has small blind (1)
Player IlxxxlI has big blind (2)
Player IlxxxlI received card: [2d]
Player IlxxxlI received card: [As]
Player LazyFish folds
Player Gronkowski69 folds
Player pokerforfun1 folds
Player Iia007 raises (6)
Player IAmClueless folds
Player PANDAisEVIL folds
Player mr.fargo folds
Player L4zy_FiSh folds
Player IlxxxlI folds
Uncalled bet (4) returned to Iia007
Player Iia007 mucks cards
------ Summary ------
Pot: 5. Rake 0
*Player Iia007 mucks (does not show cards). Bets: 2. Collects: 5. Wins: 3.
Player IAmClueless does not show cards.Bets: 0. Collects: 0. Wins: 0.
Player PANDAisEVIL does not show cards.Bets: 0. Collects: 0. Wins: 0.
Player mr.fargo does not show cards.Bets: 0. Collects: 0. Wins: 0.
Player L4zy_FiSh does not show cards.Bets: 1. Collects: 0. Loses: 1.
Player IlxxxlI does not show cards.Bets: 2. Collects: 0. Loses: 2.
Player LazyFish does not show cards.Bets: 0. Collects: 0. Wins: 0.
Player Gronkowski69 does not show cards.Bets: 0. Collects: 0. Wins: 0.
Player pokerforfun1 does not show cards.Bets: 0. Collects: 0. Wins: 0.
Game ended at: 2016/11/29 9:12:40

Game started
Game ID: 786786577 1/2 (PRR) Longana - 2 (Hold'em)
Seat 6 is the button
Seat 1: IlxxxlI (178.97).
Seat 2: Tilt-A-Whirl (200).
Seat 3: IamPhamous (291.16).
Seat 4: PANDAisEVIL (216.47).
Seat 5: Iia007 (212.24).
Seat 6: StephCurry (200).
Seat 7: L4zy_FiSh (200).
Seat 8: mr.fargo (130.51).
Seat 9: shokerAAss (227.11).
Player L4zy_FiSh has small blind (1)
Player mr.fargo has big blind (2)
Player IlxxxlI received card: [7h]
Player IlxxxlI received card: [Ad]
Player shokerAAss folds
Player IlxxxlI folds
Player Tilt-A-Whirl folds
Player IamPhamous folds
Player PANDAisEVIL folds
Player Iia007 folds
Player StephCurry folds
Player L4zy_FiSh raises (3)
Player mr.fargo folds
Uncalled bet (2) returned to L4zy_FiSh
Player L4zy_FiSh mucks cards
------ Summary ------
Pot: 4. Rake 0
Player IlxxxlI does not show cards.Bets: 0. Collects: 0. Wins: 0.
Player Tilt-A-Whirl does not show cards.Bets: 0. Collects: 0. Wins: 0.
Player IamPhamous does not show cards.Bets: 0. Collects: 0. Wins: 0.
Player PANDAisEVIL does not show cards.Bets: 0. Collects: 0. Wins: 0.
Player Iia007 does not show cards.Bets: 0. Collects: 0. Wins: 0.
Player StephCurry does not show cards.Bets: 0. Collects: 0. Wins: 0.
*Player L4zy_FiSh mucks (does not show cards). Bets: 2. Collects: 4. Wins: 2.
Player mr.fargo does not show cards.Bets: 2. Collects: 0. Loses: 2.
Player shokerAAss does not show cards.Bets: 0. Collects: 0. Wins: 0.
Game ended at: 2016/11/29 9:12:42

Game started
Game ID: 786786274 0.25/0.50 (PRR) Garuda - 2 (Hold'em)
Seat 5 is the button
Seat 1: Tilt-A-Whirl (50.85).
Seat 2: apoo11 (31.74).
Seat 3: imperceptible (23.42).
Seat 4: Ice Bank Mice Elf (102.25).
Seat 5: tutofu84 (89.41).
Seat 6: IlxxxlI (23.07).
Seat 7: coldkilla (11.50).
Seat 9: kid4life (65.38).
Player IlxxxlI has small blind (0.25)
Player coldkilla has big blind (0.50)
Player IlxxxlI received card: [2c]
Player IlxxxlI received card: [10h]
Player kid4life folds
Player Tilt-A-Whirl folds
Player apoo11 folds
Player imperceptible raises (1)
Player Ice Bank Mice Elf folds
Player tutofu84 raises (3.50)
Player IlxxxlI folds
Player coldkilla folds
Player imperceptible calls (2.50)
*** FLOP ***: [9c 3h 3c]
Player imperceptible checks
Player tutofu84 bets (4.91)
Player imperceptible folds
Uncalled bet (4.91) returned to tutofu84
Player tutofu84 mucks cards
------ Summary ------
Pot: 7.37. Rake 0.26. JP fee 0.12
Board: [9c 3h 3c]
Player Tilt-A-Whirl does not show cards.Bets: 0. Collects: 0. Wins: 0.
Player apoo11 does not show cards.Bets: 0. Collects: 0. Wins: 0.
Player imperceptible does not show cards.Bets: 3.50. Collects: 0. Loses: 3.50.
Player Ice Bank Mice Elf does not show cards.Bets: 0. Collects: 0. Wins: 0.
*Player tutofu84 mucks (does not show cards). Bets: 3.50. Collects: 7.37. Wins: 3.87.
Player IlxxxlI does not show cards.Bets: 0.25. Collects: 0. Loses: 0.25.
Player coldkilla does not show cards.Bets: 0.50. Collects: 0. Loses: 0.50.
Player kid4life does not show cards.Bets: 0. Collects: 0. Wins: 0.
Game ended at: 2016/11/29 9:12:57

Game started
Game ID: 786786055 1/2 (PRR) Longana - 2 (Hold'em)
Seat 5 is the button
Seat 1: IlxxxlI (178.97).
Seat 2: Tilt-A-Whirl (200).
Seat 3: IamPhamous (291.16).
Seat 4: PANDAisEVIL (213.47).
Seat 5: Iia007 (212.24).
Seat 6: StephCurry (200).
Seat 7: L4zy_FiSh (202).
Seat 8: mr.fargo (130.51).
Seat 9: shokerAAss (227.11).
Player StephCurry has small blind (1)
Player L4zy_FiSh has big blind (2)
Player IlxxxlI received card: [9s]
Player IlxxxlI received card: [7s]
Player mr.fargo folds
Player shokerAAss folds
Player IlxxxlI folds
Player Tilt-A-Whirl folds
Player IamPhamous folds
Player PANDAisEVIL raises (5)
Player Iia007 folds
Player StephCurry folds
Player L4zy_FiSh folds
Uncalled bet (3) returned to PANDAisEVIL
Player PANDAisEVIL mucks cards
------ Summary ------
Pot: 5. Rake 0
Player IlxxxlI does not show cards.Bets: 0. Collects: 0. Wins: 0.
Player Tilt-A-Whirl does not show cards.Bets: 0. Collects: 0. Wins: 0.
Player IamPhamous does not show cards.Bets: 0. Collects: 0. Wins: 0.
*Player PANDAisEVIL mucks (does not show cards). Bets: 2. Collects: 5. Wins: 3.
Player Iia007 does not show cards.Bets: 0. Collects: 0. Wins: 0.
Player StephCurry does not show cards.Bets: 1. Collects: 0. Loses: 1.
Player L4zy_FiSh does not show cards.Bets: 2. Collects: 0. Loses: 2.
Player mr.fargo does not show cards.Bets: 0. Collects: 0. Wins: 0.
Player shokerAAss does not show cards.Bets: 0. Collects: 0. Wins: 0.
Game ended at: 2016/11/29 9:12:3

Game started
Game ID: 786786045 0.25/0.50 (PRR) Gorgons - 7 (Hold'em)
Seat 2 is the button
Seat 1: 528 Hertz (50).
Seat 2: Heksebrygg (50).
Seat 3: Dirty4skin (43.09).
Seat 4: FaceMelt (61.48).
Seat 5: Tilt-A-Whirl (75.34).
Seat 6: IlxxxlI (20.13).
Player Dirty4skin has small blind (0.25)
Player FaceMelt has big blind (0.50)
Player IlxxxlI received card: [2h]
Player IlxxxlI received card: [Jd]
Player Tilt-A-Whirl folds
Player IlxxxlI folds
Player 528 Hertz folds
Player Heksebrygg folds
Player Dirty4skin raises (1.75)
Player FaceMelt calls (1.50)
*** FLOP ***: [6s 10d 8s]
Player Dirty4skin bets (2.53)
Player FaceMelt calls (2.53)
*** TURN ***: [6s 10d 8s] [Ah]
Player Dirty4skin checks
Player FaceMelt bets (4.30)
Player Dirty4skin raises (12)
Player FaceMelt calls (7.70)
*** RIVER ***: [6s 10d 8s Ah] [10c]
Player Dirty4skin checks
Player FaceMelt checks
Player FaceMelt mucks cards
------ Summary ------
Pot: 31.41. Rake 1.41. JP fee 0.24
Board: [6s 10d 8s Ah 10c]
Player 528 Hertz does not show cards.Bets: 0. Collects: 0. Wins: 0.
Player Heksebrygg does not show cards.Bets: 0. Collects: 0. Wins: 0.
*Player Dirty4skin shows: Two pairs. As and 10s [As Js]. Bets: 16.53. Collects: 31.41. Wins: 14.88.
Player FaceMelt mucks (does not show cards). Bets: 16.53. Collects: 0. Loses: 16.53.
Player Tilt-A-Whirl does not show cards.Bets: 0. Collects: 0. Wins: 0.
Player IlxxxlI does not show cards.Bets: 0. Collects: 0. Wins: 0.
Game ended at: 2016/11/29 9:12:50

Game started
Game ID: 786785917 0.25/0.50 (PRR) Garuda - 3 (Hold'em)
Seat 4 is the button
Seat 1: IlxxxlI (38.48).
Seat 2: Ice Bank Mice Elf (87.48).
Seat 3: tutofu84 (108.87).
Seat 4: imperceptible (22.71).
Seat 5: HanktheGrey (21.87).
Seat 6: kid4life (171.86).
Seat 7: Tilt-A-Whirl (53.56).
Seat 8: EasyQQ (53.25).
Player HanktheGrey has small blind (0.25)
Player kid4life has big blind (0.50)
Player IlxxxlI received card: [9s]
Player IlxxxlI received card: [Ah]
Player Tilt-A-Whirl raises (1)
Player EasyQQ calls (1)
Player IlxxxlI folds
Player Ice Bank Mice Elf folds
Player tutofu84 folds
Player imperceptible calls (1)
Player HanktheGrey calls (0.75)
Player kid4life folds
*** FLOP ***: [Kh 8h 10d]
Player HanktheGrey checks
Player Tilt-A-Whirl checks
Player EasyQQ checks
Player imperceptible checks
*** TURN ***: [Kh 8h 10d] [Jh]
Player HanktheGrey checks
Player Tilt-A-Whirl checks
Player EasyQQ bets (2.14)
Player imperceptible folds
Player HanktheGrey calls (2.14)
Player Tilt-A-Whirl folds
*** RIVER ***: [Kh 8h 10d Jh] [7d]
Player HanktheGrey checks
Player EasyQQ checks
------ Summary ------
Pot: 8.35. Rake 0.29. JP fee 0.14
Board: [Kh 8h 10d Jh 7d]
Player IlxxxlI does not show cards.Bets: 0. Collects: 0. Wins: 0.
Player Ice Bank Mice Elf does not show cards.Bets: 0. Collects: 0. Wins: 0.
Player tutofu84 does not show cards.Bets: 0. Collects: 0. Wins: 0.
Player imperceptible does not show cards.Bets: 1. Collects: 0. Loses: 1.
*Player HanktheGrey shows: Flush, K high [9h 7h]. Bets: 3.14. Collects: 8.35. Wins: 5.21.
Player kid4life does not show cards.Bets: 0.50. Collects: 0. Loses: 0.50.
Player Tilt-A-Whirl does not show cards.Bets: 1. Collects: 0. Loses: 1.
Player EasyQQ shows: One pair of Js [Js 3s]. Bets: 3.14. Collects: 0. Loses: 3.14.
Game ended at: 2016/11/29 9:13:42

Game started
Game ID: 786785812 0.25/0.50 (PRR) Garuda (Hold'em)
Seat 9 is the button
Seat 1: akbrow (29.50).
Seat 2: IlxxxlI (20).
Seat 3: Ice Bank Mice Elf (51.31).
Seat 4: Log_in (10.95).
Seat 5: CumBckMuny (43.14).
Seat 6: XxDominationxX (99.09).
Seat 7: coldkilla (54.77).
Seat 8: gunnfarm (47.25).
Seat 9: OmEGaKuSh (51.56).
Player akbrow has small blind (0.25)
Player IlxxxlI has big blind (0.50)
Player IlxxxlI received card: [6c]
Player IlxxxlI received card: [Qd]
Player Ice Bank Mice Elf raises (1.50)
Player Log_in folds
Player CumBckMuny calls (1.50)
Player XxDominationxX calls (1.50)
Player coldkilla folds
Player gunnfarm folds
Player OmEGaKuSh folds
Player akbrow calls (1.25)
Player IlxxxlI folds
*** FLOP ***: [6s 3d 6d]
Player akbrow checks
Player Ice Bank Mice Elf bets (4.64)
Player CumBckMuny calls (4.64)
Player XxDominationxX folds
Player akbrow folds
*** TURN ***: [6s 3d 6d] [Ks]
Player Ice Bank Mice Elf bets (7.50)
Player CumBckMuny allin (37)
Player Ice Bank Mice Elf calls (29.50)
*** RIVER ***: [6s 3d 6d Ks] [10c]
------ Summary ------
Pot: 86.78. Rake 2.76. JP fee 0.24
Board: [6s 3d 6d Ks 10c]
Player akbrow does not show cards.Bets: 1.50. Collects: 0. Loses: 1.50.
Player IlxxxlI does not show cards.Bets: 0.50. Collects: 0. Loses: 0.50.
*Player Ice Bank Mice Elf shows: Full House (K/6) [Kd Kc]. Bets: 43.14. Collects: 86.78. Wins: 43.64.
Player Log_in does not show cards.Bets: 0. Collects: 0. Wins: 0.
Player CumBckMuny shows: Full House (3/6) [3s 3h]. Bets: 43.14. Collects: 0. Loses: 43.14.
Player XxDominationxX does not show cards.Bets: 1.50. Collects: 0. Loses: 1.50.
Player coldkilla does not show cards.Bets: 0. Collects: 0. Wins: 0.
Player gunnfarm does not show cards.Bets: 0. Collects: 0. Wins: 0.
Player OmEGaKuSh does not show cards.Bets: 0. Collects: 0. Wins: 0.
Game ended at: 2016/11/29 9:12:41

Game started
Game ID: 786785689 0.25/0.50 (PRR) Gorgons - 7 (Hold'em)
Seat 1 is the button
Seat 1: 528 Hertz (50).
Seat 2: Heksebrygg (50.25).
Seat 3: Dirty4skin (42.84).
Seat 4: FaceMelt (61.48).
Seat 5: Tilt-A-Whirl (75.34).
Seat 6: IlxxxlI (20.13).
Player Heksebrygg has small blind (0.25)
Player Dirty4skin has big blind (0.50)
Player IlxxxlI received card: [8s]
Player IlxxxlI received card: [6h]
Player FaceMelt folds
Player Tilt-A-Whirl folds
Player IlxxxlI folds
Player 528 Hertz folds
Player Heksebrygg folds
Uncalled bet (0.25) returned to Dirty4skin
Player Dirty4skin mucks cards
------ Summary ------
Pot: 0.50. Rake 0
Player 528 Hertz does not show cards.Bets: 0. Collects: 0. Wins: 0.
Player Heksebrygg does not show cards.Bets: 0.25. Collects: 0. Loses: 0.25.
*Player Dirty4skin mucks (does not show cards). Bets: 0.25. Collects: 0.50. Wins: 0.25.
Player FaceMelt does not show cards.Bets: 0. Collects: 0. Wins: 0.
Player Tilt-A-Whirl does not show cards.Bets: 0. Collects: 0. Wins: 0.
Player IlxxxlI does not show cards.Bets: 0. Collects: 0. Wins: 0.
Game ended at: 2016/11/29 9:11:30

Game started
Game ID: 786785287 0.25/0.50 (PRR) Garuda (Hold'em)
Seat 8 is the button
Seat 1: akbrow (30).
Seat 2: IlxxxlI (20).
Seat 3: Ice Bank Mice Elf (50.56).
Seat 4: Log_in (10.95).
Seat 5: CumBckMuny (43.14).
Seat 6: XxDominationxX (99.09).
Seat 7: coldkilla (54.77).
Seat 8: gunnfarm (47.25).
Seat 9: OmEGaKuSh (51.81).
Player OmEGaKuSh has small blind (0.25)
Player akbrow has big blind (0.50)
Player IlxxxlI received card: [6d]
Player IlxxxlI received card: [5s]
Player IlxxxlI folds
Player Ice Bank Mice Elf raises (1.50)
Player Log_in folds
Player CumBckMuny folds
Player XxDominationxX folds
Player coldkilla folds
Player gunnfarm folds
Player OmEGaKuSh folds
Player akbrow folds
Uncalled bet (1) returned to Ice Bank Mice Elf
Player Ice Bank Mice Elf mucks cards
------ Summary ------
Pot: 1.25. Rake 0
Player akbrow does not show cards.Bets: 0.50. Collects: 0. Loses: 0.50.
Player IlxxxlI does not show cards.Bets: 0. Collects: 0. Wins: 0.
*Player Ice Bank Mice Elf mucks (does not show cards). Bets: 0.50. Collects: 1.25. Wins: 0.75.
Player Log_in does not show cards.Bets: 0. Collects: 0. Wins: 0.
Player CumBckMuny does not show cards.Bets: 0. Collects: 0. Wins: 0.
Player XxDominationxX does not show cards.Bets: 0. Collects: 0. Wins: 0.
Player coldkilla does not show cards.Bets: 0. Collects: 0. Wins: 0.
Player gunnfarm does not show cards.Bets: 0. Collects: 0. Wins: 0.
Player OmEGaKuSh does not show cards.Bets: 0.25. Collects: 0. Loses: 0.25.
Game ended at: 2016/11/29 9:11:16

Game started
Game ID: 786784764 0.25/0.50 (PRR) Garuda - 3 (Hold'em)
Seat 3 is the button
Seat 1: IlxxxlI (38.48).
Seat 2: Ice Bank Mice Elf (87.48).
Seat 3: tutofu84 (108.87).
Seat 4: imperceptible (22.96).
Seat 5: HanktheGrey (22.87).
Seat 6: kid4life (171.86).
Seat 7: Tilt-A-Whirl (52.42).
Seat 8: EasyQQ (53.25).
Player imperceptible has small blind (0.25)
Player HanktheGrey has big blind (0.50)
Player IlxxxlI received card: [Kd]
Player IlxxxlI received card: [5h]
Player kid4life folds
Player Tilt-A-Whirl raises (1)
Player EasyQQ folds
Player IlxxxlI folds
Player Ice Bank Mice Elf folds
Player tutofu84 folds
Player imperceptible folds
Player HanktheGrey calls (0.50)
*** FLOP ***: [10h 6h 5c]
Player HanktheGrey checks
Player Tilt-A-Whirl bets (0.71)
Player HanktheGrey folds
Uncalled bet (0.71) returned to Tilt-A-Whirl
Player Tilt-A-Whirl mucks cards
------ Summary ------
Pot: 2.14. Rake 0.09. JP fee 0.02
Board: [10h 6h 5c]
Player IlxxxlI does not show cards.Bets: 0. Collects: 0. Wins: 0.
Player Ice Bank Mice Elf does not show cards.Bets: 0. Collects: 0. Wins: 0.
Player tutofu84 does not show cards.Bets: 0. Collects: 0. Wins: 0.
Player imperceptible does not show cards.Bets: 0.25. Collects: 0. Loses: 0.25.
Player HanktheGrey does not show cards.Bets: 1. Collects: 0. Loses: 1.
Player kid4life does not show cards.Bets: 0. Collects: 0. Wins: 0.
*Player Tilt-A-Whirl mucks (does not show cards). Bets: 1. Collects: 2.14. Wins: 1.14.
Player EasyQQ does not show cards.Bets: 0. Collects: 0. Wins: 0.
Game ended at: 2016/11/29 9:11:21

Game started
Game ID: 786784371 0.25/0.50 (PRR) Garuda - 2 (Hold'em)
Seat 4 is the button
Seat 1: Tilt-A-Whirl (50.85).
Seat 2: apoo11 (31.74).
Seat 3: imperceptible (20).
Seat 4: Ice Bank Mice Elf (102.25).
Seat 5: tutofu84 (89.66).
Seat 6: IlxxxlI (23.57).
Seat 7: coldkilla (14.50).
Seat 9: kid4life (65.38).
Player tutofu84 has small blind (0.25)
Player IlxxxlI has big blind (0.50)
Player IlxxxlI received card: [4d]
Player IlxxxlI received card: [2s]
Player coldkilla raises (1)
Player kid4life folds
Player Tilt-A-Whirl folds
Player apoo11 folds
Player imperceptible raises (3)
Player Ice Bank Mice Elf folds
Player tutofu84 folds
Player IlxxxlI folds
Player coldkilla calls (2)
*** FLOP ***: [3h 8c Jd]
Player coldkilla checks
Player imperceptible checks
*** TURN ***: [3h 8c Jd] [9s]
Player coldkilla checks
Player imperceptible checks
*** RIVER ***: [3h 8c Jd 9s] [Qd]
Player coldkilla checks
Player imperceptible checks
Player coldkilla mucks cards
------ Summary ------
Pot: 6.42. Rake 0.23. JP fee 0.10
Board: [3h 8c Jd 9s Qd]
Player Tilt-A-Whirl does not show cards.Bets: 0. Collects: 0. Wins: 0.
Player apoo11 does not show cards.Bets: 0. Collects: 0. Wins: 0.
*Player imperceptible shows: One pair of Qs [Qs Ac]. Bets: 3. Collects: 6.42. Wins: 3.42.
Player Ice Bank Mice Elf does not show cards.Bets: 0. Collects: 0. Wins: 0.
Player tutofu84 does not show cards.Bets: 0.25. Collects: 0. Loses: 0.25.
Player IlxxxlI does not show cards.Bets: 0.50. Collects: 0. Loses: 0.50.
Player coldkilla mucks (does not show cards). Bets: 3. Collects: 0. Loses: 3.
Player kid4life does not show cards.Bets: 0. Collects: 0. Wins: 0.
Game ended at: 2016/11/29 9:11:42

Game started
Game ID: 786784360 1/2 (PRR) Longana - 4 (Hold'em)
Seat 3 is the button
Seat 1: Iia007 (271.87).
Seat 2: IAmClueless (411.48).
Seat 3: PANDAisEVIL (340.97).
Seat 4: mr.fargo (80).
Seat 5: L4zy_FiSh (204.55).
Seat 6: IlxxxlI (80).
Seat 7: LazyFish (200).
Seat 8: Gronkowski69 (227.10).
Seat 9: pokerforfun1 (54.25).
Player mr.fargo has small blind (1)
Player L4zy_FiSh has big blind (2)
Player IlxxxlI received card: [Ah]
Player IlxxxlI received card: [9s]
Player IlxxxlI folds
Player LazyFish folds
Player Gronkowski69 folds
Player pokerforfun1 calls (2)
Player Iia007 raises (8)
Player IAmClueless calls (8)
Player PANDAisEVIL folds
Player mr.fargo folds
Player L4zy_FiSh folds
Player pokerforfun1 folds
*** FLOP ***: [8c Kd 5s]
Player Iia007 bets (14)
Player IAmClueless calls (14)
*** TURN ***: [8c Kd 5s] [2c]
Player Iia007 bets (32)
Player IAmClueless calls (32)
*** RIVER ***: [8c Kd 5s 2c] [9h]
Player Iia007 checks
Player IAmClueless bets (47)
Player Iia007 folds
Uncalled bet (47) returned to IAmClueless
Player IAmClueless mucks cards
------ Summary ------
Pot: 110. Rake 2.76. JP fee 0.24
Board: [8c Kd 5s 2c 9h]
Player Iia007 does not show cards.Bets: 54. Collects: 0. Loses: 54.
*Player IAmClueless mucks (does not show cards). Bets: 54. Collects: 110. Wins: 56.
Player PANDAisEVIL does not show cards.Bets: 0. Collects: 0. Wins: 0.
Player mr.fargo does not show cards.Bets: 1. Collects: 0. Loses: 1.
Player L4zy_FiSh does not show cards.Bets: 2. Collects: 0. Loses: 2.
Player IlxxxlI does not show cards.Bets: 0. Collects: 0. Wins: 0.
Player LazyFish does not show cards.Bets: 0. Collects: 0. Wins: 0.
Player Gronkowski69 does not show cards.Bets: 0. Collects: 0. Wins: 0.
Player pokerforfun1 does not show cards.Bets: 2. Collects: 0. Loses: 2.
Game ended at: 2016/11/29 9:12:4

Game started
Game ID: 786784156 0.25/0.50 (PRR) Garuda (Hold'em)
Seat 7 is the button
Seat 2: IlxxxlI (20).
Seat 3: Ice Bank Mice Elf (50.56).
Seat 4: Log_in (13.25).
Seat 5: CumBckMuny (43.14).
Seat 6: XxDominationxX (99.09).
Seat 7: coldkilla (54.77).
Seat 8: gunnfarm (47.50).
Seat 9: OmEGaKuSh (49.50).
Player gunnfarm has small blind (0.25)
Player OmEGaKuSh has big blind (0.50)
Player IlxxxlI received card: [8s]
Player IlxxxlI received card: [4d]
Player IlxxxlI folds
Player Ice Bank Mice Elf folds
Player Log_in raises (1.12)
Player CumBckMuny folds
Player XxDominationxX folds
Player coldkilla folds
Player gunnfarm folds
Player OmEGaKuSh calls (0.62)
*** FLOP ***: [7c Jh 5d]
Player OmEGaKuSh checks
Player Log_in bets (1.18)
Player OmEGaKuSh calls (1.18)
*** TURN ***: [7c Jh 5d] [4s]
Player OmEGaKuSh bets (2.30)
Player Log_in folds
Uncalled bet (2.30) returned to OmEGaKuSh
Player OmEGaKuSh mucks cards
------ Summary ------
Pot: 4.61. Rake 0.16. JP fee 0.08
Board: [7c Jh 5d 4s]
Player IlxxxlI does not show cards.Bets: 0. Collects: 0. Wins: 0.
Player Ice Bank Mice Elf does not show cards.Bets: 0. Collects: 0. Wins: 0.
Player Log_in does not show cards.Bets: 2.30. Collects: 0. Loses: 2.30.
Player CumBckMuny does not show cards.Bets: 0. Collects: 0. Wins: 0.
Player XxDominationxX does not show cards.Bets: 0. Collects: 0. Wins: 0.
Player coldkilla does not show cards.Bets: 0. Collects: 0. Wins: 0.
Player gunnfarm does not show cards.Bets: 0.25. Collects: 0. Loses: 0.25.
*Player OmEGaKuSh mucks (does not show cards). Bets: 2.30. Collects: 4.61. Wins: 2.31.
Game ended at: 2016/11/29 9:10:43

Game started
Game ID: 786783862 1/2 (PRR) Longana - 2 (Hold'em)
Seat 4 is the button
Seat 1: IlxxxlI (178.97).
Seat 2: Tilt-A-Whirl (200).
Seat 3: IamPhamous (271.74).
Seat 4: PANDAisEVIL (217.47).
Seat 5: Iia007 (213.24).
Seat 6: StephCurry (200).
Seat 7: L4zy_FiSh (202).
Seat 8: mr.fargo (130.51).
Seat 9: shokerAAss (227.11).
Player Iia007 has small blind (1)
Player StephCurry has big blind (2)
Player IlxxxlI received card: [7h]
Player IlxxxlI received card: [8d]
Player L4zy_FiSh folds
Player mr.fargo folds
Player shokerAAss folds
Player IlxxxlI folds
Player Tilt-A-Whirl raises (4)
Player IamPhamous calls (4)
Player PANDAisEVIL calls (4)
Player Iia007 folds
Player StephCurry calls (2)
*** FLOP ***: [Jd 10c 4d]
Player StephCurry checks
Player Tilt-A-Whirl checks
Player IamPhamous bets (8.07)
Player PANDAisEVIL folds
Player StephCurry folds
Player Tilt-A-Whirl calls (8.07)
*** TURN ***: [Jd 10c 4d] [8s]
Player Tilt-A-Whirl checks
Player IamPhamous bets (20.99)
Player Tilt-A-Whirl folds
Uncalled bet (20.99) returned to IamPhamous
Player IamPhamous mucks cards
------ Summary ------
Pot: 31.49. Rake 1.41. JP fee 0.24
Board: [Jd 10c 4d 8s]
Player IlxxxlI does not show cards.Bets: 0. Collects: 0. Wins: 0.
Player Tilt-A-Whirl does not show cards.Bets: 12.07. Collects: 0. Loses: 12.07.
*Player IamPhamous mucks (does not show cards). Bets: 12.07. Collects: 31.49. Wins: 19.42.
Player PANDAisEVIL does not show cards.Bets: 4. Collects: 0. Loses: 4.
Player Iia007 does not show cards.Bets: 1. Collects: 0. Loses: 1.
Player StephCurry does not show cards.Bets: 4. Collects: 0. Loses: 4.
Player L4zy_FiSh does not show cards.Bets: 0. Collects: 0. Wins: 0.
Player mr.fargo does not show cards.Bets: 0. Collects: 0. Wins: 0.
Player shokerAAss does not show cards.Bets: 0. Collects: 0. Wins: 0.
Game ended at: 2016/11/29 9:11:31

Game started
Game ID: 786783837 0.25/0.50 (PRR) Gorgons - 7 (Hold'em)
Seat 6 is the button
Seat 1: 528 Hertz (50.05).
Seat 2: Heksebrygg (50.75).
Seat 3: Dirty4skin (42.84).
Seat 4: FaceMelt (50).
Seat 5: Tilt-A-Whirl (87.30).
Seat 6: IlxxxlI (20.13).
Player 528 Hertz has small blind (0.25)
Player Heksebrygg has big blind (0.50)
Player IlxxxlI received card: [8h]
Player IlxxxlI received card: [Ks]
Player Dirty4skin folds
Player FaceMelt raises (1.50)
Player Tilt-A-Whirl calls (1.50)
Player IlxxxlI folds
Player 528 Hertz folds
Player Heksebrygg folds
*** FLOP ***: [2c 4s 10h]
Player FaceMelt checks
Player Tilt-A-Whirl bets (2.38)
Player FaceMelt calls (2.38)
*** TURN ***: [2c 4s 10h] [Kh]
Player FaceMelt checks
Player Tilt-A-Whirl bets (4.04)
Player FaceMelt raises (8.08)
Player Tilt-A-Whirl calls (4.04)
*** RIVER ***: [2c 4s 10h Kh] [6h]
Player FaceMelt checks
Player Tilt-A-Whirl checks
Player Tilt-A-Whirl mucks cards
------ Summary ------
Pot: 23.44. Rake 0.99. JP fee 0.24
Board: [2c 4s 10h Kh 6h]
Player 528 Hertz does not show cards.Bets: 0.25. Collects: 0. Loses: 0.25.
Player Heksebrygg does not show cards.Bets: 0.50. Collects: 0. Loses: 0.50.
Player Dirty4skin does not show cards.Bets: 0. Collects: 0. Wins: 0.
*Player FaceMelt shows: One pair of Ks [Kd Qs]. Bets: 11.96. Collects: 23.44. Wins: 11.48.
Player Tilt-A-Whirl mucks (does not show cards). Bets: 11.96. Collects: 0. Loses: 11.96.
Player IlxxxlI does not show cards.Bets: 0. Collects: 0. Wins: 0.
Game ended at: 2016/11/29 9:11:5

Game started
Game ID: 786783768 0.25/0.50 (PRR) Garuda - 2 (Hold'em)
Seat 3 is the button
Seat 1: Tilt-A-Whirl (50.85).
Seat 2: apoo11 (31.74).
Seat 3: imperceptible (20).
Seat 4: Ice Bank Mice Elf (102.50).
Seat 5: tutofu84 (91.41).
Seat 6: IlxxxlI (21.75).
Seat 7: coldkilla (14.50).
Seat 9: kid4life (65.38).
Player Ice Bank Mice Elf has small blind (0.25)
Player tutofu84 has big blind (0.50)
Player IlxxxlI received card: [Jd]
Player IlxxxlI received card: [As]
Player IlxxxlI raises (1.75)
Player coldkilla folds
Player kid4life folds
Player Tilt-A-Whirl folds
Player apoo11 folds
Player imperceptible folds
Player Ice Bank Mice Elf folds
Player tutofu84 calls (1.25)
*** FLOP ***: [5c Ks Qd]
Player tutofu84 checks
Player IlxxxlI bets (1.86)
Player tutofu84 folds
Uncalled bet (1.86) returned to IlxxxlI
Player IlxxxlI mucks cards
------ Summary ------
Pot: 3.57. Rake 0.12. JP fee 0.06
Board: [5c Ks Qd]
Player Tilt-A-Whirl does not show cards.Bets: 0. Collects: 0. Wins: 0.
Player apoo11 does not show cards.Bets: 0. Collects: 0. Wins: 0.
Player imperceptible does not show cards.Bets: 0. Collects: 0. Wins: 0.
Player Ice Bank Mice Elf does not show cards.Bets: 0.25. Collects: 0. Loses: 0.25.
Player tutofu84 does not show cards.Bets: 1.75. Collects: 0. Loses: 1.75.
*Player IlxxxlI mucks (does not show cards). Bets: 1.75. Collects: 3.57. Wins: 1.82.
Player coldkilla does not show cards.Bets: 0. Collects: 0. Wins: 0.
Player kid4life does not show cards.Bets: 0. Collects: 0. Wins: 0.
Game ended at: 2016/11/29 9:9:44

Game started
Game ID: 786783715 0.25/0.50 (PRR) Garuda - 3 (Hold'em)
Seat 2 is the button
Seat 1: IlxxxlI (38.48).
Seat 2: Ice Bank Mice Elf (87.48).
Seat 3: tutofu84 (104.34).
Seat 4: imperceptible (23.46).
Seat 5: HanktheGrey (22.87).
Seat 6: kid4life (171.86).
Seat 7: Tilt-A-Whirl (52.42).
Seat 8: EasyQQ (57.75).
Player tutofu84 has small blind (0.25)
Player imperceptible has big blind (0.50)
Player IlxxxlI received card: [2d]
Player IlxxxlI received card: [3c]
Player HanktheGrey folds
Player kid4life folds
Player Tilt-A-Whirl folds
Player EasyQQ raises (1.50)
Player IlxxxlI folds
Player Ice Bank Mice Elf folds
Player tutofu84 raises (4.25)
Player imperceptible folds
Player EasyQQ calls (3)
*** FLOP ***: [Ks 7h 10c]
Player tutofu84 bets (6.02)
Player EasyQQ folds
Uncalled bet (6.02) returned to tutofu84
Player tutofu84 mucks cards
------ Summary ------
Pot: 9.03. Rake 0.33. JP fee 0.14
Board: [Ks 7h 10c]
Player IlxxxlI does not show cards.Bets: 0. Collects: 0. Wins: 0.
Player Ice Bank Mice Elf does not show cards.Bets: 0. Collects: 0. Wins: 0.
*Player tutofu84 mucks (does not show cards). Bets: 4.50. Collects: 9.03. Wins: 4.53.
Player imperceptible does not show cards.Bets: 0.50. Collects: 0. Loses: 0.50.
Player HanktheGrey does not show cards.Bets: 0. Collects: 0. Wins: 0.
Player kid4life does not show cards.Bets: 0. Collects: 0. Wins: 0.
Player Tilt-A-Whirl does not show cards.Bets: 0. Collects: 0. Wins: 0.
Player EasyQQ does not show cards.Bets: 4.50. Collects: 0. Loses: 4.50.
Game ended at: 2016/11/29 9:10:8

Game started
Game ID: 786783682 0.50/1 (PRR) Karkadann (Hold'em)
Seat 9 is the button
Seat 1: PANDAisEVIL (142.85).
Seat 2: Qrenor (114.07).
Seat 3: Tilt-A-Whirl (100).
Seat 4: IlxxxlI (61).
Seat 5: mr.fargo (40).
Seat 6: Log_in (97.02).
Seat 7: PeLanpapa (100).
Seat 8: apoo11 (48.18).
Seat 9: St3p04ka (40).
Player PANDAisEVIL has small blind (0.50)
Player Qrenor has big blind (1)
Player IlxxxlI received card: [4s]
Player IlxxxlI received card: [4d]
Player Tilt-A-Whirl folds
Player IlxxxlI folds
Player mr.fargo folds
Player Log_in raises (3)
Player PeLanpapa is timed out.
Player PeLanpapa folds
Player apoo11 folds
Player St3p04ka folds
Player PANDAisEVIL folds
Player Qrenor folds
Uncalled bet (2) returned to Log_in
Player Log_in mucks cards
------ Summary ------
Pot: 2.50. Rake 0
Player PANDAisEVIL does not show cards.Bets: 0.50. Collects: 0. Loses: 0.50.
Player Qrenor does not show cards.Bets: 1. Collects: 0. Loses: 1.
Player Tilt-A-Whirl does not show cards.Bets: 0. Collects: 0. Wins: 0.
Player IlxxxlI does not show cards.Bets: 0. Collects: 0. Wins: 0.
Player mr.fargo does not show cards.Bets: 0. Collects: 0. Wins: 0.
*Player Log_in mucks (does not show cards). Bets: 1. Collects: 2.50. Wins: 1.50.
Player PeLanpapa does not show cards.Bets: 0. Collects: 0. Wins: 0.
Player apoo11 does not show cards.Bets: 0. Collects: 0. Wins: 0.
Player St3p04ka does not show cards.Bets: 0. Collects: 0. Wins: 0.
Game ended at: 2016/11/29 9:10:19

Game started
Game ID: 786783673 0.25/0.50 (PRR) Garuda (Hold'em)
Seat 6 is the button
Seat 2: IlxxxlI (20).
Seat 3: Ice Bank Mice Elf (50.56).
Seat 4: Log_in (13.25).
Seat 5: CumBckMuny (43.14).
Seat 6: XxDominationxX (99.09).
Seat 7: coldkilla (55.02).
Seat 8: gunnfarm (47.25).
Seat 9: OmEGaKuSh (49.50).
Player coldkilla has small blind (0.25)
Player gunnfarm has big blind (0.50)
Player IlxxxlI received card: [8s]
Player IlxxxlI received card: [10c]
Player OmEGaKuSh folds
Player IlxxxlI folds
Player Ice Bank Mice Elf folds
Player Log_in folds
Player CumBckMuny folds
Player XxDominationxX folds
Player coldkilla folds
Uncalled bet (0.25) returned to gunnfarm
Player gunnfarm mucks cards
------ Summary ------
Pot: 0.50. Rake 0
Player IlxxxlI does not show cards.Bets: 0. Collects: 0. Wins: 0.
Player Ice Bank Mice Elf does not show cards.Bets: 0. Collects: 0. Wins: 0.
Player Log_in does not show cards.Bets: 0. Collects: 0. Wins: 0.
Player CumBckMuny does not show cards.Bets: 0. Collects: 0. Wins: 0.
Player XxDominationxX does not show cards.Bets: 0. Collects: 0. Wins: 0.
Player coldkilla does not show cards.Bets: 0.25. Collects: 0. Loses: 0.25.
*Player gunnfarm mucks (does not show cards). Bets: 0.25. Collects: 0.50. Wins: 0.25.
Player OmEGaKuSh does not show cards.Bets: 0. Collects: 0. Wins: 0.
Game ended at: 2016/11/29 9:9:31

Game started
Game ID: 786782910 1/2 (PRR) Longana - 4 (Hold'em)
Seat 2 is the button
Seat 1: Iia007 (277.87).
Seat 2: IAmClueless (403.23).
Seat 3: PANDAisEVIL (341.97).
Seat 4: mr.fargo (81.70).
Seat 5: L4zy_FiSh (204.55).
Seat 6: IlxxxlI (80).
Seat 7: LazyFish (200).
Seat 8: Gronkowski69 (227.10).
Seat 9: pokerforfun1 (54.25).
Player PANDAisEVIL has small blind (1)
Player mr.fargo has big blind (2)
Player IlxxxlI received card: [9h]
Player IlxxxlI received card: [3d]
Player L4zy_FiSh folds
Player IlxxxlI folds
Player LazyFish folds
Player Gronkowski69 folds
Player pokerforfun1 folds
Player Iia007 raises (6)
Player IAmClueless calls (6)
Player PANDAisEVIL folds
Player mr.fargo folds
*** FLOP ***: [8s As Jc]
Player Iia007 checks
Player IAmClueless bets (8)
Player Iia007 folds
Uncalled bet (8) returned to IAmClueless
Player IAmClueless mucks cards
------ Summary ------
Pot: 14.25. Rake 0.51. JP fee 0.24
Board: [8s As Jc]
Player Iia007 does not show cards.Bets: 6. Collects: 0. Loses: 6.
*Player IAmClueless mucks (does not show cards). Bets: 6. Collects: 14.25. Wins: 8.25.
Player PANDAisEVIL does not show cards.Bets: 1. Collects: 0. Loses: 1.
Player mr.fargo does not show cards.Bets: 2. Collects: 0. Loses: 2.
Player L4zy_FiSh does not show cards.Bets: 0. Collects: 0. Wins: 0.
Player IlxxxlI does not show cards.Bets: 0. Collects: 0. Wins: 0.
Player LazyFish does not show cards.Bets: 0. Collects: 0. Wins: 0.
Player Gronkowski69 does not show cards.Bets: 0. Collects: 0. Wins: 0.
Player pokerforfun1 does not show cards.Bets: 0. Collects: 0. Wins: 0.
Game ended at: 2016/11/29 9:9:43

Game started
Game ID: 786782871 0.25/0.50 (PRR) Garuda - 2 (Hold'em)
Seat 2 is the button
Seat 1: Tilt-A-Whirl (50.85).
Seat 2: apoo11 (31.74).
Seat 3: imperceptible (15.40).
Seat 4: Ice Bank Mice Elf (103).
Seat 5: tutofu84 (91.41).
Seat 6: IlxxxlI (21.75).
Seat 7: coldkilla (14.50).
Seat 9: kid4life (51.04).
Player imperceptible has small blind (0.25)
Player Ice Bank Mice Elf has big blind (0.50)
Player IlxxxlI received card: [5h]
Player IlxxxlI received card: [10d]
Player tutofu84 folds
Player IlxxxlI folds
Player coldkilla folds
Player kid4life raises (2)
Player Tilt-A-Whirl folds
Player apoo11 folds
Player imperceptible allin (15.15)
Player Ice Bank Mice Elf folds
Player kid4life calls (13.40)
*** FLOP ***: [8c 4s 9c]
*** TURN ***: [8c 4s 9c] [2d]
*** RIVER ***: [8c 4s 9c 2d] [Ah]
------ Summary ------
Pot: 29.74. Rake 1.32. JP fee 0.24
Board: [8c 4s 9c 2d Ah]
Player Tilt-A-Whirl does not show cards.Bets: 0. Collects: 0. Wins: 0.
Player apoo11 does not show cards.Bets: 0. Collects: 0. Wins: 0.
Player imperceptible shows: One pair of 5s [5s 5d]. Bets: 15.40. Collects: 0. Loses: 15.40.
Player Ice Bank Mice Elf does not show cards.Bets: 0.50. Collects: 0. Loses: 0.50.
Player tutofu84 does not show cards.Bets: 0. Collects: 0. Wins: 0.
Player IlxxxlI does not show cards.Bets: 0. Collects: 0. Wins: 0.
Player coldkilla does not show cards.Bets: 0. Collects: 0. Wins: 0.
*Player kid4life shows: One pair of Ks [Ks Kh]. Bets: 15.40. Collects: 29.74. Wins: 14.34.
Game ended at: 2016/11/29 9:9:6

Game started
Game ID: 786782619 0.25/0.50 (PRR) Gorgons - 7 (Hold'em)
Seat 5 is the button
Seat 1: 528 Hertz (51.05).
Seat 2: Heksebrygg (50.75).
Seat 3: Dirty4skin (42.84).
Seat 4: FaceMelt (50).
Seat 5: Tilt-A-Whirl (86.16).
Seat 6: IlxxxlI (20.38).
Player IlxxxlI has small blind (0.25)
Player 528 Hertz has big blind (0.50)
Player IlxxxlI received card: [3d]
Player IlxxxlI received card: [4d]
Player Heksebrygg folds
Player Dirty4skin folds
Player FaceMelt folds
Player Tilt-A-Whirl raises (1)
Player IlxxxlI folds
Player 528 Hertz calls (0.50)
*** FLOP ***: [Kc 3h 6c]
Player 528 Hertz checks
Player Tilt-A-Whirl checks
*** TURN ***: [Kc 3h 6c] [4h]
Player 528 Hertz checks
Player Tilt-A-Whirl bets (1.07)
Player 528 Hertz folds
Uncalled bet (1.07) returned to Tilt-A-Whirl
Player Tilt-A-Whirl mucks cards
------ Summary ------
Pot: 2.14. Rake 0.09. JP fee 0.02
Board: [Kc 3h 6c 4h]
Player 528 Hertz does not show cards.Bets: 1. Collects: 0. Loses: 1.
Player Heksebrygg does not show cards.Bets: 0. Collects: 0. Wins: 0.
Player Dirty4skin does not show cards.Bets: 0. Collects: 0. Wins: 0.
Player FaceMelt does not show cards.Bets: 0. Collects: 0. Wins: 0.
*Player Tilt-A-Whirl mucks (does not show cards). Bets: 1. Collects: 2.14. Wins: 1.14.
Player IlxxxlI does not show cards.Bets: 0.25. Collects: 0. Loses: 0.25.
Game ended at: 2016/11/29 9:9:12

Game started
Game ID: 786782499 1/2 (PRR) Longana - 2 (Hold'em)
Seat 3 is the button
Seat 1: IlxxxlI (178.97).
Seat 2: Tilt-A-Whirl (200).
Seat 3: IamPhamous (271.74).
Seat 4: PANDAisEVIL (218.47).
Seat 5: Iia007 (215.24).
Seat 7: L4zy_FiSh (202).
Seat 8: mr.fargo (157.46).
Seat 9: shokerAAss (200).
Player PANDAisEVIL has small blind (1)
Player Iia007 has big blind (2)
Player IlxxxlI received card: [6h]
Player IlxxxlI received card: [8s]
Player L4zy_FiSh folds
Player mr.fargo raises (5)
Player shokerAAss calls (5)
Player IlxxxlI folds
Player Tilt-A-Whirl folds
Player IamPhamous folds
Player PANDAisEVIL folds
Player Iia007 folds
*** FLOP ***: [7c Qc 2c]
Player mr.fargo bets (6.79)
Player shokerAAss calls (6.79)
*** TURN ***: [7c Qc 2c] [9h]
Player mr.fargo bets (15.16)
Player shokerAAss calls (15.16)
*** RIVER ***: [7c Qc 2c 9h] [5d]
Player mr.fargo checks
Player shokerAAss bets (52)
Player mr.fargo folds
Uncalled bet (52) returned to shokerAAss
Player shokerAAss mucks cards
------ Summary ------
Pot: 54.06. Rake 2.60. JP fee 0.24
Board: [7c Qc 2c 9h 5d]
Player IlxxxlI does not show cards.Bets: 0. Collects: 0. Wins: 0.
Player Tilt-A-Whirl does not show cards.Bets: 0. Collects: 0. Wins: 0.
Player IamPhamous does not show cards.Bets: 0. Collects: 0. Wins: 0.
Player PANDAisEVIL does not show cards.Bets: 1. Collects: 0. Loses: 1.
Player Iia007 does not show cards.Bets: 2. Collects: 0. Loses: 2.
Player L4zy_FiSh does not show cards.Bets: 0. Collects: 0. Wins: 0.
Player mr.fargo does not show cards.Bets: 26.95. Collects: 0. Loses: 26.95.
*Player shokerAAss mucks (does not show cards). Bets: 26.95. Collects: 54.06. Wins: 27.11.
Game ended at: 2016/11/29 9:9:13

Game started
Game ID: 786782233 0.25/0.50 (PRR) Garuda - 3 (Hold'em)
Seat 1 is the button
Seat 1: IlxxxlI (38.48).
Seat 2: Ice Bank Mice Elf (87.73).
Seat 3: tutofu84 (106.76).
Seat 4: imperceptible (23.46).
Seat 5: HanktheGrey (22.87).
Seat 6: kid4life (171.86).
Seat 7: Tilt-A-Whirl (50).
Seat 8: EasyQQ (57.75).
Player Ice Bank Mice Elf has small blind (0.25)
Player tutofu84 has big blind (0.50)
Player IlxxxlI received card: [6h]
Player IlxxxlI received card: [7s]
Player imperceptible folds
Player HanktheGrey folds
Player kid4life folds
Player Tilt-A-Whirl raises (1)
Player EasyQQ folds
Player IlxxxlI folds
Player Ice Bank Mice Elf folds
Player tutofu84 calls (0.50)
*** FLOP ***: [Jc 6s 7c]
Player tutofu84 checks
Player Tilt-A-Whirl bets (1.42)
Player tutofu84 calls (1.42)
*** TURN ***: [Jc 6s 7c] [3s]
Player tutofu84 checks
Player Tilt-A-Whirl bets (3.22)
Player tutofu84 folds
Uncalled bet (3.22) returned to Tilt-A-Whirl
Player Tilt-A-Whirl mucks cards
------ Summary ------
Pot: 4.84. Rake 0.17. JP fee 0.08
Board: [Jc 6s 7c 3s]
Player IlxxxlI does not show cards.Bets: 0. Collects: 0. Wins: 0.
Player Ice Bank Mice Elf does not show cards.Bets: 0.25. Collects: 0. Loses: 0.25.
Player tutofu84 does not show cards.Bets: 2.42. Collects: 0. Loses: 2.42.
Player imperceptible does not show cards.Bets: 0. Collects: 0. Wins: 0.
Player HanktheGrey does not show cards.Bets: 0. Collects: 0. Wins: 0.
Player kid4life does not show cards.Bets: 0. Collects: 0. Wins: 0.
*Player Tilt-A-Whirl mucks (does not show cards). Bets: 2.42. Collects: 4.84. Wins: 2.42.
Player EasyQQ does not show cards.Bets: 0. Collects: 0. Wins: 0.
Game ended at: 2016/11/29 9:9:4

Game started
Game ID: 786781872 0.50/1 (PRR) Karkadann (Hold'em)
Seat 8 is the button
Seat 1: PANDAisEVIL (143.85).
Seat 2: Qrenor (114.07).
Seat 3: Tilt-A-Whirl (101.50).
Seat 4: IlxxxlI (40).
Seat 5: mr.fargo (40).
Seat 6: Log_in (101.88).
Seat 7: PeLanpapa (100).
Seat 8: apoo11 (53.04).
Seat 9: St3p04ka (40).
Player St3p04ka has small blind (0.50)
Player PANDAisEVIL has big blind (1)
Player IlxxxlI received card: [Jd]
Player IlxxxlI received card: [Jc]
Player Qrenor folds
Player Tilt-A-Whirl raises (2)
Player IlxxxlI raises (4.86)
Player mr.fargo folds
Player Log_in calls (4.86)
Player PeLanpapa folds
Player apoo11 calls (4.86)
Player St3p04ka folds
Player PANDAisEVIL folds
Player Tilt-A-Whirl calls (2.86)
*** FLOP ***: [Ac As 5h]
Player Tilt-A-Whirl checks
Player IlxxxlI checks
Player Log_in checks
Player apoo11 checks
*** TURN ***: [Ac As 5h] [3c]
Player Tilt-A-Whirl checks
Player IlxxxlI bets (6.63)
Player Log_in folds
Player apoo11 folds
Player Tilt-A-Whirl calls (6.63)
*** RIVER ***: [Ac As 5h 3c] [8h]
Player Tilt-A-Whirl checks
Player IlxxxlI checks
Player Tilt-A-Whirl mucks cards
------ Summary ------
Pot: 32.49. Rake 1.47. JP fee 0.24
Board: [Ac As 5h 3c 8h]
Player PANDAisEVIL does not show cards.Bets: 1. Collects: 0. Loses: 1.
Player Qrenor does not show cards.Bets: 0. Collects: 0. Wins: 0.
Player Tilt-A-Whirl mucks (does not show cards). Bets: 11.49. Collects: 0. Loses: 11.49.
*Player IlxxxlI shows: Two pairs. As and Js [Jd Jc]. Bets: 11.49. Collects: 32.49. Wins: 21.
Player mr.fargo does not show cards.Bets: 0. Collects: 0. Wins: 0.
Player Log_in does not show cards.Bets: 4.86. Collects: 0. Loses: 4.86.
Player PeLanpapa does not show cards.Bets: 0. Collects: 0. Wins: 0.
Player apoo11 does not show cards.Bets: 4.86. Collects: 0. Loses: 4.86.
Player St3p04ka does not show cards.Bets: 0.50. Collects: 0. Loses: 0.50.
Game ended at: 2016/11/29 9:9:1

Game started
Game ID: 786781712 0.25/0.50 (PRR) Gorgons - 7 (Hold'em)
Seat 4 is the button
Seat 1: 528 Hertz (51.05).
Seat 2: Heksebrygg (50.75).
Seat 3: Dirty4skin (42.84).
Seat 4: FaceMelt (50).
Seat 5: Tilt-A-Whirl (85.26).
Seat 6: IlxxxlI (21.38).
Player Tilt-A-Whirl has small blind (0.25)
Player IlxxxlI has big blind (0.50)
Player IlxxxlI received card: [4h]
Player IlxxxlI received card: [Ad]
Player 528 Hertz folds
Player Heksebrygg folds
Player Dirty4skin folds
Player FaceMelt folds
Player Tilt-A-Whirl raises (0.75)
Player IlxxxlI calls (0.50)
*** FLOP ***: [10d 9s 6s]
Player Tilt-A-Whirl bets (0.95)
Player IlxxxlI folds
Uncalled bet (0.95) returned to Tilt-A-Whirl
Player Tilt-A-Whirl mucks cards
------ Summary ------
Pot: 1.90. Rake 0.08. JP fee 0.02
Board: [10d 9s 6s]
Player 528 Hertz does not show cards.Bets: 0. Collects: 0. Wins: 0.
Player Heksebrygg does not show cards.Bets: 0. Collects: 0. Wins: 0.
Player Dirty4skin does not show cards.Bets: 0. Collects: 0. Wins: 0.
Player FaceMelt does not show cards.Bets: 0. Collects: 0. Wins: 0.
*Player Tilt-A-Whirl mucks (does not show cards). Bets: 1. Collects: 1.90. Wins: 0.90.
Player IlxxxlI does not show cards.Bets: 1. Collects: 0. Loses: 1.
Game ended at: 2016/11/29 9:7:56

Game started
Game ID: 786781602 1/2 (PRR) Longana - 2 (Hold'em)
Seat 2 is the button
Seat 1: IlxxxlI (178.97).
Seat 2: Tilt-A-Whirl (200).
Seat 3: IamPhamous (272.74).
Seat 4: PANDAisEVIL (204.30).
Seat 7: L4zy_FiSh (202).
Seat 8: mr.fargo (157.46).
Seat 9: shokerAAss (200).
Player IamPhamous has small blind (1)
Player PANDAisEVIL has big blind (2)
Player IlxxxlI received card: [5h]
Player IlxxxlI received card: [10s]
Player L4zy_FiSh folds
Player mr.fargo folds
Player shokerAAss folds
Player IlxxxlI folds
Player Tilt-A-Whirl raises (4)
Player IamPhamous folds
Player PANDAisEVIL raises (12.68)
Player Tilt-A-Whirl calls (10.68)
*** FLOP ***: [3d Kd 8s]
Player PANDAisEVIL bets (17.89)
Player Tilt-A-Whirl folds
Uncalled bet (17.89) returned to PANDAisEVIL
Player PANDAisEVIL mucks cards
------ Summary ------
Pot: 28.85. Rake 1.27. JP fee 0.24
Board: [3d Kd 8s]
Player IlxxxlI does not show cards.Bets: 0. Collects: 0. Wins: 0.
Player Tilt-A-Whirl does not show cards.Bets: 14.68. Collects: 0. Loses: 14.68.
Player IamPhamous does not show cards.Bets: 1. Collects: 0. Loses: 1.
*Player PANDAisEVIL mucks (does not show cards). Bets: 14.68. Collects: 28.85. Wins: 14.17.
Player L4zy_FiSh does not show cards.Bets: 0. Collects: 0. Wins: 0.
Player mr.fargo does not show cards.Bets: 0. Collects: 0. Wins: 0.
Player shokerAAss does not show cards.Bets: 0. Collects: 0. Wins: 0.
Game ended at: 2016/11/29 9:7:48

Game started
Game ID: 786781282 0.25/0.50 (PRR) Garuda (Hold'em)
Seat 5 is the button
Seat 1: Aquaman75 (61.53).
Seat 2: IlxxxlI (20.04).
Seat 3: Ice Bank Mice Elf (50.56).
Seat 4: Log_in (13.25).
Seat 5: CumBckMuny (43.14).
Seat 6: XxDominationxX (84.91).
Seat 7: coldkilla (65.24).
Seat 8: gunnfarm (47.25).
Seat 9: OmEGaKuSh (49.50).
Player XxDominationxX has small blind (0.25)
Player coldkilla has big blind (0.50)
Player IlxxxlI received card: [Qc]
Player IlxxxlI received card: [Kc]
Player gunnfarm folds
Player OmEGaKuSh folds
Player Aquaman75 folds
Player IlxxxlI raises (1.75)
Player Ice Bank Mice Elf folds
Player Log_in folds
Player CumBckMuny folds
Player XxDominationxX calls (1.50)
Player coldkilla calls (1.25)
*** FLOP ***: [Kh 7h As]
Player XxDominationxX checks
Player coldkilla bets (2.49)
Player IlxxxlI calls (2.49)
Player XxDominationxX calls (2.49)
*** TURN ***: [Kh 7h As] [6c]
Player XxDominationxX checks
Player coldkilla checks
Player IlxxxlI bets (1)
Player XxDominationxX calls (1)
Player coldkilla calls (1)
*** RIVER ***: [Kh 7h As 6c] [3h]
Player XxDominationxX bets (4.98)
Player coldkilla calls (4.98)
Player IlxxxlI folds
Player coldkilla mucks cards
------ Summary ------
Pot: 24.40. Rake 1.04. JP fee 0.24
Board: [Kh 7h As 6c 3h]
Player Aquaman75 does not show cards.Bets: 0. Collects: 0. Wins: 0.
Player IlxxxlI does not show cards.Bets: 5.24. Collects: 0. Loses: 5.24.
Player Ice Bank Mice Elf does not show cards.Bets: 0. Collects: 0. Wins: 0.
Player Log_in does not show cards.Bets: 0. Collects: 0. Wins: 0.
Player CumBckMuny does not show cards.Bets: 0. Collects: 0. Wins: 0.
*Player XxDominationxX shows: Flush, K high [Jh 9h]. Bets: 10.22. Collects: 24.40. Wins: 14.18.
Player coldkilla mucks (does not show cards). Bets: 10.22. Collects: 0. Loses: 10.22.
Player gunnfarm does not show cards.Bets: 0. Collects: 0. Wins: 0.
Player OmEGaKuSh does not show cards.Bets: 0. Collects: 0. Wins: 0.
Game ended at: 2016/11/29 9:9:0

Game started
Game ID: 786781090 0.25/0.50 (PRR) Gorgons - 7 (Hold'em)
Seat 3 is the button
Seat 1: 528 Hertz (51.05).
Seat 2: Heksebrygg (50).
Seat 3: Dirty4skin (42.84).
Seat 4: FaceMelt (50.25).
Seat 5: Tilt-A-Whirl (85.76).
Seat 6: IlxxxlI (21.38).
Player FaceMelt has small blind (0.25)
Player Tilt-A-Whirl has big blind (0.50)
Player IlxxxlI received card: [5d]
Player IlxxxlI received card: [6s]
Player IlxxxlI folds
Player 528 Hertz folds
Player Heksebrygg raises (1.50)
Player Dirty4skin folds
Player FaceMelt folds
Player Tilt-A-Whirl folds
Uncalled bet (1) returned to Heksebrygg
Player Heksebrygg mucks cards
------ Summary ------
Pot: 1.25. Rake 0
Player 528 Hertz does not show cards.Bets: 0. Collects: 0. Wins: 0.
*Player Heksebrygg mucks (does not show cards). Bets: 0.50. Collects: 1.25. Wins: 0.75.
Player Dirty4skin does not show cards.Bets: 0. Collects: 0. Wins: 0.
Player FaceMelt does not show cards.Bets: 0.25. Collects: 0. Loses: 0.25.
Player Tilt-A-Whirl does not show cards.Bets: 0.50. Collects: 0. Loses: 0.50.
Player IlxxxlI does not show cards.Bets: 0. Collects: 0. Wins: 0.
Game ended at: 2016/11/29 9:6:58

Game started
Game ID: 786781076 1/2 (PRR) Longana - 4 (Hold'em)
Seat 1 is the button
Seat 1: Iia007 (277.87).
Seat 2: IAmClueless (431.23).
Seat 3: PANDAisEVIL (343.97).
Seat 4: mr.fargo (81.70).
Seat 5: L4zy_FiSh (204.55).
Seat 6: IlxxxlI (80).
Seat 7: LazyFish (200).
Seat 8: Gronkowski69 (200).
Seat 9: pokerforfun1 (54.25).
Player IAmClueless has small blind (1)
Player PANDAisEVIL has big blind (2)
Player IlxxxlI received card: [10c]
Player IlxxxlI received card: [8c]
Player mr.fargo folds
Player L4zy_FiSh folds
Player IlxxxlI folds
Player LazyFish folds
Player Gronkowski69 raises (5)
Player pokerforfun1 folds
Player Iia007 folds
Player IAmClueless calls (4)
Player PANDAisEVIL folds
*** FLOP ***: [4s Jh 7s]
Player IAmClueless checks
Player Gronkowski69 bets (7)
Player IAmClueless calls (7)
*** TURN ***: [4s Jh 7s] [Kh]
Player IAmClueless checks
Player Gronkowski69 bets (16)
Player IAmClueless calls (16)
*** RIVER ***: [4s Jh 7s Kh] [Jd]
Player IAmClueless checks
Player Gronkowski69 checks
Player IAmClueless mucks cards
------ Summary ------
Pot: 55.10. Rake 2.66. JP fee 0.24
Board: [4s Jh 7s Kh Jd]
Player Iia007 does not show cards.Bets: 0. Collects: 0. Wins: 0.
Player IAmClueless mucks (does not show cards). Bets: 28. Collects: 0. Loses: 28.
Player PANDAisEVIL does not show cards.Bets: 2. Collects: 0. Loses: 2.
Player mr.fargo does not show cards.Bets: 0. Collects: 0. Wins: 0.
Player L4zy_FiSh does not show cards.Bets: 0. Collects: 0. Wins: 0.
Player IlxxxlI does not show cards.Bets: 0. Collects: 0. Wins: 0.
Player LazyFish does not show cards.Bets: 0. Collects: 0. Wins: 0.
*Player Gronkowski69 shows: Two pairs. Ks and Js [Ad Kd]. Bets: 28. Collects: 55.10. Wins: 27.10.
Player pokerforfun1 does not show cards.Bets: 0. Collects: 0. Wins: 0.
Game ended at: 2016/11/29 9:8:13

Game started
Game ID: 786781064 0.50/1 (PRR) Karkadann (Hold'em)
Seat 7 is the button
Seat 1: PANDAisEVIL (143.85).
Seat 2: Qrenor (114.07).
Seat 3: Tilt-A-Whirl (100).
Seat 4: IlxxxlI (40).
Seat 5: mr.fargo (40).
Seat 6: Log_in (101.88).
Seat 7: PeLanpapa (100).
Seat 8: apoo11 (53.54).
Seat 9: St3p04ka (40).
Player apoo11 has small blind (0.50)
Player St3p04ka has big blind (1)
Player IlxxxlI received card: [Jc]
Player IlxxxlI received card: [4s]
Player PANDAisEVIL folds
Player Qrenor folds
Player Tilt-A-Whirl raises (2)
Player IlxxxlI folds
Player mr.fargo folds
Player Log_in folds
Player PeLanpapa folds
Player apoo11 folds
Player St3p04ka folds
Uncalled bet (1) returned to Tilt-A-Whirl
Player Tilt-A-Whirl mucks cards
------ Summary ------
Pot: 2.50. Rake 0
Player PANDAisEVIL does not show cards.Bets: 0. Collects: 0. Wins: 0.
Player Qrenor does not show cards.Bets: 0. Collects: 0. Wins: 0.
*Player Tilt-A-Whirl mucks (does not show cards). Bets: 1. Collects: 2.50. Wins: 1.50.
Player IlxxxlI does not show cards.Bets: 0. Collects: 0. Wins: 0.
Player mr.fargo does not show cards.Bets: 0. Collects: 0. Wins: 0.
Player Log_in does not show cards.Bets: 0. Collects: 0. Wins: 0.
Player PeLanpapa does not show cards.Bets: 0. Collects: 0. Wins: 0.
Player apoo11 does not show cards.Bets: 0.50. Collects: 0. Loses: 0.50.
Player St3p04ka does not show cards.Bets: 1. Collects: 0. Loses: 1.
Game ended at: 2016/11/29 9:7:10

Game started
Game ID: 786781000 0.25/0.50 (PRR) Garuda - 2 (Hold'em)
Seat 1 is the button
Seat 1: Tilt-A-Whirl (50.85).
Seat 2: apoo11 (81.74).
Seat 3: imperceptible (15.90).
Seat 4: Ice Bank Mice Elf (50).
Seat 5: tutofu84 (91.41).
Seat 6: IlxxxlI (21.75).
Seat 7: coldkilla (20).
Seat 9: kid4life (51.04).
Player apoo11 has small blind (0.25)
Player imperceptible has big blind (0.50)
Player IlxxxlI received card: [As]
Player IlxxxlI received card: [5s]
Player Ice Bank Mice Elf raises (1.50)
Player tutofu84 folds
Player IlxxxlI folds
Player coldkilla calls (1.50)
Player kid4life folds
Player Tilt-A-Whirl folds
Player apoo11 raises (5.25)
Player imperceptible folds
Player Ice Bank Mice Elf calls (4)
Player coldkilla calls (4)
*** FLOP ***: [7s 4d 3s]
Player apoo11 bets (8.07)
Player Ice Bank Mice Elf calls (8.07)
Player coldkilla folds
*** TURN ***: [7s 4d 3s] [Js]
Player apoo11 bets (15.74)
Player Ice Bank Mice Elf allin (36.43)
Player apoo11 calls (20.69)
*** RIVER ***: [7s 4d 3s Js] [7h]
------ Summary ------
Pot: 103. Rake 2.76. JP fee 0.24
Board: [7s 4d 3s Js 7h]
Player Tilt-A-Whirl does not show cards.Bets: 0. Collects: 0. Wins: 0.
Player apoo11 shows: Two pairs. Qs and 7s [Qh Qs]. Bets: 50. Collects: 0. Loses: 50.
Player imperceptible does not show cards.Bets: 0.50. Collects: 0. Loses: 0.50.
*Player Ice Bank Mice Elf shows: Full House (J/7) [Jd Jc]. Bets: 50. Collects: 103. Wins: 53.
Player tutofu84 does not show cards.Bets: 0. Collects: 0. Wins: 0.
Player IlxxxlI does not show cards.Bets: 0. Collects: 0. Wins: 0.
Player coldkilla does not show cards.Bets: 5.50. Collects: 0. Loses: 5.50.
Player kid4life does not show cards.Bets: 0. Collects: 0. Wins: 0.
Game ended at: 2016/11/29 9:8:11

Game started
Game ID: 786780741 0.25/0.50 (PRR) Gorgons - 7 (Hold'em)
Seat 2 is the button
Seat 1: 528 Hertz (51.05).
Seat 2: Heksebrygg (50).
Seat 3: Dirty4skin (43.09).
Seat 4: FaceMelt (50).
Seat 5: Tilt-A-Whirl (85.76).
Seat 6: IlxxxlI (21.38).
Player Dirty4skin has small blind (0.25)
Player FaceMelt has big blind (0.50)
Player IlxxxlI received card: [3h]
Player IlxxxlI received card: [Ks]
Player Tilt-A-Whirl folds
Player IlxxxlI folds
Player 528 Hertz folds
Player Heksebrygg folds
Player Dirty4skin folds
Uncalled bet (0.25) returned to FaceMelt
Player FaceMelt mucks cards
------ Summary ------
Pot: 0.50. Rake 0
Player 528 Hertz does not show cards.Bets: 0. Collects: 0. Wins: 0.
Player Heksebrygg does not show cards.Bets: 0. Collects: 0. Wins: 0.
Player Dirty4skin does not show cards.Bets: 0.25. Collects: 0. Loses: 0.25.
*Player FaceMelt mucks (does not show cards). Bets: 0.25. Collects: 0.50. Wins: 0.25.
Player Tilt-A-Whirl does not show cards.Bets: 0. Collects: 0. Wins: 0.
Player IlxxxlI does not show cards.Bets: 0. Collects: 0. Wins: 0.
Game ended at: 2016/11/29 9:6:20

Game started
Game ID: 786780401 0.25/0.50 (PRR) Garuda - 3 (Hold'em)
Seat 8 is the button
Seat 1: IlxxxlI (20).
Seat 2: Ice Bank Mice Elf (88.23).
Seat 3: tutofu84 (106.76).
Seat 4: imperceptible (23.46).
Seat 5: HanktheGrey (22.87).
Seat 6: kid4life (171.86).
Seat 7: Tilt-A-Whirl (50).
Seat 8: EasyQQ (77.75).
Player IlxxxlI has small blind (0.25)
Player Ice Bank Mice Elf has big blind (0.50)
Player IlxxxlI received card: [Qs]
Player IlxxxlI received card: [Ah]
Player tutofu84 folds
Player imperceptible folds
Player HanktheGrey folds
Player kid4life folds
Player Tilt-A-Whirl folds
Player EasyQQ raises (1.50)
Player IlxxxlI raises (3.55)
Player Ice Bank Mice Elf folds
Player EasyQQ calls (2.30)
*** FLOP ***: [Ad 8s As]
Player IlxxxlI checks
Player EasyQQ bets (3.85)
Player IlxxxlI calls (3.85)
*** TURN ***: [Ad 8s As] [5d]
Player IlxxxlI checks
Player EasyQQ checks
*** RIVER ***: [Ad 8s As 5d] [7c]
Player IlxxxlI allin (12.35)
Player EasyQQ calls (12.35)
------ Summary ------
Pot: 38.48. Rake 1.78. JP fee 0.24
Board: [Ad 8s As 5d 7c]
*Player IlxxxlI shows: Three Of Kind of As [Qs Ah]. Bets: 20. Collects: 38.48. Wins: 18.48.
Player Ice Bank Mice Elf does not show cards.Bets: 0.50. Collects: 0. Loses: 0.50.
Player tutofu84 does not show cards.Bets: 0. Collects: 0. Wins: 0.
Player imperceptible does not show cards.Bets: 0. Collects: 0. Wins: 0.
Player HanktheGrey does not show cards.Bets: 0. Collects: 0. Wins: 0.
Player kid4life does not show cards.Bets: 0. Collects: 0. Wins: 0.
Player Tilt-A-Whirl does not show cards.Bets: 0. Collects: 0. Wins: 0.
Player EasyQQ shows: Two pairs. As and 10s [10s 10d]. Bets: 20. Collects: 0. Loses: 20.
Game ended at: 2016/11/29 9:7:31

Game started
Game ID: 786780325 0.25/0.50 (PRR) Gorgons - 7 (Hold'em)
Seat 1 is the button
Seat 1: 528 Hertz (51.05).
Seat 2: Heksebrygg (50.25).
Seat 3: Dirty4skin (42.84).
Seat 5: Tilt-A-Whirl (85.76).
Seat 6: IlxxxlI (21.38).
Player Heksebrygg has small blind (0.25)
Player Dirty4skin has big blind (0.50)
Player IlxxxlI received card: [8c]
Player IlxxxlI received card: [Ks]
Player Tilt-A-Whirl folds
Player IlxxxlI folds
Player 528 Hertz folds
Player Heksebrygg folds
Uncalled bet (0.25) returned to Dirty4skin
Player Dirty4skin mucks cards
------ Summary ------
Pot: 0.50. Rake 0
Player 528 Hertz does not show cards.Bets: 0. Collects: 0. Wins: 0.
Player Heksebrygg does not show cards.Bets: 0.25. Collects: 0. Loses: 0.25.
*Player Dirty4skin mucks (does not show cards). Bets: 0.25. Collects: 0.50. Wins: 0.25.
Player Tilt-A-Whirl does not show cards.Bets: 0. Collects: 0. Wins: 0.
Player IlxxxlI does not show cards.Bets: 0. Collects: 0. Wins: 0.
Game ended at: 2016/11/29 9:5:59

Game started
Game ID: 786780198 1/2 (PRR) Longana - 4 (Hold'em)
Seat 9 is the button
Seat 1: Iia007 (278.87).
Seat 2: IAmClueless (424.88).
Seat 3: PANDAisEVIL (343.97).
Seat 4: mr.fargo (81.70).
Seat 5: L4zy_FiSh (204.55).
Seat 6: IlxxxlI (80).
Seat 7: LazyFish (200).
Seat 8: Gronkowski69 (200).
Seat 9: pokerforfun1 (60.25).
Player Iia007 has small blind (1)
Player IAmClueless has big blind (2)
Player IlxxxlI received card: [6c]
Player IlxxxlI received card: [5c]
Player PANDAisEVIL folds
Player mr.fargo folds
Player L4zy_FiSh folds
Player IlxxxlI folds
Player LazyFish folds
Player Gronkowski69 folds
Player pokerforfun1 raises (6)
Player Iia007 folds
Player IAmClueless calls (4)
*** FLOP ***: [Qh As Qd]
Player IAmClueless checks
Player pokerforfun1 checks
*** TURN ***: [Qh As Qd] [Jh]
Player IAmClueless bets (6)
Player pokerforfun1 folds
Uncalled bet (6) returned to IAmClueless
Player IAmClueless mucks cards
------ Summary ------
Pot: 12.35. Rake 0.45. JP fee 0.20
Board: [Qh As Qd Jh]
Player Iia007 does not show cards.Bets: 1. Collects: 0. Loses: 1.
*Player IAmClueless mucks (does not show cards). Bets: 6. Collects: 12.35. Wins: 6.35.
Player PANDAisEVIL does not show cards.Bets: 0. Collects: 0. Wins: 0.
Player mr.fargo does not show cards.Bets: 0. Collects: 0. Wins: 0.
Player L4zy_FiSh does not show cards.Bets: 0. Collects: 0. Wins: 0.
Player IlxxxlI does not show cards.Bets: 0. Collects: 0. Wins: 0.
Player LazyFish does not show cards.Bets: 0. Collects: 0. Wins: 0.
Player Gronkowski69 does not show cards.Bets: 0. Collects: 0. Wins: 0.
Player pokerforfun1 does not show cards.Bets: 6. Collects: 0. Loses: 6.
Game ended at: 2016/11/29 9:6:20

Game started
Game ID: 786779937 0.25/0.50 (PRR) Gorgons - 7 (Hold'em)
Seat 6 is the button
Seat 1: 528 Hertz (51.30).
Seat 2: Heksebrygg (50).
Seat 3: Dirty4skin (42.84).
Seat 5: Tilt-A-Whirl (85.76).
Seat 6: IlxxxlI (21.38).
Player 528 Hertz has small blind (0.25)
Player Heksebrygg has big blind (0.50)
Player IlxxxlI received card: [4c]
Player IlxxxlI received card: [3s]
Player Dirty4skin folds
Player Tilt-A-Whirl folds
Player IlxxxlI folds
Player 528 Hertz folds
Uncalled bet (0.25) returned to Heksebrygg
Player Heksebrygg mucks cards
------ Summary ------
Pot: 0.50. Rake 0
Player 528 Hertz does not show cards.Bets: 0.25. Collects: 0. Loses: 0.25.
*Player Heksebrygg mucks (does not show cards). Bets: 0.25. Collects: 0.50. Wins: 0.25.
Player Dirty4skin does not show cards.Bets: 0. Collects: 0. Wins: 0.
Player Tilt-A-Whirl does not show cards.Bets: 0. Collects: 0. Wins: 0.
Player IlxxxlI does not show cards.Bets: 0. Collects: 0. Wins: 0.
Game ended at: 2016/11/29 9:5:33

Game started
Game ID: 786779661 0.50/1 (PRR) Karkadann (Hold'em)
Seat 6 is the button
Seat 1: PANDAisEVIL (143.85).
Seat 2: Qrenor (117.07).
Seat 3: Tilt-A-Whirl (102.30).
Seat 4: IlxxxlI (40).
Seat 5: mr.fargo (41.50).
Seat 6: Log_in (83.05).
Seat 7: PeLanpapa (100.14).
Seat 8: apoo11 (54.54).
Player PeLanpapa has small blind (0.50)
Player apoo11 has big blind (1)
Player IlxxxlI received card: [5s]
Player IlxxxlI received card: [8h]
Player PANDAisEVIL folds
Player Qrenor raises (3)
Player Tilt-A-Whirl calls (3)
Player IlxxxlI folds
Player mr.fargo calls (3)
Player Log_in raises (13)
Player PeLanpapa folds
Player apoo11 folds
Player Qrenor folds
Player Tilt-A-Whirl calls (10)
Player mr.fargo folds
*** FLOP ***: [2d 5d Ac]
Player Tilt-A-Whirl checks
Player Log_in bets (13.50)
Player Tilt-A-Whirl folds
Uncalled bet (13.50) returned to Log_in
Player Log_in mucks cards
------ Summary ------
Pot: 31.83. Rake 1.43. JP fee 0.24
Board: [2d 5d Ac]
Player PANDAisEVIL does not show cards.Bets: 0. Collects: 0. Wins: 0.
Player Qrenor does not show cards.Bets: 3. Collects: 0. Loses: 3.
Player Tilt-A-Whirl does not show cards.Bets: 13. Collects: 0. Loses: 13.
Player IlxxxlI does not show cards.Bets: 0. Collects: 0. Wins: 0.
Player mr.fargo does not show cards.Bets: 3. Collects: 0. Loses: 3.
*Player Log_in mucks (does not show cards). Bets: 13. Collects: 31.83. Wins: 18.83.
Player PeLanpapa does not show cards.Bets: 0.50. Collects: 0. Loses: 0.50.
Player apoo11 does not show cards.Bets: 1. Collects: 0. Loses: 1.
Game ended at: 2016/11/29 9:6:18

Game started
Game ID: 786779552 0.25/0.50 (PRR) Garuda (Hold'em)
Seat 4 is the button
Seat 1: Aquaman75 (62.53).
Seat 2: IlxxxlI (20.04).
Seat 3: Ice Bank Mice Elf (50.56).
Seat 4: Log_in (13.25).
Seat 5: CumBckMuny (44.14).
Seat 6: XxDominationxX (82.58).
Seat 7: coldkilla (65.24).
Seat 8: gunnfarm (47.25).
Seat 9: OmEGaKuSh (50).
Player CumBckMuny has small blind (0.25)
Player XxDominationxX has big blind (0.50)
Player OmEGaKuSh posts (0.50)
Player IlxxxlI received card: [10h]
Player IlxxxlI received card: [Qs]
Player coldkilla folds
Player gunnfarm folds
Player OmEGaKuSh checks
Player Aquaman75 raises (1)
Player IlxxxlI folds
Player Ice Bank Mice Elf folds
Player Log_in folds
Player CumBckMuny calls (0.75)
Player XxDominationxX calls (0.50)
Player OmEGaKuSh folds
*** FLOP ***: [3h 6c Jd]
Player CumBckMuny checks
Player XxDominationxX checks
Player Aquaman75 checks
*** TURN ***: [3h 6c Jd] [4h]
Player CumBckMuny checks
Player XxDominationxX bets (1.66)
Player Aquaman75 folds
Player CumBckMuny folds
Uncalled bet (1.66) returned to XxDominationxX
Player XxDominationxX mucks cards
------ Summary ------
Pot: 3.33. Rake 0.13. JP fee 0.04
Board: [3h 6c Jd 4h]
Player Aquaman75 does not show cards.Bets: 1. Collects: 0. Loses: 1.
Player IlxxxlI does not show cards.Bets: 0. Collects: 0. Wins: 0.
Player Ice Bank Mice Elf does not show cards.Bets: 0. Collects: 0. Wins: 0.
Player Log_in does not show cards.Bets: 0. Collects: 0. Wins: 0.
Player CumBckMuny does not show cards.Bets: 1. Collects: 0. Loses: 1.
*Player XxDominationxX mucks (does not show cards). Bets: 1. Collects: 3.33. Wins: 2.33.
Player coldkilla does not show cards.Bets: 0. Collects: 0. Wins: 0.
Player gunnfarm does not show cards.Bets: 0. Collects: 0. Wins: 0.
Player OmEGaKuSh does not show cards.Bets: 0.50. Collects: 0. Loses: 0.50.
Game ended at: 2016/11/29 9:6:32

Game started
Game ID: 786779357 0.25/0.50 (PRR) Gorgons - 7 (Hold'em)
Seat 5 is the button
Seat 1: 528 Hertz (52.55).
Seat 3: Dirty4skin (42.84).
Seat 5: Tilt-A-Whirl (85.76).
Seat 6: IlxxxlI (20.25).
Player IlxxxlI has small blind (0.25)
Player 528 Hertz has big blind (0.50)
Player IlxxxlI received card: [8s]
Player IlxxxlI received card: [8d]
Player Dirty4skin folds
Player Tilt-A-Whirl folds
Player IlxxxlI raises (1)
Player 528 Hertz calls (0.75)
*** FLOP ***: [Qc Qh 6s]
Player IlxxxlI bets (1.24)
Player 528 Hertz folds
Uncalled bet (1.24) returned to IlxxxlI
Player IlxxxlI mucks cards
------ Summary ------
Pot: 2.38. Rake 0.08. JP fee 0.04
Board: [Qc Qh 6s]
Player 528 Hertz does not show cards.Bets: 1.25. Collects: 0. Loses: 1.25.
Player Dirty4skin does not show cards.Bets: 0. Collects: 0. Wins: 0.
Player Tilt-A-Whirl does not show cards.Bets: 0. Collects: 0. Wins: 0.
*Player IlxxxlI mucks (does not show cards). Bets: 1.25. Collects: 2.38. Wins: 1.13.
Game ended at: 2016/11/29 9:5:10

Game started
Game ID: 786779139 0.25/0.50 (PRR) Garuda - 2 (Hold'em)
Seat 9 is the button
Seat 1: Tilt-A-Whirl (51.10).
Seat 2: apoo11 (82.74).
Seat 3: imperceptible (14.76).
Seat 4: Ice Bank Mice Elf (50).
Seat 5: tutofu84 (91.41).
Seat 6: IlxxxlI (21.75).
Seat 7: coldkilla (20).
Seat 9: kid4life (51.04).
Player Tilt-A-Whirl has small blind (0.25)
Player apoo11 has big blind (0.50)
Player IlxxxlI received card: [7c]
Player IlxxxlI received card: [Ks]
Player imperceptible raises (1)
Player Ice Bank Mice Elf folds
Player tutofu84 folds
Player IlxxxlI folds
Player coldkilla folds
Player kid4life folds
Player Tilt-A-Whirl folds
Player apoo11 calls (0.50)
*** FLOP ***: [5d 6c 10c]
Player apoo11 checks
Player imperceptible bets (1.07)
Player apoo11 folds
Uncalled bet (1.07) returned to imperceptible
Player imperceptible mucks cards
------ Summary ------
Pot: 2.14. Rake 0.09. JP fee 0.02
Board: [5d 6c 10c]
Player Tilt-A-Whirl does not show cards.Bets: 0.25. Collects: 0. Loses: 0.25.
Player apoo11 does not show cards.Bets: 1. Collects: 0. Loses: 1.
*Player imperceptible mucks (does not show cards). Bets: 1. Collects: 2.14. Wins: 1.14.
Player Ice Bank Mice Elf does not show cards.Bets: 0. Collects: 0. Wins: 0.
Player tutofu84 does not show cards.Bets: 0. Collects: 0. Wins: 0.
Player IlxxxlI does not show cards.Bets: 0. Collects: 0. Wins: 0.
Player coldkilla does not show cards.Bets: 0. Collects: 0. Wins: 0.
Player kid4life does not show cards.Bets: 0. Collects: 0. Wins: 0.
Game ended at: 2016/11/29 9:6:14

Game started
Game ID: 786779117 0.25/0.50 (PRR) Gorgons - 7 (Hold'em)
Seat 3 is the button
Seat 1: 528 Hertz (52.55).
Seat 3: Dirty4skin (42.84).
Seat 5: Tilt-A-Whirl (86.01).
Seat 6: IlxxxlI (20).
Player Tilt-A-Whirl has small blind (0.25)
Player IlxxxlI has big blind (0.50)
Player IlxxxlI received card: [4h]
Player IlxxxlI received card: [Qd]
Player 528 Hertz folds
Player Dirty4skin folds
Player Tilt-A-Whirl folds
Uncalled bet (0.25) returned to IlxxxlI
Player IlxxxlI mucks cards
------ Summary ------
Pot: 0.50. Rake 0
Player 528 Hertz does not show cards.Bets: 0. Collects: 0. Wins: 0.
Player Dirty4skin does not show cards.Bets: 0. Collects: 0. Wins: 0.
Player Tilt-A-Whirl does not show cards.Bets: 0.25. Collects: 0. Loses: 0.25.
*Player IlxxxlI mucks (does not show cards). Bets: 0.25. Collects: 0.50. Wins: 0.25.
Game ended at: 2016/11/29 9:4:36

Game started
Game ID: 786778982 0.50/1 (PRR) Karkadann (Hold'em)
Seat 5 is the button
Seat 1: PANDAisEVIL (143.85).
Seat 2: Qrenor (117.07).
Seat 3: Tilt-A-Whirl (102.30).
Seat 4: IlxxxlI (40).
Seat 5: mr.fargo (40).
Seat 6: Log_in (83.55).
Seat 7: PeLanpapa (101.14).
Seat 8: apoo11 (54.54).
Player Log_in has small blind (0.50)
Player PeLanpapa has big blind (1)
Player IlxxxlI received card: [Ad]
Player IlxxxlI received card: [9s]
Player apoo11 folds
Player PANDAisEVIL folds
Player Qrenor folds
Player Tilt-A-Whirl folds
Player IlxxxlI folds
Player mr.fargo raises (2.20)
Player Log_in folds
Player PeLanpapa folds
Uncalled bet (1.20) returned to mr.fargo
Player mr.fargo mucks cards
------ Summary ------
Pot: 2.50. Rake 0
Player PANDAisEVIL does not show cards.Bets: 0. Collects: 0. Wins: 0.
Player Qrenor does not show cards.Bets: 0. Collects: 0. Wins: 0.
Player Tilt-A-Whirl does not show cards.Bets: 0. Collects: 0. Wins: 0.
Player IlxxxlI does not show cards.Bets: 0. Collects: 0. Wins: 0.
*Player mr.fargo mucks (does not show cards). Bets: 1. Collects: 2.50. Wins: 1.50.
Player Log_in does not show cards.Bets: 0.50. Collects: 0. Loses: 0.50.
Player PeLanpapa does not show cards.Bets: 1. Collects: 0. Loses: 1.
Player apoo11 does not show cards.Bets: 0. Collects: 0. Wins: 0.
Game ended at: 2016/11/29 9:4:52

Game started
Game ID: 786778967 1/2 (PRR) Longana - 2 (Hold'em)
Seat 1 is the button
Seat 1: IlxxxlI (184.97).
Seat 2: Tilt-A-Whirl (204.56).
Seat 3: IamPhamous (197.39).
Seat 4: PANDAisEVIL (204.30).
Seat 7: L4zy_FiSh (202).
Seat 8: mr.fargo (157.46).
Seat 9: shokerAAss (200).
Player Tilt-A-Whirl has small blind (1)
Player IamPhamous has big blind (2)
Player IlxxxlI received card: [Kc]
Player IlxxxlI received card: [8h]
Player PANDAisEVIL folds
Player L4zy_FiSh folds
Player mr.fargo folds
Player shokerAAss folds
Player IlxxxlI raises (6)
Player Tilt-A-Whirl calls (5)
Player IamPhamous raises (12)
Player IlxxxlI folds
Player Tilt-A-Whirl calls (8)
*** FLOP ***: [6d 10d 9h]
Player Tilt-A-Whirl checks
Player IamPhamous bets (16.15)
Player Tilt-A-Whirl calls (16.15)
*** TURN ***: [6d 10d 9h] [6h]
Player Tilt-A-Whirl checks
Player IamPhamous bets (42.20)
Player Tilt-A-Whirl calls (42.20)
*** RIVER ***: [6d 10d 9h 6h] [6c]
Player Tilt-A-Whirl checks
Player IamPhamous checks
Player Tilt-A-Whirl mucks cards
------ Summary ------
Pot: 147.70. Rake 2.76. JP fee 0.24
Board: [6d 10d 9h 6h 6c]
Player IlxxxlI does not show cards.Bets: 6. Collects: 0. Loses: 6.
Player Tilt-A-Whirl mucks (does not show cards). Bets: 72.35. Collects: 0. Loses: 72.35.
*Player IamPhamous shows: Three Of Kind of 6s [Qh Ah]. Bets: 72.35. Collects: 147.70. Wins: 75.35.
Player PANDAisEVIL does not show cards.Bets: 0. Collects: 0. Wins: 0.
Player L4zy_FiSh does not show cards.Bets: 0. Collects: 0. Wins: 0.
Player mr.fargo does not show cards.Bets: 0. Collects: 0. Wins: 0.
Player shokerAAss does not show cards.Bets: 0. Collects: 0. Wins: 0.
Game ended at: 2016/11/29 9:6:50

Game started
Game ID: 786778702 0.25/0.50 (PRR) Garuda - 3 (Hold'em)
Seat 7 is the button
Seat 1: IlxxxlI (20).
Seat 2: Ice Bank Mice Elf (88.23).
Seat 3: tutofu84 (106.76).
Seat 4: imperceptible (23.46).
Seat 5: HanktheGrey (22.87).
Seat 6: kid4life (171.86).
Seat 7: Tilt-A-Whirl (50).
Seat 8: EasyQQ (72.75).
Player EasyQQ has small blind (0.25)
Player IlxxxlI has big blind (0.50)
Player IlxxxlI received card: [8d]
Player IlxxxlI received card: [10h]
Player Ice Bank Mice Elf folds
Player tutofu84 folds
Player imperceptible folds
Player HanktheGrey folds
Player kid4life folds
Player Tilt-A-Whirl folds
Player EasyQQ raises (1.25)
Player IlxxxlI calls (1)
*** FLOP ***: [Jh 9h 4s]
Player EasyQQ bets (1.90)
Player IlxxxlI calls (1.90)
*** TURN ***: [Jh 9h 4s] [4d]
Player EasyQQ checks
Player IlxxxlI bets (2.15)
Player EasyQQ calls (2.15)
*** RIVER ***: [Jh 9h 4s 4d] [5s]
Player EasyQQ checks
Player IlxxxlI checks
------ Summary ------
Pot: 10.55. Rake 0.37. JP fee 0.18
Board: [Jh 9h 4s 4d 5s]
Player IlxxxlI shows: One pair of 4s [8d 10h]. Bets: 5.55. Collects: 0. Loses: 5.55.
Player Ice Bank Mice Elf does not show cards.Bets: 0. Collects: 0. Wins: 0.
Player tutofu84 does not show cards.Bets: 0. Collects: 0. Wins: 0.
Player imperceptible does not show cards.Bets: 0. Collects: 0. Wins: 0.
Player HanktheGrey does not show cards.Bets: 0. Collects: 0. Wins: 0.
Player kid4life does not show cards.Bets: 0. Collects: 0. Wins: 0.
Player Tilt-A-Whirl does not show cards.Bets: 0. Collects: 0. Wins: 0.
*Player EasyQQ shows: One pair of 4s (kicker K) [Ks Qh]. Bets: 5.55. Collects: 10.55. Wins: 5.
Game ended at: 2016/11/29 9:5:36

Game started
Game ID: 786778539 0.50/1 (PRR) Karkadann (Hold'em)
Seat 4 is the button
Seat 1: PANDAisEVIL (143.85).
Seat 2: Qrenor (117.07).
Seat 3: Tilt-A-Whirl (102.30).
Seat 4: IlxxxlI (40).
Seat 5: mr.fargo (40).
Seat 6: Log_in (83.05).
Seat 8: apoo11 (54.54).
Player mr.fargo has small blind (0.50)
Player Log_in has big blind (1)
Player IlxxxlI received card: [9h]
Player IlxxxlI received card: [3d]
Player apoo11 folds
Player PANDAisEVIL folds
Player Qrenor folds
Player Tilt-A-Whirl folds
Player IlxxxlI folds
Player mr.fargo folds
Uncalled bet (0.50) returned to Log_in
Player Log_in mucks cards
------ Summary ------
Pot: 1. Rake 0
Player PANDAisEVIL does not show cards.Bets: 0. Collects: 0. Wins: 0.
Player Qrenor does not show cards.Bets: 0. Collects: 0. Wins: 0.
Player Tilt-A-Whirl does not show cards.Bets: 0. Collects: 0. Wins: 0.
Player IlxxxlI does not show cards.Bets: 0. Collects: 0. Wins: 0.
Player mr.fargo does not show cards.Bets: 0.50. Collects: 0. Loses: 0.50.
*Player Log_in mucks (does not show cards). Bets: 0.50. Collects: 1. Wins: 0.50.
Player apoo11 does not show cards.Bets: 0. Collects: 0. Wins: 0.
Game ended at: 2016/11/29 9:4:12

Game started
Game ID: 786778094 0.25/0.50 (PRR) Garuda - 2 (Hold'em)
Seat 7 is the button
Seat 1: Tilt-A-Whirl (51.60).
Seat 2: apoo11 (82.74).
Seat 3: imperceptible (14.76).
Seat 4: Ice Bank Mice Elf (50).
Seat 5: tutofu84 (91.41).
Seat 6: IlxxxlI (21.75).
Seat 7: coldkilla (19.25).
Seat 9: kid4life (51.29).
Player kid4life has small blind (0.25)
Player Tilt-A-Whirl has big blind (0.50)
Player IlxxxlI received card: [Ks]
Player IlxxxlI received card: [7c]
Player apoo11 folds
Player imperceptible folds
Player Ice Bank Mice Elf folds
Player tutofu84 folds
Player IlxxxlI folds
Player coldkilla raises (1)
Player kid4life folds
Player Tilt-A-Whirl folds
Uncalled bet (0.50) returned to coldkilla
Player coldkilla mucks cards
------ Summary ------
Pot: 1.25. Rake 0
Player Tilt-A-Whirl does not show cards.Bets: 0.50. Collects: 0. Loses: 0.50.
Player apoo11 does not show cards.Bets: 0. Collects: 0. Wins: 0.
Player imperceptible does not show cards.Bets: 0. Collects: 0. Wins: 0.
Player Ice Bank Mice Elf does not show cards.Bets: 0. Collects: 0. Wins: 0.
Player tutofu84 does not show cards.Bets: 0. Collects: 0. Wins: 0.
Player IlxxxlI does not show cards.Bets: 0. Collects: 0. Wins: 0.
*Player coldkilla mucks (does not show cards). Bets: 0.50. Collects: 1.25. Wins: 0.75.
Player kid4life does not show cards.Bets: 0.25. Collects: 0. Loses: 0.25.
Game ended at: 2016/11/29 9:4:22

Game started
Game ID: 786778028 0.25/0.50 (PRR) Gorgons - 7 (Hold'em)
Seat 2 is the button
Seat 1: 528 Hertz (52.55).
Seat 2: Heksebrygg (50.59).
Seat 3: Dirty4skin (43.09).
Seat 5: Tilt-A-Whirl (84.76).
Seat 6: IlxxxlI (20).
Player Dirty4skin has small blind (0.25)
Player Tilt-A-Whirl has big blind (0.50)
Player IlxxxlI received card: [4s]
Player IlxxxlI received card: [9c]
Player IlxxxlI is timed out.
Player IlxxxlI folds
Player 528 Hertz folds
Player Heksebrygg raises (1)
Player Dirty4skin folds
Player Tilt-A-Whirl raises (2.50)
Player Heksebrygg is timed out.
Player Heksebrygg folds
Uncalled bet (2) returned to Tilt-A-Whirl
Player Tilt-A-Whirl mucks cards
------ Summary ------
Pot: 2.25. Rake 0
Player 528 Hertz does not show cards.Bets: 0. Collects: 0. Wins: 0.
Player Heksebrygg does not show cards.Bets: 1. Collects: 0. Loses: 1.
Player Dirty4skin does not show cards.Bets: 0.25. Collects: 0. Loses: 0.25.
*Player Tilt-A-Whirl mucks (does not show cards). Bets: 1. Collects: 2.25. Wins: 1.25.
Player IlxxxlI does not show cards.Bets: 0. Collects: 0. Wins: 0.
Game ended at: 2016/11/29 9:4:20

Game started
Game ID: 786777707 0.50/1 (PRR) Karkadann (Hold'em)
Seat 3 is the button
Seat 1: PANDAisEVIL (143.85).
Seat 2: Qrenor (105.16).
Seat 3: Tilt-A-Whirl (102.30).
Seat 4: IlxxxlI (40).
Seat 5: mr.fargo (43).
Seat 6: Log_in (83.05).
Seat 8: apoo11 (54.54).
Player IlxxxlI has small blind (0.50)
Player mr.fargo has big blind (1)
Player IlxxxlI received card: [2h]
Player IlxxxlI received card: [6d]
Player Log_in folds
Player apoo11 folds
Player PANDAisEVIL folds
Player Qrenor raises (2.50)
Player Tilt-A-Whirl folds
Player IlxxxlI folds
Player mr.fargo calls (1.50)
*** FLOP ***: [Ac 10c 2d]
Player mr.fargo checks
Player Qrenor checks
*** TURN ***: [Ac 10c 2d] [9d]
Player mr.fargo bets (3.14)
Player Qrenor calls (3.14)
*** RIVER ***: [Ac 10c 2d 9d] [Ad]
Player mr.fargo bets (7.06)
Player Qrenor calls (7.06)
------ Summary ------
Pot: 24.61. Rake 1.05. JP fee 0.24
Board: [Ac 10c 2d 9d Ad]
Player PANDAisEVIL does not show cards.Bets: 0. Collects: 0. Wins: 0.
*Player Qrenor shows: Two pairs. As and 10s [Kh 10s]. Bets: 12.70. Collects: 24.61. Wins: 11.91.
Player Tilt-A-Whirl does not show cards.Bets: 0. Collects: 0. Wins: 0.
Player IlxxxlI does not show cards.Bets: 0.50. Collects: 0. Loses: 0.50.
Player mr.fargo shows: One pair of As [Jc Kd]. Bets: 12.70. Collects: 0. Loses: 12.70.
Player Log_in does not show cards.Bets: 0. Collects: 0. Wins: 0.
Player apoo11 does not show cards.Bets: 0. Collects: 0. Wins: 0.
Game ended at: 2016/11/29 9:3:43

Game started
Game ID: 786777560 1/2 (PRR) Longana - 2 (Hold'em)
Seat 9 is the button
Seat 1: IlxxxlI (185.97).
Seat 2: Tilt-A-Whirl (208.96).
Seat 3: IamPhamous (197.39).
Seat 4: PANDAisEVIL (204.30).
Seat 7: L4zy_FiSh (202).
Seat 8: mr.fargo (152.55).
Seat 9: shokerAAss (200).
Player IlxxxlI has small blind (1)
Player Tilt-A-Whirl has big blind (2)
Player IlxxxlI received card: [5h]
Player IlxxxlI received card: [Jc]
Player IamPhamous folds
Player PANDAisEVIL folds
Player L4zy_FiSh folds
Player mr.fargo raises (4.40)
Player shokerAAss folds
Player IlxxxlI folds
Player Tilt-A-Whirl calls (2.40)
*** FLOP ***: [Kc 8h 10s]
Player Tilt-A-Whirl checks
Player mr.fargo checks
*** TURN ***: [Kc 8h 10s] [4c]
Player Tilt-A-Whirl checks
Player mr.fargo bets (5.59)
Player Tilt-A-Whirl folds
Uncalled bet (5.59) returned to mr.fargo
Player mr.fargo mucks cards
------ Summary ------
Pot: 9.31. Rake 0.33. JP fee 0.16
Board: [Kc 8h 10s 4c]
Player IlxxxlI does not show cards.Bets: 1. Collects: 0. Loses: 1.
Player Tilt-A-Whirl does not show cards.Bets: 4.40. Collects: 0. Loses: 4.40.
Player IamPhamous does not show cards.Bets: 0. Collects: 0. Wins: 0.
Player PANDAisEVIL does not show cards.Bets: 0. Collects: 0. Wins: 0.
Player L4zy_FiSh does not show cards.Bets: 0. Collects: 0. Wins: 0.
*Player mr.fargo mucks (does not show cards). Bets: 4.40. Collects: 9.31. Wins: 4.91.
Player shokerAAss does not show cards.Bets: 0. Collects: 0. Wins: 0.
Game ended at: 2016/11/29 9:4:12

Game started
Game ID: 786777428 1/2 (PRR) Longana - 4 (Hold'em)
Seat 8 is the button
Seat 1: Iia007 (280.87).
Seat 2: IAmClueless (424.88).
Seat 3: PANDAisEVIL (208.45).
Seat 4: mr.fargo (81.70).
Seat 5: L4zy_FiSh (204.55).
Seat 6: IlxxxlI (80).
Seat 7: LazyFish (295).
Seat 8: Gronkowski69 (200).
Seat 9: pokerforfun1 (61.25).
Player pokerforfun1 has small blind (1)
Player Iia007 has big blind (2)
Player IlxxxlI received card: [6c]
Player IlxxxlI received card: [Kd]
Player IAmClueless folds
Player PANDAisEVIL raises (6)
Player mr.fargo folds
Player L4zy_FiSh folds
Player IlxxxlI folds
Player LazyFish raises (16.50)
Player Gronkowski69 folds
Player pokerforfun1 folds
Player Iia007 folds
Player PANDAisEVIL calls (10.50)
*** FLOP ***: [Ks 9c 8h]
Player PANDAisEVIL checks
Player LazyFish bets (12)
Player PANDAisEVIL calls (12)
*** TURN ***: [Ks 9c 8h] [4s]
Player PANDAisEVIL checks
Player LazyFish bets (32)
Player PANDAisEVIL calls (32)
*** RIVER ***: [Ks 9c 8h 4s] [10s]
Player PANDAisEVIL bets (75.02)
Player LazyFish calls (75.02)
Player LazyFish mucks cards
------ Summary ------
Pot: 271.04. Rake 2.76. JP fee 0.24
Board: [Ks 9c 8h 4s 10s]
Player Iia007 does not show cards.Bets: 2. Collects: 0. Loses: 2.
Player IAmClueless does not show cards.Bets: 0. Collects: 0. Wins: 0.
*Player PANDAisEVIL shows: Flush, K high [5s 6s]. Bets: 135.52. Collects: 271.04. Wins: 135.52.
Player mr.fargo does not show cards.Bets: 0. Collects: 0. Wins: 0.
Player L4zy_FiSh does not show cards.Bets: 0. Collects: 0. Wins: 0.
Player IlxxxlI does not show cards.Bets: 0. Collects: 0. Wins: 0.
Player LazyFish mucks (does not show cards). Bets: 135.52. Collects: 0. Loses: 135.52.
Player Gronkowski69 does not show cards.Bets: 0. Collects: 0. Wins: 0.
Player pokerforfun1 does not show cards.Bets: 1. Collects: 0. Loses: 1.
Game ended at: 2016/11/29 9:5:24

Game started
Game ID: 786777126 0.25/0.50 (PRR) Garuda (Hold'em)
Seat 3 is the button
Seat 1: Aquaman75 (62.53).
Seat 2: IlxxxlI (20.04).
Seat 3: Ice Bank Mice Elf (60.43).
Seat 4: Log_in (13.50).
Seat 5: CumBckMuny (35.01).
Seat 6: XxDominationxX (82.58).
Seat 7: coldkilla (65.24).
Seat 8: gunnfarm (47.25).
Player Log_in has small blind (0.25)
Player CumBckMuny has big blind (0.50)
Player IlxxxlI received card: [4h]
Player IlxxxlI received card: [9c]
Player XxDominationxX folds
Player coldkilla folds
Player gunnfarm folds
Player Aquaman75 folds
Player IlxxxlI folds
Player Ice Bank Mice Elf raises (1)
Player Log_in folds
Player CumBckMuny calls (0.50)
*** FLOP ***: [5c 2s 3s]
Player CumBckMuny checks
Player Ice Bank Mice Elf bets (1.61)
Player CumBckMuny raises (4)
Player Ice Bank Mice Elf calls (2.39)
*** TURN ***: [5c 2s 3s] [10d]
Player CumBckMuny bets (4.87)
Player Ice Bank Mice Elf calls (4.87)
*** RIVER ***: [5c 2s 3s 10d] [Js]
Player CumBckMuny bets (9.50)
Player Ice Bank Mice Elf folds
Uncalled bet (9.50) returned to CumBckMuny
Player CumBckMuny mucks cards
------ Summary ------
Pot: 19. Rake 0.75. JP fee 0.24
Board: [5c 2s 3s 10d Js]
Player Aquaman75 does not show cards.Bets: 0. Collects: 0. Wins: 0.
Player IlxxxlI does not show cards.Bets: 0. Collects: 0. Wins: 0.
Player Ice Bank Mice Elf does not show cards.Bets: 9.87. Collects: 0. Loses: 9.87.
Player Log_in does not show cards.Bets: 0.25. Collects: 0. Loses: 0.25.
*Player CumBckMuny mucks (does not show cards). Bets: 9.87. Collects: 19. Wins: 9.13.
Player XxDominationxX does not show cards.Bets: 0. Collects: 0. Wins: 0.
Player coldkilla does not show cards.Bets: 0. Collects: 0. Wins: 0.
Player gunnfarm does not show cards.Bets: 0. Collects: 0. Wins: 0.
Game ended at: 2016/11/29 9:4:45

Game started
Game ID: 786777113 1/2 (PRR) Longana - 2 (Hold'em)
Seat 8 is the button
Seat 1: IlxxxlI (187.97).
Seat 2: Tilt-A-Whirl (208.96).
Seat 3: IamPhamous (197.39).
Seat 4: PANDAisEVIL (204.30).
Seat 7: L4zy_FiSh (202).
Seat 8: mr.fargo (149.55).
Seat 9: shokerAAss (200).
Player shokerAAss has small blind (1)
Player IlxxxlI has big blind (2)
Player IlxxxlI received card: [Kh]
Player IlxxxlI received card: [4c]
Player Tilt-A-Whirl folds
Player IamPhamous folds
Player PANDAisEVIL folds
Player L4zy_FiSh folds
Player mr.fargo raises (4.40)
Player shokerAAss folds
Player IlxxxlI folds
Uncalled bet (2.40) returned to mr.fargo
Player mr.fargo mucks cards
------ Summary ------
Pot: 5. Rake 0
Player IlxxxlI does not show cards.Bets: 2. Collects: 0. Loses: 2.
Player Tilt-A-Whirl does not show cards.Bets: 0. Collects: 0. Wins: 0.
Player IamPhamous does not show cards.Bets: 0. Collects: 0. Wins: 0.
Player PANDAisEVIL does not show cards.Bets: 0. Collects: 0. Wins: 0.
Player L4zy_FiSh does not show cards.Bets: 0. Collects: 0. Wins: 0.
*Player mr.fargo mucks (does not show cards). Bets: 2. Collects: 5. Wins: 3.
Player shokerAAss does not show cards.Bets: 1. Collects: 0. Loses: 1.
Game ended at: 2016/11/29 9:2:39

Game started
Game ID: 786777056 0.25/0.50 (PRR) Garuda - 2 (Hold'em)
Seat 6 is the button
Seat 1: Tilt-A-Whirl (51.60).
Seat 2: apoo11 (82.74).
Seat 3: imperceptible (14.76).
Seat 4: Ice Bank Mice Elf (50).
Seat 5: tutofu84 (88.18).
Seat 6: IlxxxlI (21.75).
Seat 7: coldkilla (19.50).
Seat 9: kid4life (51.79).
Player coldkilla has small blind (0.25)
Player kid4life has big blind (0.50)
Player IlxxxlI received card: [10s]
Player IlxxxlI received card: [Ah]
Player Tilt-A-Whirl folds
Player apoo11 folds
Player imperceptible folds
Player Ice Bank Mice Elf raises (1.25)
Player tutofu84 calls (1.25)
Player IlxxxlI folds
Player coldkilla folds
Player kid4life folds
*** FLOP ***: [7c 8h Qc]
Player Ice Bank Mice Elf bets (1.54)
Player tutofu84 raises (4.62)
Player Ice Bank Mice Elf folds
Uncalled bet (3.08) returned to tutofu84
Player tutofu84 mucks cards
------ Summary ------
Pot: 6.02. Rake 0.21. JP fee 0.10
Board: [7c 8h Qc]
Player Tilt-A-Whirl does not show cards.Bets: 0. Collects: 0. Wins: 0.
Player apoo11 does not show cards.Bets: 0. Collects: 0. Wins: 0.
Player imperceptible does not show cards.Bets: 0. Collects: 0. Wins: 0.
Player Ice Bank Mice Elf does not show cards.Bets: 2.79. Collects: 0. Loses: 2.79.
*Player tutofu84 mucks (does not show cards). Bets: 2.79. Collects: 6.02. Wins: 3.23.
Player IlxxxlI does not show cards.Bets: 0. Collects: 0. Wins: 0.
Player coldkilla does not show cards.Bets: 0.25. Collects: 0. Loses: 0.25.
Player kid4life does not show cards.Bets: 0.50. Collects: 0. Loses: 0.50.
Game ended at: 2016/11/29 9:3:17

Game started
Game ID: 786776582 0.50/1 (PRR) Karkadann (Hold'em)
Seat 2 is the button
Seat 1: PANDAisEVIL (143.85).
Seat 2: Qrenor (105.16).
Seat 3: Tilt-A-Whirl (100.50).
Seat 4: IlxxxlI (40).
Seat 5: mr.fargo (43).
Seat 6: Log_in (83.05).
Seat 8: apoo11 (54.54).
Player Tilt-A-Whirl has small blind (0.50)
Player IlxxxlI has big blind (1)
Player IlxxxlI received card: [8s]
Player IlxxxlI received card: [Jd]
Player mr.fargo folds
Player Log_in folds
Player apoo11 folds
Player PANDAisEVIL folds
Player Qrenor folds
Player Tilt-A-Whirl raises (1.50)
Player IlxxxlI calls (1)
*** FLOP ***: [8h Ks 5d]
Player Tilt-A-Whirl bets (1.90)
Player IlxxxlI folds
Uncalled bet (1.90) returned to Tilt-A-Whirl
Player Tilt-A-Whirl mucks cards
------ Summary ------
Pot: 3.80. Rake 0.14. JP fee 0.06
Board: [8h Ks 5d]
Player PANDAisEVIL does not show cards.Bets: 0. Collects: 0. Wins: 0.
Player Qrenor does not show cards.Bets: 0. Collects: 0. Wins: 0.
*Player Tilt-A-Whirl mucks (does not show cards). Bets: 2. Collects: 3.80. Wins: 1.80.
Player IlxxxlI does not show cards.Bets: 2. Collects: 0. Loses: 2.
Player mr.fargo does not show cards.Bets: 0. Collects: 0. Wins: 0.
Player Log_in does not show cards.Bets: 0. Collects: 0. Wins: 0.
Player apoo11 does not show cards.Bets: 0. Collects: 0. Wins: 0.
Game ended at: 2016/11/29 9:2:50

Game started
Game ID: 786776453 0.25/0.50 (PRR) Garuda (Hold'em)
Seat 2 is the button
Seat 1: Aquaman75 (62.53).
Seat 2: IlxxxlI (20.04).
Seat 3: Ice Bank Mice Elf (59.93).
Seat 4: Log_in (14).
Seat 5: CumBckMuny (35.01).
Seat 6: XxDominationxX (82.58).
Seat 7: coldkilla (65.24).
Seat 8: gunnfarm (47.25).
Player Ice Bank Mice Elf has small blind (0.25)
Player Log_in has big blind (0.50)
Player IlxxxlI received card: [Js]
Player IlxxxlI received card: [2c]
Player CumBckMuny folds
Player XxDominationxX folds
Player coldkilla folds
Player gunnfarm folds
Player Aquaman75 folds
Player IlxxxlI folds
Player Ice Bank Mice Elf raises (1)
Player Log_in folds
Uncalled bet (0.75) returned to Ice Bank Mice Elf
Player Ice Bank Mice Elf mucks cards
------ Summary ------
Pot: 1. Rake 0
Player Aquaman75 does not show cards.Bets: 0. Collects: 0. Wins: 0.
Player IlxxxlI does not show cards.Bets: 0. Collects: 0. Wins: 0.
*Player Ice Bank Mice Elf mucks (does not show cards). Bets: 0.50. Collects: 1. Wins: 0.50.
Player Log_in does not show cards.Bets: 0.50. Collects: 0. Loses: 0.50.
Player CumBckMuny does not show cards.Bets: 0. Collects: 0. Wins: 0.
Player XxDominationxX does not show cards.Bets: 0. Collects: 0. Wins: 0.
Player coldkilla does not show cards.Bets: 0. Collects: 0. Wins: 0.
Player gunnfarm does not show cards.Bets: 0. Collects: 0. Wins: 0.
Game ended at: 2016/11/29 9:2:8

Game started
Game ID: 786776409 1/2 (PRR) Longana - 2 (Hold'em)
Seat 7 is the button
Seat 1: IlxxxlI (187.97).
Seat 2: Tilt-A-Whirl (212.96).
Seat 3: IamPhamous (190.39).
Seat 4: PANDAisEVIL (204.30).
Seat 7: L4zy_FiSh (202).
Seat 8: mr.fargo (150.55).
Seat 9: shokerAAss (200).
Player mr.fargo has small blind (1)
Player shokerAAss has big blind (2)
Player IlxxxlI received card: [Qs]
Player IlxxxlI received card: [6s]
Player IlxxxlI folds
Player Tilt-A-Whirl raises (4)
Player IamPhamous raises (12)
Player PANDAisEVIL folds
Player L4zy_FiSh folds
Player mr.fargo folds
Player shokerAAss folds
Player Tilt-A-Whirl folds
Uncalled bet (8) returned to IamPhamous
Player IamPhamous mucks cards
------ Summary ------
Pot: 11. Rake 0
Player IlxxxlI does not show cards.Bets: 0. Collects: 0. Wins: 0.
Player Tilt-A-Whirl does not show cards.Bets: 4. Collects: 0. Loses: 4.
*Player IamPhamous mucks (does not show cards). Bets: 4. Collects: 11. Wins: 7.
Player PANDAisEVIL does not show cards.Bets: 0. Collects: 0. Wins: 0.
Player L4zy_FiSh does not show cards.Bets: 0. Collects: 0. Wins: 0.
Player mr.fargo does not show cards.Bets: 1. Collects: 0. Loses: 1.
Player shokerAAss does not show cards.Bets: 2. Collects: 0. Loses: 2.
Game ended at: 2016/11/29 9:2:8

Game started
Game ID: 786776365 1/2 (PRR) Longana - 4 (Hold'em)
Seat 7 is the button
Seat 2: IAmClueless (422.13).
Seat 3: PANDAisEVIL (208.45).
Seat 4: mr.fargo (81.70).
Seat 5: L4zy_FiSh (204.55).
Seat 6: IlxxxlI (80).
Seat 7: LazyFish (295).
Seat 8: Gronkowski69 (200).
Seat 9: pokerforfun1 (63.25).
Player Gronkowski69 has small blind (1)
Player pokerforfun1 has big blind (2)
Player IlxxxlI received card: [2s]
Player IlxxxlI received card: [As]
Player IAmClueless calls (2)
Player PANDAisEVIL folds
Player mr.fargo folds
Player L4zy_FiSh folds
Player IlxxxlI folds
Player LazyFish folds
Player Gronkowski69 folds
Player pokerforfun1 checks
*** FLOP ***: [Ah Qh 4h]
Player pokerforfun1 checks
Player IAmClueless bets (6)
Player pokerforfun1 folds
Uncalled bet (6) returned to IAmClueless
Player IAmClueless mucks cards
------ Summary ------
Pot: 4.75. Rake 0.17. JP fee 0.08
Board: [Ah Qh 4h]
*Player IAmClueless mucks (does not show cards). Bets: 2. Collects: 4.75. Wins: 2.75.
Player PANDAisEVIL does not show cards.Bets: 0. Collects: 0. Wins: 0.
Player mr.fargo does not show cards.Bets: 0. Collects: 0. Wins: 0.
Player L4zy_FiSh does not show cards.Bets: 0. Collects: 0. Wins: 0.
Player IlxxxlI does not show cards.Bets: 0. Collects: 0. Wins: 0.
Player LazyFish does not show cards.Bets: 0. Collects: 0. Wins: 0.
Player Gronkowski69 does not show cards.Bets: 1. Collects: 0. Loses: 1.
Player pokerforfun1 does not show cards.Bets: 2. Collects: 0. Loses: 2.
Game ended at: 2016/11/29 9:2:31

Game started
Game ID: 786776260 0.25/0.50 (PRR) Garuda - 2 (Hold'em)
Seat 5 is the button
Seat 1: Tilt-A-Whirl (51.60).
Seat 2: apoo11 (82.74).
Seat 3: imperceptible (14.76).
Seat 4: Ice Bank Mice Elf (50).
Seat 5: tutofu84 (88.18).
Seat 6: IlxxxlI (20).
Seat 7: coldkilla (20).
Seat 8: Aquaman75 (70.33).
Seat 9: kid4life (51.79).
Player IlxxxlI has small blind (0.25)
Player coldkilla has big blind (0.50)
Player IlxxxlI received card: [8d]
Player IlxxxlI received card: [8c]
Player Aquaman75 folds
Player kid4life folds
Player Tilt-A-Whirl folds
Player apoo11 folds
Player imperceptible folds
Player Ice Bank Mice Elf raises (1.25)
Player tutofu84 folds
Player IlxxxlI raises (2.94)
Player coldkilla folds
Player Ice Bank Mice Elf folds
Uncalled bet (1.94) returned to IlxxxlI
Player IlxxxlI mucks cards
------ Summary ------
Pot: 3. Rake 0
Player Tilt-A-Whirl does not show cards.Bets: 0. Collects: 0. Wins: 0.
Player apoo11 does not show cards.Bets: 0. Collects: 0. Wins: 0.
Player imperceptible does not show cards.Bets: 0. Collects: 0. Wins: 0.
Player Ice Bank Mice Elf does not show cards.Bets: 1.25. Collects: 0. Loses: 1.25.
Player tutofu84 does not show cards.Bets: 0. Collects: 0. Wins: 0.
*Player IlxxxlI mucks (does not show cards). Bets: 1.25. Collects: 3. Wins: 1.75.
Player coldkilla does not show cards.Bets: 0.50. Collects: 0. Loses: 0.50.
Player Aquaman75 does not show cards.Bets: 0. Collects: 0. Wins: 0.
Player kid4life does not show cards.Bets: 0. Collects: 0. Wins: 0.
Game ended at: 2016/11/29 9:2:3

Game started
Game ID: 786776265 0.25/0.50 (PRR) Gorgons - 7 (Hold'em)
Seat 1 is the button
Seat 1: 528 Hertz (52.55).
Seat 2: Heksebrygg (50.84).
Seat 3: Dirty4skin (43.59).
Seat 5: Tilt-A-Whirl (74.35).
Seat 6: IlxxxlI (20).
Player Heksebrygg has small blind (0.25)
Player Dirty4skin has big blind (0.50)
Player IlxxxlI received card: [Ad]
Player IlxxxlI received card: [Qd]
Player Tilt-A-Whirl raises (1.50)
Player IlxxxlI calls (1.50)
Player 528 Hertz folds
Player Heksebrygg folds
Player Dirty4skin folds
*** FLOP ***: [8c 5h Qs]
Player Tilt-A-Whirl bets (1.78)
Player IlxxxlI calls (1.78)
*** TURN ***: [8c 5h Qs] [4c]
Player Tilt-A-Whirl checks
Player IlxxxlI bets (4)
Player Tilt-A-Whirl calls (4)
*** RIVER ***: [8c 5h Qs 4c] [Kh]
Player Tilt-A-Whirl checks
Player IlxxxlI bets (3.49)
Player Tilt-A-Whirl raises (20.94)
Player IlxxxlI folds
Uncalled bet (17.45) returned to Tilt-A-Whirl
Player Tilt-A-Whirl mucks cards
------ Summary ------
Pot: 21.18. Rake 0.87. JP fee 0.24
Board: [8c 5h Qs 4c Kh]
Player 528 Hertz does not show cards.Bets: 0. Collects: 0. Wins: 0.
Player Heksebrygg does not show cards.Bets: 0.25. Collects: 0. Loses: 0.25.
Player Dirty4skin does not show cards.Bets: 0.50. Collects: 0. Loses: 0.50.
*Player Tilt-A-Whirl mucks (does not show cards). Bets: 10.77. Collects: 21.18. Wins: 10.41.
Player IlxxxlI does not show cards.Bets: 10.77. Collects: 0. Loses: 10.77.
Game ended at: 2016/11/29 9:3:12

Game started
Game ID: 786776118 1/2 (PRR) Longana - 2 (Hold'em)
Seat 4 is the button
Seat 1: IlxxxlI (187.97).
Seat 2: Tilt-A-Whirl (212.96).
Seat 3: IamPhamous (190.39).
Seat 4: PANDAisEVIL (204.30).
Seat 7: L4zy_FiSh (200).
Seat 8: mr.fargo (152.55).
Seat 9: shokerAAss (200).
Player L4zy_FiSh has small blind (1)
Player mr.fargo has big blind (2)
Player IlxxxlI received card: [10c]
Player IlxxxlI received card: [4c]
Player shokerAAss folds
Player IlxxxlI folds
Player Tilt-A-Whirl folds
Player IamPhamous folds
Player PANDAisEVIL folds
Player L4zy_FiSh raises (3)
Player mr.fargo folds
Uncalled bet (2) returned to L4zy_FiSh
Player L4zy_FiSh mucks cards
------ Summary ------
Pot: 4. Rake 0
Player IlxxxlI does not show cards.Bets: 0. Collects: 0. Wins: 0.
Player Tilt-A-Whirl does not show cards.Bets: 0. Collects: 0. Wins: 0.
Player IamPhamous does not show cards.Bets: 0. Collects: 0. Wins: 0.
Player PANDAisEVIL does not show cards.Bets: 0. Collects: 0. Wins: 0.
*Player L4zy_FiSh mucks (does not show cards). Bets: 2. Collects: 4. Wins: 2.
Player mr.fargo does not show cards.Bets: 2. Collects: 0. Loses: 2.
Player shokerAAss does not show cards.Bets: 0. Collects: 0. Wins: 0.
Game ended at: 2016/11/29 9:1:25

Game started
Game ID: 786775797 1/2 (PRR) Longana - 2 (Hold'em)
Seat 3 is the button
Seat 1: IlxxxlI (187.97).
Seat 2: Tilt-A-Whirl (212.96).
Seat 3: IamPhamous (187.39).
Seat 4: PANDAisEVIL (205.30).
Seat 5: Iia007 (215.24).
Seat 6: 322xxx (200).
Seat 7: L4zy_FiSh (200).
Seat 8: mr.fargo (152.55).
Seat 9: shokerAAss (200).
Player PANDAisEVIL has small blind (1)
Player Iia007 sitting out
Player 322xxx sitting out
Player L4zy_FiSh has big blind (2)
Player IlxxxlI received card: [9c]
Player IlxxxlI received card: [Qd]
Player mr.fargo folds
Player shokerAAss folds
Player IlxxxlI folds
Player Tilt-A-Whirl folds
Player IamPhamous raises (6)
Player PANDAisEVIL folds
Player L4zy_FiSh folds
Uncalled bet (4) returned to IamPhamous
Player IamPhamous mucks cards
------ Summary ------
Pot: 5. Rake 0
Player IlxxxlI does not show cards.Bets: 0. Collects: 0. Wins: 0.
Player Tilt-A-Whirl does not show cards.Bets: 0. Collects: 0. Wins: 0.
*Player IamPhamous mucks (does not show cards). Bets: 2. Collects: 5. Wins: 3.
Player PANDAisEVIL does not show cards.Bets: 1. Collects: 0. Loses: 1.
Player Iia007 does not show cards.Bets: 0. Collects: 0. Wins: 0.
Player 322xxx does not show cards.Bets: 0. Collects: 0. Wins: 0.
Player L4zy_FiSh does not show cards.Bets: 2. Collects: 0. Loses: 2.
Player mr.fargo does not show cards.Bets: 0. Collects: 0. Wins: 0.
Player shokerAAss does not show cards.Bets: 0. Collects: 0. Wins: 0.
Game ended at: 2016/11/29 9:1:0

Game started
Game ID: 786775789 0.25/0.50 (PRR) Garuda (Hold'em)
Seat 1 is the button
Seat 1: Aquaman75 (63.53).
Seat 2: IlxxxlI (20.29).
Seat 3: Ice Bank Mice Elf (60.43).
Seat 4: Log_in (14).
Seat 5: CumBckMuny (35.01).
Seat 6: XxDominationxX (82.58).
Seat 7: coldkilla (63.62).
Seat 8: gunnfarm (47.25).
Player IlxxxlI has small blind (0.25)
Player Ice Bank Mice Elf has big blind (0.50)
Player IlxxxlI received card: [9c]
Player IlxxxlI received card: [10c]
Player Log_in folds
Player CumBckMuny folds
Player XxDominationxX folds
Player coldkilla raises (1)
Player gunnfarm folds
Player Aquaman75 calls (1)
Player IlxxxlI folds
Player Ice Bank Mice Elf folds
*** FLOP ***: [10s 4s Qd]
Player coldkilla bets (1.31)
Player Aquaman75 folds
Uncalled bet (1.31) returned to coldkilla
Player coldkilla mucks cards
------ Summary ------
Pot: 2.62. Rake 0.09. JP fee 0.04
Board: [10s 4s Qd]
Player Aquaman75 does not show cards.Bets: 1. Collects: 0. Loses: 1.
Player IlxxxlI does not show cards.Bets: 0.25. Collects: 0. Loses: 0.25.
Player Ice Bank Mice Elf does not show cards.Bets: 0.50. Collects: 0. Loses: 0.50.
Player Log_in does not show cards.Bets: 0. Collects: 0. Wins: 0.
Player CumBckMuny does not show cards.Bets: 0. Collects: 0. Wins: 0.
Player XxDominationxX does not show cards.Bets: 0. Collects: 0. Wins: 0.
*Player coldkilla mucks (does not show cards). Bets: 1. Collects: 2.62. Wins: 1.62.
Player gunnfarm does not show cards.Bets: 0. Collects: 0. Wins: 0.
Game ended at: 2016/11/29 9:1:27

Game started
Game ID: 786775466 0.25/0.50 (PRR) Gorgons - 7 (Hold'em)
Seat 6 is the button
Seat 1: 528 Hertz (50.25).
Seat 2: Heksebrygg (51.84).
Seat 3: Dirty4skin (43.59).
Seat 5: Tilt-A-Whirl (74.35).
Seat 6: IlxxxlI (20.23).
Player 528 Hertz has small blind (0.25)
Player Heksebrygg has big blind (0.50)
Player IlxxxlI received card: [2s]
Player IlxxxlI received card: [Ac]
Player Dirty4skin folds
Player Tilt-A-Whirl folds
Player IlxxxlI raises (1)
Player 528 Hertz calls (0.75)
Player Heksebrygg calls (0.50)
*** FLOP ***: [5d Jh Ks]
Player 528 Hertz checks
Player Heksebrygg checks
Player IlxxxlI bets (0.50)
Player 528 Hertz calls (0.50)
Player Heksebrygg folds
*** TURN ***: [5d Jh Ks] [10d]
Player 528 Hertz checks
Player IlxxxlI checks
*** RIVER ***: [5d Jh Ks 10d] [8d]
Player 528 Hertz bets (1.90)
Player IlxxxlI folds
Uncalled bet (1.90) returned to 528 Hertz
Player 528 Hertz mucks cards
------ Summary ------
Pot: 3.80. Rake 0.14. JP fee 0.06
Board: [5d Jh Ks 10d 8d]
*Player 528 Hertz mucks (does not show cards). Bets: 1.50. Collects: 3.80. Wins: 2.30.
Player Heksebrygg does not show cards.Bets: 1. Collects: 0. Loses: 1.
Player Dirty4skin does not show cards.Bets: 0. Collects: 0. Wins: 0.
Player Tilt-A-Whirl does not show cards.Bets: 0. Collects: 0. Wins: 0.
Player IlxxxlI does not show cards.Bets: 1.50. Collects: 0. Loses: 1.50.
Game ended at: 2016/11/29 9:1:13

Game started
Game ID: 786775410 1/2 (PRR) Longana - 4 (Hold'em)
Seat 6 is the button
Seat 2: IAmClueless (422.13).
Seat 3: PANDAisEVIL (208.45).
Seat 4: mr.fargo (81.70).
Seat 5: L4zy_FiSh (200).
Seat 6: IlxxxlI (80).
Seat 7: LazyFish (296).
Seat 8: Gronkowski69 (200).
Seat 9: pokerforfun1 (63.25).
Player LazyFish has small blind (1)
Player Gronkowski69 has big blind (2)
Player IlxxxlI received card: [2d]
Player IlxxxlI received card: [7d]
Player pokerforfun1 folds
Player IAmClueless folds
Player PANDAisEVIL folds
Player mr.fargo folds
Player L4zy_FiSh raises (4)
Player IlxxxlI folds
Player LazyFish folds
Player Gronkowski69 calls (2)
*** FLOP ***: [5h Qd 10s]
Player Gronkowski69 checks
Player L4zy_FiSh bets (4.27)
Player Gronkowski69 folds
Uncalled bet (4.27) returned to L4zy_FiSh
Player L4zy_FiSh mucks cards
------ Summary ------
Pot: 8.55. Rake 0.31. JP fee 0.14
Board: [5h Qd 10s]
Player IAmClueless does not show cards.Bets: 0. Collects: 0. Wins: 0.
Player PANDAisEVIL does not show cards.Bets: 0. Collects: 0. Wins: 0.
Player mr.fargo does not show cards.Bets: 0. Collects: 0. Wins: 0.
*Player L4zy_FiSh mucks (does not show cards). Bets: 4. Collects: 8.55. Wins: 4.55.
Player IlxxxlI does not show cards.Bets: 0. Collects: 0. Wins: 0.
Player LazyFish does not show cards.Bets: 1. Collects: 0. Loses: 1.
Player Gronkowski69 does not show cards.Bets: 4. Collects: 0. Loses: 4.
Player pokerforfun1 does not show cards.Bets: 0. Collects: 0. Wins: 0.
Game ended at: 2016/11/29 9:1:21

Game started
Game ID: 786775391 1/2 (PRR) Longana - 2 (Hold'em)
Seat 2 is the button
Seat 1: IlxxxlI (187.97).
Seat 2: Tilt-A-Whirl (212.96).
Seat 3: IamPhamous (188.39).
Seat 4: PANDAisEVIL (207.30).
Seat 5: Iia007 (215.24).
Seat 6: 322xxx (200).
Seat 7: L4zy_FiSh (200).
Seat 8: mr.fargo (143.55).
Seat 9: shokerAAss (200).
Player IamPhamous has small blind (1)
Player PANDAisEVIL has big blind (2)
Player IlxxxlI received card: [3c]
Player IlxxxlI received card: [5h]
Player Iia007 folds
Player 322xxx folds
Player L4zy_FiSh raises (6)
Player mr.fargo raises (16.20)
Player shokerAAss folds
Player IlxxxlI folds
Player Tilt-A-Whirl folds
Player IamPhamous folds
Player PANDAisEVIL folds
Player L4zy_FiSh folds
Uncalled bet (10.20) returned to mr.fargo
Player mr.fargo mucks cards
------ Summary ------
Pot: 15. Rake 0
Player IlxxxlI does not show cards.Bets: 0. Collects: 0. Wins: 0.
Player Tilt-A-Whirl does not show cards.Bets: 0. Collects: 0. Wins: 0.
Player IamPhamous does not show cards.Bets: 1. Collects: 0. Loses: 1.
Player PANDAisEVIL does not show cards.Bets: 2. Collects: 0. Loses: 2.
Player Iia007 does not show cards.Bets: 0. Collects: 0. Wins: 0.
Player 322xxx does not show cards.Bets: 0. Collects: 0. Wins: 0.
Player L4zy_FiSh does not show cards.Bets: 6. Collects: 0. Loses: 6.
*Player mr.fargo mucks (does not show cards). Bets: 6. Collects: 15. Wins: 9.
Player shokerAAss does not show cards.Bets: 0. Collects: 0. Wins: 0.
Game ended at: 2016/11/29 9:0:33

Game started
Game ID: 786775229 0.25/0.50 (PRR) Gorgons - 7 (Hold'em)
Seat 5 is the button
Seat 1: 528 Hertz (50.75).
Seat 2: Heksebrygg (51.84).
Seat 3: Dirty4skin (42.84).
Seat 5: Tilt-A-Whirl (74.35).
Seat 6: IlxxxlI (20.48).
Player IlxxxlI has small blind (0.25)
Player 528 Hertz has big blind (0.50)
Player IlxxxlI received card: [2h]
Player IlxxxlI received card: [9h]
Player Heksebrygg folds
Player Dirty4skin raises (1.50)
Player Tilt-A-Whirl folds
Player IlxxxlI folds
Player 528 Hertz folds
Uncalled bet (1) returned to Dirty4skin
Player Dirty4skin mucks cards
------ Summary ------
Pot: 1.25. Rake 0
Player 528 Hertz does not show cards.Bets: 0.50. Collects: 0. Loses: 0.50.
Player Heksebrygg does not show cards.Bets: 0. Collects: 0. Wins: 0.
*Player Dirty4skin mucks (does not show cards). Bets: 0.50. Collects: 1.25. Wins: 0.75.
Player Tilt-A-Whirl does not show cards.Bets: 0. Collects: 0. Wins: 0.
Player IlxxxlI does not show cards.Bets: 0.25. Collects: 0. Loses: 0.25.
Game ended at: 2016/11/29 8:59:55

Game started
Game ID: 786775232 0.25/0.50 (PRR) Garuda (Hold'em)
Seat 8 is the button
Seat 1: Aquaman75 (63.78).
Seat 2: IlxxxlI (20.79).
Seat 3: Ice Bank Mice Elf (60.43).
Seat 4: Log_in (14).
Seat 5: CumBckMuny (35.01).
Seat 6: XxDominationxX (80.51).
Seat 7: coldkilla (65.12).
Seat 8: gunnfarm (47.25).
Player Aquaman75 has small blind (0.25)
Player IlxxxlI has big blind (0.50)
Player IlxxxlI received card: [5h]
Player IlxxxlI received card: [10c]
Player Ice Bank Mice Elf folds
Player Log_in folds
Player CumBckMuny folds
Player XxDominationxX raises (1.50)
Player coldkilla calls (1.50)
Player gunnfarm folds
Player Aquaman75 folds
Player IlxxxlI folds
*** FLOP ***: [8c Ah 5c]
Player XxDominationxX bets (2.38)
Player coldkilla folds
Uncalled bet (2.38) returned to XxDominationxX
Player XxDominationxX mucks cards
------ Summary ------
Pot: 3.57. Rake 0.12. JP fee 0.06
Board: [8c Ah 5c]
Player Aquaman75 does not show cards.Bets: 0.25. Collects: 0. Loses: 0.25.
Player IlxxxlI does not show cards.Bets: 0.50. Collects: 0. Loses: 0.50.
Player Ice Bank Mice Elf does not show cards.Bets: 0. Collects: 0. Wins: 0.
Player Log_in does not show cards.Bets: 0. Collects: 0. Wins: 0.
Player CumBckMuny does not show cards.Bets: 0. Collects: 0. Wins: 0.
*Player XxDominationxX mucks (does not show cards). Bets: 1.50. Collects: 3.57. Wins: 2.07.
Player coldkilla does not show cards.Bets: 1.50. Collects: 0. Loses: 1.50.
Player gunnfarm does not show cards.Bets: 0. Collects: 0. Wins: 0.
Game ended at: 2016/11/29 9:0:31

Game started
Game ID: 786775061 0.25/0.50 (PRR) Garuda - 2 (Hold'em)
Seat 4 is the button
Seat 1: Tilt-A-Whirl (51.60).
Seat 2: apoo11 (82.74).
Seat 3: imperceptible (14.76).
Seat 4: Ice Bank Mice Elf (50).
Seat 5: tutofu84 (89.39).
Seat 6: IlxxxlI (20).
Seat 8: Aquaman75 (70.33).
Seat 9: kid4life (50.22).
Player tutofu84 has small blind (0.25)
Player IlxxxlI has big blind (0.50)
Player IlxxxlI received card: [5d]
Player IlxxxlI received card: [8h]
Player Aquaman75 folds
Player kid4life calls (0.50)
Player Tilt-A-Whirl folds
Player apoo11 folds
Player imperceptible folds
Player Ice Bank Mice Elf folds
Player tutofu84 calls (0.25)
Player IlxxxlI checks
*** FLOP ***: [Jd 7d 7h]
Player tutofu84 checks
Player IlxxxlI checks
Player kid4life checks
*** TURN ***: [Jd 7d 7h] [Ad]
Player tutofu84 bets (0.71)
Player IlxxxlI folds
Player kid4life calls (0.71)
*** RIVER ***: [Jd 7d 7h Ad] [8d]
Player tutofu84 checks
Player kid4life bets (1.85)
Player tutofu84 folds
Uncalled bet (1.85) returned to kid4life
Player kid4life mucks cards
------ Summary ------
Pot: 2.78. Rake 0.10. JP fee 0.04
Board: [Jd 7d 7h Ad 8d]
Player Tilt-A-Whirl does not show cards.Bets: 0. Collects: 0. Wins: 0.
Player apoo11 does not show cards.Bets: 0. Collects: 0. Wins: 0.
Player imperceptible does not show cards.Bets: 0. Collects: 0. Wins: 0.
Player Ice Bank Mice Elf does not show cards.Bets: 0. Collects: 0. Wins: 0.
Player tutofu84 does not show cards.Bets: 1.21. Collects: 0. Loses: 1.21.
Player IlxxxlI does not show cards.Bets: 0.50. Collects: 0. Loses: 0.50.
Player Aquaman75 does not show cards.Bets: 0. Collects: 0. Wins: 0.
*Player kid4life mucks (does not show cards). Bets: 1.21. Collects: 2.78. Wins: 1.57.
Game ended at: 2016/11/29 9:1:13

Game started
Game ID: 786774996 1/2 (PRR) Longana - 4 (Hold'em)
Seat 5 is the button
Seat 2: IAmClueless (419.13).
Seat 3: PANDAisEVIL (208.45).
Seat 4: mr.fargo (81.70).
Seat 5: L4zy_FiSh (200).
Seat 6: IlxxxlI (80).
Seat 7: LazyFish (298).
Seat 8: Gronkowski69 (200).
Seat 9: pokerforfun1 (63.25).
Player IlxxxlI has small blind (1)
Player LazyFish has big blind (2)
Player IlxxxlI received card: [7d]
Player IlxxxlI received card: [Ah]
Player Gronkowski69 folds
Player pokerforfun1 folds
Player IAmClueless raises (6)
Player PANDAisEVIL folds
Player mr.fargo folds
Player L4zy_FiSh folds
Player IlxxxlI folds
Player LazyFish folds
Uncalled bet (4) returned to IAmClueless
Player IAmClueless mucks cards
------ Summary ------
Pot: 5. Rake 0
*Player IAmClueless mucks (does not show cards). Bets: 2. Collects: 5. Wins: 3.
Player PANDAisEVIL does not show cards.Bets: 0. Collects: 0. Wins: 0.
Player mr.fargo does not show cards.Bets: 0. Collects: 0. Wins: 0.
Player L4zy_FiSh does not show cards.Bets: 0. Collects: 0. Wins: 0.
Player IlxxxlI does not show cards.Bets: 1. Collects: 0. Loses: 1.
Player LazyFish does not show cards.Bets: 2. Collects: 0. Loses: 2.
Player Gronkowski69 does not show cards.Bets: 0. Collects: 0. Wins: 0.
Player pokerforfun1 does not show cards.Bets: 0. Collects: 0. Wins: 0.
Game ended at: 2016/11/29 8:59:50

Game started
Game ID: 786774898 0.25/0.50 (PRR) Gorgons - 7 (Hold'em)
Seat 3 is the button
Seat 1: 528 Hertz (50.75).
Seat 2: Heksebrygg (51.84).
Seat 3: Dirty4skin (44.34).
Seat 5: Tilt-A-Whirl (72.35).
Seat 6: IlxxxlI (20.98).
Player Tilt-A-Whirl has small blind (0.25)
Player IlxxxlI has big blind (0.50)
Player IlxxxlI received card: [3h]
Player IlxxxlI received card: [2h]
Player 528 Hertz folds
Player Heksebrygg folds
Player Dirty4skin raises (1.50)
Player Tilt-A-Whirl raises (4.25)
Player IlxxxlI folds
Player Dirty4skin folds
Uncalled bet (3) returned to Tilt-A-Whirl
Player Tilt-A-Whirl mucks cards
------ Summary ------
Pot: 3.50. Rake 0
Player 528 Hertz does not show cards.Bets: 0. Collects: 0. Wins: 0.
Player Heksebrygg does not show cards.Bets: 0. Collects: 0. Wins: 0.
Player Dirty4skin does not show cards.Bets: 1.50. Collects: 0. Loses: 1.50.
*Player Tilt-A-Whirl mucks (does not show cards). Bets: 1.50. Collects: 3.50. Wins: 2.
Player IlxxxlI does not show cards.Bets: 0.50. Collects: 0. Loses: 0.50.
Game ended at: 2016/11/29 8:59:28

Game started
Game ID: 786774839 1/2 (PRR) Longana - 2 (Hold'em)
Seat 1 is the button
Seat 1: IlxxxlI (187.97).
Seat 2: Tilt-A-Whirl (218.96).
Seat 3: IamPhamous (190.39).
Seat 4: PANDAisEVIL (200).
Seat 5: Iia007 (215.24).
Seat 6: 322xxx (200).
Seat 7: L4zy_FiSh (200).
Seat 8: mr.fargo (143.55).
Seat 9: shokerAAss (200).
Player Tilt-A-Whirl has small blind (1)
Player IamPhamous has big blind (2)
Player IlxxxlI received card: [Qs]
Player IlxxxlI received card: [2d]
Player PANDAisEVIL raises (6)
Player Iia007 folds
Player 322xxx folds
Player L4zy_FiSh folds
Player mr.fargo folds
Player shokerAAss folds
Player IlxxxlI folds
Player Tilt-A-Whirl calls (5)
Player IamPhamous folds
*** FLOP ***: [10c 8h 3d]
Player Tilt-A-Whirl checks
Player PANDAisEVIL checks
*** TURN ***: [10c 8h 3d] [4d]
Player Tilt-A-Whirl checks
Player PANDAisEVIL bets (8.25)
Player Tilt-A-Whirl folds
Uncalled bet (8.25) returned to PANDAisEVIL
Player PANDAisEVIL mucks cards
------ Summary ------
Pot: 13.30. Rake 0.48. JP fee 0.22
Board: [10c 8h 3d 4d]
Player IlxxxlI does not show cards.Bets: 0. Collects: 0. Wins: 0.
Player Tilt-A-Whirl does not show cards.Bets: 6. Collects: 0. Loses: 6.
Player IamPhamous does not show cards.Bets: 2. Collects: 0. Loses: 2.
*Player PANDAisEVIL mucks (does not show cards). Bets: 6. Collects: 13.30. Wins: 7.30.
Player Iia007 does not show cards.Bets: 0. Collects: 0. Wins: 0.
Player 322xxx does not show cards.Bets: 0. Collects: 0. Wins: 0.
Player L4zy_FiSh does not show cards.Bets: 0. Collects: 0. Wins: 0.
Player mr.fargo does not show cards.Bets: 0. Collects: 0. Wins: 0.
Player shokerAAss does not show cards.Bets: 0. Collects: 0. Wins: 0.
Game ended at: 2016/11/29 8:59:48

Game started
Game ID: 786774652 1/2 (PRR) Longana - 4 (Hold'em)
Seat 4 is the button
Seat 2: IAmClueless (419.13).
Seat 3: PANDAisEVIL (203).
Seat 4: mr.fargo (81.70).
Seat 5: L4zy_FiSh (200).
Seat 6: IlxxxlI (80).
Seat 7: LazyFish (298).
Seat 8: Gronkowski69 (200).
Seat 9: pokerforfun1 (63.25).
Player L4zy_FiSh has small blind (1)
Player IlxxxlI has big blind (2)
Player IlxxxlI received card: [8h]
Player IlxxxlI received card: [9s]
Player LazyFish folds
Player Gronkowski69 folds
Player pokerforfun1 folds
Player IAmClueless folds
Player PANDAisEVIL raises (5)
Player mr.fargo folds
Player L4zy_FiSh folds
Player IlxxxlI calls (3)
*** FLOP ***: [2s 3d 7h]
Player IlxxxlI checks
Player PANDAisEVIL bets (6.48)
Player IlxxxlI folds
Uncalled bet (6.48) returned to PANDAisEVIL
Player PANDAisEVIL mucks cards
------ Summary ------
Pot: 10.45. Rake 0.37. JP fee 0.18
Board: [2s 3d 7h]
Player IAmClueless does not show cards.Bets: 0. Collects: 0. Wins: 0.
*Player PANDAisEVIL mucks (does not show cards). Bets: 5. Collects: 10.45. Wins: 5.45.
Player mr.fargo does not show cards.Bets: 0. Collects: 0. Wins: 0.
Player L4zy_FiSh does not show cards.Bets: 1. Collects: 0. Loses: 1.
Player IlxxxlI does not show cards.Bets: 5. Collects: 0. Loses: 5.
Player LazyFish does not show cards.Bets: 0. Collects: 0. Wins: 0.
Player Gronkowski69 does not show cards.Bets: 0. Collects: 0. Wins: 0.
Player pokerforfun1 does not show cards.Bets: 0. Collects: 0. Wins: 0.
Game ended at: 2016/11/29 8:59:0

Game started
Game ID: 786774633 0.25/0.50 (PRR) Gorgons - 7 (Hold'em)
Seat 2 is the button
Seat 1: 528 Hertz (50).
Seat 2: Heksebrygg (51.84).
Seat 3: Dirty4skin (44.59).
Seat 4: imperceptible (21.28).
Seat 5: Tilt-A-Whirl (72.85).
Seat 6: IlxxxlI (20.98).
Player Dirty4skin has small blind (0.25)
Player imperceptible sitting out
Player Tilt-A-Whirl has big blind (0.50)
Player IlxxxlI received card: [8s]
Player IlxxxlI received card: [4h]
Player IlxxxlI folds
Player 528 Hertz raises (1.75)
Player Heksebrygg folds
Player Dirty4skin folds
Player Tilt-A-Whirl folds
Uncalled bet (1.25) returned to 528 Hertz
Player 528 Hertz mucks cards
------ Summary ------
Pot: 1.25. Rake 0
*Player 528 Hertz mucks (does not show cards). Bets: 0.50. Collects: 1.25. Wins: 0.75.
Player Heksebrygg does not show cards.Bets: 0. Collects: 0. Wins: 0.
Player Dirty4skin does not show cards.Bets: 0.25. Collects: 0. Loses: 0.25.
Player imperceptible does not show cards.Bets: 0. Collects: 0. Wins: 0.
Player Tilt-A-Whirl does not show cards.Bets: 0.50. Collects: 0. Loses: 0.50.
Player IlxxxlI does not show cards.Bets: 0. Collects: 0. Wins: 0.
Game ended at: 2016/11/29 8:58:48

Game started
Game ID: 786774585 1/2 (PRR) Longana - 2 (Hold'em)
Seat 9 is the button
Seat 1: IlxxxlI (188.97).
Seat 2: Tilt-A-Whirl (220.96).
Seat 3: IamPhamous (190.39).
Seat 4: PANDAisEVIL (200).
Seat 5: Iia007 (212.24).
Seat 6: 322xxx (200).
Seat 7: L4zy_FiSh (200).
Seat 8: mr.fargo (143.55).
Seat 9: shokerAAss (200).
Player IlxxxlI has small blind (1)
Player Tilt-A-Whirl has big blind (2)
Player IlxxxlI received card: [Qs]
Player IlxxxlI received card: [2h]
Player IamPhamous folds
Player PANDAisEVIL folds
Player Iia007 raises (6)
Player 322xxx folds
Player L4zy_FiSh folds
Player mr.fargo folds
Player shokerAAss folds
Player IlxxxlI folds
Player Tilt-A-Whirl folds
Uncalled bet (4) returned to Iia007
Player Iia007 mucks cards
------ Summary ------
Pot: 5. Rake 0
Player IlxxxlI does not show cards.Bets: 1. Collects: 0. Loses: 1.
Player Tilt-A-Whirl does not show cards.Bets: 2. Collects: 0. Loses: 2.
Player IamPhamous does not show cards.Bets: 0. Collects: 0. Wins: 0.
Player PANDAisEVIL does not show cards.Bets: 0. Collects: 0. Wins: 0.
*Player Iia007 mucks (does not show cards). Bets: 2. Collects: 5. Wins: 3.
Player 322xxx does not show cards.Bets: 0. Collects: 0. Wins: 0.
Player L4zy_FiSh does not show cards.Bets: 0. Collects: 0. Wins: 0.
Player mr.fargo does not show cards.Bets: 0. Collects: 0. Wins: 0.
Player shokerAAss does not show cards.Bets: 0. Collects: 0. Wins: 0.
Game ended at: 2016/11/29 8:58:42

Game started
Game ID: 786774524 0.25/0.50 (PRR) Garuda - 2 (Hold'em)
Seat 3 is the button
Seat 1: Tilt-A-Whirl (51.60).
Seat 2: apoo11 (82.74).
Seat 3: imperceptible (15.76).
Seat 4: Ice Bank Mice Elf (50).
Seat 5: tutofu84 (88.14).
Seat 6: IlxxxlI (20).
Seat 8: Aquaman75 (70.33).
Seat 9: kid4life (50.22).
Player Ice Bank Mice Elf has small blind (0.25)
Player tutofu84 has big blind (0.50)
Player IlxxxlI received card: [8s]
Player IlxxxlI received card: [Qc]
Player IlxxxlI folds
Player Aquaman75 folds
Player kid4life folds
Player Tilt-A-Whirl folds
Player apoo11 folds
Player imperceptible raises (1)
Player Ice Bank Mice Elf folds
Player tutofu84 raises (2.50)
Player imperceptible folds
Uncalled bet (2) returned to tutofu84
Player tutofu84 mucks cards
------ Summary ------
Pot: 2.25. Rake 0
Player Tilt-A-Whirl does not show cards.Bets: 0. Collects: 0. Wins: 0.
Player apoo11 does not show cards.Bets: 0. Collects: 0. Wins: 0.
Player imperceptible does not show cards.Bets: 1. Collects: 0. Loses: 1.
Player Ice Bank Mice Elf does not show cards.Bets: 0.25. Collects: 0. Loses: 0.25.
*Player tutofu84 mucks (does not show cards). Bets: 1. Collects: 2.25. Wins: 1.25.
Player IlxxxlI does not show cards.Bets: 0. Collects: 0. Wins: 0.
Player Aquaman75 does not show cards.Bets: 0. Collects: 0. Wins: 0.
Player kid4life does not show cards.Bets: 0. Collects: 0. Wins: 0.
Game ended at: 2016/11/29 8:59:8

Game started
Game ID: 786774459 0.25/0.50 (PRR) Garuda (Hold'em)
Seat 7 is the button
Seat 1: Aquaman75 (64.28).
Seat 2: IlxxxlI (20.79).
Seat 3: Ice Bank Mice Elf (60.43).
Seat 4: Log_in (14).
Seat 5: CumBckMuny (35.01).
Seat 6: XxDominationxX (84.38).
Seat 7: coldkilla (59.73).
Seat 8: gunnfarm (48.75).
Player gunnfarm has small blind (0.25)
Player Aquaman75 has big blind (0.50)
Player IlxxxlI received card: [4d]
Player IlxxxlI received card: [Ad]
Player IlxxxlI folds
Player Ice Bank Mice Elf folds
Player Log_in folds
Player CumBckMuny folds
Player XxDominationxX raises (1.50)
Player coldkilla calls (1.50)
Player gunnfarm calls (1.25)
Player Aquaman75 folds
*** FLOP ***: [Kd 7s 6s]
Player gunnfarm checks
Player XxDominationxX checks
Player coldkilla checks
*** TURN ***: [Kd 7s 6s] [8c]
Player gunnfarm checks
Player XxDominationxX checks
Player coldkilla bets (2.37)
Player gunnfarm folds
Player XxDominationxX calls (2.37)
*** RIVER ***: [Kd 7s 6s 8c] [5d]
Player XxDominationxX checks
Player coldkilla checks
Player XxDominationxX mucks cards
------ Summary ------
Pot: 9.26. Rake 0.32. JP fee 0.16
Board: [Kd 7s 6s 8c 5d]
Player Aquaman75 does not show cards.Bets: 0.50. Collects: 0. Loses: 0.50.
Player IlxxxlI does not show cards.Bets: 0. Collects: 0. Wins: 0.
Player Ice Bank Mice Elf does not show cards.Bets: 0. Collects: 0. Wins: 0.
Player Log_in does not show cards.Bets: 0. Collects: 0. Wins: 0.
Player CumBckMuny does not show cards.Bets: 0. Collects: 0. Wins: 0.
Player XxDominationxX mucks (does not show cards). Bets: 3.87. Collects: 0. Loses: 3.87.
*Player coldkilla shows: One pair of 8s [Ac 8s]. Bets: 3.87. Collects: 9.26. Wins: 5.39.
Player gunnfarm does not show cards.Bets: 1.50. Collects: 0. Loses: 1.50.
Game ended at: 2016/11/29 8:59:27

Game started
Game ID: 786774439 0.25/0.50 (PRR) Gorgons - 7 (Hold'em)
Seat 1 is the button
Seat 1: 528 Hertz (50).
Seat 2: Heksebrygg (52.09).
Seat 3: Dirty4skin (44.34).
Seat 4: imperceptible (21.28).
Seat 5: Tilt-A-Whirl (72.85).
Seat 6: IlxxxlI (20.98).
Player Heksebrygg has small blind (0.25)
Player Dirty4skin has big blind (0.50)
Player IlxxxlI received card: [9c]
Player IlxxxlI received card: [3h]
Player imperceptible folds
Player Tilt-A-Whirl folds
Player IlxxxlI folds
Player 528 Hertz folds
Player Heksebrygg folds
Uncalled bet (0.25) returned to Dirty4skin
Player Dirty4skin mucks cards
------ Summary ------
Pot: 0.50. Rake 0
Player 528 Hertz does not show cards.Bets: 0. Collects: 0. Wins: 0.
Player Heksebrygg does not show cards.Bets: 0.25. Collects: 0. Loses: 0.25.
*Player Dirty4skin mucks (does not show cards). Bets: 0.25. Collects: 0.50. Wins: 0.25.
Player imperceptible does not show cards.Bets: 0. Collects: 0. Wins: 0.
Player Tilt-A-Whirl does not show cards.Bets: 0. Collects: 0. Wins: 0.
Player IlxxxlI does not show cards.Bets: 0. Collects: 0. Wins: 0.
Game ended at: 2016/11/29 8:58:18

Game started
Game ID: 786774214 0.25/0.50 (PRR) Garuda - 2 (Hold'em)
Seat 2 is the button
Seat 1: Tilt-A-Whirl (51.60).
Seat 2: apoo11 (82.74).
Seat 3: imperceptible (16.01).
Seat 4: Ice Bank Mice Elf (50).
Seat 5: tutofu84 (88.14).
Seat 6: IlxxxlI (20).
Seat 8: Aquaman75 (70.83).
Seat 9: kid4life (48.97).
Player imperceptible has small blind (0.25)
Player Ice Bank Mice Elf has big blind (0.50)
Player IlxxxlI received card: [8c]
Player IlxxxlI received card: [3c]
Player tutofu84 folds
Player IlxxxlI folds
Player Aquaman75 calls (0.50)
Player kid4life raises (2.50)
Player Tilt-A-Whirl folds
Player apoo11 folds
Player imperceptible folds
Player Ice Bank Mice Elf folds
Player Aquaman75 folds
Uncalled bet (2) returned to kid4life
Player kid4life mucks cards
------ Summary ------
Pot: 1.75. Rake 0
Player Tilt-A-Whirl does not show cards.Bets: 0. Collects: 0. Wins: 0.
Player apoo11 does not show cards.Bets: 0. Collects: 0. Wins: 0.
Player imperceptible does not show cards.Bets: 0.25. Collects: 0. Loses: 0.25.
Player Ice Bank Mice Elf does not show cards.Bets: 0.50. Collects: 0. Loses: 0.50.
Player tutofu84 does not show cards.Bets: 0. Collects: 0. Wins: 0.
Player IlxxxlI does not show cards.Bets: 0. Collects: 0. Wins: 0.
Player Aquaman75 does not show cards.Bets: 0.50. Collects: 0. Loses: 0.50.
*Player kid4life mucks (does not show cards). Bets: 0.50. Collects: 1.75. Wins: 1.25.
Game ended at: 2016/11/29 8:58:5

Game started
Game ID: 786774163 0.25/0.50 (PRR) Gorgons - 7 (Hold'em)
Seat 6 is the button
Seat 1: 528 Hertz (50.25).
Seat 2: Heksebrygg (52.59).
Seat 3: Dirty4skin (44.34).
Seat 4: imperceptible (21.28).
Seat 5: Tilt-A-Whirl (72.10).
Seat 6: IlxxxlI (20.98).
Player 528 Hertz has small blind (0.25)
Player Heksebrygg has big blind (0.50)
Player IlxxxlI received card: [2c]
Player IlxxxlI received card: [5h]
Player Dirty4skin folds
Player imperceptible folds
Player Tilt-A-Whirl raises (1.50)
Player IlxxxlI folds
Player 528 Hertz folds
Player Heksebrygg folds
Uncalled bet (1) returned to Tilt-A-Whirl
Player Tilt-A-Whirl mucks cards
------ Summary ------
Pot: 1.25. Rake 0
Player 528 Hertz does not show cards.Bets: 0.25. Collects: 0. Loses: 0.25.
Player Heksebrygg does not show cards.Bets: 0.50. Collects: 0. Loses: 0.50.
Player Dirty4skin does not show cards.Bets: 0. Collects: 0. Wins: 0.
Player imperceptible does not show cards.Bets: 0. Collects: 0. Wins: 0.
*Player Tilt-A-Whirl mucks (does not show cards). Bets: 0.50. Collects: 1.25. Wins: 0.75.
Player IlxxxlI does not show cards.Bets: 0. Collects: 0. Wins: 0.
Game ended at: 2016/11/29 8:57:55

Game started
Game ID: 786774087 1/2 (PRR) Longana - 2 (Hold'em)
Seat 8 is the button
Seat 1: IlxxxlI (184.42).
Seat 2: Tilt-A-Whirl (220.96).
Seat 3: IamPhamous (190.39).
Seat 4: PANDAisEVIL (200).
Seat 5: Iia007 (212.24).
Seat 6: 322xxx (200).
Seat 7: L4zy_FiSh (200).
Seat 8: mr.fargo (143.55).
Seat 9: shokerAAss (201).
Player shokerAAss has small blind (1)
Player IlxxxlI has big blind (2)
Player IlxxxlI received card: [9s]
Player IlxxxlI received card: [Qd]
Player Tilt-A-Whirl folds
Player IamPhamous folds
Player PANDAisEVIL folds
Player Iia007 folds
Player 322xxx raises (4)
Player L4zy_FiSh folds
Player mr.fargo folds
Player shokerAAss folds
Player IlxxxlI calls (2)
*** FLOP ***: [Kc 9d Qh]
Player IlxxxlI checks
Player 322xxx checks
*** TURN ***: [Kc 9d Qh] [As]
Player IlxxxlI bets (6)
Player 322xxx folds
Uncalled bet (6) returned to IlxxxlI
Player IlxxxlI mucks cards
------ Summary ------
Pot: 8.55. Rake 0.31. JP fee 0.14
Board: [Kc 9d Qh As]
*Player IlxxxlI mucks (does not show cards). Bets: 4. Collects: 8.55. Wins: 4.55.
Player Tilt-A-Whirl does not show cards.Bets: 0. Collects: 0. Wins: 0.
Player IamPhamous does not show cards.Bets: 0. Collects: 0. Wins: 0.
Player PANDAisEVIL does not show cards.Bets: 0. Collects: 0. Wins: 0.
Player Iia007 does not show cards.Bets: 0. Collects: 0. Wins: 0.
Player 322xxx does not show cards.Bets: 4. Collects: 0. Loses: 4.
Player L4zy_FiSh does not show cards.Bets: 0. Collects: 0. Wins: 0.
Player mr.fargo does not show cards.Bets: 0. Collects: 0. Wins: 0.
Player shokerAAss does not show cards.Bets: 1. Collects: 0. Loses: 1.
Game ended at: 2016/11/29 8:58:13

Game started
Game ID: 786774019 0.25/0.50 (PRR) Garuda (Hold'em)
Seat 6 is the button
Seat 1: Aquaman75 (64.28).
Seat 2: IlxxxlI (20.79).
Seat 3: Ice Bank Mice Elf (61.68).
Seat 4: Log_in (14).
Seat 5: CumBckMuny (35.01).
Seat 6: XxDominationxX (80.88).
Seat 7: coldkilla (60.98).
Seat 8: gunnfarm (50).
Player coldkilla has small blind (0.25)
Player gunnfarm has big blind (0.50)
Player IlxxxlI received card: [9h]
Player IlxxxlI received card: [4s]
Player Aquaman75 folds
Player IlxxxlI folds
Player Ice Bank Mice Elf raises (1.25)
Player Log_in folds
Player CumBckMuny folds
Player XxDominationxX calls (1.25)
Player coldkilla calls (1)
Player gunnfarm calls (0.75)
*** FLOP ***: [7h 10s 3h]
Player coldkilla checks
Player gunnfarm checks
Player Ice Bank Mice Elf checks
Player XxDominationxX bets (3.16)
Player coldkilla folds
Player gunnfarm folds
Player Ice Bank Mice Elf folds
Uncalled bet (3.16) returned to XxDominationxX
Player XxDominationxX mucks cards
------ Summary ------
Pot: 4.75. Rake 0.17. JP fee 0.08
Board: [7h 10s 3h]
Player Aquaman75 does not show cards.Bets: 0. Collects: 0. Wins: 0.
Player IlxxxlI does not show cards.Bets: 0. Collects: 0. Wins: 0.
Player Ice Bank Mice Elf does not show cards.Bets: 1.25. Collects: 0. Loses: 1.25.
Player Log_in does not show cards.Bets: 0. Collects: 0. Wins: 0.
Player CumBckMuny does not show cards.Bets: 0. Collects: 0. Wins: 0.
*Player XxDominationxX mucks (does not show cards). Bets: 1.25. Collects: 4.75. Wins: 3.50.
Player coldkilla does not show cards.Bets: 1.25. Collects: 0. Loses: 1.25.
Player gunnfarm does not show cards.Bets: 1.25. Collects: 0. Loses: 1.25.
Game ended at: 2016/11/29 8:57:58

Game started
Game ID: 786773986 0.25/0.50 (PRR) Gorgons - 7 (Hold'em)
Seat 5 is the button
Seat 1: 528 Hertz (50).
Seat 2: Heksebrygg (52.59).
Seat 3: Dirty4skin (44.34).
Seat 4: imperceptible (21.28).
Seat 5: Tilt-A-Whirl (72.10).
Seat 6: IlxxxlI (21.23).
Player IlxxxlI has small blind (0.25)
Player 528 Hertz has big blind (0.50)
Player IlxxxlI received card: [8c]
Player IlxxxlI received card: [3d]
Player Heksebrygg folds
Player Dirty4skin folds
Player imperceptible folds
Player Tilt-A-Whirl folds
Player IlxxxlI folds
Uncalled bet (0.25) returned to 528 Hertz
Player 528 Hertz mucks cards
------ Summary ------
Pot: 0.50. Rake 0
*Player 528 Hertz mucks (does not show cards). Bets: 0.25. Collects: 0.50. Wins: 0.25.
Player Heksebrygg does not show cards.Bets: 0. Collects: 0. Wins: 0.
Player Dirty4skin does not show cards.Bets: 0. Collects: 0. Wins: 0.
Player imperceptible does not show cards.Bets: 0. Collects: 0. Wins: 0.
Player Tilt-A-Whirl does not show cards.Bets: 0. Collects: 0. Wins: 0.
Player IlxxxlI does not show cards.Bets: 0.25. Collects: 0. Loses: 0.25.
Game ended at: 2016/11/29 8:57:21

Game started
Game ID: 786773759 0.25/0.50 (PRR) Gorgons - 7 (Hold'em)
Seat 4 is the button
Seat 2: Heksebrygg (52.59).
Seat 3: Dirty4skin (44.34).
Seat 4: imperceptible (21.28).
Seat 5: Tilt-A-Whirl (71.60).
Seat 6: IlxxxlI (21.73).
Player Tilt-A-Whirl has small blind (0.25)
Player IlxxxlI has big blind (0.50)
Player IlxxxlI received card: [4c]
Player IlxxxlI received card: [6d]
Player Heksebrygg folds
Player Dirty4skin folds
Player imperceptible folds
Player Tilt-A-Whirl raises (0.75)
Player IlxxxlI folds
Uncalled bet (0.50) returned to Tilt-A-Whirl
Player Tilt-A-Whirl mucks cards
------ Summary ------
Pot: 1. Rake 0
Player Heksebrygg does not show cards.Bets: 0. Collects: 0. Wins: 0.
Player Dirty4skin does not show cards.Bets: 0. Collects: 0. Wins: 0.
Player imperceptible does not show cards.Bets: 0. Collects: 0. Wins: 0.
*Player Tilt-A-Whirl mucks (does not show cards). Bets: 0.50. Collects: 1. Wins: 0.50.
Player IlxxxlI does not show cards.Bets: 0.50. Collects: 0. Loses: 0.50.
Game ended at: 2016/11/29 8:57:3

Game started
Game ID: 786773541 0.25/0.50 (PRR) Garuda - 2 (Hold'em)
Seat 1 is the button
Seat 1: Tilt-A-Whirl (51.60).
Seat 2: apoo11 (82.99).
Seat 3: imperceptible (16.51).
Seat 4: Ice Bank Mice Elf (50).
Seat 5: tutofu84 (88.14).
Seat 6: IlxxxlI (20).
Seat 8: Aquaman75 (64.04).
Seat 9: kid4life (55.72).
Player apoo11 has small blind (0.25)
Player imperceptible has big blind (0.50)
Player IlxxxlI received card: [4c]
Player IlxxxlI received card: [Kd]
Player Ice Bank Mice Elf folds
Player tutofu84 folds
Player IlxxxlI folds
Player Aquaman75 raises (1.50)
Player kid4life calls (1.50)
Player Tilt-A-Whirl folds
Player apoo11 folds
Player imperceptible folds
*** FLOP ***: [6s 2s Jd]
Player Aquaman75 bets (1.78)
Player kid4life calls (1.78)
*** TURN ***: [6s 2s Jd] [3d]
Player Aquaman75 bets (3.47)
Player kid4life calls (3.47)
*** RIVER ***: [6s 2s Jd 3d] [5c]
Player Aquaman75 checks
Player kid4life checks
Player kid4life mucks cards
------ Summary ------
Pot: 13.54. Rake 0.49. JP fee 0.22
Board: [6s 2s Jd 3d 5c]
Player Tilt-A-Whirl does not show cards.Bets: 0. Collects: 0. Wins: 0.
Player apoo11 does not show cards.Bets: 0.25. Collects: 0. Loses: 0.25.
Player imperceptible does not show cards.Bets: 0.50. Collects: 0. Loses: 0.50.
Player Ice Bank Mice Elf does not show cards.Bets: 0. Collects: 0. Wins: 0.
Player tutofu84 does not show cards.Bets: 0. Collects: 0. Wins: 0.
Player IlxxxlI does not show cards.Bets: 0. Collects: 0. Wins: 0.
*Player Aquaman75 shows: High card A [Qd As]. Bets: 6.75. Collects: 13.54. Wins: 6.79.
Player kid4life mucks (does not show cards). Bets: 6.75. Collects: 0. Loses: 6.75.
Game ended at: 2016/11/29 8:57:27

Game started
Game ID: 786773519 1/2 (PRR) Longana - 2 (Hold'em)
Seat 7 is the button
Seat 1: IlxxxlI (92.21).
Seat 2: Tilt-A-Whirl (220.96).
Seat 3: IamPhamous (190.39).
Seat 4: PANDAisEVIL (214.93).
Seat 5: Iia007 (212.24).
Seat 6: 322xxx (200).
Seat 7: L4zy_FiSh (200).
Seat 8: mr.fargo (144.55).
Seat 9: shokerAAss (203).
Player mr.fargo has small blind (1)
Player shokerAAss has big blind (2)
Player IlxxxlI received card: [Kd]
Player IlxxxlI received card: [Kh]
Player IlxxxlI raises (7)
Player Tilt-A-Whirl folds
Player IamPhamous folds
Player PANDAisEVIL raises (16)
Player Iia007 folds
Player 322xxx folds
Player L4zy_FiSh folds
Player mr.fargo folds
Player shokerAAss folds
Player IlxxxlI calls (9)
*** FLOP ***: [4s Jc 10h]
Player IlxxxlI checks
Player PANDAisEVIL bets (16.62)
Player IlxxxlI calls (16.62)
*** TURN ***: [4s Jc 10h] [7c]
Player IlxxxlI checks
Player PANDAisEVIL allin (182.31)
Player IlxxxlI allin (59.59)
Uncalled bet (122.72) returned to PANDAisEVIL
*** RIVER ***: [4s Jc 10h 7c] [8s]
------ Summary ------
Pot: 184.42. Rake 2.76. JP fee 0.24
Board: [4s Jc 10h 7c 8s]
*Player IlxxxlI shows: One pair of Ks [Kd Kh]. Bets: 92.21. Collects: 184.42. Wins: 92.21.
Player Tilt-A-Whirl does not show cards.Bets: 0. Collects: 0. Wins: 0.
Player IamPhamous does not show cards.Bets: 0. Collects: 0. Wins: 0.
Player PANDAisEVIL shows: One pair of 4s [4c 5c]. Bets: 92.21. Collects: 0. Loses: 92.21.
Player Iia007 does not show cards.Bets: 0. Collects: 0. Wins: 0.
Player 322xxx does not show cards.Bets: 0. Collects: 0. Wins: 0.
Player L4zy_FiSh does not show cards.Bets: 0. Collects: 0. Wins: 0.
Player mr.fargo does not show cards.Bets: 1. Collects: 0. Loses: 1.
Player shokerAAss does not show cards.Bets: 2. Collects: 0. Loses: 2.
Game ended at: 2016/11/29 8:57:12

Game started
Game ID: 786773500 0.25/0.50 (PRR) Gorgons - 7 (Hold'em)
Seat 3 is the button
Seat 2: Heksebrygg (51.84).
Seat 3: Dirty4skin (44.34).
Seat 4: imperceptible (21.53).
Seat 5: Tilt-A-Whirl (72.10).
Seat 6: IlxxxlI (21.73).
Player imperceptible has small blind (0.25)
Player Tilt-A-Whirl has big blind (0.50)
Player IlxxxlI received card: [As]
Player IlxxxlI received card: [8c]
Player IlxxxlI folds
Player Heksebrygg raises (1.50)
Player Dirty4skin folds
Player imperceptible folds
Player Tilt-A-Whirl folds
Uncalled bet (1) returned to Heksebrygg
Player Heksebrygg mucks cards
------ Summary ------
Pot: 1.25. Rake 0
*Player Heksebrygg mucks (does not show cards). Bets: 0.50. Collects: 1.25. Wins: 0.75.
Player Dirty4skin does not show cards.Bets: 0. Collects: 0. Wins: 0.
Player imperceptible does not show cards.Bets: 0.25. Collects: 0. Loses: 0.25.
Player Tilt-A-Whirl does not show cards.Bets: 0.50. Collects: 0. Loses: 0.50.
Player IlxxxlI does not show cards.Bets: 0. Collects: 0. Wins: 0.
Game ended at: 2016/11/29 8:56:38

Game started
Game ID: 786773501 0.25/0.50 (PRR) Garuda (Hold'em)
Seat 5 is the button
Seat 1: Aquaman75 (64.28).
Seat 2: IlxxxlI (20.79).
Seat 3: Ice Bank Mice Elf (61.68).
Seat 4: Log_in (14).
Seat 5: CumBckMuny (32.23).
Seat 6: XxDominationxX (82.38).
Seat 7: coldkilla (62.48).
Player XxDominationxX has small blind (0.25)
Player coldkilla has big blind (0.50)
Player IlxxxlI received card: [9d]
Player IlxxxlI received card: [Ah]
Player Aquaman75 folds
Player IlxxxlI folds
Player Ice Bank Mice Elf folds
Player Log_in folds
Player CumBckMuny raises (1.50)
Player XxDominationxX calls (1.25)
Player coldkilla calls (1)
*** FLOP ***: [9h 3c 3d]
Player XxDominationxX checks
Player coldkilla checks
Player CumBckMuny bets (2.14)
Player XxDominationxX folds
Player coldkilla folds
Uncalled bet (2.14) returned to CumBckMuny
Player CumBckMuny mucks cards
------ Summary ------
Pot: 4.28. Rake 0.16. JP fee 0.06
Board: [9h 3c 3d]
Player Aquaman75 does not show cards.Bets: 0. Collects: 0. Wins: 0.
Player IlxxxlI does not show cards.Bets: 0. Collects: 0. Wins: 0.
Player Ice Bank Mice Elf does not show cards.Bets: 0. Collects: 0. Wins: 0.
Player Log_in does not show cards.Bets: 0. Collects: 0. Wins: 0.
*Player CumBckMuny mucks (does not show cards). Bets: 1.50. Collects: 4.28. Wins: 2.78.
Player XxDominationxX does not show cards.Bets: 1.50. Collects: 0. Loses: 1.50.
Player coldkilla does not show cards.Bets: 1.50. Collects: 0. Loses: 1.50.
Game ended at: 2016/11/29 8:57:6

Game started
Game ID: 786773332 0.25/0.50 (PRR) Gorgons - 7 (Hold'em)
Seat 2 is the button
Seat 2: Heksebrygg (51.84).
Seat 3: Dirty4skin (44.59).
Seat 4: imperceptible (21.28).
Seat 5: Tilt-A-Whirl (72.10).
Seat 6: IlxxxlI (21.73).
Player Dirty4skin has small blind (0.25)
Player imperceptible has big blind (0.50)
Player IlxxxlI received card: [9d]
Player IlxxxlI received card: [As]
Player Tilt-A-Whirl folds
Player IlxxxlI folds
Player Heksebrygg folds
Player Dirty4skin folds
Uncalled bet (0.25) returned to imperceptible
Player imperceptible mucks cards
------ Summary ------
Pot: 0.50. Rake 0
Player Heksebrygg does not show cards.Bets: 0. Collects: 0. Wins: 0.
Player Dirty4skin does not show cards.Bets: 0.25. Collects: 0. Loses: 0.25.
*Player imperceptible mucks (does not show cards). Bets: 0.25. Collects: 0.50. Wins: 0.25.
Player Tilt-A-Whirl does not show cards.Bets: 0. Collects: 0. Wins: 0.
Player IlxxxlI does not show cards.Bets: 0. Collects: 0. Wins: 0.
Game ended at: 2016/11/29 8:56:6

Game started
Game ID: 786773198 0.25/0.50 (PRR) Garuda - 2 (Hold'em)
Seat 9 is the button
Seat 1: Tilt-A-Whirl (51.85).
Seat 2: apoo11 (83.49).
Seat 3: imperceptible (16.51).
Seat 4: Ice Bank Mice Elf (50).
Seat 5: tutofu84 (88.14).
Seat 6: IlxxxlI (20).
Seat 8: Aquaman75 (64.04).
Seat 9: kid4life (54.97).
Player Tilt-A-Whirl has small blind (0.25)
Player apoo11 has big blind (0.50)
Player IlxxxlI received card: [8d]
Player IlxxxlI received card: [6c]
Player imperceptible folds
Player Ice Bank Mice Elf folds
Player tutofu84 folds
Player IlxxxlI folds
Player Aquaman75 folds
Player kid4life raises (2)
Player Tilt-A-Whirl folds
Player apoo11 folds
Uncalled bet (1.50) returned to kid4life
Player kid4life mucks cards
------ Summary ------
Pot: 1.25. Rake 0
Player Tilt-A-Whirl does not show cards.Bets: 0.25. Collects: 0. Loses: 0.25.
Player apoo11 does not show cards.Bets: 0.50. Collects: 0. Loses: 0.50.
Player imperceptible does not show cards.Bets: 0. Collects: 0. Wins: 0.
Player Ice Bank Mice Elf does not show cards.Bets: 0. Collects: 0. Wins: 0.
Player tutofu84 does not show cards.Bets: 0. Collects: 0. Wins: 0.
Player IlxxxlI does not show cards.Bets: 0. Collects: 0. Wins: 0.
Player Aquaman75 does not show cards.Bets: 0. Collects: 0. Wins: 0.
*Player kid4life mucks (does not show cards). Bets: 0.50. Collects: 1.25. Wins: 0.75.
Game ended at: 2016/11/29 8:56:13

Game started
Game ID: 786773106 0.25/0.50 (PRR) Garuda (Hold'em)
Seat 4 is the button
Seat 1: Aquaman75 (64.28).
Seat 2: IlxxxlI (20.79).
Seat 3: Ice Bank Mice Elf (61.68).
Seat 4: Log_in (12.75).
Seat 5: CumBckMuny (32.48).
Seat 6: XxDominationxX (83.50).
Seat 7: coldkilla (62.48).
Player CumBckMuny has small blind (0.25)
Player XxDominationxX has big blind (0.50)
Player IlxxxlI received card: [6s]
Player IlxxxlI received card: [Kc]
Player coldkilla folds
Player Aquaman75 folds
Player IlxxxlI folds
Player Ice Bank Mice Elf folds
Player Log_in raises (1.12)
Player CumBckMuny folds
Player XxDominationxX calls (0.62)
*** FLOP ***: [6d 10d Qh]
Player XxDominationxX checks
Player Log_in bets (1.58)
Player XxDominationxX folds
Uncalled bet (1.58) returned to Log_in
Player Log_in mucks cards
------ Summary ------
Pot: 2.37. Rake 0.08. JP fee 0.04
Board: [6d 10d Qh]
Player Aquaman75 does not show cards.Bets: 0. Collects: 0. Wins: 0.
Player IlxxxlI does not show cards.Bets: 0. Collects: 0. Wins: 0.
Player Ice Bank Mice Elf does not show cards.Bets: 0. Collects: 0. Wins: 0.
*Player Log_in mucks (does not show cards). Bets: 1.12. Collects: 2.37. Wins: 1.25.
Player CumBckMuny does not show cards.Bets: 0.25. Collects: 0. Loses: 0.25.
Player XxDominationxX does not show cards.Bets: 1.12. Collects: 0. Loses: 1.12.
Player coldkilla does not show cards.Bets: 0. Collects: 0. Wins: 0.
Game ended at: 2016/11/29 8:56:7

Game started
Game ID: 786772877 1/2 (PRR) Longana - 2 (Hold'em)
Seat 6 is the button
Seat 1: IlxxxlI (99.21).
Seat 2: Tilt-A-Whirl (220.96).
Seat 3: IamPhamous (190.39).
Seat 4: PANDAisEVIL (204.93).
Seat 5: Iia007 (212.24).
Seat 6: 322xxx (200).
Seat 7: L4zy_FiSh (200).
Seat 8: mr.fargo (146.55).
Seat 9: shokerAAss (203).
Player L4zy_FiSh has small blind (1)
Player mr.fargo has big blind (2)
Player IlxxxlI received card: [Kd]
Player IlxxxlI received card: [10d]
Player shokerAAss folds
Player IlxxxlI raises (7)
Player Tilt-A-Whirl folds
Player IamPhamous folds
Player PANDAisEVIL raises (16)
Player Iia007 folds
Player 322xxx folds
Player L4zy_FiSh folds
Player mr.fargo folds
Player IlxxxlI folds
Uncalled bet (9) returned to PANDAisEVIL
Player PANDAisEVIL mucks cards
------ Summary ------
Pot: 17. Rake 0
Player IlxxxlI does not show cards.Bets: 7. Collects: 0. Loses: 7.
Player Tilt-A-Whirl does not show cards.Bets: 0. Collects: 0. Wins: 0.
Player IamPhamous does not show cards.Bets: 0. Collects: 0. Wins: 0.
*Player PANDAisEVIL mucks (does not show cards). Bets: 7. Collects: 17. Wins: 10.
Player Iia007 does not show cards.Bets: 0. Collects: 0. Wins: 0.
Player 322xxx does not show cards.Bets: 0. Collects: 0. Wins: 0.
Player L4zy_FiSh does not show cards.Bets: 1. Collects: 0. Loses: 1.
Player mr.fargo does not show cards.Bets: 2. Collects: 0. Loses: 2.
Player shokerAAss does not show cards.Bets: 0. Collects: 0. Wins: 0.
Game ended at: 2016/11/29 8:56:10

Game started
Game ID: 786772763 0.25/0.50 (PRR) Garuda (Hold'em)
Seat 3 is the button
Seat 1: Aquaman75 (64.28).
Seat 2: IlxxxlI (20.79).
Seat 3: Ice Bank Mice Elf (60.93).
Seat 4: Log_in (13).
Seat 5: CumBckMuny (32.98).
Seat 6: XxDominationxX (83.50).
Seat 7: coldkilla (62.48).
Player Log_in has small blind (0.25)
Player CumBckMuny has big blind (0.50)
Player IlxxxlI received card: [3d]
Player IlxxxlI received card: [4h]
Player XxDominationxX folds
Player coldkilla folds
Player Aquaman75 folds
Player IlxxxlI folds
Player Ice Bank Mice Elf raises (1)
Player Log_in folds
Player CumBckMuny folds
Uncalled bet (0.50) returned to Ice Bank Mice Elf
Player Ice Bank Mice Elf mucks cards
------ Summary ------
Pot: 1.25. Rake 0
Player Aquaman75 does not show cards.Bets: 0. Collects: 0. Wins: 0.
Player IlxxxlI does not show cards.Bets: 0. Collects: 0. Wins: 0.
*Player Ice Bank Mice Elf mucks (does not show cards). Bets: 0.50. Collects: 1.25. Wins: 0.75.
Player Log_in does not show cards.Bets: 0.25. Collects: 0. Loses: 0.25.
Player CumBckMuny does not show cards.Bets: 0.50. Collects: 0. Loses: 0.50.
Player XxDominationxX does not show cards.Bets: 0. Collects: 0. Wins: 0.
Player coldkilla does not show cards.Bets: 0. Collects: 0. Wins: 0.
Game ended at: 2016/11/29 8:55:24

Game started
Game ID: 786772602 0.25/0.50 (PRR) Gorgons - 7 (Hold'em)
Seat 6 is the button
Seat 1: Evilclown (19).
Seat 2: Heksebrygg (52.34).
Seat 3: Dirty4skin (46.09).
Seat 4: imperceptible (21.28).
Seat 5: Tilt-A-Whirl (53.10).
Seat 6: IlxxxlI (21.73).
Player Evilclown has small blind (0.25)
Player Heksebrygg has big blind (0.50)
Player IlxxxlI received card: [10d]
Player IlxxxlI received card: [Js]
Player Dirty4skin raises (1.50)
Player imperceptible folds
Player Tilt-A-Whirl calls (1.50)
Player IlxxxlI folds
Player Evilclown calls (1.25)
Player Heksebrygg folds
*** FLOP ***: [Qs 8c Jh]
Player Evilclown checks
Player Dirty4skin checks
Player Tilt-A-Whirl bets (3.50)
Player Evilclown calls (3.50)
Player Dirty4skin folds
*** TURN ***: [Qs 8c Jh] [Kc]
Player Evilclown checks
Player Tilt-A-Whirl bets (7.60)
Player Evilclown allin (14)
Player Tilt-A-Whirl calls (6.40)
*** RIVER ***: [Qs 8c Jh Kc] [4c]
------ Summary ------
Pot: 38. Rake 1.76. JP fee 0.24
Board: [Qs 8c Jh Kc 4c]
Player Evilclown shows: Two pairs. Qs and Js [Jd Qc]. Bets: 19. Collects: 0. Loses: 19.
Player Heksebrygg does not show cards.Bets: 0.50. Collects: 0. Loses: 0.50.
Player Dirty4skin does not show cards.Bets: 1.50. Collects: 0. Loses: 1.50.
Player imperceptible does not show cards.Bets: 0. Collects: 0. Wins: 0.
*Player Tilt-A-Whirl shows: Straight to K [9s 10s]. Bets: 19. Collects: 38. Wins: 19.
Player IlxxxlI does not show cards.Bets: 0. Collects: 0. Wins: 0.
Game ended at: 2016/11/29 8:55:47

Game started
Game ID: 786772414 0.25/0.50 (PRR) Garuda - 2 (Hold'em)
Seat 8 is the button
Seat 1: Tilt-A-Whirl (50).
Seat 2: apoo11 (83.49).
Seat 3: imperceptible (16.51).
Seat 4: Ice Bank Mice Elf (50).
Seat 5: tutofu84 (89.14).
Seat 6: IlxxxlI (20).
Seat 8: Aquaman75 (64.04).
Seat 9: kid4life (55.97).
Player kid4life has small blind (0.25)
Player Tilt-A-Whirl has big blind (0.50)
Player IlxxxlI received card: [5h]
Player IlxxxlI received card: [Qs]
Player apoo11 folds
Player imperceptible folds
Player Ice Bank Mice Elf folds
Player tutofu84 raises (1)
Player IlxxxlI folds
Player Aquaman75 folds
Player kid4life calls (0.75)
Player Tilt-A-Whirl calls (0.50)
*** FLOP ***: [4s 9s 2s]
Player kid4life checks
Player Tilt-A-Whirl bets (1.42)
Player tutofu84 folds
Player kid4life folds
Uncalled bet (1.42) returned to Tilt-A-Whirl
Player Tilt-A-Whirl mucks cards
------ Summary ------
Pot: 2.85. Rake 0.11. JP fee 0.04
Board: [4s 9s 2s]
*Player Tilt-A-Whirl mucks (does not show cards). Bets: 1. Collects: 2.85. Wins: 1.85.
Player apoo11 does not show cards.Bets: 0. Collects: 0. Wins: 0.
Player imperceptible does not show cards.Bets: 0. Collects: 0. Wins: 0.
Player Ice Bank Mice Elf does not show cards.Bets: 0. Collects: 0. Wins: 0.
Player tutofu84 does not show cards.Bets: 1. Collects: 0. Loses: 1.
Player IlxxxlI does not show cards.Bets: 0. Collects: 0. Wins: 0.
Player Aquaman75 does not show cards.Bets: 0. Collects: 0. Wins: 0.
Player kid4life does not show cards.Bets: 1. Collects: 0. Loses: 1.
Game ended at: 2016/11/29 8:55:35

Game started
Game ID: 786772201 0.25/0.50 (PRR) Garuda (Hold'em)
Seat 2 is the button
Seat 1: Aquaman75 (64.28).
Seat 2: IlxxxlI (20.79).
Seat 3: Ice Bank Mice Elf (61.18).
Seat 4: Log_in (13.50).
Seat 5: CumBckMuny (32.98).
Seat 6: XxDominationxX (82.75).
Seat 7: coldkilla (62.48).
Player Ice Bank Mice Elf has small blind (0.25)
Player Log_in has big blind (0.50)
Player IlxxxlI received card: [4h]
Player IlxxxlI received card: [Jh]
Player CumBckMuny folds
Player XxDominationxX raises (1.50)
Player coldkilla folds
Player Aquaman75 folds
Player IlxxxlI folds
Player Ice Bank Mice Elf folds
Player Log_in folds
Uncalled bet (1) returned to XxDominationxX
Player XxDominationxX mucks cards
------ Summary ------
Pot: 1.25. Rake 0
Player Aquaman75 does not show cards.Bets: 0. Collects: 0. Wins: 0.
Player IlxxxlI does not show cards.Bets: 0. Collects: 0. Wins: 0.
Player Ice Bank Mice Elf does not show cards.Bets: 0.25. Collects: 0. Loses: 0.25.
Player Log_in does not show cards.Bets: 0.50. Collects: 0. Loses: 0.50.
Player CumBckMuny does not show cards.Bets: 0. Collects: 0. Wins: 0.
*Player XxDominationxX mucks (does not show cards). Bets: 0.50. Collects: 1.25. Wins: 0.75.
Player coldkilla does not show cards.Bets: 0. Collects: 0. Wins: 0.
Game ended at: 2016/11/29 8:54:48

Game started
Game ID: 786771982 0.25/0.50 (PRR) Gorgons - 7 (Hold'em)
Seat 5 is the button
Seat 1: Evilclown (19.50).
Seat 2: Heksebrygg (51.59).
Seat 3: Dirty4skin (46.09).
Seat 4: imperceptible (21.28).
Seat 5: Tilt-A-Whirl (53.10).
Seat 6: IlxxxlI (21.98).
Player IlxxxlI has small blind (0.25)
Player Evilclown has big blind (0.50)
Player IlxxxlI received card: [2s]
Player IlxxxlI received card: [10s]
Player Heksebrygg raises (1.50)
Player Dirty4skin folds
Player imperceptible folds
Player Tilt-A-Whirl folds
Player IlxxxlI folds
Player Evilclown folds
Uncalled bet (1) returned to Heksebrygg
Player Heksebrygg mucks cards
------ Summary ------
Pot: 1.25. Rake 0
Player Evilclown does not show cards.Bets: 0.50. Collects: 0. Loses: 0.50.
*Player Heksebrygg mucks (does not show cards). Bets: 0.50. Collects: 1.25. Wins: 0.75.
Player Dirty4skin does not show cards.Bets: 0. Collects: 0. Wins: 0.
Player imperceptible does not show cards.Bets: 0. Collects: 0. Wins: 0.
Player Tilt-A-Whirl does not show cards.Bets: 0. Collects: 0. Wins: 0.
Player IlxxxlI does not show cards.Bets: 0.25. Collects: 0. Loses: 0.25.
Game ended at: 2016/11/29 8:54:36

Game started
Game ID: 786771436 1/2 (PRR) Longana - 2 (Hold'em)
Seat 5 is the button
Seat 1: IlxxxlI (99.21).
Seat 2: Tilt-A-Whirl (220.96).
Seat 3: IamPhamous (153.87).
Seat 4: PANDAisEVIL (204.93).
Seat 5: Iia007 (248.76).
Seat 6: 322xxx (200).
Seat 7: L4zy_FiSh (200).
Seat 8: mr.fargo (146.55).
Seat 9: shokerAAss (203).
Player 322xxx has small blind (1)
Player L4zy_FiSh has big blind (2)
Player IlxxxlI received card: [4c]
Player IlxxxlI received card: [Jd]
Player mr.fargo folds
Player shokerAAss folds
Player IlxxxlI folds
Player Tilt-A-Whirl folds
Player IamPhamous raises (6)
Player PANDAisEVIL folds
Player Iia007 raises (18)
Player 322xxx folds
Player L4zy_FiSh folds
Player IamPhamous calls (12)
*** FLOP ***: [7c 6s Ad]
Player IamPhamous checks
Player Iia007 bets (18.52)
Player IamPhamous calls (18.52)
*** TURN ***: [7c 6s Ad] [Js]
Player IamPhamous checks
Player Iia007 checks
*** RIVER ***: [7c 6s Ad Js] [8d]
Player IamPhamous bets (48.69)
Player Iia007 folds
Uncalled bet (48.69) returned to IamPhamous
Player IamPhamous mucks cards
------ Summary ------
Pot: 73.04. Rake 2.76. JP fee 0.24
Board: [7c 6s Ad Js 8d]
Player IlxxxlI does not show cards.Bets: 0. Collects: 0. Wins: 0.
Player Tilt-A-Whirl does not show cards.Bets: 0. Collects: 0. Wins: 0.
*Player IamPhamous mucks (does not show cards). Bets: 36.52. Collects: 73.04. Wins: 36.52.
Player PANDAisEVIL does not show cards.Bets: 0. Collects: 0. Wins: 0.
Player Iia007 does not show cards.Bets: 36.52. Collects: 0. Loses: 36.52.
Player 322xxx does not show cards.Bets: 1. Collects: 0. Loses: 1.
Player L4zy_FiSh does not show cards.Bets: 2. Collects: 0. Loses: 2.
Player mr.fargo does not show cards.Bets: 0. Collects: 0. Wins: 0.
Player shokerAAss does not show cards.Bets: 0. Collects: 0. Wins: 0.
Game ended at: 2016/11/29 8:54:59

Game started
Game ID: 786771016 1/2 (PRR) Longana - 2 (Hold'em)
Seat 4 is the button
Seat 1: IlxxxlI (99.21).
Seat 2: Tilt-A-Whirl (220.96).
Seat 3: IamPhamous (153.87).
Seat 4: PANDAisEVIL (204.93).
Seat 5: Iia007 (249.76).
Seat 6: 322xxx (200).
Seat 8: mr.fargo (146.55).
Seat 9: shokerAAss (200).
Player Iia007 has small blind (1)
Player 322xxx has big blind (2)
Player IlxxxlI received card: [Ah]
Player IlxxxlI received card: [3c]
Player mr.fargo folds
Player shokerAAss raises (6)
Player IlxxxlI folds
Player Tilt-A-Whirl folds
Player IamPhamous folds
Player PANDAisEVIL folds
Player Iia007 folds
Player 322xxx folds
Uncalled bet (4) returned to shokerAAss
Player shokerAAss mucks cards
------ Summary ------
Pot: 5. Rake 0
Player IlxxxlI does not show cards.Bets: 0. Collects: 0. Wins: 0.
Player Tilt-A-Whirl does not show cards.Bets: 0. Collects: 0. Wins: 0.
Player IamPhamous does not show cards.Bets: 0. Collects: 0. Wins: 0.
Player PANDAisEVIL does not show cards.Bets: 0. Collects: 0. Wins: 0.
Player Iia007 does not show cards.Bets: 1. Collects: 0. Loses: 1.
Player 322xxx does not show cards.Bets: 2. Collects: 0. Loses: 2.
Player mr.fargo does not show cards.Bets: 0. Collects: 0. Wins: 0.
*Player shokerAAss mucks (does not show cards). Bets: 2. Collects: 5. Wins: 3.
Game ended at: 2016/11/29 8:53:20

Game started
Game ID: 786770923 0.25/0.50 (PRR) Gorgons - 7 (Hold'em)
Seat 4 is the button
Seat 1: Evilclown (19.50).
Seat 2: Heksebrygg (51.59).
Seat 3: Dirty4skin (46.09).
Seat 4: imperceptible (21.28).
Seat 5: Tilt-A-Whirl (51.75).
Seat 6: IlxxxlI (23.48).
Player Tilt-A-Whirl has small blind (0.25)
Player IlxxxlI has big blind (0.50)
Player IlxxxlI received card: [10h]
Player IlxxxlI received card: [8c]
Player Evilclown is timed out.
Player Evilclown folds
Player Heksebrygg folds
Player Dirty4skin folds
Player imperceptible folds
Player Tilt-A-Whirl raises (1.25)
Player IlxxxlI calls (1)
*** FLOP ***: [6d Kc 5c]
Player Tilt-A-Whirl bets (1.42)
Player IlxxxlI folds
Uncalled bet (1.42) returned to Tilt-A-Whirl
Player Tilt-A-Whirl mucks cards
------ Summary ------
Pot: 2.85. Rake 0.11. JP fee 0.04
Board: [6d Kc 5c]
Player Evilclown does not show cards.Bets: 0. Collects: 0. Wins: 0.
Player Heksebrygg does not show cards.Bets: 0. Collects: 0. Wins: 0.
Player Dirty4skin does not show cards.Bets: 0. Collects: 0. Wins: 0.
Player imperceptible does not show cards.Bets: 0. Collects: 0. Wins: 0.
*Player Tilt-A-Whirl mucks (does not show cards). Bets: 1.50. Collects: 2.85. Wins: 1.35.
Player IlxxxlI does not show cards.Bets: 1.50. Collects: 0. Loses: 1.50.
Game ended at: 2016/11/29 8:53:57

Game started
Game ID: 786770836 0.25/0.50 (PRR) Garuda (Hold'em)
Seat 1 is the button
Seat 1: Aquaman75 (64.28).
Seat 2: IlxxxlI (21.04).
Seat 3: Ice Bank Mice Elf (62.68).
Seat 4: Log_in (13.50).
Seat 5: CumBckMuny (31.39).
Seat 6: XxDominationxX (82.75).
Seat 7: coldkilla (62.48).
Player IlxxxlI has small blind (0.25)
Player Ice Bank Mice Elf has big blind (0.50)
Player IlxxxlI received card: [5c]
Player IlxxxlI received card: [10h]
Player Log_in folds
Player CumBckMuny raises (1.50)
Player XxDominationxX folds
Player coldkilla folds
Player Aquaman75 folds
Player IlxxxlI folds
Player Ice Bank Mice Elf calls (1)
*** FLOP ***: [4h Jc 7h]
Player Ice Bank Mice Elf checks
Player CumBckMuny bets (1.54)
Player Ice Bank Mice Elf folds
Uncalled bet (1.54) returned to CumBckMuny
Player CumBckMuny mucks cards
------ Summary ------
Pot: 3.09. Rake 0.12. JP fee 0.04
Board: [4h Jc 7h]
Player Aquaman75 does not show cards.Bets: 0. Collects: 0. Wins: 0.
Player IlxxxlI does not show cards.Bets: 0.25. Collects: 0. Loses: 0.25.
Player Ice Bank Mice Elf does not show cards.Bets: 1.50. Collects: 0. Loses: 1.50.
Player Log_in does not show cards.Bets: 0. Collects: 0. Wins: 0.
*Player CumBckMuny mucks (does not show cards). Bets: 1.50. Collects: 3.09. Wins: 1.59.
Player XxDominationxX does not show cards.Bets: 0. Collects: 0. Wins: 0.
Player coldkilla does not show cards.Bets: 0. Collects: 0. Wins: 0.
Game ended at: 2016/11/29 8:54:10

Game started
Game ID: 786770450 1/2 (PRR) Longana - 2 (Hold'em)
Seat 3 is the button
Seat 1: IlxxxlI (96.21).
Seat 2: Tilt-A-Whirl (220.96).
Seat 3: IamPhamous (153.87).
Seat 4: PANDAisEVIL (205.93).
Seat 5: Iia007 (251.76).
Seat 6: 322xxx (200).
Seat 8: mr.fargo (146.55).
Seat 9: shokerAAss (200).
Player PANDAisEVIL has small blind (1)
Player Iia007 has big blind (2)
Player IlxxxlI received card: [Kd]
Player IlxxxlI received card: [Jc]
Player 322xxx folds
Player mr.fargo folds
Player shokerAAss folds
Player IlxxxlI raises (7)
Player Tilt-A-Whirl folds
Player IamPhamous folds
Player PANDAisEVIL folds
Player Iia007 folds
Uncalled bet (5) returned to IlxxxlI
Player IlxxxlI mucks cards
------ Summary ------
Pot: 5. Rake 0
*Player IlxxxlI mucks (does not show cards). Bets: 2. Collects: 5. Wins: 3.
Player Tilt-A-Whirl does not show cards.Bets: 0. Collects: 0. Wins: 0.
Player IamPhamous does not show cards.Bets: 0. Collects: 0. Wins: 0.
Player PANDAisEVIL does not show cards.Bets: 1. Collects: 0. Loses: 1.
Player Iia007 does not show cards.Bets: 2. Collects: 0. Loses: 2.
Player 322xxx does not show cards.Bets: 0. Collects: 0. Wins: 0.
Player mr.fargo does not show cards.Bets: 0. Collects: 0. Wins: 0.
Player shokerAAss does not show cards.Bets: 0. Collects: 0. Wins: 0.
Game ended at: 2016/11/29 8:52:50

Game started
Game ID: 786770398 0.25/0.50 (PRR) Gorgons - 7 (Hold'em)
Seat 3 is the button
Seat 1: Evilclown (19.50).
Seat 2: Heksebrygg (51.59).
Seat 3: Dirty4skin (46.09).
Seat 4: imperceptible (21.53).
Seat 5: Tilt-A-Whirl (51.50).
Seat 6: IlxxxlI (23.48).
Player imperceptible has small blind (0.25)
Player Tilt-A-Whirl has big blind (0.50)
Player IlxxxlI received card: [9s]
Player IlxxxlI received card: [Kc]
Player IlxxxlI is timed out.
Player IlxxxlI folds
Player Evilclown folds
Player Heksebrygg folds
Player Dirty4skin folds
Player imperceptible folds
Uncalled bet (0.25) returned to Tilt-A-Whirl
Player Tilt-A-Whirl mucks cards
------ Summary ------
Pot: 0.50. Rake 0
Player Evilclown does not show cards.Bets: 0. Collects: 0. Wins: 0.
Player Heksebrygg does not show cards.Bets: 0. Collects: 0. Wins: 0.
Player Dirty4skin does not show cards.Bets: 0. Collects: 0. Wins: 0.
Player imperceptible does not show cards.Bets: 0.25. Collects: 0. Loses: 0.25.
*Player Tilt-A-Whirl mucks (does not show cards). Bets: 0.25. Collects: 0.50. Wins: 0.25.
Player IlxxxlI does not show cards.Bets: 0. Collects: 0. Wins: 0.
Game ended at: 2016/11/29 8:52:44

Game started
Game ID: 786770355 0.25/0.50 (PRR) Garuda - 2 (Hold'em)
Seat 6 is the button
Seat 1: Tilt-A-Whirl (50).
Seat 2: apoo11 (83.49).
Seat 3: imperceptible (16.51).
Seat 4: Ice Bank Mice Elf (50).
Seat 5: tutofu84 (92.64).
Seat 6: IlxxxlI (20).
Seat 8: Aquaman75 (64.29).
Seat 9: kid4life (49.25).
Player Aquaman75 has small blind (0.25)
Player kid4life has big blind (0.50)
Player IlxxxlI received card: [Ad]
Player IlxxxlI received card: [3h]
Player Tilt-A-Whirl folds
Player apoo11 folds
Player imperceptible folds
Player Ice Bank Mice Elf raises (1.25)
Player tutofu84 raises (3.50)
Player IlxxxlI folds
Player Aquaman75 folds
Player kid4life calls (3)
Player Ice Bank Mice Elf calls (2.25)
*** FLOP ***: [Qs As Kh]
Player kid4life checks
Player Ice Bank Mice Elf checks
Player tutofu84 checks
*** TURN ***: [Qs As Kh] [10d]
Player kid4life bets (5.11)
Player Ice Bank Mice Elf folds
Player tutofu84 folds
Uncalled bet (5.11) returned to kid4life
Player kid4life mucks cards
------ Summary ------
Pot: 10.22. Rake 0.37. JP fee 0.16
Board: [Qs As Kh 10d]
Player Tilt-A-Whirl does not show cards.Bets: 0. Collects: 0. Wins: 0.
Player apoo11 does not show cards.Bets: 0. Collects: 0. Wins: 0.
Player imperceptible does not show cards.Bets: 0. Collects: 0. Wins: 0.
Player Ice Bank Mice Elf does not show cards.Bets: 3.50. Collects: 0. Loses: 3.50.
Player tutofu84 does not show cards.Bets: 3.50. Collects: 0. Loses: 3.50.
Player IlxxxlI does not show cards.Bets: 0. Collects: 0. Wins: 0.
Player Aquaman75 does not show cards.Bets: 0.25. Collects: 0. Loses: 0.25.
*Player kid4life mucks (does not show cards). Bets: 3.50. Collects: 10.22. Wins: 6.72.
Game ended at: 2016/11/29 8:54:25

Game started
Game ID: 786770126 0.25/0.50 (PRR) Garuda (Hold'em)
Seat 7 is the button
Seat 1: Aquaman75 (64.53).
Seat 2: IlxxxlI (21.54).
Seat 3: Ice Bank Mice Elf (62.68).
Seat 4: Log_in (13.50).
Seat 5: CumBckMuny (31.39).
Seat 6: XxDominationxX (82).
Seat 7: coldkilla (62.48).
Player Aquaman75 has small blind (0.25)
Player IlxxxlI has big blind (0.50)
Player IlxxxlI received card: [6c]
Player IlxxxlI received card: [Qd]
Player Ice Bank Mice Elf folds
Player Log_in folds
Player CumBckMuny folds
Player XxDominationxX raises (1.50)
Player coldkilla folds
Player Aquaman75 folds
Player IlxxxlI is timed out.
Player IlxxxlI folds
Uncalled bet (1) returned to XxDominationxX
Player XxDominationxX mucks cards
------ Summary ------
Pot: 1.25. Rake 0
Player Aquaman75 does not show cards.Bets: 0.25. Collects: 0. Loses: 0.25.
Player IlxxxlI does not show cards.Bets: 0.50. Collects: 0. Loses: 0.50.
Player Ice Bank Mice Elf does not show cards.Bets: 0. Collects: 0. Wins: 0.
Player Log_in does not show cards.Bets: 0. Collects: 0. Wins: 0.
Player CumBckMuny does not show cards.Bets: 0. Collects: 0. Wins: 0.
*Player XxDominationxX mucks (does not show cards). Bets: 0.50. Collects: 1.25. Wins: 0.75.
Player coldkilla does not show cards.Bets: 0. Collects: 0. Wins: 0.
Game ended at: 2016/11/29 8:52:39

Game started
Game ID: 786769636 1/2 (PRR) Longana - 2 (Hold'em)
Seat 2 is the button
Seat 1: IlxxxlI (96.21).
Seat 2: Tilt-A-Whirl (220.96).
Seat 3: IamPhamous (146.87).
Seat 4: PANDAisEVIL (212.93).
Seat 5: Iia007 (251.76).
Seat 6: 322xxx (200).
Seat 7: MadLifeGrinder (245.04).
Seat 8: mr.fargo (146.55).
Seat 9: shokerAAss (200).
Player IamPhamous has small blind (1)
Player PANDAisEVIL has big blind (2)
Player IlxxxlI received card: [As]
Player IlxxxlI received card: [5c]
Player Iia007 folds
Player 322xxx folds
Player MadLifeGrinder folds
Player mr.fargo folds
Player shokerAAss folds
Player IlxxxlI folds
Player Tilt-A-Whirl folds
Player IamPhamous calls (1)
Player PANDAisEVIL raises (5)
Player IamPhamous raises (20)
Player PANDAisEVIL folds
Uncalled bet (15) returned to IamPhamous
Player IamPhamous mucks cards
------ Summary ------
Pot: 14. Rake 0
Player IlxxxlI does not show cards.Bets: 0. Collects: 0. Wins: 0.
Player Tilt-A-Whirl does not show cards.Bets: 0. Collects: 0. Wins: 0.
*Player IamPhamous mucks (does not show cards). Bets: 7. Collects: 14. Wins: 7.
Player PANDAisEVIL does not show cards.Bets: 7. Collects: 0. Loses: 7.
Player Iia007 does not show cards.Bets: 0. Collects: 0. Wins: 0.
Player 322xxx does not show cards.Bets: 0. Collects: 0. Wins: 0.
Player MadLifeGrinder does not show cards.Bets: 0. Collects: 0. Wins: 0.
Player mr.fargo does not show cards.Bets: 0. Collects: 0. Wins: 0.
Player shokerAAss does not show cards.Bets: 0. Collects: 0. Wins: 0.
Game ended at: 2016/11/29 8:52:13

Game started
Game ID: 786769565 0.25/0.50 (PRR) Gorgons - 7 (Hold'em)
Seat 2 is the button
Seat 1: Evilclown (20).
Seat 2: Heksebrygg (51.59).
Seat 3: Dirty4skin (48.09).
Seat 4: imperceptible (19.25).
Seat 5: Tilt-A-Whirl (51.50).
Seat 6: IlxxxlI (23.48).
Player Dirty4skin has small blind (0.25)
Player imperceptible has big blind (0.50)
Player IlxxxlI received card: [Qc]
Player IlxxxlI received card: [5c]
Player Tilt-A-Whirl folds
Player IlxxxlI folds
Player Evilclown calls (0.50)
Player Heksebrygg folds
Player Dirty4skin calls (0.25)
Player imperceptible raises (1.50)
Player Evilclown folds
Player Dirty4skin calls (1.50)
*** FLOP ***: [2h As 8h]
Player Dirty4skin checks
Player imperceptible bets (2.85)
Player Dirty4skin folds
Uncalled bet (2.85) returned to imperceptible
Player imperceptible mucks cards
------ Summary ------
Pot: 4.28. Rake 0.16. JP fee 0.06
Board: [2h As 8h]
Player Evilclown does not show cards.Bets: 0.50. Collects: 0. Loses: 0.50.
Player Heksebrygg does not show cards.Bets: 0. Collects: 0. Wins: 0.
Player Dirty4skin does not show cards.Bets: 2. Collects: 0. Loses: 2.
*Player imperceptible mucks (does not show cards). Bets: 2. Collects: 4.28. Wins: 2.28.
Player Tilt-A-Whirl does not show cards.Bets: 0. Collects: 0. Wins: 0.
Player IlxxxlI does not show cards.Bets: 0. Collects: 0. Wins: 0.
Game ended at: 2016/11/29 8:52:9

Game started
Game ID: 786769247 0.25/0.50 (PRR) Gorgons - 7 (Hold'em)
Seat 1 is the button
Seat 1: Evilclown (20).
Seat 2: Heksebrygg (51.84).
Seat 3: Dirty4skin (48.59).
Seat 4: imperceptible (19.25).
Seat 5: Tilt-A-Whirl (50.75).
Seat 6: IlxxxlI (23.48).
Player Heksebrygg has small blind (0.25)
Player Dirty4skin has big blind (0.50)
Player IlxxxlI received card: [4d]
Player IlxxxlI received card: [7c]
Player imperceptible folds
Player Tilt-A-Whirl raises (1)
Player IlxxxlI folds
Player Evilclown folds
Player Heksebrygg folds
Player Dirty4skin folds
Uncalled bet (0.50) returned to Tilt-A-Whirl
Player Tilt-A-Whirl mucks cards
------ Summary ------
Pot: 1.25. Rake 0
Player Evilclown does not show cards.Bets: 0. Collects: 0. Wins: 0.
Player Heksebrygg does not show cards.Bets: 0.25. Collects: 0. Loses: 0.25.
Player Dirty4skin does not show cards.Bets: 0.50. Collects: 0. Loses: 0.50.
Player imperceptible does not show cards.Bets: 0. Collects: 0. Wins: 0.
*Player Tilt-A-Whirl mucks (does not show cards). Bets: 0.50. Collects: 1.25. Wins: 0.75.
Player IlxxxlI does not show cards.Bets: 0. Collects: 0. Wins: 0.
Game ended at: 2016/11/29 8:51:10

Game started
Game ID: 786769196 1/2 (PRR) Longana - 2 (Hold'em)
Seat 1 is the button
Seat 1: IlxxxlI (96.21).
Seat 2: Tilt-A-Whirl (221.96).
Seat 3: IamPhamous (148.87).
Seat 4: PANDAisEVIL (209.93).
Seat 5: Iia007 (251.76).
Seat 6: 322xxx (200).
Seat 7: MadLifeGrinder (245.04).
Seat 8: mr.fargo (146.55).
Seat 9: shokerAAss (200).
Player Tilt-A-Whirl has small blind (1)
Player IamPhamous has big blind (2)
Player IlxxxlI received card: [6s]
Player IlxxxlI received card: [Jc]
Player PANDAisEVIL raises (6)
Player Iia007 folds
Player 322xxx folds
Player MadLifeGrinder folds
Player mr.fargo folds
Player shokerAAss folds
Player IlxxxlI folds
Player Tilt-A-Whirl folds
Player IamPhamous folds
Uncalled bet (4) returned to PANDAisEVIL
Player PANDAisEVIL mucks cards
------ Summary ------
Pot: 5. Rake 0
Player IlxxxlI does not show cards.Bets: 0. Collects: 0. Wins: 0.
Player Tilt-A-Whirl does not show cards.Bets: 1. Collects: 0. Loses: 1.
Player IamPhamous does not show cards.Bets: 2. Collects: 0. Loses: 2.
*Player PANDAisEVIL mucks (does not show cards). Bets: 2. Collects: 5. Wins: 3.
Player Iia007 does not show cards.Bets: 0. Collects: 0. Wins: 0.
Player 322xxx does not show cards.Bets: 0. Collects: 0. Wins: 0.
Player MadLifeGrinder does not show cards.Bets: 0. Collects: 0. Wins: 0.
Player mr.fargo does not show cards.Bets: 0. Collects: 0. Wins: 0.
Player shokerAAss does not show cards.Bets: 0. Collects: 0. Wins: 0.
Game ended at: 2016/11/29 8:51:16

Game started
Game ID: 786768939 0.25/0.50 (PRR) Garuda - 2 (Hold'em)
Seat 5 is the button
Seat 1: Tilt-A-Whirl (50.75).
Seat 2: apoo11 (83.49).
Seat 3: imperceptible (16.51).
Seat 4: Ice Bank Mice Elf (50).
Seat 5: tutofu84 (88.77).
Seat 6: IlxxxlI (20).
Seat 8: Aquaman75 (64.79).
Seat 9: kid4life (49.25).
Player IlxxxlI has small blind (0.25)
Player Aquaman75 has big blind (0.50)
Player IlxxxlI received card: [2h]
Player IlxxxlI received card: [5s]
Player kid4life folds
Player Tilt-A-Whirl raises (1)
Player apoo11 folds
Player imperceptible folds
Player Ice Bank Mice Elf folds
Player tutofu84 raises (3.50)
Player IlxxxlI folds
Player Aquaman75 folds
Player Tilt-A-Whirl calls (2.50)
*** FLOP ***: [5d Ks 4s]
Player Tilt-A-Whirl checks
Player tutofu84 bets (4.91)
Player Tilt-A-Whirl folds
Uncalled bet (4.91) returned to tutofu84
Player tutofu84 mucks cards
------ Summary ------
Pot: 7.37. Rake 0.26. JP fee 0.12
Board: [5d Ks 4s]
Player Tilt-A-Whirl does not show cards.Bets: 3.50. Collects: 0. Loses: 3.50.
Player apoo11 does not show cards.Bets: 0. Collects: 0. Wins: 0.
Player imperceptible does not show cards.Bets: 0. Collects: 0. Wins: 0.
Player Ice Bank Mice Elf does not show cards.Bets: 0. Collects: 0. Wins: 0.
*Player tutofu84 mucks (does not show cards). Bets: 3.50. Collects: 7.37. Wins: 3.87.
Player IlxxxlI does not show cards.Bets: 0.25. Collects: 0. Loses: 0.25.
Player Aquaman75 does not show cards.Bets: 0.50. Collects: 0. Loses: 0.50.
Player kid4life does not show cards.Bets: 0. Collects: 0. Wins: 0.
Game ended at: 2016/11/29 8:52:6

Game started
Game ID: 786768875 0.25/0.50 (PRR) Gorgons - 7 (Hold'em)
Seat 6 is the button
Seat 1: Evilclown (20.25).
Seat 2: Heksebrygg (51.59).
Seat 3: Dirty4skin (48.59).
Seat 4: imperceptible (19.25).
Seat 5: Tilt-A-Whirl (50.75).
Seat 6: IlxxxlI (23.48).
Player Evilclown has small blind (0.25)
Player Heksebrygg has big blind (0.50)
Player IlxxxlI received card: [Js]
Player IlxxxlI received card: [6s]
Player Dirty4skin folds
Player imperceptible folds
Player Tilt-A-Whirl folds
Player IlxxxlI folds
Player Evilclown folds
Uncalled bet (0.25) returned to Heksebrygg
Player Heksebrygg mucks cards
------ Summary ------
Pot: 0.50. Rake 0
Player Evilclown does not show cards.Bets: 0.25. Collects: 0. Loses: 0.25.
*Player Heksebrygg mucks (does not show cards). Bets: 0.25. Collects: 0.50. Wins: 0.25.
Player Dirty4skin does not show cards.Bets: 0. Collects: 0. Wins: 0.
Player imperceptible does not show cards.Bets: 0. Collects: 0. Wins: 0.
Player Tilt-A-Whirl does not show cards.Bets: 0. Collects: 0. Wins: 0.
Player IlxxxlI does not show cards.Bets: 0. Collects: 0. Wins: 0.
Game ended at: 2016/11/29 8:50:48

Game started
Game ID: 786768073 0.25/0.50 (PRR) Garuda (Hold'em)
Seat 6 is the button
Seat 1: Aquaman75 (64.53).
Seat 2: IlxxxlI (21.54).
Seat 3: Ice Bank Mice Elf (63.93).
Seat 4: Log_in (13.50).
Seat 5: CumBckMuny (31.39).
Seat 6: XxDominationxX (82).
Seat 7: coldkilla (60.16).
Seat 9: Taxriverman (51.83).
Player coldkilla has small blind (0.25)
Player Taxriverman has big blind (0.50)
Player IlxxxlI received card: [8c]
Player IlxxxlI received card: [Qh]
Player Aquaman75 folds
Player IlxxxlI folds
Player Ice Bank Mice Elf raises (1.25)
Player Log_in folds
Player CumBckMuny folds
Player XxDominationxX folds
Player coldkilla calls (1)
Player Taxriverman calls (0.75)
*** FLOP ***: [5s Jh 3c]
Player coldkilla checks
Player Taxriverman is timed out.
Player Taxriverman checks
Player Ice Bank Mice Elf checks
*** TURN ***: [5s Jh 3c] [8h]
Player coldkilla bets (0.50)
Player Taxriverman is timed out.
Player Taxriverman folds
Player Ice Bank Mice Elf folds
Uncalled bet (0.50) returned to coldkilla
Player coldkilla mucks cards
------ Summary ------
Pot: 3.57. Rake 0.12. JP fee 0.06
Board: [5s Jh 3c 8h]
Player Aquaman75 does not show cards.Bets: 0. Collects: 0. Wins: 0.
Player IlxxxlI does not show cards.Bets: 0. Collects: 0. Wins: 0.
Player Ice Bank Mice Elf does not show cards.Bets: 1.25. Collects: 0. Loses: 1.25.
Player Log_in does not show cards.Bets: 0. Collects: 0. Wins: 0.
Player CumBckMuny does not show cards.Bets: 0. Collects: 0. Wins: 0.
Player XxDominationxX does not show cards.Bets: 0. Collects: 0. Wins: 0.
*Player coldkilla mucks (does not show cards). Bets: 1.25. Collects: 3.57. Wins: 2.32.
Player Taxriverman does not show cards.Bets: 1.25. Collects: 0. Loses: 1.25.
Game ended at: 2016/11/29 8:51:50

Game started
Game ID: 786767926 0.25/0.50 (PRR) Gorgons - 7 (Hold'em)
Seat 5 is the button
Seat 1: Evilclown (20.75).
Seat 2: Heksebrygg (51.59).
Seat 3: Dirty4skin (48.59).
Seat 4: imperceptible (19.25).
Seat 5: Tilt-A-Whirl (50).
Seat 6: IlxxxlI (23.73).
Player IlxxxlI has small blind (0.25)
Player Evilclown has big blind (0.50)
Player IlxxxlI received card: [6c]
Player IlxxxlI received card: [5d]
Player Heksebrygg folds
Player Dirty4skin folds
Player imperceptible folds
Player Tilt-A-Whirl raises (1.50)
Player IlxxxlI is timed out.
Player IlxxxlI folds
Player Evilclown folds
Uncalled bet (1) returned to Tilt-A-Whirl
Player Tilt-A-Whirl mucks cards
------ Summary ------
Pot: 1.25. Rake 0
Player Evilclown does not show cards.Bets: 0.50. Collects: 0. Loses: 0.50.
Player Heksebrygg does not show cards.Bets: 0. Collects: 0. Wins: 0.
Player Dirty4skin does not show cards.Bets: 0. Collects: 0. Wins: 0.
Player imperceptible does not show cards.Bets: 0. Collects: 0. Wins: 0.
*Player Tilt-A-Whirl mucks (does not show cards). Bets: 0.50. Collects: 1.25. Wins: 0.75.
Player IlxxxlI does not show cards.Bets: 0.25. Collects: 0. Loses: 0.25.
Game ended at: 2016/11/29 8:50:24

Game started
Game ID: 786767552 0.25/0.50 (PRR) Garuda - 2 (Hold'em)
Seat 4 is the button
Seat 1: Tilt-A-Whirl (50).
Seat 2: apoo11 (83.49).
Seat 3: imperceptible (16.51).
Seat 4: Ice Bank Mice Elf (50).
Seat 5: tutofu84 (89.02).
Seat 6: IlxxxlI (20).
Seat 8: Aquaman75 (64.79).
Seat 9: kid4life (49.25).
Player tutofu84 has small blind (0.25)
Player IlxxxlI has big blind (0.50)
Player IlxxxlI received card: [10h]
Player IlxxxlI received card: [4d]
Player Aquaman75 folds
Player kid4life folds
Player Tilt-A-Whirl raises (1.50)
Player apoo11 folds
Player imperceptible folds
Player Ice Bank Mice Elf folds
Player tutofu84 folds
Player IlxxxlI is timed out.
Player IlxxxlI folds
Uncalled bet (1) returned to Tilt-A-Whirl
Player Tilt-A-Whirl mucks cards
------ Summary ------
Pot: 1.25. Rake 0
*Player Tilt-A-Whirl mucks (does not show cards). Bets: 0.50. Collects: 1.25. Wins: 0.75.
Player apoo11 does not show cards.Bets: 0. Collects: 0. Wins: 0.
Player imperceptible does not show cards.Bets: 0. Collects: 0. Wins: 0.
Player Ice Bank Mice Elf does not show cards.Bets: 0. Collects: 0. Wins: 0.
Player tutofu84 does not show cards.Bets: 0.25. Collects: 0. Loses: 0.25.
Player IlxxxlI does not show cards.Bets: 0.50. Collects: 0. Loses: 0.50.
Player Aquaman75 does not show cards.Bets: 0. Collects: 0. Wins: 0.
Player kid4life does not show cards.Bets: 0. Collects: 0. Wins: 0.
Game ended at: 2016/11/29 8:50:29

Game started
Game ID: 786767356 1/2 (PRR) Longana - 2 (Hold'em)
Seat 9 is the button
Seat 1: IlxxxlI (97.21).
Seat 2: Tilt-A-Whirl (227.96).
Seat 3: IamPhamous (154.87).
Seat 4: PANDAisEVIL (209.93).
Seat 5: Iia007 (251.76).
Seat 6: 322xxx (200).
Seat 7: MadLifeGrinder (213.04).
Seat 8: mr.fargo (146.55).
Seat 9: shokerAAss (200).
Player IlxxxlI has small blind (1)
Player Tilt-A-Whirl has big blind (2)
Player IlxxxlI received card: [Ad]
Player IlxxxlI received card: [10c]
Player IamPhamous raises (6)
Player PANDAisEVIL folds
Player Iia007 folds
Player 322xxx folds
Player MadLifeGrinder calls (6)
Player mr.fargo folds
Player shokerAAss calls (6)
Player IlxxxlI folds
Player Tilt-A-Whirl calls (4)
*** FLOP ***: [9s 6h 5h]
Player Tilt-A-Whirl checks
Player IamPhamous checks
Player MadLifeGrinder bets (15.83)
Player shokerAAss calls (15.83)
Player Tilt-A-Whirl folds
Player IamPhamous folds
*** TURN ***: [9s 6h 5h] [4d]
Player MadLifeGrinder bets (44)
Player shokerAAss folds
Uncalled bet (44) returned to MadLifeGrinder
Player MadLifeGrinder mucks cards
------ Summary ------
Pot: 53.83. Rake 2.59. JP fee 0.24
Board: [9s 6h 5h 4d]
Player IlxxxlI does not show cards.Bets: 1. Collects: 0. Loses: 1.
Player Tilt-A-Whirl does not show cards.Bets: 6. Collects: 0. Loses: 6.
Player IamPhamous does not show cards.Bets: 6. Collects: 0. Loses: 6.
Player PANDAisEVIL does not show cards.Bets: 0. Collects: 0. Wins: 0.
Player Iia007 does not show cards.Bets: 0. Collects: 0. Wins: 0.
Player 322xxx does not show cards.Bets: 0. Collects: 0. Wins: 0.
*Player MadLifeGrinder mucks (does not show cards). Bets: 21.83. Collects: 53.83. Wins: 32.
Player mr.fargo does not show cards.Bets: 0. Collects: 0. Wins: 0.
Player shokerAAss does not show cards.Bets: 21.83. Collects: 0. Loses: 21.83.
Game ended at: 2016/11/29 8:50:45

Game started
Game ID: 786767150 0.25/0.50 (PRR) Gorgons - 7 (Hold'em)
Seat 4 is the button
Seat 1: Evilclown (20.75).
Seat 2: Heksebrygg (51.59).
Seat 3: Dirty4skin (51.63).
Seat 4: imperceptible (19.25).
Seat 5: Tilt-A-Whirl (50).
Seat 6: IlxxxlI (20.75).
Player Tilt-A-Whirl has small blind (0.25)
Player IlxxxlI has big blind (0.50)
Player IlxxxlI received card: [6s]
Player IlxxxlI received card: [As]
Player Evilclown folds
Player Heksebrygg folds
Player Dirty4skin raises (1.50)
Player imperceptible folds
Player Tilt-A-Whirl folds
Player IlxxxlI calls (1)
*** FLOP ***: [5s 4h Qc]
Player IlxxxlI checks
Player Dirty4skin bets (1.54)
Player IlxxxlI raises (3.42)
Player Dirty4skin folds
Uncalled bet (1.88) returned to IlxxxlI
Player IlxxxlI mucks cards
------ Summary ------
Pot: 6.02. Rake 0.21. JP fee 0.10
Board: [5s 4h Qc]
Player Evilclown does not show cards.Bets: 0. Collects: 0. Wins: 0.
Player Heksebrygg does not show cards.Bets: 0. Collects: 0. Wins: 0.
Player Dirty4skin does not show cards.Bets: 3.04. Collects: 0. Loses: 3.04.
Player imperceptible does not show cards.Bets: 0. Collects: 0. Wins: 0.
Player Tilt-A-Whirl does not show cards.Bets: 0.25. Collects: 0. Loses: 0.25.
*Player IlxxxlI mucks (does not show cards). Bets: 3.04. Collects: 6.02. Wins: 2.98.
Game ended at: 2016/11/29 8:49:21

Game started
Game ID: 786766793 1/2 (PRR) Longana - 2 (Hold'em)
Seat 8 is the button
Seat 1: IlxxxlI (101.21).
Seat 2: Tilt-A-Whirl (223.41).
Seat 3: IamPhamous (154.87).
Seat 4: PANDAisEVIL (209.93).
Seat 5: Iia007 (251.76).
Seat 6: 322xxx (200).
Seat 7: MadLifeGrinder (213.04).
Seat 8: mr.fargo (146.55).
Seat 9: shokerAAss (200.25).
Player shokerAAss has small blind (1)
Player IlxxxlI has big blind (2)
Player IlxxxlI received card: [6h]
Player IlxxxlI received card: [Kh]
Player Tilt-A-Whirl raises (4)
Player IamPhamous folds
Player PANDAisEVIL folds
Player Iia007 folds
Player 322xxx folds
Player MadLifeGrinder folds
Player mr.fargo folds
Player shokerAAss folds
Player IlxxxlI calls (2)
*** FLOP ***: [4c 5c 10s]
Player IlxxxlI checks
Player Tilt-A-Whirl bets (2.85)
Player IlxxxlI folds
Uncalled bet (2.85) returned to Tilt-A-Whirl
Player Tilt-A-Whirl mucks cards
------ Summary ------
Pot: 8.55. Rake 0.31. JP fee 0.14
Board: [4c 5c 10s]
Player IlxxxlI does not show cards.Bets: 4. Collects: 0. Loses: 4.
*Player Tilt-A-Whirl mucks (does not show cards). Bets: 4. Collects: 8.55. Wins: 4.55.
Player IamPhamous does not show cards.Bets: 0. Collects: 0. Wins: 0.
Player PANDAisEVIL does not show cards.Bets: 0. Collects: 0. Wins: 0.
Player Iia007 does not show cards.Bets: 0. Collects: 0. Wins: 0.
Player 322xxx does not show cards.Bets: 0. Collects: 0. Wins: 0.
Player MadLifeGrinder does not show cards.Bets: 0. Collects: 0. Wins: 0.
Player mr.fargo does not show cards.Bets: 0. Collects: 0. Wins: 0.
Player shokerAAss does not show cards.Bets: 1. Collects: 0. Loses: 1.
Game ended at: 2016/11/29 8:48:42

Game started
Game ID: 786766439 0.25/0.50 (PRR) Garuda - 2 (Hold'em)
Seat 3 is the button
Seat 1: Tilt-A-Whirl (50).
Seat 2: apoo11 (83.49).
Seat 3: imperceptible (16.51).
Seat 4: Ice Bank Mice Elf (50.12).
Seat 5: tutofu84 (87.88).
Seat 6: IlxxxlI (20).
Seat 8: Aquaman75 (64.79).
Seat 9: kid4life (49.25).
Player Ice Bank Mice Elf has small blind (0.25)
Player tutofu84 has big blind (0.50)
Player IlxxxlI received card: [As]
Player IlxxxlI received card: [5c]
Player IlxxxlI folds
Player Aquaman75 folds
Player kid4life folds
Player Tilt-A-Whirl raises (1)
Player apoo11 folds
Player imperceptible folds
Player Ice Bank Mice Elf folds
Player tutofu84 calls (0.50)
*** FLOP ***: [Qs Ad Jd]
Player tutofu84 checks
Player Tilt-A-Whirl checks
*** TURN ***: [Qs Ad Jd] [6c]
Player tutofu84 bets (1.07)
Player Tilt-A-Whirl folds
Uncalled bet (1.07) returned to tutofu84
Player tutofu84 mucks cards
------ Summary ------
Pot: 2.14. Rake 0.09. JP fee 0.02
Board: [Qs Ad Jd 6c]
Player Tilt-A-Whirl does not show cards.Bets: 1. Collects: 0. Loses: 1.
Player apoo11 does not show cards.Bets: 0. Collects: 0. Wins: 0.
Player imperceptible does not show cards.Bets: 0. Collects: 0. Wins: 0.
Player Ice Bank Mice Elf does not show cards.Bets: 0.25. Collects: 0. Loses: 0.25.
*Player tutofu84 mucks (does not show cards). Bets: 1. Collects: 2.14. Wins: 1.14.
Player IlxxxlI does not show cards.Bets: 0. Collects: 0. Wins: 0.
Player Aquaman75 does not show cards.Bets: 0. Collects: 0. Wins: 0.
Player kid4life does not show cards.Bets: 0. Collects: 0. Wins: 0.
Game ended at: 2016/11/29 8:48:57

Game started
Game ID: 786766352 1/2 (PRR) Longana - 2 (Hold'em)
Seat 7 is the button
Seat 1: IlxxxlI (98.21).
Seat 2: Tilt-A-Whirl (223.41).
Seat 3: IamPhamous (154.87).
Seat 4: PANDAisEVIL (209.93).
Seat 5: Iia007 (251.76).
Seat 6: 322xxx (200).
Seat 7: MadLifeGrinder (213.04).
Seat 8: mr.fargo (147.55).
Seat 9: shokerAAss (202.25).
Player mr.fargo has small blind (1)
Player shokerAAss has big blind (2)
Player IlxxxlI received card: [Ac]
Player IlxxxlI received card: [Ad]
Player IlxxxlI raises (7)
Player Tilt-A-Whirl folds
Player IamPhamous folds
Player PANDAisEVIL folds
Player Iia007 folds
Player 322xxx folds
Player MadLifeGrinder folds
Player mr.fargo folds
Player shokerAAss folds
Uncalled bet (5) returned to IlxxxlI
Player IlxxxlI mucks cards
------ Summary ------
Pot: 5. Rake 0
*Player IlxxxlI mucks (does not show cards). Bets: 2. Collects: 5. Wins: 3.
Player Tilt-A-Whirl does not show cards.Bets: 0. Collects: 0. Wins: 0.
Player IamPhamous does not show cards.Bets: 0. Collects: 0. Wins: 0.
Player PANDAisEVIL does not show cards.Bets: 0. Collects: 0. Wins: 0.
Player Iia007 does not show cards.Bets: 0. Collects: 0. Wins: 0.
Player 322xxx does not show cards.Bets: 0. Collects: 0. Wins: 0.
Player MadLifeGrinder does not show cards.Bets: 0. Collects: 0. Wins: 0.
Player mr.fargo does not show cards.Bets: 1. Collects: 0. Loses: 1.
Player shokerAAss does not show cards.Bets: 2. Collects: 0. Loses: 2.
Game ended at: 2016/11/29 8:48:7

Game started
Game ID: 786766291 0.25/0.50 (PRR) Gorgons - 7 (Hold'em)
Seat 3 is the button
Seat 1: Evilclown (20.75).
Seat 2: Heksebrygg (50).
Seat 3: Dirty4skin (51.63).
Seat 4: imperceptible (19.50).
Seat 5: Tilt-A-Whirl (50).
Seat 6: IlxxxlI (20.75).
Player imperceptible has small blind (0.25)
Player Tilt-A-Whirl has big blind (0.50)
Player IlxxxlI received card: [Qd]
Player IlxxxlI received card: [3c]
Player IlxxxlI folds
Player Evilclown folds
Player Heksebrygg raises (1.50)
Player Dirty4skin folds
Player imperceptible folds
Player Tilt-A-Whirl calls (1)
*** FLOP ***: [Kh Jc 4d]
Player Tilt-A-Whirl checks
Player Heksebrygg checks
*** TURN ***: [Kh Jc 4d] [6d]
Player Tilt-A-Whirl checks
Player Heksebrygg checks
*** RIVER ***: [Kh Jc 4d 6d] [7s]
Player Tilt-A-Whirl checks
Player Heksebrygg checks
Player Tilt-A-Whirl mucks cards
------ Summary ------
Pot: 3.09. Rake 0.12. JP fee 0.04
Board: [Kh Jc 4d 6d 7s]
Player Evilclown does not show cards.Bets: 0. Collects: 0. Wins: 0.
*Player Heksebrygg shows: One pair of 10s [10d 10h]. Bets: 1.50. Collects: 3.09. Wins: 1.59.
Player Dirty4skin does not show cards.Bets: 0. Collects: 0. Wins: 0.
Player imperceptible does not show cards.Bets: 0.25. Collects: 0. Loses: 0.25.
Player Tilt-A-Whirl mucks (does not show cards). Bets: 1.50. Collects: 0. Loses: 1.50.
Player IlxxxlI does not show cards.Bets: 0. Collects: 0. Wins: 0.
Game ended at: 2016/11/29 8:48:27

Game started
Game ID: 786766260 0.25/0.50 (PRR) Garuda (Hold'em)
Seat 5 is the button
Seat 1: Aquaman75 (64.53).
Seat 2: IlxxxlI (21.54).
Seat 3: Ice Bank Mice Elf (63.93).
Seat 4: Log_in (13.50).
Seat 5: CumBckMuny (31.39).
Seat 6: XxDominationxX (82.50).
Seat 7: coldkilla (60.66).
Seat 9: Taxriverman (50.90).
Player XxDominationxX has small blind (0.25)
Player coldkilla has big blind (0.50)
Player IlxxxlI received card: [8d]
Player IlxxxlI received card: [Kh]
Player Taxriverman calls (0.50)
Player Aquaman75 folds
Player IlxxxlI folds
Player Ice Bank Mice Elf folds
Player Log_in folds
Player CumBckMuny folds
Player XxDominationxX calls (0.25)
Player coldkilla checks
*** FLOP ***: [Ks 3c 6s]
Player XxDominationxX checks
Player coldkilla checks
Player Taxriverman checks
*** TURN ***: [Ks 3c 6s] [9s]
Player XxDominationxX checks
Player coldkilla checks
Player Taxriverman is timed out.
Player Taxriverman checks
*** RIVER ***: [Ks 3c 6s 9s] [Kd]
Player XxDominationxX checks
Player coldkilla checks
Player Taxriverman is timed out.
Player Taxriverman checks
Player XxDominationxX mucks cards
Player coldkilla mucks cards
------ Summary ------
Pot: 1.43. Rake 0.05. JP fee 0.02
Board: [Ks 3c 6s 9s Kd]
Player Aquaman75 does not show cards.Bets: 0. Collects: 0. Wins: 0.
Player IlxxxlI does not show cards.Bets: 0. Collects: 0. Wins: 0.
Player Ice Bank Mice Elf does not show cards.Bets: 0. Collects: 0. Wins: 0.
Player Log_in does not show cards.Bets: 0. Collects: 0. Wins: 0.
Player CumBckMuny does not show cards.Bets: 0. Collects: 0. Wins: 0.
Player XxDominationxX mucks (does not show cards). Bets: 0.50. Collects: 0. Loses: 0.50.
Player coldkilla mucks (does not show cards). Bets: 0.50. Collects: 0. Loses: 0.50.
*Player Taxriverman shows: One pair of Ks [Qd Ac]. Bets: 0.50. Collects: 1.43. Wins: 0.93.
Game ended at: 2016/11/29 8:49:30

Game started
Game ID: 786765932 0.25/0.50 (PRR) Gorgons - 7 (Hold'em)
Seat 2 is the button
Seat 1: Evilclown (20).
Seat 2: Heksebrygg (50).
Seat 3: Dirty4skin (51.88).
Seat 4: imperceptible (20).
Seat 6: IlxxxlI (20.75).
Player Dirty4skin has small blind (0.25)
Player imperceptible has big blind (0.50)
Player IlxxxlI received card: [5d]
Player IlxxxlI received card: [Jc]
Player IlxxxlI folds
Player Evilclown raises (1)
Player Heksebrygg folds
Player Dirty4skin folds
Player imperceptible folds
Uncalled bet (0.50) returned to Evilclown
Player Evilclown mucks cards
------ Summary ------
Pot: 1.25. Rake 0
*Player Evilclown mucks (does not show cards). Bets: 0.50. Collects: 1.25. Wins: 0.75.
Player Heksebrygg does not show cards.Bets: 0. Collects: 0. Wins: 0.
Player Dirty4skin does not show cards.Bets: 0.25. Collects: 0. Loses: 0.25.
Player imperceptible does not show cards.Bets: 0.50. Collects: 0. Loses: 0.50.
Player IlxxxlI does not show cards.Bets: 0. Collects: 0. Wins: 0.
Game ended at: 2016/11/29 8:47:33

Game started
Game ID: 786765652 0.25/0.50 (PRR) Garuda (Hold'em)
Seat 4 is the button
Seat 1: Aquaman75 (64.53).
Seat 2: IlxxxlI (21.54).
Seat 3: Ice Bank Mice Elf (65.18).
Seat 4: Log_in (11.50).
Seat 5: CumBckMuny (31.64).
Seat 6: XxDominationxX (83).
Seat 7: coldkilla (60.66).
Seat 9: Taxriverman (50.90).
Player CumBckMuny has small blind (0.25)
Player XxDominationxX has big blind (0.50)
Player IlxxxlI received card: [6d]
Player IlxxxlI received card: [10h]
Player coldkilla folds
Player Taxriverman folds
Player Aquaman75 folds
Player IlxxxlI folds
Player Ice Bank Mice Elf raises (1.25)
Player Log_in allin (11.50)
Player CumBckMuny folds
Player XxDominationxX folds
Player Ice Bank Mice Elf folds
Uncalled bet (10.25) returned to Log_in
Player Log_in mucks cards
------ Summary ------
Pot: 3.25. Rake 0
Player Aquaman75 does not show cards.Bets: 0. Collects: 0. Wins: 0.
Player IlxxxlI does not show cards.Bets: 0. Collects: 0. Wins: 0.
Player Ice Bank Mice Elf does not show cards.Bets: 1.25. Collects: 0. Loses: 1.25.
*Player Log_in mucks (does not show cards). Bets: 1.25. Collects: 3.25. Wins: 2.
Player CumBckMuny does not show cards.Bets: 0.25. Collects: 0. Loses: 0.25.
Player XxDominationxX does not show cards.Bets: 0.50. Collects: 0. Loses: 0.50.
Player coldkilla does not show cards.Bets: 0. Collects: 0. Wins: 0.
Player Taxriverman does not show cards.Bets: 0. Collects: 0. Wins: 0.
Game ended at: 2016/11/29 8:47:32

Game started
Game ID: 786765513 0.25/0.50 (PRR) Gorgons - 7 (Hold'em)
Seat 1 is the button
Seat 1: Evilclown (20).
Seat 2: Heksebrygg (50).
Seat 3: Dirty4skin (51.63).
Seat 4: imperceptible (20).
Seat 6: IlxxxlI (20.75).
Player Heksebrygg has small blind (0.25)
Player Dirty4skin has big blind (0.50)
Player imperceptible wait BB
Player IlxxxlI received card: [4h]
Player IlxxxlI received card: [5s]
Player IlxxxlI folds
Player Evilclown folds
Player Heksebrygg folds
Uncalled bet (0.25) returned to Dirty4skin
Player Dirty4skin mucks cards
------ Summary ------
Pot: 0.50. Rake 0
Player Evilclown does not show cards.Bets: 0. Collects: 0. Wins: 0.
Player Heksebrygg does not show cards.Bets: 0.25. Collects: 0. Loses: 0.25.
*Player Dirty4skin mucks (does not show cards). Bets: 0.25. Collects: 0.50. Wins: 0.25.
Player imperceptible does not show cards.Bets: 0. Collects: 0. Wins: 0.
Player IlxxxlI does not show cards.Bets: 0. Collects: 0. Wins: 0.
Game ended at: 2016/11/29 8:47:9

Game started
Game ID: 786765423 1/2 (PRR) Longana - 2 (Hold'em)
Seat 6 is the button
Seat 1: IlxxxlI (98.21).
Seat 2: Tilt-A-Whirl (223.41).
Seat 3: IamPhamous (174.87).
Seat 4: PANDAisEVIL (209.93).
Seat 5: Iia007 (230.91).
Seat 6: 322xxx (200).
Seat 7: MadLifeGrinder (214.04).
Seat 8: mr.fargo (149.55).
Seat 9: shokerAAss (202.25).
Player MadLifeGrinder has small blind (1)
Player mr.fargo has big blind (2)
Player IlxxxlI received card: [Ah]
Player IlxxxlI received card: [4h]
Player shokerAAss folds
Player IlxxxlI folds
Player Tilt-A-Whirl folds
Player IamPhamous raises (6)
Player PANDAisEVIL folds
Player Iia007 raises (20)
Player 322xxx folds
Player MadLifeGrinder folds
Player mr.fargo folds
Player IamPhamous calls (14)
*** FLOP ***: [8c 6h 3h]
Player IamPhamous checks
Player Iia007 bets (20.42)
Player IamPhamous folds
Uncalled bet (20.42) returned to Iia007
Player Iia007 mucks cards
------ Summary ------
Pot: 40.85. Rake 1.91. JP fee 0.24
Board: [8c 6h 3h]
Player IlxxxlI does not show cards.Bets: 0. Collects: 0. Wins: 0.
Player Tilt-A-Whirl does not show cards.Bets: 0. Collects: 0. Wins: 0.
Player IamPhamous does not show cards.Bets: 20. Collects: 0. Loses: 20.
Player PANDAisEVIL does not show cards.Bets: 0. Collects: 0. Wins: 0.
*Player Iia007 mucks (does not show cards). Bets: 20. Collects: 40.85. Wins: 20.85.
Player 322xxx does not show cards.Bets: 0. Collects: 0. Wins: 0.
Player MadLifeGrinder does not show cards.Bets: 1. Collects: 0. Loses: 1.
Player mr.fargo does not show cards.Bets: 2. Collects: 0. Loses: 2.
Player shokerAAss does not show cards.Bets: 0. Collects: 0. Wins: 0.
Game ended at: 2016/11/29 8:47:39

Game started
Game ID: 786765172 0.25/0.50 (PRR) Gorgons - 7 (Hold'em)
Seat 6 is the button
Seat 1: Evilclown (20.25).
Seat 2: Heksebrygg (50).
Seat 3: Dirty4skin (51.63).
Seat 4: imperceptible (20).
Seat 6: IlxxxlI (20).
Player Evilclown has small blind (0.25)
Player Heksebrygg has big blind (0.50)
Player imperceptible wait BB
Player IlxxxlI received card: [Js]
Player IlxxxlI received card: [Ac]
Player Dirty4skin folds
Player IlxxxlI raises (1.50)
Player Evilclown folds
Player Heksebrygg folds
Uncalled bet (1) returned to IlxxxlI
Player IlxxxlI mucks cards
------ Summary ------
Pot: 1.25. Rake 0
Player Evilclown does not show cards.Bets: 0.25. Collects: 0. Loses: 0.25.
Player Heksebrygg does not show cards.Bets: 0.50. Collects: 0. Loses: 0.50.
Player Dirty4skin does not show cards.Bets: 0. Collects: 0. Wins: 0.
Player imperceptible does not show cards.Bets: 0. Collects: 0. Wins: 0.
*Player IlxxxlI mucks (does not show cards). Bets: 0.50. Collects: 1.25. Wins: 0.75.
Game ended at: 2016/11/29 8:46:40

Game started
Game ID: 786764942 0.25/0.50 (PRR) Gorgons - 7 (Hold'em)
Seat 3 is the button
Seat 1: Evilclown (20).
Seat 2: Heksebrygg (50).
Seat 3: Dirty4skin (51.63).
Seat 6: IlxxxlI (20).
Player IlxxxlI has small blind (0.25)
Player Evilclown has big blind (0.50)
Player IlxxxlI received card: [2d]
Player IlxxxlI received card: [4h]
Player Heksebrygg folds
Player Dirty4skin folds
Player IlxxxlI folds
Uncalled bet (0.25) returned to Evilclown
Player Evilclown mucks cards
------ Summary ------
Pot: 0.50. Rake 0
*Player Evilclown mucks (does not show cards). Bets: 0.25. Collects: 0.50. Wins: 0.25.
Player Heksebrygg does not show cards.Bets: 0. Collects: 0. Wins: 0.
Player Dirty4skin does not show cards.Bets: 0. Collects: 0. Wins: 0.
Player IlxxxlI does not show cards.Bets: 0.25. Collects: 0. Loses: 0.25.
Game ended at: 2016/11/29 8:46:15

Game started
Game ID: 786764887 0.25/0.50 (PRR) Garuda (Hold'em)
Seat 3 is the button
Seat 1: Aquaman75 (64.53).
Seat 2: IlxxxlI (21.54).
Seat 3: Ice Bank Mice Elf (65.18).
Seat 4: Log_in (11.75).
Seat 5: CumBckMuny (32.14).
Seat 6: XxDominationxX (83).
Seat 7: coldkilla (59.91).
Seat 9: Taxriverman (50.90).
Player Log_in has small blind (0.25)
Player CumBckMuny has big blind (0.50)
Player IlxxxlI received card: [Qd]
Player IlxxxlI received card: [5h]
Player XxDominationxX folds
Player coldkilla raises (1.50)
Player Taxriverman folds
Player Aquaman75 folds
Player IlxxxlI folds
Player Ice Bank Mice Elf folds
Player Log_in folds
Player CumBckMuny folds
Uncalled bet (1) returned to coldkilla
Player coldkilla mucks cards
------ Summary ------
Pot: 1.25. Rake 0
Player Aquaman75 does not show cards.Bets: 0. Collects: 0. Wins: 0.
Player IlxxxlI does not show cards.Bets: 0. Collects: 0. Wins: 0.
Player Ice Bank Mice Elf does not show cards.Bets: 0. Collects: 0. Wins: 0.
Player Log_in does not show cards.Bets: 0.25. Collects: 0. Loses: 0.25.
Player CumBckMuny does not show cards.Bets: 0.50. Collects: 0. Loses: 0.50.
Player XxDominationxX does not show cards.Bets: 0. Collects: 0. Wins: 0.
*Player coldkilla mucks (does not show cards). Bets: 0.50. Collects: 1.25. Wins: 0.75.
Player Taxriverman does not show cards.Bets: 0. Collects: 0. Wins: 0.
Game ended at: 2016/11/29 8:46:51

Game started
Game ID: 786764800 1/2 (PRR) Longana - 2 (Hold'em)
Seat 5 is the button
Seat 1: IlxxxlI (98.21).
Seat 2: Tilt-A-Whirl (223.41).
Seat 3: IamPhamous (165.87).
Seat 4: PANDAisEVIL (209.93).
Seat 5: Iia007 (230.91).
Seat 6: 322xxx (200).
Seat 7: MadLifeGrinder (216.04).
Seat 8: mr.fargo (149.55).
Seat 9: shokerAAss (208.25).
Player 322xxx has small blind (1)
Player MadLifeGrinder has big blind (2)
Player IlxxxlI received card: [2c]
Player IlxxxlI received card: [3d]
Player mr.fargo folds
Player shokerAAss raises (6)
Player IlxxxlI folds
Player Tilt-A-Whirl folds
Player IamPhamous raises (18)
Player PANDAisEVIL folds
Player Iia007 folds
Player 322xxx folds
Player MadLifeGrinder folds
Player shokerAAss folds
Uncalled bet (12) returned to IamPhamous
Player IamPhamous mucks cards
------ Summary ------
Pot: 15. Rake 0
Player IlxxxlI does not show cards.Bets: 0. Collects: 0. Wins: 0.
Player Tilt-A-Whirl does not show cards.Bets: 0. Collects: 0. Wins: 0.
*Player IamPhamous mucks (does not show cards). Bets: 6. Collects: 15. Wins: 9.
Player PANDAisEVIL does not show cards.Bets: 0. Collects: 0. Wins: 0.
Player Iia007 does not show cards.Bets: 0. Collects: 0. Wins: 0.
Player 322xxx does not show cards.Bets: 1. Collects: 0. Loses: 1.
Player MadLifeGrinder does not show cards.Bets: 2. Collects: 0. Loses: 2.
Player mr.fargo does not show cards.Bets: 0. Collects: 0. Wins: 0.
Player shokerAAss does not show cards.Bets: 6. Collects: 0. Loses: 6.
Game ended at: 2016/11/29 8:46:34

Game started
Game ID: 786764474 0.25/0.50 (PRR) Garuda - 2 (Hold'em)
Seat 1 is the button
Seat 1: Tilt-A-Whirl (50).
Seat 2: apoo11 (83.74).
Seat 3: imperceptible (17.26).
Seat 4: Ice Bank Mice Elf (50.62).
Seat 5: tutofu84 (86.48).
Seat 6: IlxxxlI (20).
Seat 8: Aquaman75 (64.04).
Seat 9: kid4life (50).
Player apoo11 has small blind (0.25)
Player imperceptible has big blind (0.50)
Player kid4life wait BB
Player IlxxxlI received card: [5h]
Player IlxxxlI received card: [10d]
Player Ice Bank Mice Elf folds
Player tutofu84 folds
Player IlxxxlI folds
Player Aquaman75 raises (1.50)
Player Tilt-A-Whirl folds
Player apoo11 folds
Player imperceptible folds
Uncalled bet (1) returned to Aquaman75
Player Aquaman75 mucks cards
------ Summary ------
Pot: 1.25. Rake 0
Player Tilt-A-Whirl does not show cards.Bets: 0. Collects: 0. Wins: 0.
Player apoo11 does not show cards.Bets: 0.25. Collects: 0. Loses: 0.25.
Player imperceptible does not show cards.Bets: 0.50. Collects: 0. Loses: 0.50.
Player Ice Bank Mice Elf does not show cards.Bets: 0. Collects: 0. Wins: 0.
Player tutofu84 does not show cards.Bets: 0. Collects: 0. Wins: 0.
Player IlxxxlI does not show cards.Bets: 0. Collects: 0. Wins: 0.
*Player Aquaman75 mucks (does not show cards). Bets: 0.50. Collects: 1.25. Wins: 0.75.
Player kid4life does not show cards.Bets: 0. Collects: 0. Wins: 0.
Game ended at: 2016/11/29 8:46:14

Game started
Game ID: 786764209 1/2 (PRR) Longana - 2 (Hold'em)
Seat 4 is the button
Seat 1: IlxxxlI (98.21).
Seat 2: Tilt-A-Whirl (223.41).
Seat 3: IamPhamous (171.87).
Seat 4: PANDAisEVIL (209.93).
Seat 5: Iia007 (231.91).
Seat 6: 322xxx (200).
Seat 7: MadLifeGrinder (216.04).
Seat 8: mr.fargo (149.55).
Seat 9: shokerAAss (200).
Player Iia007 has small blind (1)
Player 322xxx has big blind (2)
Player IlxxxlI received card: [Kh]
Player IlxxxlI received card: [8c]
Player MadLifeGrinder folds
Player mr.fargo folds
Player shokerAAss raises (6)
Player IlxxxlI folds
Player Tilt-A-Whirl folds
Player IamPhamous calls (6)
Player PANDAisEVIL folds
Player Iia007 folds
Player 322xxx folds
*** FLOP ***: [As 6h 6s]
Player shokerAAss bets (7.12)
Player IamPhamous folds
Uncalled bet (7.12) returned to shokerAAss
Player shokerAAss mucks cards
------ Summary ------
Pot: 14.25. Rake 0.51. JP fee 0.24
Board: [As 6h 6s]
Player IlxxxlI does not show cards.Bets: 0. Collects: 0. Wins: 0.
Player Tilt-A-Whirl does not show cards.Bets: 0. Collects: 0. Wins: 0.
Player IamPhamous does not show cards.Bets: 6. Collects: 0. Loses: 6.
Player PANDAisEVIL does not show cards.Bets: 0. Collects: 0. Wins: 0.
Player Iia007 does not show cards.Bets: 1. Collects: 0. Loses: 1.
Player 322xxx does not show cards.Bets: 2. Collects: 0. Loses: 2.
Player MadLifeGrinder does not show cards.Bets: 0. Collects: 0. Wins: 0.
Player mr.fargo does not show cards.Bets: 0. Collects: 0. Wins: 0.
*Player shokerAAss mucks (does not show cards). Bets: 6. Collects: 14.25. Wins: 8.25.
Game ended at: 2016/11/29 8:45:53

Game started
Game ID: 786764190 0.25/0.50 (PRR) Gorgons - 7 (Hold'em)
Seat 2 is the button
Seat 2: Heksebrygg (50).
Seat 3: Dirty4skin (50.25).
Seat 6: IlxxxlI (20).
Player Dirty4skin has small blind (0.25)
Player IlxxxlI has big blind (0.50)
Player IlxxxlI received card: [7d]
Player IlxxxlI received card: [3h]
Player Heksebrygg raises (1)
Player Dirty4skin calls (0.75)
Player IlxxxlI folds
*** FLOP ***: [4d Kc 10c]
Player Dirty4skin checks
Player Heksebrygg checks
*** TURN ***: [4d Kc 10c] [2s]
Player Dirty4skin bets (1.58)
Player Heksebrygg folds
Uncalled bet (1.58) returned to Dirty4skin
Player Dirty4skin mucks cards
------ Summary ------
Pot: 2.38. Rake 0.08. JP fee 0.04
Board: [4d Kc 10c 2s]
Player Heksebrygg does not show cards.Bets: 1. Collects: 0. Loses: 1.
*Player Dirty4skin mucks (does not show cards). Bets: 1. Collects: 2.38. Wins: 1.38.
Player IlxxxlI does not show cards.Bets: 0.50. Collects: 0. Loses: 0.50.
Game ended at: 2016/11/29 8:46:1

Game started
Game ID: 786764192 0.25/0.50 (PRR) Garuda (Hold'em)
Seat 2 is the button
Seat 1: Aquaman75 (64.53).
Seat 2: IlxxxlI (21.54).
Seat 3: Ice Bank Mice Elf (65.43).
Seat 4: Log_in (12.25).
Seat 5: CumBckMuny (32.14).
Seat 6: XxDominationxX (83).
Seat 7: coldkilla (59.16).
Seat 9: Taxriverman (50.90).
Player Ice Bank Mice Elf has small blind (0.25)
Player Log_in has big blind (0.50)
Player IlxxxlI received card: [5s]
Player IlxxxlI received card: [9h]
Player CumBckMuny folds
Player XxDominationxX folds
Player coldkilla raises (1.50)
Player Taxriverman folds
Player Aquaman75 folds
Player IlxxxlI folds
Player Ice Bank Mice Elf folds
Player Log_in folds
Uncalled bet (1) returned to coldkilla
Player coldkilla mucks cards
------ Summary ------
Pot: 1.25. Rake 0
Player Aquaman75 does not show cards.Bets: 0. Collects: 0. Wins: 0.
Player IlxxxlI does not show cards.Bets: 0. Collects: 0. Wins: 0.
Player Ice Bank Mice Elf does not show cards.Bets: 0.25. Collects: 0. Loses: 0.25.
Player Log_in does not show cards.Bets: 0.50. Collects: 0. Loses: 0.50.
Player CumBckMuny does not show cards.Bets: 0. Collects: 0. Wins: 0.
Player XxDominationxX does not show cards.Bets: 0. Collects: 0. Wins: 0.
*Player coldkilla mucks (does not show cards). Bets: 0.50. Collects: 1.25. Wins: 0.75.
Player Taxriverman does not show cards.Bets: 0. Collects: 0. Wins: 0.
Game ended at: 2016/11/29 8:45:58

Game started
Game ID: 786763991 0.25/0.50 (PRR) Gorgons - 7 (Hold'em)
Seat 6 is the button
Seat 2: Heksebrygg (50).
Seat 3: Dirty4skin (50).
Seat 4: virtualbox (61.99).
Seat 6: IlxxxlI (20).
Player Heksebrygg has small blind (0.25)
Player Dirty4skin has big blind (0.50)
Player IlxxxlI received card: [8d]
Player IlxxxlI received card: [10s]
Player virtualbox folds
Player IlxxxlI folds
Player Heksebrygg folds
Uncalled bet (0.25) returned to Dirty4skin
Player Dirty4skin mucks cards
------ Summary ------
Pot: 0.50. Rake 0
Player Heksebrygg does not show cards.Bets: 0.25. Collects: 0. Loses: 0.25.
*Player Dirty4skin mucks (does not show cards). Bets: 0.25. Collects: 0.50. Wins: 0.25.
Player virtualbox does not show cards.Bets: 0. Collects: 0. Wins: 0.
Player IlxxxlI does not show cards.Bets: 0. Collects: 0. Wins: 0.
Game ended at: 2016/11/29 8:45:14

Game started
Game ID: 786763839 0.25/0.50 (PRR) Garuda - 2 (Hold'em)
Seat 8 is the button
Seat 1: Tilt-A-Whirl (50.25).
Seat 2: apoo11 (84.24).
Seat 3: imperceptible (16.51).
Seat 4: Ice Bank Mice Elf (50.62).
Seat 5: tutofu84 (86.48).
Seat 6: IlxxxlI (20).
Seat 8: Aquaman75 (64.04).
Player Tilt-A-Whirl has small blind (0.25)
Player apoo11 has big blind (0.50)
Player IlxxxlI received card: [4s]
Player IlxxxlI received card: [Jh]
Player imperceptible raises (1.50)
Player Ice Bank Mice Elf folds
Player tutofu84 folds
Player IlxxxlI folds
Player Aquaman75 folds
Player Tilt-A-Whirl folds
Player apoo11 folds
Uncalled bet (1) returned to imperceptible
Player imperceptible mucks cards
------ Summary ------
Pot: 1.25. Rake 0
Player Tilt-A-Whirl does not show cards.Bets: 0.25. Collects: 0. Loses: 0.25.
Player apoo11 does not show cards.Bets: 0.50. Collects: 0. Loses: 0.50.
*Player imperceptible mucks (does not show cards). Bets: 0.50. Collects: 1.25. Wins: 0.75.
Player Ice Bank Mice Elf does not show cards.Bets: 0. Collects: 0. Wins: 0.
Player tutofu84 does not show cards.Bets: 0. Collects: 0. Wins: 0.
Player IlxxxlI does not show cards.Bets: 0. Collects: 0. Wins: 0.
Player Aquaman75 does not show cards.Bets: 0. Collects: 0. Wins: 0.
Game ended at: 2016/11/29 8:45:31

Game started
Game ID: 786763840 0.25/0.50 (PRR) Garuda (Hold'em)
Seat 1 is the button
Seat 1: Aquaman75 (64.53).
Seat 2: IlxxxlI (21.79).
Seat 3: Ice Bank Mice Elf (65.18).
Seat 4: Log_in (12.25).
Seat 5: CumBckMuny (32.14).
Seat 6: XxDominationxX (83).
Seat 7: coldkilla (59.16).
Seat 9: Taxriverman (50.90).
Player IlxxxlI has small blind (0.25)
Player Ice Bank Mice Elf has big blind (0.50)
Player IlxxxlI received card: [2c]
Player IlxxxlI received card: [7c]
Player Log_in folds
Player CumBckMuny folds
Player XxDominationxX folds
Player coldkilla folds
Player Taxriverman folds
Player Aquaman75 folds
Player IlxxxlI folds
Uncalled bet (0.25) returned to Ice Bank Mice Elf
Player Ice Bank Mice Elf mucks cards
------ Summary ------
Pot: 0.50. Rake 0
Player Aquaman75 does not show cards.Bets: 0. Collects: 0. Wins: 0.
Player IlxxxlI does not show cards.Bets: 0.25. Collects: 0. Loses: 0.25.
*Player Ice Bank Mice Elf mucks (does not show cards). Bets: 0.25. Collects: 0.50. Wins: 0.25.
Player Log_in does not show cards.Bets: 0. Collects: 0. Wins: 0.
Player CumBckMuny does not show cards.Bets: 0. Collects: 0. Wins: 0.
Player XxDominationxX does not show cards.Bets: 0. Collects: 0. Wins: 0.
Player coldkilla does not show cards.Bets: 0. Collects: 0. Wins: 0.
Player Taxriverman does not show cards.Bets: 0. Collects: 0. Wins: 0.
Game ended at: 2016/11/29 8:45:14

Game started
Game ID: 786763453 0.25/0.50 (PRR) Garuda - 2 (Hold'em)
Seat 6 is the button
Seat 1: Tilt-A-Whirl (50).
Seat 2: apoo11 (84.24).
Seat 3: imperceptible (16.51).
Seat 4: Ice Bank Mice Elf (50.62).
Seat 5: tutofu84 (86.48).
Seat 6: IlxxxlI (20).
Seat 8: Aquaman75 (64.29).
Player Aquaman75 has small blind (0.25)
Player Tilt-A-Whirl has big blind (0.50)
Player IlxxxlI received card: [7c]
Player IlxxxlI received card: [2s]
Player apoo11 folds
Player imperceptible folds
Player Ice Bank Mice Elf folds
Player tutofu84 folds
Player IlxxxlI folds
Player Aquaman75 folds
Uncalled bet (0.25) returned to Tilt-A-Whirl
Player Tilt-A-Whirl mucks cards
------ Summary ------
Pot: 0.50. Rake 0
*Player Tilt-A-Whirl mucks (does not show cards). Bets: 0.25. Collects: 0.50. Wins: 0.25.
Player apoo11 does not show cards.Bets: 0. Collects: 0. Wins: 0.
Player imperceptible does not show cards.Bets: 0. Collects: 0. Wins: 0.
Player Ice Bank Mice Elf does not show cards.Bets: 0. Collects: 0. Wins: 0.
Player tutofu84 does not show cards.Bets: 0. Collects: 0. Wins: 0.
Player IlxxxlI does not show cards.Bets: 0. Collects: 0. Wins: 0.
Player Aquaman75 does not show cards.Bets: 0.25. Collects: 0. Loses: 0.25.
Game ended at: 2016/11/29 8:44:50

Game started
Game ID: 786762795 0.25/0.50 (PRR) Garuda (Hold'em)
Seat 9 is the button
Seat 1: Aquaman75 (64.78).
Seat 2: IlxxxlI (22.29).
Seat 3: Ice Bank Mice Elf (65.18).
Seat 4: Log_in (12.25).
Seat 5: CumBckMuny (33.64).
Seat 6: XxDominationxX (80.93).
Seat 7: coldkilla (59.16).
Seat 8: rounderontilt (21.83).
Seat 9: Taxriverman (50.90).
Player Aquaman75 has small blind (0.25)
Player IlxxxlI has big blind (0.50)
Player IlxxxlI received card: [8d]
Player IlxxxlI received card: [3s]
Player Ice Bank Mice Elf folds
Player Log_in folds
Player CumBckMuny raises (1.50)
Player XxDominationxX calls (1.50)
Player coldkilla folds
Player rounderontilt folds
Player Taxriverman folds
Player Aquaman75 folds
Player IlxxxlI folds
*** FLOP ***: [Kd 4h Js]
Player CumBckMuny checks
Player XxDominationxX bets (1.78)
Player CumBckMuny folds
Uncalled bet (1.78) returned to XxDominationxX
Player XxDominationxX mucks cards
------ Summary ------
Pot: 3.57. Rake 0.12. JP fee 0.06
Board: [Kd 4h Js]
Player Aquaman75 does not show cards.Bets: 0.25. Collects: 0. Loses: 0.25.
Player IlxxxlI does not show cards.Bets: 0.50. Collects: 0. Loses: 0.50.
Player Ice Bank Mice Elf does not show cards.Bets: 0. Collects: 0. Wins: 0.
Player Log_in does not show cards.Bets: 0. Collects: 0. Wins: 0.
Player CumBckMuny does not show cards.Bets: 1.50. Collects: 0. Loses: 1.50.
*Player XxDominationxX mucks (does not show cards). Bets: 1.50. Collects: 3.57. Wins: 2.07.
Player coldkilla does not show cards.Bets: 0. Collects: 0. Wins: 0.
Player rounderontilt does not show cards.Bets: 0. Collects: 0. Wins: 0.
Player Taxriverman does not show cards.Bets: 0. Collects: 0. Wins: 0.
Game ended at: 2016/11/29 8:44:51

Game started
Game ID: 786762192 0.25/0.50 (PRR) Garuda - 2 (Hold'em)
Seat 5 is the button
Seat 1: Tilt-A-Whirl (50).
Seat 2: apoo11 (84.24).
Seat 3: imperceptible (16.51).
Seat 4: Ice Bank Mice Elf (50.62).
Seat 5: tutofu84 (56.49).
Seat 6: IlxxxlI (20).
Seat 7: Log_in (49.21).
Seat 8: Aquaman75 (64.79).
Seat 9: kid4life (32.24).
Player IlxxxlI has small blind (0.25)
Player Log_in sitting out
Player Aquaman75 has big blind (0.50)
Player IlxxxlI received card: [3d]
Player IlxxxlI received card: [10s]
Player kid4life raises (2)
Player Tilt-A-Whirl folds
Player apoo11 folds
Player imperceptible folds
Player Ice Bank Mice Elf folds
Player tutofu84 calls (2)
Player IlxxxlI folds
Player Aquaman75 folds
*** FLOP ***: [7h 6h 5h]
Player kid4life bets (2.26)
Player tutofu84 calls (2.26)
*** TURN ***: [7h 6h 5h] [Kc]
Player kid4life bets (4.40)
Player tutofu84 calls (4.40)
*** RIVER ***: [7h 6h 5h Kc] [Kh]
Player kid4life allin (23.58)
Player tutofu84 calls (23.58)
------ Summary ------
Pot: 62.23. Rake 2.76. JP fee 0.24
Board: [7h 6h 5h Kc Kh]
Player Tilt-A-Whirl does not show cards.Bets: 0. Collects: 0. Wins: 0.
Player apoo11 does not show cards.Bets: 0. Collects: 0. Wins: 0.
Player imperceptible does not show cards.Bets: 0. Collects: 0. Wins: 0.
Player Ice Bank Mice Elf does not show cards.Bets: 0. Collects: 0. Wins: 0.
*Player tutofu84 shows: Straight Flush to 7 h [3h 4h]. Bets: 32.24. Collects: 62.23. Wins: 29.99.
Player IlxxxlI does not show cards.Bets: 0.25. Collects: 0. Loses: 0.25.
Player Log_in does not show cards.Bets: 0. Collects: 0. Wins: 0.
Player Aquaman75 does not show cards.Bets: 0.50. Collects: 0. Loses: 0.50.
Player kid4life shows: Full House (6/K) [6s 6d]. Bets: 32.24. Collects: 0. Loses: 32.24.
Game ended at: 2016/11/29 8:44:24

Game started
Game ID: 786762153 0.25/0.50 (PRR) Gorgons - 7 (Hold'em)
Seat 4 is the button
Seat 1: Madmonkeygan (58.04).
Seat 2: Heksebrygg (53.56).
Seat 4: virtualbox (56.12).
Seat 6: IlxxxlI (20).
Player IlxxxlI has small blind (0.25)
Player Madmonkeygan sitting out
Player Heksebrygg has big blind (0.50)
Player IlxxxlI received card: [9c]
Player IlxxxlI received card: [4h]
Player virtualbox raises (1)
Player IlxxxlI folds
Player Heksebrygg calls (0.50)
*** FLOP ***: [As 9d 8d]
Player Heksebrygg checks
Player virtualbox bets (1.07)
Player Heksebrygg calls (1.07)
*** TURN ***: [As 9d 8d] [6s]
Player Heksebrygg checks
Player virtualbox bets (4.18)
Player Heksebrygg calls (4.18)
*** RIVER ***: [As 9d 8d 6s] [7h]
Player Heksebrygg checks
Player virtualbox checks
Player Heksebrygg mucks cards
------ Summary ------
Pot: 12.12. Rake 0.55. JP fee 0.08
Board: [As 9d 8d 6s 7h]
Player Madmonkeygan does not show cards.Bets: 0. Collects: 0. Wins: 0.
Player Heksebrygg mucks (does not show cards). Bets: 6.25. Collects: 0. Loses: 6.25.
*Player virtualbox shows: Two pairs. As and 8s [8c Ad]. Bets: 6.25. Collects: 12.12. Wins: 5.87.
Player IlxxxlI does not show cards.Bets: 0.25. Collects: 0. Loses: 0.25.
Game ended at: 2016/11/29 8:44:58

Game started
Game ID: 786762126 1/2 (PRR) Longana - 2 (Hold'em)
Seat 3 is the button
Seat 1: IlxxxlI (98.21).
Seat 2: Tilt-A-Whirl (223.41).
Seat 3: IamPhamous (171.87).
Seat 4: PANDAisEVIL (222.93).
Seat 5: Iia007 (220.21).
Seat 7: MadLifeGrinder (216.04).
Seat 8: mr.fargo (149.55).
Seat 9: shokerAAss (200).
Player PANDAisEVIL has small blind (1)
Player Iia007 has big blind (2)
Player IlxxxlI received card: [3c]
Player IlxxxlI received card: [5c]
Player MadLifeGrinder folds
Player mr.fargo folds
Player shokerAAss folds
Player IlxxxlI folds
Player Tilt-A-Whirl folds
Player IamPhamous folds
Player PANDAisEVIL raises (4)
Player Iia007 calls (3)
*** FLOP ***: [6c Jh 7d]
Player PANDAisEVIL checks
Player Iia007 bets (8)
Player PANDAisEVIL calls (8)
*** TURN ***: [6c Jh 7d] [9c]
Player PANDAisEVIL checks
Player Iia007 checks
*** RIVER ***: [6c Jh 7d 9c] [4s]
Player PANDAisEVIL checks
Player Iia007 checks
Player PANDAisEVIL mucks cards
------ Summary ------
Pot: 24.70. Rake 1.06. JP fee 0.24
Board: [6c Jh 7d 9c 4s]
Player IlxxxlI does not show cards.Bets: 0. Collects: 0. Wins: 0.
Player Tilt-A-Whirl does not show cards.Bets: 0. Collects: 0. Wins: 0.
Player IamPhamous does not show cards.Bets: 0. Collects: 0. Wins: 0.
Player PANDAisEVIL mucks (does not show cards). Bets: 13. Collects: 0. Loses: 13.
*Player Iia007 shows: One pair of 9s [9s 10h]. Bets: 13. Collects: 24.70. Wins: 11.70.
Player MadLifeGrinder does not show cards.Bets: 0. Collects: 0. Wins: 0.
Player mr.fargo does not show cards.Bets: 0. Collects: 0. Wins: 0.
Player shokerAAss does not show cards.Bets: 0. Collects: 0. Wins: 0.
Game ended at: 2016/11/29 8:45:14

Game started
Game ID: 786761653 0.25/0.50 (PRR) Garuda - 2 (Hold'em)
Seat 4 is the button
Seat 1: Tilt-A-Whirl (50).
Seat 2: apoo11 (84.24).
Seat 3: imperceptible (16.51).
Seat 4: Ice Bank Mice Elf (50.62).
Seat 5: tutofu84 (56.74).
Seat 6: IlxxxlI (20).
Seat 7: Log_in (48.46).
Seat 8: Aquaman75 (64.79).
Seat 9: kid4life (32.24).
Player tutofu84 has small blind (0.25)
Player IlxxxlI has big blind (0.50)
Player IlxxxlI received card: [7d]
Player IlxxxlI received card: [9s]
Player Log_in raises (1.50)
Player Aquaman75 folds
Player kid4life folds
Player Tilt-A-Whirl folds
Player apoo11 folds
Player imperceptible folds
Player Ice Bank Mice Elf folds
Player tutofu84 folds
Player IlxxxlI folds
Uncalled bet (1) returned to Log_in
Player Log_in mucks cards
------ Summary ------
Pot: 1.25. Rake 0
Player Tilt-A-Whirl does not show cards.Bets: 0. Collects: 0. Wins: 0.
Player apoo11 does not show cards.Bets: 0. Collects: 0. Wins: 0.
Player imperceptible does not show cards.Bets: 0. Collects: 0. Wins: 0.
Player Ice Bank Mice Elf does not show cards.Bets: 0. Collects: 0. Wins: 0.
Player tutofu84 does not show cards.Bets: 0.25. Collects: 0. Loses: 0.25.
Player IlxxxlI does not show cards.Bets: 0.50. Collects: 0. Loses: 0.50.
*Player Log_in mucks (does not show cards). Bets: 0.50. Collects: 1.25. Wins: 0.75.
Player Aquaman75 does not show cards.Bets: 0. Collects: 0. Wins: 0.
Player kid4life does not show cards.Bets: 0. Collects: 0. Wins: 0.
Game ended at: 2016/11/29 8:43:2

Game started
Game ID: 786760985 0.25/0.50 (PRR) Gorgons - 7 (Hold'em)
Seat 2 is the button
Seat 1: Madmonkeygan (58.04).
Seat 2: Heksebrygg (50).
Seat 4: virtualbox (57.12).
Seat 6: IlxxxlI (20.75).
Player virtualbox has small blind (0.25)
Player IlxxxlI has big blind (0.50)
Player IlxxxlI received card: [Ks]
Player IlxxxlI received card: [7s]
Player Madmonkeygan folds
Player Heksebrygg raises (1)
Player virtualbox calls (0.75)
Player IlxxxlI calls (0.50)
*** FLOP ***: [4s 7h Ad]
Player virtualbox checks
Player IlxxxlI checks
Player Heksebrygg bets (1.90)
Player virtualbox folds
Player IlxxxlI calls (1.90)
*** TURN ***: [4s 7h Ad] [3c]
Player IlxxxlI checks
Player Heksebrygg bets (4.50)
Player IlxxxlI folds
Uncalled bet (4.50) returned to Heksebrygg
Player Heksebrygg mucks cards
------ Summary ------
Pot: 6.46. Rake 0.24. JP fee 0.10
Board: [4s 7h Ad 3c]
Player Madmonkeygan does not show cards.Bets: 0. Collects: 0. Wins: 0.
*Player Heksebrygg mucks (does not show cards). Bets: 2.90. Collects: 6.46. Wins: 3.56.
Player virtualbox does not show cards.Bets: 1. Collects: 0. Loses: 1.
Player IlxxxlI does not show cards.Bets: 2.90. Collects: 0. Loses: 2.90.
Game ended at: 2016/11/29 8:42:58

Game started
Game ID: 786760457 1/2 (PRR) Longana - 2 (Hold'em)
Seat 2 is the button
Seat 1: IlxxxlI (83).
Seat 2: Tilt-A-Whirl (223.41).
Seat 3: IamPhamous (172.87).
Seat 4: PANDAisEVIL (238.77).
Seat 5: Iia007 (220.21).
Seat 7: MadLifeGrinder (216.04).
Seat 8: mr.fargo (149.55).
Seat 9: shokerAAss (200).
Player IamPhamous has small blind (1)
Player PANDAisEVIL has big blind (2)
Player IlxxxlI received card: [7d]
Player IlxxxlI received card: [9d]
Player Iia007 folds
Player MadLifeGrinder folds
Player mr.fargo folds
Player shokerAAss folds
Player IlxxxlI calls (2)
Player Tilt-A-Whirl folds
Player IamPhamous folds
Player PANDAisEVIL raises (5)
Player IlxxxlI calls (5)
*** FLOP ***: [5s 2c 8d]
Player PANDAisEVIL bets (8.84)
Player IlxxxlI calls (8.84)
*** TURN ***: [5s 2c 8d] [2s]
Player PANDAisEVIL checks
Player IlxxxlI bets (10.35)
Player PANDAisEVIL folds
Uncalled bet (10.35) returned to IlxxxlI
Player IlxxxlI mucks cards
------ Summary ------
Pot: 31.05. Rake 1.39. JP fee 0.24
Board: [5s 2c 8d 2s]
*Player IlxxxlI mucks (does not show cards). Bets: 15.84. Collects: 31.05. Wins: 15.21.
Player Tilt-A-Whirl does not show cards.Bets: 0. Collects: 0. Wins: 0.
Player IamPhamous does not show cards.Bets: 1. Collects: 0. Loses: 1.
Player PANDAisEVIL does not show cards.Bets: 15.84. Collects: 0. Loses: 15.84.
Player Iia007 does not show cards.Bets: 0. Collects: 0. Wins: 0.
Player MadLifeGrinder does not show cards.Bets: 0. Collects: 0. Wins: 0.
Player mr.fargo does not show cards.Bets: 0. Collects: 0. Wins: 0.
Player shokerAAss does not show cards.Bets: 0. Collects: 0. Wins: 0.
Game ended at: 2016/11/29 8:42:57

Game started
Game ID: 786760266 0.25/0.50 (PRR) Gorgons - 7 (Hold'em)
Seat 1 is the button
Seat 1: Madmonkeygan (58.04).
Seat 2: Heksebrygg (50).
Seat 4: virtualbox (57.62).
Seat 5: Log_in (24.75).
Seat 6: IlxxxlI (20).
Player Heksebrygg has small blind (0.25)
Player virtualbox has big blind (0.50)
Player IlxxxlI received card: [Kh]
Player IlxxxlI received card: [Js]
Player Log_in folds
Player IlxxxlI raises (1.20)
Player Madmonkeygan folds
Player Heksebrygg folds
Player virtualbox folds
Uncalled bet (0.70) returned to IlxxxlI
Player IlxxxlI mucks cards
------ Summary ------
Pot: 1.25. Rake 0
Player Madmonkeygan does not show cards.Bets: 0. Collects: 0. Wins: 0.
Player Heksebrygg does not show cards.Bets: 0.25. Collects: 0. Loses: 0.25.
Player virtualbox does not show cards.Bets: 0.50. Collects: 0. Loses: 0.50.
Player Log_in does not show cards.Bets: 0. Collects: 0. Wins: 0.
*Player IlxxxlI mucks (does not show cards). Bets: 0.50. Collects: 1.25. Wins: 0.75.
Game ended at: 2016/11/29 8:41:42

Game started
Game ID: 786760027 0.25/0.50 (PRR) Garuda (Hold'em)
Seat 7 is the button
Seat 1: Aquaman75 (65.28).
Seat 2: IlxxxlI (22.29).
Seat 3: Ice Bank Mice Elf (64.43).
Seat 4: Log_in (12.25).
Seat 5: CumBckMuny (33.64).
Seat 6: XxDominationxX (70.90).
Seat 7: coldkilla (59.16).
Seat 8: rounderontilt (32.44).
Seat 9: Taxriverman (51.65).
Player rounderontilt has small blind (0.25)
Player Taxriverman has big blind (0.50)
Player IlxxxlI received card: [7c]
Player IlxxxlI received card: [8s]
Player Aquaman75 folds
Player IlxxxlI is timed out.
Player IlxxxlI folds
Player Ice Bank Mice Elf folds
Player Log_in folds
Player CumBckMuny folds
Player XxDominationxX raises (1.50)
Player coldkilla folds
Player rounderontilt calls (1.25)
Player Taxriverman folds
*** FLOP ***: [9d 10c Ad]
Player rounderontilt checks
Player XxDominationxX bets (1.66)
Player rounderontilt calls (1.66)
*** TURN ***: [9d 10c Ad] [Ac]
Player rounderontilt checks
Player XxDominationxX bets (3.24)
Player rounderontilt calls (3.24)
*** RIVER ***: [9d 10c Ad Ac] [2d]
Player rounderontilt checks
Player XxDominationxX bets (4.21)
Player rounderontilt calls (4.21)
Player rounderontilt mucks cards
------ Summary ------
Pot: 20.64. Rake 0.84. JP fee 0.24
Board: [9d 10c Ad Ac 2d]
Player Aquaman75 does not show cards.Bets: 0. Collects: 0. Wins: 0.
Player IlxxxlI does not show cards.Bets: 0. Collects: 0. Wins: 0.
Player Ice Bank Mice Elf does not show cards.Bets: 0. Collects: 0. Wins: 0.
Player Log_in does not show cards.Bets: 0. Collects: 0. Wins: 0.
Player CumBckMuny does not show cards.Bets: 0. Collects: 0. Wins: 0.
*Player XxDominationxX shows: Flush, A high [10d Jd]. Bets: 10.61. Collects: 20.64. Wins: 10.03.
Player coldkilla does not show cards.Bets: 0. Collects: 0. Wins: 0.
Player rounderontilt mucks (does not show cards). Bets: 10.61. Collects: 0. Loses: 10.61.
Player Taxriverman does not show cards.Bets: 0.50. Collects: 0. Loses: 0.50.
Game ended at: 2016/11/29 8:42:44

Game started
Game ID: 786759963 0.25/0.50 (PRR) Gorgons - 7 (Hold'em)
Seat 6 is the button
Seat 1: Madmonkeygan (58.29).
Seat 2: Heksebrygg (50).
Seat 4: virtualbox (57.62).
Seat 5: Log_in (24).
Seat 6: IlxxxlI (20).
Player Madmonkeygan has small blind (0.25)
Player Heksebrygg has big blind (0.50)
Player IlxxxlI received card: [10c]
Player IlxxxlI received card: [6c]
Player virtualbox folds
Player Log_in raises (1.12)
Player IlxxxlI folds
Player Madmonkeygan folds
Player Heksebrygg folds
Uncalled bet (0.62) returned to Log_in
Player Log_in mucks cards
------ Summary ------
Pot: 1.25. Rake 0
Player Madmonkeygan does not show cards.Bets: 0.25. Collects: 0. Loses: 0.25.
Player Heksebrygg does not show cards.Bets: 0.50. Collects: 0. Loses: 0.50.
Player virtualbox does not show cards.Bets: 0. Collects: 0. Wins: 0.
*Player Log_in mucks (does not show cards). Bets: 0.50. Collects: 1.25. Wins: 0.75.
Player IlxxxlI does not show cards.Bets: 0. Collects: 0. Wins: 0.
Game ended at: 2016/11/29 8:40:53

Game started
Game ID: 786759309 0.25/0.50 (PRR) Gorgons - 7 (Hold'em)
Seat 5 is the button
Seat 1: Madmonkeygan (57.79).
Seat 2: Heksebrygg (50).
Seat 3: Patty P (31.33).
Seat 4: virtualbox (57.62).
Seat 5: Log_in (24).
Seat 6: IlxxxlI (20.25).
Player IlxxxlI has small blind (0.25)
Player Madmonkeygan has big blind (0.50)
Player IlxxxlI received card: [Qh]
Player IlxxxlI received card: [9s]
Player Heksebrygg folds
Player Patty P folds
Player virtualbox folds
Player Log_in folds
Player IlxxxlI calls (0.25)
Player Madmonkeygan raises (1.50)
Player IlxxxlI folds
Uncalled bet (1.50) returned to Madmonkeygan
Player Madmonkeygan mucks cards
------ Summary ------
Pot: 1. Rake 0
*Player Madmonkeygan mucks (does not show cards). Bets: 0.50. Collects: 1. Wins: 0.50.
Player Heksebrygg does not show cards.Bets: 0. Collects: 0. Wins: 0.
Player Patty P does not show cards.Bets: 0. Collects: 0. Wins: 0.
Player virtualbox does not show cards.Bets: 0. Collects: 0. Wins: 0.
Player Log_in does not show cards.Bets: 0. Collects: 0. Wins: 0.
Player IlxxxlI does not show cards.Bets: 0.50. Collects: 0. Loses: 0.50.
Game ended at: 2016/11/29 8:40:32

Game started
Game ID: 786759051 1/2 (PRR) Longana - 2 (Hold'em)
Seat 1 is the button
Seat 1: IlxxxlI (83).
Seat 2: Tilt-A-Whirl (201).
Seat 3: IamPhamous (174.87).
Seat 4: PANDAisEVIL (238.77).
Seat 5: Iia007 (226.21).
Seat 7: MadLifeGrinder (216.04).
Seat 8: mr.fargo (166).
Seat 9: shokerAAss (200).
Player Tilt-A-Whirl has small blind (1)
Player IamPhamous has big blind (2)
Player IlxxxlI received card: [Jh]
Player IlxxxlI received card: [Qs]
Player PANDAisEVIL folds
Player Iia007 raises (6)
Player MadLifeGrinder folds
Player mr.fargo calls (6)
Player shokerAAss folds
Player IlxxxlI folds
Player Tilt-A-Whirl calls (5)
Player IamPhamous folds
*** FLOP ***: [7c Jd 8c]
Player Tilt-A-Whirl checks
Player Iia007 checks
Player mr.fargo bets (10.45)
Player Tilt-A-Whirl calls (10.45)
Player Iia007 folds
*** TURN ***: [7c Jd 8c] [2h]
Player Tilt-A-Whirl checks
Player mr.fargo checks
*** RIVER ***: [7c Jd 8c 2h] [8h]
Player Tilt-A-Whirl bets (19.43)
Player mr.fargo folds
Uncalled bet (19.43) returned to Tilt-A-Whirl
Player Tilt-A-Whirl mucks cards
------ Summary ------
Pot: 38.86. Rake 1.80. JP fee 0.24
Board: [7c Jd 8c 2h 8h]
Player IlxxxlI does not show cards.Bets: 0. Collects: 0. Wins: 0.
*Player Tilt-A-Whirl mucks (does not show cards). Bets: 16.45. Collects: 38.86. Wins: 22.41.
Player IamPhamous does not show cards.Bets: 2. Collects: 0. Loses: 2.
Player PANDAisEVIL does not show cards.Bets: 0. Collects: 0. Wins: 0.
Player Iia007 does not show cards.Bets: 6. Collects: 0. Loses: 6.
Player MadLifeGrinder does not show cards.Bets: 0. Collects: 0. Wins: 0.
Player mr.fargo does not show cards.Bets: 16.45. Collects: 0. Loses: 16.45.
Player shokerAAss does not show cards.Bets: 0. Collects: 0. Wins: 0.
Game ended at: 2016/11/29 8:41:6

Game started
Game ID: 786759029 0.25/0.50 (PRR) Garuda (Hold'em)
Seat 6 is the button
Seat 1: Aquaman75 (65.28).
Seat 2: IlxxxlI (22.29).
Seat 3: Ice Bank Mice Elf (64.43).
Seat 4: Log_in (12.25).
Seat 5: CumBckMuny (33.64).
Seat 6: XxDominationxX (70.15).
Seat 7: coldkilla (59.41).
Seat 8: rounderontilt (32.94).
Seat 9: Taxriverman (51.65).
Player coldkilla has small blind (0.25)
Player rounderontilt has big blind (0.50)
Player IlxxxlI received card: [10h]
Player IlxxxlI received card: [4s]
Player Taxriverman folds
Player Aquaman75 folds
Player IlxxxlI folds
Player Ice Bank Mice Elf folds
Player Log_in folds
Player CumBckMuny folds
Player XxDominationxX raises (1.50)
Player coldkilla folds
Player rounderontilt folds
Uncalled bet (1) returned to XxDominationxX
Player XxDominationxX mucks cards
------ Summary ------
Pot: 1.25. Rake 0
Player Aquaman75 does not show cards.Bets: 0. Collects: 0. Wins: 0.
Player IlxxxlI does not show cards.Bets: 0. Collects: 0. Wins: 0.
Player Ice Bank Mice Elf does not show cards.Bets: 0. Collects: 0. Wins: 0.
Player Log_in does not show cards.Bets: 0. Collects: 0. Wins: 0.
Player CumBckMuny does not show cards.Bets: 0. Collects: 0. Wins: 0.
*Player XxDominationxX mucks (does not show cards). Bets: 0.50. Collects: 1.25. Wins: 0.75.
Player coldkilla does not show cards.Bets: 0.25. Collects: 0. Loses: 0.25.
Player rounderontilt does not show cards.Bets: 0.50. Collects: 0. Loses: 0.50.
Player Taxriverman does not show cards.Bets: 0. Collects: 0. Wins: 0.
Game ended at: 2016/11/29 8:40:37

Game started
Game ID: 786758661 0.25/0.50 (PRR) Gorgons - 7 (Hold'em)
Seat 4 is the button
Seat 1: Madmonkeygan (55.79).
Seat 2: Heksebrygg (50).
Seat 3: Patty P (32.75).
Seat 4: virtualbox (57.62).
Seat 5: Log_in (24.25).
Seat 6: IlxxxlI (20.75).
Player Log_in has small blind (0.25)
Player IlxxxlI has big blind (0.50)
Player IlxxxlI received card: [Jc]
Player IlxxxlI received card: [8c]
Player Madmonkeygan raises (1.42)
Player Heksebrygg folds
Player Patty P calls (1.42)
Player virtualbox folds
Player Log_in folds
Player IlxxxlI folds
*** FLOP ***: [9h 6s 5d]
Player Madmonkeygan checks
Player Patty P checks
*** TURN ***: [9h 6s 5d] [Jd]
Player Madmonkeygan bets (2.89)
Player Patty P folds
Uncalled bet (2.89) returned to Madmonkeygan
Player Madmonkeygan mucks cards
------ Summary ------
Pot: 3.42. Rake 0.13. JP fee 0.04
Board: [9h 6s 5d Jd]
*Player Madmonkeygan mucks (does not show cards). Bets: 1.42. Collects: 3.42. Wins: 2.
Player Heksebrygg does not show cards.Bets: 0. Collects: 0. Wins: 0.
Player Patty P does not show cards.Bets: 1.42. Collects: 0. Loses: 1.42.
Player virtualbox does not show cards.Bets: 0. Collects: 0. Wins: 0.
Player Log_in does not show cards.Bets: 0.25. Collects: 0. Loses: 0.25.
Player IlxxxlI does not show cards.Bets: 0.50. Collects: 0. Loses: 0.50.
Game ended at: 2016/11/29 8:39:48

Game started
Game ID: 786758584 1/2 (PRR) Longana - 2 (Hold'em)
Seat 9 is the button
Seat 1: IlxxxlI (84).
Seat 2: Tilt-A-Whirl (200).
Seat 3: IamPhamous (174.87).
Seat 4: PANDAisEVIL (238.77).
Seat 5: Iia007 (226.21).
Seat 7: MadLifeGrinder (216.04).
Seat 8: mr.fargo (166).
Seat 9: shokerAAss (200).
Player IlxxxlI has small blind (1)
Player Tilt-A-Whirl has big blind (2)
Player IlxxxlI received card: [10c]
Player IlxxxlI received card: [2d]
Player IamPhamous folds
Player PANDAisEVIL folds
Player Iia007 folds
Player MadLifeGrinder folds
Player mr.fargo folds
Player shokerAAss folds
Player IlxxxlI folds
Uncalled bet (1) returned to Tilt-A-Whirl
Player Tilt-A-Whirl mucks cards
------ Summary ------
Pot: 2. Rake 0
Player IlxxxlI does not show cards.Bets: 1. Collects: 0. Loses: 1.
*Player Tilt-A-Whirl mucks (does not show cards). Bets: 1. Collects: 2. Wins: 1.
Player IamPhamous does not show cards.Bets: 0. Collects: 0. Wins: 0.
Player PANDAisEVIL does not show cards.Bets: 0. Collects: 0. Wins: 0.
Player Iia007 does not show cards.Bets: 0. Collects: 0. Wins: 0.
Player MadLifeGrinder does not show cards.Bets: 0. Collects: 0. Wins: 0.
Player mr.fargo does not show cards.Bets: 0. Collects: 0. Wins: 0.
Player shokerAAss does not show cards.Bets: 0. Collects: 0. Wins: 0.
Game ended at: 2016/11/29 8:39:31

Game started
Game ID: 786758428 0.25/0.50 (PRR) Garuda (Hold'em)
Seat 5 is the button
Seat 1: Aquaman75 (65.28).
Seat 2: IlxxxlI (22.29).
Seat 3: Ice Bank Mice Elf (63.18).
Seat 4: Log_in (12.25).
Seat 5: CumBckMuny (33.64).
Seat 6: XxDominationxX (70.40).
Seat 7: coldkilla (59.91).
Seat 8: rounderontilt (32.94).
Seat 9: Taxriverman (52.15).
Player XxDominationxX has small blind (0.25)
Player coldkilla has big blind (0.50)
Player IlxxxlI received card: [Kc]
Player IlxxxlI received card: [9d]
Player rounderontilt folds
Player Taxriverman calls (0.50)
Player Aquaman75 folds
Player IlxxxlI folds
Player Ice Bank Mice Elf raises (1.75)
Player Log_in folds
Player CumBckMuny folds
Player XxDominationxX folds
Player coldkilla folds
Player Taxriverman folds
Uncalled bet (1.25) returned to Ice Bank Mice Elf
Player Ice Bank Mice Elf mucks cards
------ Summary ------
Pot: 1.75. Rake 0
Player Aquaman75 does not show cards.Bets: 0. Collects: 0. Wins: 0.
Player IlxxxlI does not show cards.Bets: 0. Collects: 0. Wins: 0.
*Player Ice Bank Mice Elf mucks (does not show cards). Bets: 0.50. Collects: 1.75. Wins: 1.25.
Player Log_in does not show cards.Bets: 0. Collects: 0. Wins: 0.
Player CumBckMuny does not show cards.Bets: 0. Collects: 0. Wins: 0.
Player XxDominationxX does not show cards.Bets: 0.25. Collects: 0. Loses: 0.25.
Player coldkilla does not show cards.Bets: 0.50. Collects: 0. Loses: 0.50.
Player rounderontilt does not show cards.Bets: 0. Collects: 0. Wins: 0.
Player Taxriverman does not show cards.Bets: 0.50. Collects: 0. Loses: 0.50.
Game ended at: 2016/11/29 8:39:29

Game started
Game ID: 786758073 1/2 (PRR) Longana - 2 (Hold'em)
Seat 8 is the button
Seat 1: IlxxxlI (86).
Seat 2: Tilt-A-Whirl (200).
Seat 3: IamPhamous (174.87).
Seat 4: PANDAisEVIL (238.77).
Seat 5: Iia007 (226.21).
Seat 7: MadLifeGrinder (216.04).
Seat 8: mr.fargo (163).
Seat 9: shokerAAss (200).
Player shokerAAss has small blind (1)
Player IlxxxlI has big blind (2)
Player IlxxxlI received card: [4h]
Player IlxxxlI received card: [Jc]
Player Tilt-A-Whirl folds
Player IamPhamous folds
Player PANDAisEVIL folds
Player Iia007 folds
Player MadLifeGrinder folds
Player mr.fargo raises (4.40)
Player shokerAAss folds
Player IlxxxlI folds
Uncalled bet (2.40) returned to mr.fargo
Player mr.fargo mucks cards
------ Summary ------
Pot: 5. Rake 0
Player IlxxxlI does not show cards.Bets: 2. Collects: 0. Loses: 2.
Player Tilt-A-Whirl does not show cards.Bets: 0. Collects: 0. Wins: 0.
Player IamPhamous does not show cards.Bets: 0. Collects: 0. Wins: 0.
Player PANDAisEVIL does not show cards.Bets: 0. Collects: 0. Wins: 0.
Player Iia007 does not show cards.Bets: 0. Collects: 0. Wins: 0.
Player MadLifeGrinder does not show cards.Bets: 0. Collects: 0. Wins: 0.
*Player mr.fargo mucks (does not show cards). Bets: 2. Collects: 5. Wins: 3.
Player shokerAAss does not show cards.Bets: 1. Collects: 0. Loses: 1.
Game ended at: 2016/11/29 8:39:1

Game started
Game ID: 786757358 0.25/0.50 (PRR) Garuda (Hold'em)
Seat 4 is the button
Seat 1: Aquaman75 (65.28).
Seat 2: IlxxxlI (20).
Seat 3: Ice Bank Mice Elf (64.93).
Seat 4: Log_in (12.25).
Seat 5: CumBckMuny (33.89).
Seat 6: XxDominationxX (70.90).
Seat 8: rounderontilt (32.94).
Seat 9: Taxriverman (52.15).
Player CumBckMuny has small blind (0.25)
Player XxDominationxX has big blind (0.50)
Player IlxxxlI received card: [10s]
Player IlxxxlI received card: [10c]
Player rounderontilt folds
Player Taxriverman folds
Player Aquaman75 folds
Player IlxxxlI raises (1.75)
Player Ice Bank Mice Elf calls (1.75)
Player Log_in folds
Player CumBckMuny folds
Player XxDominationxX folds
*** FLOP ***: [3s 8c 5h]
Player IlxxxlI bets (2.69)
Player Ice Bank Mice Elf folds
Uncalled bet (2.69) returned to IlxxxlI
Player IlxxxlI mucks cards
------ Summary ------
Pot: 4.04. Rake 0.15. JP fee 0.06
Board: [3s 8c 5h]
Player Aquaman75 does not show cards.Bets: 0. Collects: 0. Wins: 0.
*Player IlxxxlI mucks (does not show cards). Bets: 1.75. Collects: 4.04. Wins: 2.29.
Player Ice Bank Mice Elf does not show cards.Bets: 1.75. Collects: 0. Loses: 1.75.
Player Log_in does not show cards.Bets: 0. Collects: 0. Wins: 0.
Player CumBckMuny does not show cards.Bets: 0.25. Collects: 0. Loses: 0.25.
Player XxDominationxX does not show cards.Bets: 0.50. Collects: 0. Loses: 0.50.
Player rounderontilt does not show cards.Bets: 0. Collects: 0. Wins: 0.
Player Taxriverman does not show cards.Bets: 0. Collects: 0. Wins: 0.
Game ended at: 2016/11/29 8:38:50

Game started
Game ID: 786757268 1/2 (PRR) Longana - 2 (Hold'em)
Seat 7 is the button
Seat 1: IlxxxlI (86).
Seat 2: Tilt-A-Whirl (200).
Seat 3: IamPhamous (174.87).
Seat 4: PANDAisEVIL (235.77).
Seat 5: Iia007 (226.21).
Seat 7: MadLifeGrinder (216.04).
Seat 8: mr.fargo (164).
Seat 9: shokerAAss (200).
Player mr.fargo has small blind (1)
Player shokerAAss has big blind (2)
Player IlxxxlI received card: [6s]
Player IlxxxlI received card: [9d]
Player IlxxxlI folds
Player Tilt-A-Whirl folds
Player IamPhamous folds
Player PANDAisEVIL raises (6)
Player Iia007 folds
Player MadLifeGrinder folds
Player mr.fargo folds
Player shokerAAss folds
Uncalled bet (4) returned to PANDAisEVIL
Player PANDAisEVIL mucks cards
------ Summary ------
Pot: 5. Rake 0
Player IlxxxlI does not show cards.Bets: 0. Collects: 0. Wins: 0.
Player Tilt-A-Whirl does not show cards.Bets: 0. Collects: 0. Wins: 0.
Player IamPhamous does not show cards.Bets: 0. Collects: 0. Wins: 0.
*Player PANDAisEVIL mucks (does not show cards). Bets: 2. Collects: 5. Wins: 3.
Player Iia007 does not show cards.Bets: 0. Collects: 0. Wins: 0.
Player MadLifeGrinder does not show cards.Bets: 0. Collects: 0. Wins: 0.
Player mr.fargo does not show cards.Bets: 1. Collects: 0. Loses: 1.
Player shokerAAss does not show cards.Bets: 2. Collects: 0. Loses: 2.
Game ended at: 2016/11/29 8:38:28

Game started
Game ID: 786757121 0.25/0.50 (PRR) Gorgons - 7 (Hold'em)
Seat 3 is the button
Seat 1: Madmonkeygan (50).
Seat 2: Heksebrygg (50).
Seat 3: Patty P (34.17).
Seat 4: virtualbox (62.02).
Seat 5: Log_in (24.75).
Seat 6: IlxxxlI (20.75).
Player virtualbox has small blind (0.25)
Player Log_in has big blind (0.50)
Player IlxxxlI received card: [10h]
Player IlxxxlI received card: [2h]
Player IlxxxlI folds
Player Madmonkeygan raises (1.42)
Player Heksebrygg folds
Player Patty P calls (1.42)
Player virtualbox calls (1.17)
Player Log_in folds
*** FLOP ***: [3s Js Qc]
Player virtualbox checks
Player Madmonkeygan checks
Player Patty P checks
*** TURN ***: [3s Js Qc] [10d]
Player virtualbox checks
Player Madmonkeygan checks
Player Patty P checks
*** RIVER ***: [3s Js Qc 10d] [5c]
Player virtualbox bets (2.98)
Player Madmonkeygan calls (2.98)
Player Patty P folds
------ Summary ------
Pot: 10.19. Rake 0.37. JP fee 0.16
Board: [3s Js Qc 10d 5c]
*Player Madmonkeygan shows: One pair of Js [Jh Ks]. Bets: 4.40. Collects: 10.19. Wins: 5.79.
Player Heksebrygg does not show cards.Bets: 0. Collects: 0. Wins: 0.
Player Patty P does not show cards.Bets: 1.42. Collects: 0. Loses: 1.42.
Player virtualbox shows: High card A [Ah 9h]. Bets: 4.40. Collects: 0. Loses: 4.40.
Player Log_in does not show cards.Bets: 0.50. Collects: 0. Loses: 0.50.
Player IlxxxlI does not show cards.Bets: 0. Collects: 0. Wins: 0.
Game ended at: 2016/11/29 8:39:3

Game started
Game ID: 786756755 0.25/0.50 (PRR) Gorgons - 7 (Hold'em)
Seat 2 is the button
Seat 1: Madmonkeygan (50).
Seat 2: Heksebrygg (50).
Seat 3: Patty P (34.42).
Seat 4: virtualbox (62.52).
Seat 5: Log_in (24).
Seat 6: IlxxxlI (20.75).
Player Patty P has small blind (0.25)
Player virtualbox has big blind (0.50)
Player IlxxxlI received card: [2d]
Player IlxxxlI received card: [10h]
Player Log_in raises (1.12)
Player IlxxxlI folds
Player Madmonkeygan folds
Player Heksebrygg folds
Player Patty P folds
Player virtualbox folds
Uncalled bet (0.62) returned to Log_in
Player Log_in mucks cards
------ Summary ------
Pot: 1.25. Rake 0
Player Madmonkeygan does not show cards.Bets: 0. Collects: 0. Wins: 0.
Player Heksebrygg does not show cards.Bets: 0. Collects: 0. Wins: 0.
Player Patty P does not show cards.Bets: 0.25. Collects: 0. Loses: 0.25.
Player virtualbox does not show cards.Bets: 0.50. Collects: 0. Loses: 0.50.
*Player Log_in mucks (does not show cards). Bets: 0.50. Collects: 1.25. Wins: 0.75.
Player IlxxxlI does not show cards.Bets: 0. Collects: 0. Wins: 0.
Game ended at: 2016/11/29 8:37:28

Game started
Game ID: 786756509 0.25/0.50 (PRR) Gorgons - 7 (Hold'em)
Seat 1 is the button
Seat 1: Madmonkeygan (50).
Seat 2: Heksebrygg (50).
Seat 3: Patty P (34.17).
Seat 4: virtualbox (62.52).
Seat 5: Log_in (24).
Seat 6: IlxxxlI (20.75).
Player Heksebrygg has small blind (0.25)
Player Patty P has big blind (0.50)
Player IlxxxlI received card: [Kd]
Player IlxxxlI received card: [2s]
Player virtualbox folds
Player Log_in folds
Player IlxxxlI folds
Player Madmonkeygan folds
Player Heksebrygg folds
Uncalled bet (0.25) returned to Patty P
Player Patty P mucks cards
------ Summary ------
Pot: 0.50. Rake 0
Player Madmonkeygan does not show cards.Bets: 0. Collects: 0. Wins: 0.
Player Heksebrygg does not show cards.Bets: 0.25. Collects: 0. Loses: 0.25.
*Player Patty P mucks (does not show cards). Bets: 0.25. Collects: 0.50. Wins: 0.25.
Player virtualbox does not show cards.Bets: 0. Collects: 0. Wins: 0.
Player Log_in does not show cards.Bets: 0. Collects: 0. Wins: 0.
Player IlxxxlI does not show cards.Bets: 0. Collects: 0. Wins: 0.
Game ended at: 2016/11/29 8:37:3

Game started
Game ID: 786756079 0.25/0.50 (PRR) Gorgons - 7 (Hold'em)
Seat 6 is the button
Seat 1: Madmonkeygan (50).
Seat 2: Heksebrygg (50).
Seat 3: Patty P (34.17).
Seat 4: virtualbox (62.52).
Seat 5: Log_in (24).
Seat 6: IlxxxlI (20).
Player Madmonkeygan has small blind (0.25)
Player Heksebrygg has big blind (0.50)
Player IlxxxlI received card: [Ah]
Player IlxxxlI received card: [7h]
Player Patty P folds
Player virtualbox folds
Player Log_in folds
Player IlxxxlI raises (1.50)
Player Madmonkeygan folds
Player Heksebrygg folds
Uncalled bet (1) returned to IlxxxlI
Player IlxxxlI mucks cards
------ Summary ------
Pot: 1.25. Rake 0
Player Madmonkeygan does not show cards.Bets: 0.25. Collects: 0. Loses: 0.25.
Player Heksebrygg does not show cards.Bets: 0.50. Collects: 0. Loses: 0.50.
Player Patty P does not show cards.Bets: 0. Collects: 0. Wins: 0.
Player virtualbox does not show cards.Bets: 0. Collects: 0. Wins: 0.
Player Log_in does not show cards.Bets: 0. Collects: 0. Wins: 0.
*Player IlxxxlI mucks (does not show cards). Bets: 0.50. Collects: 1.25. Wins: 0.75.
Game ended at: 2016/11/29 8:36:47

Game started
Game ID: 786755996 1/2 (PRR) Longana - 2 (Hold'em)
Seat 5 is the button
Seat 1: IlxxxlI (86).
Seat 2: Tilt-A-Whirl (200).
Seat 3: IamPhamous (174.87).
Seat 4: PANDAisEVIL (235.77).
Seat 5: Iia007 (226.21).
Seat 7: MadLifeGrinder (217.04).
Seat 8: mr.fargo (83).
Seat 9: shokerAAss (275.76).
Player MadLifeGrinder has small blind (1)
Player mr.fargo has big blind (2)
Player IlxxxlI received card: [3c]
Player IlxxxlI received card: [Js]
Player shokerAAss raises (6)
Player IlxxxlI folds
Player Tilt-A-Whirl folds
Player IamPhamous folds
Player PANDAisEVIL folds
Player Iia007 folds
Player MadLifeGrinder folds
Player mr.fargo calls (4)
*** FLOP ***: [6d 4d 6s]
Player mr.fargo checks
Player shokerAAss bets (6.17)
Player mr.fargo calls (6.17)
*** TURN ***: [6d 4d 6s] [9c]
Player mr.fargo checks
Player shokerAAss bets (18)
Player mr.fargo calls (18)
*** RIVER ***: [6d 4d 6s 9c] [5c]
Player mr.fargo checks
Player shokerAAss allin (245.59)
Player mr.fargo allin (52.83)
Uncalled bet (192.76) returned to shokerAAss
------ Summary ------
Pot: 164. Rake 2.76. JP fee 0.24
Board: [6d 4d 6s 9c 5c]
Player IlxxxlI does not show cards.Bets: 0. Collects: 0. Wins: 0.
Player Tilt-A-Whirl does not show cards.Bets: 0. Collects: 0. Wins: 0.
Player IamPhamous does not show cards.Bets: 0. Collects: 0. Wins: 0.
Player PANDAisEVIL does not show cards.Bets: 0. Collects: 0. Wins: 0.
Player Iia007 does not show cards.Bets: 0. Collects: 0. Wins: 0.
Player MadLifeGrinder does not show cards.Bets: 1. Collects: 0. Loses: 1.
*Player mr.fargo shows: Full House (9/6) [9h 9d]. Bets: 83. Collects: 164. Wins: 81.
Player shokerAAss shows: Two pairs. As and 6s [Ad Ac]. Bets: 83. Collects: 0. Loses: 83.
Game ended at: 2016/11/29 8:37:35

Game started
Game ID: 786755889 0.25/0.50 (PRR) Garuda (Hold'em)
Seat 3 is the button
Seat 1: Aquaman75 (65.28).
Seat 2: IlxxxlI (20).
Seat 3: Ice Bank Mice Elf (64.93).
Seat 4: Log_in (14.25).
Seat 5: CumBckMuny (38.74).
Seat 6: XxDominationxX (70.90).
Seat 8: rounderontilt (26.67).
Seat 9: Taxriverman (52.15).
Player Log_in has small blind (0.25)
Player CumBckMuny has big blind (0.50)
Player IlxxxlI received card: [5s]
Player IlxxxlI received card: [Qd]
Player XxDominationxX folds
Player rounderontilt calls (0.50)
Player Taxriverman folds
Player Aquaman75 folds
Player IlxxxlI folds
Player Ice Bank Mice Elf folds
Player Log_in raises (1.75)
Player CumBckMuny calls (1.50)
Player rounderontilt calls (1.50)
*** FLOP ***: [9d 9c 10c]
Player Log_in checks
Player CumBckMuny bets (2.85)
Player rounderontilt calls (2.85)
Player Log_in folds
*** TURN ***: [9d 9c 10c] [Kc]
Player CumBckMuny checks
Player rounderontilt bets (5.56)
Player CumBckMuny folds
Uncalled bet (5.56) returned to rounderontilt
Player rounderontilt mucks cards
------ Summary ------
Pot: 11.12. Rake 0.40. JP fee 0.18
Board: [9d 9c 10c Kc]
Player Aquaman75 does not show cards.Bets: 0. Collects: 0. Wins: 0.
Player IlxxxlI does not show cards.Bets: 0. Collects: 0. Wins: 0.
Player Ice Bank Mice Elf does not show cards.Bets: 0. Collects: 0. Wins: 0.
Player Log_in does not show cards.Bets: 2. Collects: 0. Loses: 2.
Player CumBckMuny does not show cards.Bets: 4.85. Collects: 0. Loses: 4.85.
Player XxDominationxX does not show cards.Bets: 0. Collects: 0. Wins: 0.
*Player rounderontilt mucks (does not show cards). Bets: 4.85. Collects: 11.12. Wins: 6.27.
Player Taxriverman does not show cards.Bets: 0. Collects: 0. Wins: 0.
Game ended at: 2016/11/29 8:37:42

Game started
Game ID: 786755178 1/2 (PRR) Longana - 2 (Hold'em)
Seat 4 is the button
Seat 1: IlxxxlI (86).
Seat 2: Tilt-A-Whirl (200).
Seat 3: IamPhamous (165.87).
Seat 4: PANDAisEVIL (235.77).
Seat 5: Iia007 (227.21).
Seat 7: MadLifeGrinder (219.04).
Seat 8: mr.fargo (83).
Seat 9: shokerAAss (281.76).
Player Iia007 has small blind (1)
Player MadLifeGrinder has big blind (2)
Player IlxxxlI received card: [5d]
Player IlxxxlI received card: [2h]
Player mr.fargo folds
Player shokerAAss raises (6)
Player IlxxxlI folds
Player Tilt-A-Whirl folds
Player IamPhamous raises (18)
Player PANDAisEVIL folds
Player Iia007 folds
Player MadLifeGrinder folds
Player shokerAAss folds
Uncalled bet (12) returned to IamPhamous
Player IamPhamous mucks cards
------ Summary ------
Pot: 15. Rake 0
Player IlxxxlI does not show cards.Bets: 0. Collects: 0. Wins: 0.
Player Tilt-A-Whirl does not show cards.Bets: 0. Collects: 0. Wins: 0.
*Player IamPhamous mucks (does not show cards). Bets: 6. Collects: 15. Wins: 9.
Player PANDAisEVIL does not show cards.Bets: 0. Collects: 0. Wins: 0.
Player Iia007 does not show cards.Bets: 1. Collects: 0. Loses: 1.
Player MadLifeGrinder does not show cards.Bets: 2. Collects: 0. Loses: 2.
Player mr.fargo does not show cards.Bets: 0. Collects: 0. Wins: 0.
Player shokerAAss does not show cards.Bets: 6. Collects: 0. Loses: 6.
Game ended at: 2016/11/29 8:36:17

Game started
Game ID: 786754969 0.25/0.50 (PRR) Gorgons - 7 (Hold'em)
Seat 5 is the button
Seat 1: Madmonkeygan (53.56).
Seat 2: Heksebrygg (50).
Seat 3: Patty P (34.17).
Seat 4: virtualbox (56.08).
Seat 5: Log_in (24).
Seat 6: IlxxxlI (20).
Player IlxxxlI has small blind (0.25)
Player Madmonkeygan has big blind (0.50)
Player IlxxxlI received card: [2d]
Player IlxxxlI received card: [Kc]
Player Heksebrygg folds
Player Patty P folds
Player virtualbox raises (1.25)
Player Log_in folds
Player IlxxxlI folds
Player Madmonkeygan calls (0.75)
*** FLOP ***: [Ad 3s 4s]
Player Madmonkeygan checks
Player virtualbox bets (1.31)
Player Madmonkeygan calls (1.31)
*** TURN ***: [Ad 3s 4s] [4h]
Player Madmonkeygan bets (4.33)
Player virtualbox calls (4.33)
*** RIVER ***: [Ad 3s 4s 4h] [Qh]
Player Madmonkeygan checks
Player virtualbox checks
------ Summary ------
Pot: 13.33. Rake 0.48. JP fee 0.22
Board: [Ad 3s 4s 4h Qh]
Player Madmonkeygan shows: One pair of 4s [Ks 6s]. Bets: 6.89. Collects: 0. Loses: 6.89.
Player Heksebrygg does not show cards.Bets: 0. Collects: 0. Wins: 0.
Player Patty P does not show cards.Bets: 0. Collects: 0. Wins: 0.
*Player virtualbox shows: Two pairs. As and 4s [3c Ac]. Bets: 6.89. Collects: 13.33. Wins: 6.44.
Player Log_in does not show cards.Bets: 0. Collects: 0. Wins: 0.
Player IlxxxlI does not show cards.Bets: 0.25. Collects: 0. Loses: 0.25.
Game ended at: 2016/11/29 8:36:19

Game started
Game ID: 786754849 0.25/0.50 (PRR) Garuda (Hold'em)
Seat 2 is the button
Seat 1: Aquaman75 (65.28).
Seat 2: IlxxxlI (20).
Seat 3: Ice Bank Mice Elf (66.93).
Seat 4: Log_in (14.75).
Seat 5: CumBckMuny (38.74).
Seat 6: XxDominationxX (72.90).
Seat 8: rounderontilt (20.59).
Seat 9: Taxriverman (52.15).
Player Ice Bank Mice Elf has small blind (0.25)
Player Log_in has big blind (0.50)
Player IlxxxlI received card: [8d]
Player IlxxxlI received card: [8c]
Player CumBckMuny folds
Player XxDominationxX calls (0.50)
Player rounderontilt raises (2)
Player Taxriverman folds
Player Aquaman75 folds
Player IlxxxlI calls (2)
Player Ice Bank Mice Elf calls (1.75)
Player Log_in folds
Player XxDominationxX calls (1.50)
*** FLOP ***: [10d 9d 6d]
Player Ice Bank Mice Elf checks
Player XxDominationxX checks
Player rounderontilt bets (4.04)
Player IlxxxlI folds
Player Ice Bank Mice Elf folds
Player XxDominationxX folds
Uncalled bet (4.04) returned to rounderontilt
Player rounderontilt mucks cards
------ Summary ------
Pot: 8.08. Rake 0.28. JP fee 0.14
Board: [10d 9d 6d]
Player Aquaman75 does not show cards.Bets: 0. Collects: 0. Wins: 0.
Player IlxxxlI does not show cards.Bets: 2. Collects: 0. Loses: 2.
Player Ice Bank Mice Elf does not show cards.Bets: 2. Collects: 0. Loses: 2.
Player Log_in does not show cards.Bets: 0.50. Collects: 0. Loses: 0.50.
Player CumBckMuny does not show cards.Bets: 0. Collects: 0. Wins: 0.
Player XxDominationxX does not show cards.Bets: 2. Collects: 0. Loses: 2.
*Player rounderontilt mucks (does not show cards). Bets: 2. Collects: 8.08. Wins: 6.08.
Player Taxriverman does not show cards.Bets: 0. Collects: 0. Wins: 0.
Game ended at: 2016/11/29 8:36:10

Game started
Game ID: 786754832 1/2 (PRR) Longana - 2 (Hold'em)
Seat 3 is the button
Seat 1: IlxxxlI (86).
Seat 2: Tilt-A-Whirl (200).
Seat 3: IamPhamous (165.87).
Seat 4: PANDAisEVIL (236.77).
Seat 5: Iia007 (226.21).
Seat 7: MadLifeGrinder (219.04).
Seat 8: mr.fargo (83).
Seat 9: shokerAAss (281.76).
Player PANDAisEVIL has small blind (1)
Player Iia007 has big blind (2)
Player IlxxxlI received card: [3h]
Player IlxxxlI received card: [3s]
Player MadLifeGrinder folds
Player mr.fargo folds
Player shokerAAss folds
Player IlxxxlI folds
Player Tilt-A-Whirl folds
Player IamPhamous folds
Player PANDAisEVIL folds
Uncalled bet (1) returned to Iia007
Player Iia007 mucks cards
------ Summary ------
Pot: 2. Rake 0
Player IlxxxlI does not show cards.Bets: 0. Collects: 0. Wins: 0.
Player Tilt-A-Whirl does not show cards.Bets: 0. Collects: 0. Wins: 0.
Player IamPhamous does not show cards.Bets: 0. Collects: 0. Wins: 0.
Player PANDAisEVIL does not show cards.Bets: 1. Collects: 0. Loses: 1.
*Player Iia007 mucks (does not show cards). Bets: 1. Collects: 2. Wins: 1.
Player MadLifeGrinder does not show cards.Bets: 0. Collects: 0. Wins: 0.
Player mr.fargo does not show cards.Bets: 0. Collects: 0. Wins: 0.
Player shokerAAss does not show cards.Bets: 0. Collects: 0. Wins: 0.
Game ended at: 2016/11/29 8:35:19

Game started
Game ID: 786754023 1/2 (PRR) Longana - 2 (Hold'em)
Seat 2 is the button
Seat 1: IlxxxlI (86).
Seat 2: Tilt-A-Whirl (200).
Seat 3: IamPhamous (154.97).
Seat 4: PANDAisEVIL (238.77).
Seat 5: Iia007 (226.21).
Seat 7: MadLifeGrinder (219.04).
Seat 8: mr.fargo (83).
Seat 9: shokerAAss (281.76).
Player IamPhamous has small blind (1)
Player PANDAisEVIL has big blind (2)
Player IlxxxlI received card: [10c]
Player IlxxxlI received card: [6d]
Player Iia007 folds
Player MadLifeGrinder folds
Player mr.fargo folds
Player shokerAAss folds
Player IlxxxlI folds
Player Tilt-A-Whirl raises (4)
Player IamPhamous raises (9)
Player PANDAisEVIL folds
Player Tilt-A-Whirl calls (6)
*** FLOP ***: [3s 3c 6h]
Player IamPhamous bets (10.45)
Player Tilt-A-Whirl folds
Uncalled bet (10.45) returned to IamPhamous
Player IamPhamous mucks cards
------ Summary ------
Pot: 20.90. Rake 0.86. JP fee 0.24
Board: [3s 3c 6h]
Player IlxxxlI does not show cards.Bets: 0. Collects: 0. Wins: 0.
Player Tilt-A-Whirl does not show cards.Bets: 10. Collects: 0. Loses: 10.
*Player IamPhamous mucks (does not show cards). Bets: 10. Collects: 20.90. Wins: 10.90.
Player PANDAisEVIL does not show cards.Bets: 2. Collects: 0. Loses: 2.
Player Iia007 does not show cards.Bets: 0. Collects: 0. Wins: 0.
Player MadLifeGrinder does not show cards.Bets: 0. Collects: 0. Wins: 0.
Player mr.fargo does not show cards.Bets: 0. Collects: 0. Wins: 0.
Player shokerAAss does not show cards.Bets: 0. Collects: 0. Wins: 0.
Game ended at: 2016/11/29 8:34:58

Game started
Game ID: 786753883 0.25/0.50 (PRR) Gorgons - 7 (Hold'em)
Seat 4 is the button
Seat 1: Madmonkeygan (53.56).
Seat 2: Heksebrygg (50).
Seat 3: Patty P (39.47).
Seat 4: virtualbox (56.08).
Seat 5: Log_in (18.75).
Seat 6: IlxxxlI (20).
Player Log_in has small blind (0.25)
Player IlxxxlI has big blind (0.50)
Player IlxxxlI received card: [2h]
Player IlxxxlI received card: [8s]
Player Madmonkeygan folds
Player Heksebrygg folds
Player Patty P raises (1)
Player virtualbox folds
Player Log_in raises (2.90)
Player IlxxxlI folds
Player Patty P calls (2.15)
*** FLOP ***: [6c 6d Jd]
Player Log_in bets (2.15)
Player Patty P calls (2.15)
*** TURN ***: [6c 6d Jd] [7d]
Player Log_in allin (13.45)
Player Patty P folds
Uncalled bet (13.45) returned to Log_in
Player Log_in mucks cards
------ Summary ------
Pot: 10.55. Rake 0.37. JP fee 0.18
Board: [6c 6d Jd 7d]
Player Madmonkeygan does not show cards.Bets: 0. Collects: 0. Wins: 0.
Player Heksebrygg does not show cards.Bets: 0. Collects: 0. Wins: 0.
Player Patty P does not show cards.Bets: 5.30. Collects: 0. Loses: 5.30.
Player virtualbox does not show cards.Bets: 0. Collects: 0. Wins: 0.
*Player Log_in mucks (does not show cards). Bets: 5.30. Collects: 10.55. Wins: 5.25.
Player IlxxxlI does not show cards.Bets: 0.50. Collects: 0. Loses: 0.50.
Game ended at: 2016/11/29 8:35:5

Game started
Game ID: 786753616 0.25/0.50 (PRR) Garuda (Hold'em)
Seat 1 is the button
Seat 1: Aquaman75 (65.78).
Seat 2: IlxxxlI (20).
Seat 3: Ice Bank Mice Elf (67.43).
Seat 4: Log_in (14.75).
Seat 5: CumBckMuny (38.74).
Seat 6: XxDominationxX (72.90).
Seat 8: rounderontilt (20.59).
Seat 9: Taxriverman (50.98).
Player IlxxxlI has small blind (0.25)
Player Ice Bank Mice Elf has big blind (0.50)
Player IlxxxlI received card: [3h]
Player IlxxxlI received card: [Qd]
Player Log_in folds
Player CumBckMuny folds
Player XxDominationxX folds
Player rounderontilt folds
Player Taxriverman calls (0.50)
Player Aquaman75 calls (0.50)
Player IlxxxlI folds
Player Ice Bank Mice Elf checks
*** FLOP ***: [Qs 3d 7h]
Player Ice Bank Mice Elf checks
Player Taxriverman checks
Player Aquaman75 checks
*** TURN ***: [Qs 3d 7h] [4d]
Player Ice Bank Mice Elf checks
Player Taxriverman bets (1.11)
Player Aquaman75 folds
Player Ice Bank Mice Elf folds
Uncalled bet (1.11) returned to Taxriverman
Player Taxriverman mucks cards
------ Summary ------
Pot: 1.67. Rake 0.06. JP fee 0.02
Board: [Qs 3d 7h 4d]
Player Aquaman75 does not show cards.Bets: 0.50. Collects: 0. Loses: 0.50.
Player IlxxxlI does not show cards.Bets: 0.25. Collects: 0. Loses: 0.25.
Player Ice Bank Mice Elf does not show cards.Bets: 0.50. Collects: 0. Loses: 0.50.
Player Log_in does not show cards.Bets: 0. Collects: 0. Wins: 0.
Player CumBckMuny does not show cards.Bets: 0. Collects: 0. Wins: 0.
Player XxDominationxX does not show cards.Bets: 0. Collects: 0. Wins: 0.
Player rounderontilt does not show cards.Bets: 0. Collects: 0. Wins: 0.
*Player Taxriverman mucks (does not show cards). Bets: 0.50. Collects: 1.67. Wins: 1.17.
Game ended at: 2016/11/29 8:34:59

Game started
Game ID: 786753489 1/2 (PRR) Longana - 2 (Hold'em)
Seat 1 is the button
Seat 1: IlxxxlI (86).
Seat 2: Tilt-A-Whirl (200).
Seat 3: IamPhamous (156.97).
Seat 4: PANDAisEVIL (238.77).
Seat 5: Iia007 (226.21).
Seat 7: MadLifeGrinder (219.04).
Seat 8: mr.fargo (80).
Seat 9: shokerAAss (281.76).
Player Tilt-A-Whirl has small blind (1)
Player IamPhamous has big blind (2)
Player IlxxxlI received card: [9c]
Player IlxxxlI received card: [Jc]
Player PANDAisEVIL folds
Player Iia007 folds
Player MadLifeGrinder folds
Player mr.fargo raises (5)
Player shokerAAss folds
Player IlxxxlI folds
Player Tilt-A-Whirl folds
Player IamPhamous folds
Uncalled bet (3) returned to mr.fargo
Player mr.fargo mucks cards
------ Summary ------
Pot: 5. Rake 0
Player IlxxxlI does not show cards.Bets: 0. Collects: 0. Wins: 0.
Player Tilt-A-Whirl does not show cards.Bets: 1. Collects: 0. Loses: 1.
Player IamPhamous does not show cards.Bets: 2. Collects: 0. Loses: 2.
Player PANDAisEVIL does not show cards.Bets: 0. Collects: 0. Wins: 0.
Player Iia007 does not show cards.Bets: 0. Collects: 0. Wins: 0.
Player MadLifeGrinder does not show cards.Bets: 0. Collects: 0. Wins: 0.
*Player mr.fargo mucks (does not show cards). Bets: 2. Collects: 5. Wins: 3.
Player shokerAAss does not show cards.Bets: 0. Collects: 0. Wins: 0.
Game ended at: 2016/11/29 8:34:7

Game started
Game ID: 786753037 0.25/0.50 (PRR) Garuda (Hold'em)
Seat 9 is the button
Seat 1: Aquaman75 (66.03).
Seat 2: IlxxxlI (20).
Seat 3: Ice Bank Mice Elf (67.43).
Seat 4: Log_in (14.75).
Seat 5: CumBckMuny (38.74).
Seat 6: XxDominationxX (72.15).
Seat 8: rounderontilt (20.59).
Seat 9: Taxriverman (50.98).
Player Aquaman75 has small blind (0.25)
Player IlxxxlI has big blind (0.50)
Player IlxxxlI received card: [7s]
Player IlxxxlI received card: [8d]
Player Ice Bank Mice Elf folds
Player Log_in folds
Player CumBckMuny folds
Player XxDominationxX raises (1.50)
Player rounderontilt folds
Player Taxriverman folds
Player Aquaman75 folds
Player IlxxxlI folds
Uncalled bet (1) returned to XxDominationxX
Player XxDominationxX mucks cards
------ Summary ------
Pot: 1.25. Rake 0
Player Aquaman75 does not show cards.Bets: 0.25. Collects: 0. Loses: 0.25.
Player IlxxxlI does not show cards.Bets: 0.50. Collects: 0. Loses: 0.50.
Player Ice Bank Mice Elf does not show cards.Bets: 0. Collects: 0. Wins: 0.
Player Log_in does not show cards.Bets: 0. Collects: 0. Wins: 0.
Player CumBckMuny does not show cards.Bets: 0. Collects: 0. Wins: 0.
*Player XxDominationxX mucks (does not show cards). Bets: 0.50. Collects: 1.25. Wins: 0.75.
Player rounderontilt does not show cards.Bets: 0. Collects: 0. Wins: 0.
Player Taxriverman does not show cards.Bets: 0. Collects: 0. Wins: 0.
Game ended at: 2016/11/29 8:33:40

Game started
Game ID: 786752419 1/2 (PRR) Longana - 2 (Hold'em)
Seat 9 is the button
Seat 1: IlxxxlI (87).
Seat 2: Tilt-A-Whirl (200).
Seat 3: IamPhamous (153.97).
Seat 4: PANDAisEVIL (238.77).
Seat 5: Iia007 (226.21).
Seat 6: AgSweep (147.77).
Seat 7: MadLifeGrinder (219.04).
Seat 8: mr.fargo (80).
Seat 9: shokerAAss (281.76).
Player IlxxxlI has small blind (1)
Player Tilt-A-Whirl has big blind (2)
Player IlxxxlI received card: [6c]
Player IlxxxlI received card: [2d]
Player IamPhamous raises (6)
Player PANDAisEVIL folds
Player Iia007 folds
Player AgSweep is timed out.
Player AgSweep folds
Player MadLifeGrinder folds
Player mr.fargo folds
Player shokerAAss folds
Player IlxxxlI folds
Player Tilt-A-Whirl folds
Uncalled bet (4) returned to IamPhamous
Player IamPhamous mucks cards
------ Summary ------
Pot: 5. Rake 0
Player IlxxxlI does not show cards.Bets: 1. Collects: 0. Loses: 1.
Player Tilt-A-Whirl does not show cards.Bets: 2. Collects: 0. Loses: 2.
*Player IamPhamous mucks (does not show cards). Bets: 2. Collects: 5. Wins: 3.
Player PANDAisEVIL does not show cards.Bets: 0. Collects: 0. Wins: 0.
Player Iia007 does not show cards.Bets: 0. Collects: 0. Wins: 0.
Player AgSweep does not show cards.Bets: 0. Collects: 0. Wins: 0.
Player MadLifeGrinder does not show cards.Bets: 0. Collects: 0. Wins: 0.
Player mr.fargo does not show cards.Bets: 0. Collects: 0. Wins: 0.
Player shokerAAss does not show cards.Bets: 0. Collects: 0. Wins: 0.
Game ended at: 2016/11/29 8:33:30

Game started
Game ID: 786751655 1/2 (PRR) Longana - 2 (Hold'em)
Seat 8 is the button
Seat 1: IlxxxlI (89).
Seat 3: IamPhamous (153.97).
Seat 4: PANDAisEVIL (238.77).
Seat 5: Iia007 (226.21).
Seat 6: AgSweep (147.77).
Seat 7: MadLifeGrinder (216.04).
Seat 8: mr.fargo (80).
Seat 9: shokerAAss (282.76).
Player shokerAAss has small blind (1)
Player IlxxxlI has big blind (2)
Player IlxxxlI received card: [4c]
Player IlxxxlI received card: [Jd]
Player IamPhamous folds
Player PANDAisEVIL folds
Player Iia007 folds
Player AgSweep folds
Player MadLifeGrinder raises (5)
Player mr.fargo folds
Player shokerAAss folds
Player IlxxxlI folds
Uncalled bet (3) returned to MadLifeGrinder
Player MadLifeGrinder mucks cards
------ Summary ------
Pot: 5. Rake 0
Player IlxxxlI does not show cards.Bets: 2. Collects: 0. Loses: 2.
Player IamPhamous does not show cards.Bets: 0. Collects: 0. Wins: 0.
Player PANDAisEVIL does not show cards.Bets: 0. Collects: 0. Wins: 0.
Player Iia007 does not show cards.Bets: 0. Collects: 0. Wins: 0.
Player AgSweep does not show cards.Bets: 0. Collects: 0. Wins: 0.
*Player MadLifeGrinder mucks (does not show cards). Bets: 2. Collects: 5. Wins: 3.
Player mr.fargo does not show cards.Bets: 0. Collects: 0. Wins: 0.
Player shokerAAss does not show cards.Bets: 1. Collects: 0. Loses: 1.
Game ended at: 2016/11/29 8:32:19

Game started
Game ID: 786750271 1/2 (PRR) Longana - 2 (Hold'em)
Seat 7 is the button
Seat 1: IlxxxlI (89).
Seat 3: IamPhamous (153.97).
Seat 4: PANDAisEVIL (238.77).
Seat 5: Iia007 (226.21).
Seat 6: AgSweep (172.88).
Seat 7: MadLifeGrinder (216.04).
Seat 8: mr.fargo (80).
Seat 9: shokerAAss (259.21).
Player mr.fargo has small blind (1)
Player shokerAAss has big blind (2)
Player IlxxxlI received card: [5c]
Player IlxxxlI received card: [7d]
Player IlxxxlI folds
Player IamPhamous folds
Player PANDAisEVIL folds
Player Iia007 folds
Player AgSweep raises (6)
Player MadLifeGrinder folds
Player mr.fargo folds
Player shokerAAss calls (4)
*** FLOP ***: [4s 2s 9d]
Player shokerAAss checks
Player AgSweep bets (4.11)
Player shokerAAss calls (4.11)
*** TURN ***: [4s 2s 9d] [8c]
Player shokerAAss bets (15)
Player AgSweep calls (15)
*** RIVER ***: [4s 2s 9d 8c] [5s]
Player shokerAAss checks
Player AgSweep checks
Player AgSweep mucks cards
------ Summary ------
Pot: 48.66. Rake 2.32. JP fee 0.24
Board: [4s 2s 9d 8c 5s]
Player IlxxxlI does not show cards.Bets: 0. Collects: 0. Wins: 0.
Player IamPhamous does not show cards.Bets: 0. Collects: 0. Wins: 0.
Player PANDAisEVIL does not show cards.Bets: 0. Collects: 0. Wins: 0.
Player Iia007 does not show cards.Bets: 0. Collects: 0. Wins: 0.
Player AgSweep mucks (does not show cards). Bets: 25.11. Collects: 0. Loses: 25.11.
Player MadLifeGrinder does not show cards.Bets: 0. Collects: 0. Wins: 0.
Player mr.fargo does not show cards.Bets: 1. Collects: 0. Loses: 1.
*Player shokerAAss shows: One pair of Qs [Qs Qh]. Bets: 25.11. Collects: 48.66. Wins: 23.55.
Game ended at: 2016/11/29 8:31:26

Game started
Game ID: 786749856 1/2 (PRR) Longana - 2 (Hold'em)
Seat 6 is the button
Seat 1: IlxxxlI (86).
Seat 3: IamPhamous (153.97).
Seat 4: PANDAisEVIL (238.77).
Seat 5: Iia007 (226.21).
Seat 6: AgSweep (172.88).
Seat 7: MadLifeGrinder (217.04).
Seat 8: mr.fargo (80).
Seat 9: shokerAAss (259.21).
Player MadLifeGrinder has small blind (1)
Player mr.fargo has big blind (2)
Player IlxxxlI received card: [Ah]
Player IlxxxlI received card: [10s]
Player shokerAAss folds
Player IlxxxlI raises (7)
Player IamPhamous folds
Player PANDAisEVIL folds
Player Iia007 folds
Player AgSweep folds
Player MadLifeGrinder folds
Player mr.fargo folds
Uncalled bet (5) returned to IlxxxlI
Player IlxxxlI mucks cards
------ Summary ------
Pot: 5. Rake 0
*Player IlxxxlI mucks (does not show cards). Bets: 2. Collects: 5. Wins: 3.
Player IamPhamous does not show cards.Bets: 0. Collects: 0. Wins: 0.
Player PANDAisEVIL does not show cards.Bets: 0. Collects: 0. Wins: 0.
Player Iia007 does not show cards.Bets: 0. Collects: 0. Wins: 0.
Player AgSweep does not show cards.Bets: 0. Collects: 0. Wins: 0.
Player MadLifeGrinder does not show cards.Bets: 1. Collects: 0. Loses: 1.
Player mr.fargo does not show cards.Bets: 2. Collects: 0. Loses: 2.
Player shokerAAss does not show cards.Bets: 0. Collects: 0. Wins: 0.
Game ended at: 2016/11/29 8:29:57

Game started
Game ID: 786748690 1/2 (PRR) Longana - 2 (Hold'em)
Seat 5 is the button
Seat 1: IlxxxlI (86).
Seat 3: IamPhamous (153.97).
Seat 4: PANDAisEVIL (243.77).
Seat 5: Iia007 (238.81).
Seat 6: AgSweep (173.88).
Seat 7: MadLifeGrinder (200).
Seat 9: shokerAAss (259.21).
Player AgSweep has small blind (1)
Player MadLifeGrinder has big blind (2)
Player IlxxxlI received card: [3s]
Player IlxxxlI received card: [6h]
Player shokerAAss folds
Player IlxxxlI folds
Player IamPhamous folds
Player PANDAisEVIL raises (5)
Player Iia007 calls (5)
Player AgSweep folds
Player MadLifeGrinder calls (3)
*** FLOP ***: [2h Qc Qd]
Player MadLifeGrinder checks
Player PANDAisEVIL checks
Player Iia007 bets (7.60)
Player MadLifeGrinder calls (7.60)
Player PANDAisEVIL folds
*** TURN ***: [2h Qc Qd] [6d]
Player MadLifeGrinder checks
Player Iia007 checks
*** RIVER ***: [2h Qc Qd 6d] [2s]
Player MadLifeGrinder bets (19.76)
Player Iia007 folds
Uncalled bet (19.76) returned to MadLifeGrinder
Player MadLifeGrinder mucks cards
------ Summary ------
Pot: 29.64. Rake 1.32. JP fee 0.24
Board: [2h Qc Qd 6d 2s]
Player IlxxxlI does not show cards.Bets: 0. Collects: 0. Wins: 0.
Player IamPhamous does not show cards.Bets: 0. Collects: 0. Wins: 0.
Player PANDAisEVIL does not show cards.Bets: 5. Collects: 0. Loses: 5.
Player Iia007 does not show cards.Bets: 12.60. Collects: 0. Loses: 12.60.
Player AgSweep does not show cards.Bets: 1. Collects: 0. Loses: 1.
*Player MadLifeGrinder mucks (does not show cards). Bets: 12.60. Collects: 29.64. Wins: 17.04.
Player shokerAAss does not show cards.Bets: 0. Collects: 0. Wins: 0.
Game ended at: 2016/11/29 8:29:31

Game started
Game ID: 786748409 1/2 (PRR) Longana (Hold'em)
Seat 2 is the button
Seat 2: PANDAisEVIL (295.31).
Seat 3: IlxxxlI (80).
Player PANDAisEVIL has small blind (1)
Player IlxxxlI has big blind (2)
Player IlxxxlI received card: [As]
Player IlxxxlI received card: [10s]
Player PANDAisEVIL raises (4)
Player IlxxxlI raises (10.15)
Player PANDAisEVIL calls (7.15)
*** FLOP ***: [2s 3s Ac]
Player IlxxxlI bets (7.93)
Player PANDAisEVIL calls (7.93)
*** TURN ***: [2s 3s Ac] [8c]
Player IlxxxlI checks
Player PANDAisEVIL checks
*** RIVER ***: [2s 3s Ac 8c] [10h]
Player IlxxxlI bets (32)
Player PANDAisEVIL folds
Uncalled bet (32) returned to IlxxxlI
Player IlxxxlI mucks cards
------ Summary ------
Pot: 39.66. Rake 0.46. JP fee 0.04
Board: [2s 3s Ac 8c 10h]
Player PANDAisEVIL does not show cards.Bets: 20.08. Collects: 0. Loses: 20.08.
*Player IlxxxlI mucks (does not show cards). Bets: 20.08. Collects: 39.66. Wins: 19.58.
Game ended at: 2016/11/29 8:28:56

Game started
Game ID: 786748119 1/2 (PRR) Longana (Hold'em)
Seat 3 is the button
Seat 2: PANDAisEVIL (293.31).
Seat 3: IlxxxlI (80).
Player IlxxxlI has small blind (1)
Player PANDAisEVIL has big blind (2)
Player IlxxxlI received card: [6s]
Player IlxxxlI received card: [7d]
Player IlxxxlI calls (1)
Player PANDAisEVIL raises (5)
Player IlxxxlI folds
Uncalled bet (5) returned to PANDAisEVIL
Player PANDAisEVIL mucks cards
------ Summary ------
Pot: 4. Rake 0
*Player PANDAisEVIL mucks (does not show cards). Bets: 2. Collects: 4. Wins: 2.
Player IlxxxlI does not show cards.Bets: 2. Collects: 0. Loses: 2.
Game ended at: 2016/11/29 8:27:56

Game started
Game ID: 786747772 1/2 (PRR) Longana - 2 (Hold'em)
Seat 4 is the button
Seat 1: IlxxxlI (83).
Seat 3: IamPhamous (153.97).
Seat 4: PANDAisEVIL (243.77).
Seat 5: Iia007 (239.81).
Seat 6: AgSweep (175.88).
Seat 7: MadLifeGrinder (200).
Seat 9: shokerAAss (259.21).
Player Iia007 has small blind (1)
Player AgSweep has big blind (2)
Player IlxxxlI received card: [10h]
Player IlxxxlI received card: [Ah]
Player MadLifeGrinder folds
Player shokerAAss folds
Player IlxxxlI raises (7)
Player IamPhamous folds
Player PANDAisEVIL folds
Player Iia007 folds
Player AgSweep folds
Uncalled bet (5) returned to IlxxxlI
Player IlxxxlI mucks cards
------ Summary ------
Pot: 5. Rake 0
*Player IlxxxlI mucks (does not show cards). Bets: 2. Collects: 5. Wins: 3.
Player IamPhamous does not show cards.Bets: 0. Collects: 0. Wins: 0.
Player PANDAisEVIL does not show cards.Bets: 0. Collects: 0. Wins: 0.
Player Iia007 does not show cards.Bets: 1. Collects: 0. Loses: 1.
Player AgSweep does not show cards.Bets: 2. Collects: 0. Loses: 2.
Player MadLifeGrinder does not show cards.Bets: 0. Collects: 0. Wins: 0.
Player shokerAAss does not show cards.Bets: 0. Collects: 0. Wins: 0.
Game ended at: 2016/11/29 8:28:14

Game started
Game ID: 786747022 1/2 (PRR) Longana (Hold'em)
Seat 2 is the button
Seat 2: PANDAisEVIL (280.96).
Seat 3: IlxxxlI (80).
Seat 9: Gargantuatua (212.80).
Player IlxxxlI has small blind (1)
Player Gargantuatua sitting out
Player PANDAisEVIL has big blind (2)
Player IlxxxlI received card: [8d]
Player IlxxxlI received card: [7d]
Player IlxxxlI raises (4)
Player PANDAisEVIL raises (11.35)
Player IlxxxlI calls (8.35)
*** FLOP ***: [3s 10d 5h]
Player IlxxxlI checks
Player PANDAisEVIL bets (12.85)
Player IlxxxlI folds
Uncalled bet (12.85) returned to PANDAisEVIL
Player PANDAisEVIL mucks cards
------ Summary ------
Pot: 25.70. Rake 0.96. JP fee 0.04
Board: [3s 10d 5h]
*Player PANDAisEVIL mucks (does not show cards). Bets: 13.35. Collects: 25.70. Wins: 12.35.
Player IlxxxlI does not show cards.Bets: 13.35. Collects: 0. Loses: 13.35.
Player Gargantuatua does not show cards.Bets: 0. Collects: 0. Wins: 0.
Game ended at: 2016/11/29 8:27:38

Game started
Game ID: 786746332 0.50/1 (PRR) Karkadann - 2 (Hold'em)
Seat 9 is the button
Seat 1: SoMeFarmer (90.91).
Seat 2: shokerAAss (115.11).
Seat 4: IlxxxlI (75.42).
Seat 8: Qrenor (269.17).
Seat 9: PeLanpapa (294.90).
Player SoMeFarmer has small blind (0.50)
Player shokerAAss has big blind (1)
Player IlxxxlI received card: [7d]
Player IlxxxlI received card: [5h]
Player IlxxxlI folds
Player Qrenor folds
Player PeLanpapa raises (2)
Player SoMeFarmer folds
Player shokerAAss folds
Uncalled bet (1) returned to PeLanpapa
Player PeLanpapa mucks cards
------ Summary ------
Pot: 2.50. Rake 0
Player SoMeFarmer does not show cards.Bets: 0.50. Collects: 0. Loses: 0.50.
Player shokerAAss does not show cards.Bets: 1. Collects: 0. Loses: 1.
Player IlxxxlI does not show cards.Bets: 0. Collects: 0. Wins: 0.
Player Qrenor does not show cards.Bets: 0. Collects: 0. Wins: 0.
*Player PeLanpapa mucks (does not show cards). Bets: 1. Collects: 2.50. Wins: 1.50.
Game ended at: 2016/11/29 8:26:5

Game started
Game ID: 786746175 1/2 (PRR) Longana (Hold'em)
Seat 9 is the button
Seat 2: PANDAisEVIL (281.96).
Seat 3: IlxxxlI (80).
Seat 7: TonnaMunz (200).
Seat 9: Gargantuatua (200.95).
Player PANDAisEVIL has small blind (1)
Player IlxxxlI has big blind (2)
Player IlxxxlI received card: [Qc]
Player IlxxxlI received card: [4c]
Player TonnaMunz folds
Player Gargantuatua raises (6)
Player PANDAisEVIL folds
Player IlxxxlI calls (4)
*** FLOP ***: [Qh Jd Ah]
Player IlxxxlI checks
Player Gargantuatua bets (4.11)
Player IlxxxlI calls (4.11)
*** TURN ***: [Qh Jd Ah] [Ks]
Player IlxxxlI bets (2)
Player Gargantuatua raises (14)
Player IlxxxlI folds
Uncalled bet (12) returned to Gargantuatua
Player Gargantuatua mucks cards
------ Summary ------
Pot: 23.96. Rake 1.02. JP fee 0.24
Board: [Qh Jd Ah Ks]
Player PANDAisEVIL does not show cards.Bets: 1. Collects: 0. Loses: 1.
Player IlxxxlI does not show cards.Bets: 12.11. Collects: 0. Loses: 12.11.
Player TonnaMunz does not show cards.Bets: 0. Collects: 0. Wins: 0.
*Player Gargantuatua mucks (does not show cards). Bets: 12.11. Collects: 23.96. Wins: 11.85.
Game ended at: 2016/11/29 8:26:29

Game started
Game ID: 786746138 1/2 (PRR) Longana - 2 (Hold'em)
Seat 3 is the button
Seat 1: IlxxxlI (83).
Seat 3: IamPhamous (153.97).
Seat 4: PANDAisEVIL (219.25).
Seat 5: Iia007 (241.81).
Seat 6: AgSweep (175.88).
Seat 7: MadLifeGrinder (200).
Seat 9: shokerAAss (259.21).
Player PANDAisEVIL has small blind (1)
Player Iia007 has big blind (2)
Player IlxxxlI received card: [Js]
Player IlxxxlI received card: [9d]
Player AgSweep folds
Player MadLifeGrinder raises (5)
Player shokerAAss folds
Player IlxxxlI folds
Player IamPhamous folds
Player PANDAisEVIL calls (4)
Player Iia007 folds
*** FLOP ***: [7c 6s 6h]
Player PANDAisEVIL checks
Player MadLifeGrinder bets (6)
Player PANDAisEVIL calls (6)
*** TURN ***: [7c 6s 6h] [8d]
Player PANDAisEVIL checks
Player MadLifeGrinder checks
*** RIVER ***: [7c 6s 6h 8d] [8s]
Player PANDAisEVIL bets (14.13)
Player MadLifeGrinder calls (14.13)
Player MadLifeGrinder mucks cards
------ Summary ------
Pot: 49.65. Rake 2.37. JP fee 0.24
Board: [7c 6s 6h 8d 8s]
Player IlxxxlI does not show cards.Bets: 0. Collects: 0. Wins: 0.
Player IamPhamous does not show cards.Bets: 0. Collects: 0. Wins: 0.
*Player PANDAisEVIL shows: Four of kind of 8s [8c 8h]. Bets: 25.13. Collects: 49.65. Wins: 24.52.
Player Iia007 does not show cards.Bets: 2. Collects: 0. Loses: 2.
Player AgSweep does not show cards.Bets: 0. Collects: 0. Wins: 0.
Player MadLifeGrinder mucks (does not show cards). Bets: 25.13. Collects: 0. Loses: 25.13.
Player shokerAAss does not show cards.Bets: 0. Collects: 0. Wins: 0.
Game ended at: 2016/11/29 8:27:14

Game started
Game ID: 786745574 0.50/1 (PRR) Karkadann - 2 (Hold'em)
Seat 8 is the button
Seat 1: SoMeFarmer (91.91).
Seat 2: shokerAAss (115.11).
Seat 4: IlxxxlI (75.42).
Seat 8: Qrenor (269.17).
Seat 9: PeLanpapa (294).
Player PeLanpapa has small blind (0.50)
Player SoMeFarmer has big blind (1)
Player IlxxxlI received card: [Kc]
Player IlxxxlI received card: [7d]
Player shokerAAss folds
Player IlxxxlI folds
Player Qrenor folds
Player PeLanpapa calls (0.50)
Player SoMeFarmer checks
*** FLOP ***: [3c Ac 8h]
Player PeLanpapa bets (1)
Player SoMeFarmer folds
Uncalled bet (1) returned to PeLanpapa
Player PeLanpapa mucks cards
------ Summary ------
Pot: 1.90. Rake 0.08. JP fee 0.02
Board: [3c Ac 8h]
Player SoMeFarmer does not show cards.Bets: 1. Collects: 0. Loses: 1.
Player shokerAAss does not show cards.Bets: 0. Collects: 0. Wins: 0.
Player IlxxxlI does not show cards.Bets: 0. Collects: 0. Wins: 0.
Player Qrenor does not show cards.Bets: 0. Collects: 0. Wins: 0.
*Player PeLanpapa mucks (does not show cards). Bets: 1. Collects: 1.90. Wins: 0.90.
Game ended at: 2016/11/29 8:25:43

Game started
Game ID: 786745279 1/2 (PRR) Longana - 2 (Hold'em)
Seat 1 is the button
Seat 1: IlxxxlI (80).
Seat 3: IamPhamous (154.97).
Seat 4: PANDAisEVIL (221.25).
Seat 5: Iia007 (241.81).
Seat 6: AgSweep (175.88).
Seat 7: MadLifeGrinder (200).
Seat 9: shokerAAss (259.21).
Player IamPhamous has small blind (1)
Player PANDAisEVIL has big blind (2)
Player IlxxxlI received card: [Ad]
Player IlxxxlI received card: [Jc]
Player Iia007 folds
Player AgSweep folds
Player MadLifeGrinder folds
Player shokerAAss folds
Player IlxxxlI raises (6)
Player IamPhamous folds
Player PANDAisEVIL folds
Uncalled bet (4) returned to IlxxxlI
Player IlxxxlI mucks cards
------ Summary ------
Pot: 5. Rake 0
*Player IlxxxlI mucks (does not show cards). Bets: 2. Collects: 5. Wins: 3.
Player IamPhamous does not show cards.Bets: 1. Collects: 0. Loses: 1.
Player PANDAisEVIL does not show cards.Bets: 2. Collects: 0. Loses: 2.
Player Iia007 does not show cards.Bets: 0. Collects: 0. Wins: 0.
Player AgSweep does not show cards.Bets: 0. Collects: 0. Wins: 0.
Player MadLifeGrinder does not show cards.Bets: 0. Collects: 0. Wins: 0.
Player shokerAAss does not show cards.Bets: 0. Collects: 0. Wins: 0.
Game ended at: 2016/11/29 8:25:32

Game started
Game ID: 786744578 1/2 (PRR) Longana - 2 (Hold'em)
Seat 9 is the button
Seat 1: IlxxxlI (80).
Seat 2: loolu (217.20).
Seat 3: IamPhamous (156.97).
Seat 4: PANDAisEVIL (221.25).
Seat 5: Iia007 (241.81).
Seat 6: AgSweep (172.88).
Seat 7: MadLifeGrinder (200).
Seat 9: shokerAAss (259.21).
Player IlxxxlI has small blind (1)
Player loolu sitting out
Player IamPhamous has big blind (2)
Player IlxxxlI received card: [Ks]
Player IlxxxlI received card: [5h]
Player PANDAisEVIL folds
Player Iia007 folds
Player AgSweep raises (6)
Player MadLifeGrinder folds
Player shokerAAss folds
Player IlxxxlI folds
Player IamPhamous folds
Uncalled bet (4) returned to AgSweep
Player AgSweep mucks cards
------ Summary ------
Pot: 5. Rake 0
Player IlxxxlI does not show cards.Bets: 1. Collects: 0. Loses: 1.
Player loolu does not show cards.Bets: 0. Collects: 0. Wins: 0.
Player IamPhamous does not show cards.Bets: 2. Collects: 0. Loses: 2.
Player PANDAisEVIL does not show cards.Bets: 0. Collects: 0. Wins: 0.
Player Iia007 does not show cards.Bets: 0. Collects: 0. Wins: 0.
*Player AgSweep mucks (does not show cards). Bets: 2. Collects: 5. Wins: 3.
Player MadLifeGrinder does not show cards.Bets: 0. Collects: 0. Wins: 0.
Player shokerAAss does not show cards.Bets: 0. Collects: 0. Wins: 0.
Game ended at: 2016/11/29 8:24:36

Game started
Game ID: 786743962 0.50/1 (PRR) Karkadann (Hold'em)
Seat 8 is the button
Seat 1: PANDAisEVIL (100).
Seat 2: Qrenor (126.49).
Seat 3: IlxxxlI (56.42).
Seat 4: IamPhamous (164.92).
Seat 6: Log_in (35.90).
Seat 7: PeLanpapa (100).
Seat 8: apoo11 (97).
Seat 9: Iia007 (127.82).
Player Iia007 has small blind (0.50)
Player PANDAisEVIL has big blind (1)
Player IlxxxlI received card: [7s]
Player IlxxxlI received card: [Qs]
Player Qrenor raises (3)
Player IlxxxlI folds
Player IamPhamous folds
Player Log_in folds
Player PeLanpapa is timed out.
Player PeLanpapa folds
Player apoo11 folds
Player Iia007 folds
Player PANDAisEVIL folds
Uncalled bet (2) returned to Qrenor
Player Qrenor mucks cards
------ Summary ------
Pot: 2.50. Rake 0
Player PANDAisEVIL does not show cards.Bets: 1. Collects: 0. Loses: 1.
*Player Qrenor mucks (does not show cards). Bets: 1. Collects: 2.50. Wins: 1.50.
Player IlxxxlI does not show cards.Bets: 0. Collects: 0. Wins: 0.
Player IamPhamous does not show cards.Bets: 0. Collects: 0. Wins: 0.
Player Log_in does not show cards.Bets: 0. Collects: 0. Wins: 0.
Player PeLanpapa does not show cards.Bets: 0. Collects: 0. Wins: 0.
Player apoo11 does not show cards.Bets: 0. Collects: 0. Wins: 0.
Player Iia007 does not show cards.Bets: 0.50. Collects: 0. Loses: 0.50.
Game ended at: 2016/11/29 8:24:16

Game started
Game ID: 786743481 1/2 (PRR) Longana - 2 (Hold'em)
Seat 7 is the button
Seat 1: IlxxxlI (80).
Seat 2: loolu (217.20).
Seat 3: IamPhamous (156.97).
Seat 4: PANDAisEVIL (221.25).
Seat 5: Iia007 (261.81).
Seat 6: AgSweep (172.88).
Seat 7: MadLifeGrinder (200).
Seat 9: shokerAAss (239.31).
Player shokerAAss has small blind (1)
Player IlxxxlI has big blind (2)
Player IlxxxlI received card: [2d]
Player IlxxxlI received card: [8d]
Player loolu folds
Player IamPhamous folds
Player PANDAisEVIL folds
Player Iia007 raises (6)
Player AgSweep folds
Player MadLifeGrinder folds
Player shokerAAss raises (19)
Player IlxxxlI folds
Player Iia007 calls (14)
*** FLOP ***: [5s Kh 5c]
Player shokerAAss bets (19.95)
Player Iia007 folds
Uncalled bet (19.95) returned to shokerAAss
Player shokerAAss mucks cards
------ Summary ------
Pot: 39.90. Rake 1.86. JP fee 0.24
Board: [5s Kh 5c]
Player IlxxxlI does not show cards.Bets: 2. Collects: 0. Loses: 2.
Player loolu does not show cards.Bets: 0. Collects: 0. Wins: 0.
Player IamPhamous does not show cards.Bets: 0. Collects: 0. Wins: 0.
Player PANDAisEVIL does not show cards.Bets: 0. Collects: 0. Wins: 0.
Player Iia007 does not show cards.Bets: 20. Collects: 0. Loses: 20.
Player AgSweep does not show cards.Bets: 0. Collects: 0. Wins: 0.
Player MadLifeGrinder does not show cards.Bets: 0. Collects: 0. Wins: 0.
*Player shokerAAss mucks (does not show cards). Bets: 20. Collects: 39.90. Wins: 19.90.
Game ended at: 2016/11/29 8:23:52

Game started
Game ID: 786743284 0.50/1 (PRR) Karkadann (Hold'em)
Seat 7 is the button
Seat 2: Qrenor (126.49).
Seat 3: IlxxxlI (56.42).
Seat 4: IamPhamous (164.92).
Seat 6: Log_in (35.90).
Seat 7: PeLanpapa (100).
Seat 8: apoo11 (99).
Seat 9: Iia007 (125.82).
Player apoo11 has small blind (0.50)
Player Iia007 has big blind (1)
Player IlxxxlI received card: [Qh]
Player IlxxxlI received card: [Jd]
Player Qrenor folds
Player IlxxxlI folds
Player IamPhamous folds
Player Log_in folds
Player PeLanpapa folds
Player apoo11 raises (1.50)
Player Iia007 raises (5)
Player apoo11 folds
Uncalled bet (4) returned to Iia007
Player Iia007 mucks cards
------ Summary ------
Pot: 4. Rake 0
Player Qrenor does not show cards.Bets: 0. Collects: 0. Wins: 0.
Player IlxxxlI does not show cards.Bets: 0. Collects: 0. Wins: 0.
Player IamPhamous does not show cards.Bets: 0. Collects: 0. Wins: 0.
Player Log_in does not show cards.Bets: 0. Collects: 0. Wins: 0.
Player PeLanpapa does not show cards.Bets: 0. Collects: 0. Wins: 0.
Player apoo11 does not show cards.Bets: 2. Collects: 0. Loses: 2.
*Player Iia007 mucks (does not show cards). Bets: 2. Collects: 4. Wins: 2.
Game ended at: 2016/11/29 8:23:14

Game started
Game ID: 786742965 1/2 (PRR) Longana - 2 (Hold'em)
Seat 6 is the button
Seat 1: IlxxxlI (80).
Seat 2: loolu (217.20).
Seat 3: IamPhamous (156.97).
Seat 4: PANDAisEVIL (218.25).
Seat 5: Iia007 (261.81).
Seat 6: AgSweep (172.88).
Seat 7: MadLifeGrinder (200.45).
Seat 9: shokerAAss (241.31).
Player MadLifeGrinder has small blind (1)
Player shokerAAss has big blind (2)
Player IlxxxlI received card: [7d]
Player IlxxxlI received card: [9s]
Player IlxxxlI folds
Player loolu folds
Player IamPhamous folds
Player PANDAisEVIL raises (6)
Player Iia007 folds
Player AgSweep folds
Player MadLifeGrinder folds
Player shokerAAss folds
Uncalled bet (4) returned to PANDAisEVIL
Player PANDAisEVIL mucks cards
------ Summary ------
Pot: 5. Rake 0
Player IlxxxlI does not show cards.Bets: 0. Collects: 0. Wins: 0.
Player loolu does not show cards.Bets: 0. Collects: 0. Wins: 0.
Player IamPhamous does not show cards.Bets: 0. Collects: 0. Wins: 0.
*Player PANDAisEVIL mucks (does not show cards). Bets: 2. Collects: 5. Wins: 3.
Player Iia007 does not show cards.Bets: 0. Collects: 0. Wins: 0.
Player AgSweep does not show cards.Bets: 0. Collects: 0. Wins: 0.
Player MadLifeGrinder does not show cards.Bets: 1. Collects: 0. Loses: 1.
Player shokerAAss does not show cards.Bets: 2. Collects: 0. Loses: 2.
Game ended at: 2016/11/29 8:22:43

Game started
Game ID: 786742769 0.50/1 (PRR) Karkadann - 2 (Hold'em)
Seat 5 is the button
Seat 2: shokerAAss (115.11).
Seat 4: IlxxxlI (75.42).
Seat 5: Iia007 (100).
Seat 8: Qrenor (271.17).
Seat 9: PeLanpapa (195).
Player Qrenor has small blind (0.50)
Player PeLanpapa has big blind (1)
Player IlxxxlI received card: [2c]
Player IlxxxlI received card: [10c]
Player shokerAAss folds
Player IlxxxlI folds
Player Iia007 raises (2)
Player Qrenor calls (1.50)
Player PeLanpapa calls (1)
*** FLOP ***: [Qs 9s 8c]
Player Qrenor checks
Player PeLanpapa checks
Player Iia007 bets (4)
Player Qrenor folds
Player PeLanpapa calls (4)
*** TURN ***: [Qs 9s 8c] [6c]
Player PeLanpapa checks
Player Iia007 bets (20)
Player PeLanpapa raises (100)
Player Iia007 allin (74)
Uncalled bet (6) returned to PeLanpapa
*** RIVER ***: [Qs 9s 8c 6c] [5h]
------ Summary ------
Pot: 199. Rake 2.76. JP fee 0.24
Board: [Qs 9s 8c 6c 5h]
Player shokerAAss does not show cards.Bets: 0. Collects: 0. Wins: 0.
Player IlxxxlI does not show cards.Bets: 0. Collects: 0. Wins: 0.
Player Iia007 shows: One pair of Ks [Kd Kh]. Bets: 100. Collects: 0. Loses: 100.
Player Qrenor does not show cards.Bets: 2. Collects: 0. Loses: 2.
*Player PeLanpapa shows: Straight to Q [10s Js]. Bets: 100. Collects: 199. Wins: 99.
Game ended at: 2016/11/29 8:24:54

Game started
Game ID: 786742499 0.50/1 (PRR) Karkadann (Hold'em)
Seat 6 is the button
Seat 2: Qrenor (126.49).
Seat 3: IlxxxlI (59.92).
Seat 4: IamPhamous (164.92).
Seat 6: Log_in (30.90).
Seat 7: PeLanpapa (100).
Seat 8: apoo11 (100).
Seat 9: Iia007 (125.82).
Player PeLanpapa has small blind (0.50)
Player apoo11 has big blind (1)
Player IlxxxlI received card: [Jd]
Player IlxxxlI received card: [10d]
Player Iia007 folds
Player Qrenor folds
Player IlxxxlI raises (3.50)
Player IamPhamous folds
Player Log_in allin (30.90)
Player PeLanpapa folds
Player apoo11 folds
Player IlxxxlI folds
Uncalled bet (27.40) returned to Log_in
Player Log_in mucks cards
------ Summary ------
Pot: 8.50. Rake 0
Player Qrenor does not show cards.Bets: 0. Collects: 0. Wins: 0.
Player IlxxxlI does not show cards.Bets: 3.50. Collects: 0. Loses: 3.50.
Player IamPhamous does not show cards.Bets: 0. Collects: 0. Wins: 0.
*Player Log_in mucks (does not show cards). Bets: 3.50. Collects: 8.50. Wins: 5.
Player PeLanpapa does not show cards.Bets: 0.50. Collects: 0. Loses: 0.50.
Player apoo11 does not show cards.Bets: 1. Collects: 0. Loses: 1.
Player Iia007 does not show cards.Bets: 0. Collects: 0. Wins: 0.
Game ended at: 2016/11/29 8:22:28

Game started
Game ID: 786742446 0.50/1 (PRR) Karkadann - 2 (Hold'em)
Seat 4 is the button
Seat 2: shokerAAss (113.61).
Seat 4: IlxxxlI (75.42).
Seat 5: Iia007 (100).
Seat 6: Winter is here (202.14).
Seat 8: Qrenor (272.17).
Seat 9: PeLanpapa (195).
Player Iia007 has small blind (0.50)
Player Winter is here sitting out
Player Qrenor has big blind (1)
Player IlxxxlI received card: [7h]
Player IlxxxlI received card: [8s]
Player PeLanpapa folds
Player shokerAAss raises (3)
Player IlxxxlI folds
Player Iia007 folds
Player Qrenor folds
Uncalled bet (2) returned to shokerAAss
Player shokerAAss mucks cards
------ Summary ------
Pot: 2.50. Rake 0
*Player shokerAAss mucks (does not show cards). Bets: 1. Collects: 2.50. Wins: 1.50.
Player IlxxxlI does not show cards.Bets: 0. Collects: 0. Wins: 0.
Player Iia007 does not show cards.Bets: 0.50. Collects: 0. Loses: 0.50.
Player Winter is here does not show cards.Bets: 0. Collects: 0. Wins: 0.
Player Qrenor does not show cards.Bets: 1. Collects: 0. Loses: 1.
Player PeLanpapa does not show cards.Bets: 0. Collects: 0. Wins: 0.
Game ended at: 2016/11/29 8:21:58

Game started
Game ID: 786742045 0.50/1 (PRR) Karkadann (Hold'em)
Seat 4 is the button
Seat 2: Qrenor (126.49).
Seat 3: IlxxxlI (59.92).
Seat 4: IamPhamous (163.42).
Seat 6: Log_in (31.40).
Seat 7: PeLanpapa (100).
Seat 9: Iia007 (125.82).
Player Log_in has small blind (0.50)
Player PeLanpapa has big blind (1)
Player IlxxxlI received card: [9d]
Player IlxxxlI received card: [3d]
Player Iia007 folds
Player Qrenor folds
Player IlxxxlI folds
Player IamPhamous raises (3)
Player Log_in folds
Player PeLanpapa folds
Uncalled bet (2) returned to IamPhamous
Player IamPhamous mucks cards
------ Summary ------
Pot: 2.50. Rake 0
Player Qrenor does not show cards.Bets: 0. Collects: 0. Wins: 0.
Player IlxxxlI does not show cards.Bets: 0. Collects: 0. Wins: 0.
*Player IamPhamous mucks (does not show cards). Bets: 1. Collects: 2.50. Wins: 1.50.
Player Log_in does not show cards.Bets: 0.50. Collects: 0. Loses: 0.50.
Player PeLanpapa does not show cards.Bets: 1. Collects: 0. Loses: 1.
Player Iia007 does not show cards.Bets: 0. Collects: 0. Wins: 0.
Game ended at: 2016/11/29 8:21:41

Game started
Game ID: 786742009 0.50/1 (PRR) Karkadann - 2 (Hold'em)
Seat 2 is the button
Seat 2: shokerAAss (113.61).
Seat 4: IlxxxlI (75.92).
Seat 5: Iia007 (100).
Seat 6: Winter is here (200.64).
Seat 8: Qrenor (272.17).
Seat 9: PeLanpapa (195).
Player IlxxxlI has small blind (0.50)
Player Iia007 has big blind (1)
Player IlxxxlI received card: [2h]
Player IlxxxlI received card: [5d]
Player Winter is here raises (2)
Player Qrenor folds
Player PeLanpapa folds
Player shokerAAss folds
Player IlxxxlI folds
Player Iia007 folds
Uncalled bet (1) returned to Winter is here
Player Winter is here is timed out.
Player Winter is here mucks cards
------ Summary ------
Pot: 2.50. Rake 0
Player shokerAAss does not show cards.Bets: 0. Collects: 0. Wins: 0.
Player IlxxxlI does not show cards.Bets: 0.50. Collects: 0. Loses: 0.50.
Player Iia007 does not show cards.Bets: 1. Collects: 0. Loses: 1.
*Player Winter is here mucks (does not show cards). Bets: 1. Collects: 2.50. Wins: 1.50.
Player Qrenor does not show cards.Bets: 0. Collects: 0. Wins: 0.
Player PeLanpapa does not show cards.Bets: 0. Collects: 0. Wins: 0.
Game ended at: 2016/11/29 8:21:38

Game started
Game ID: 786741610 1/2 (PRR) Longana - 2 (Hold'em)
Seat 5 is the button
Seat 1: IlxxxlI (80).
Seat 2: loolu (217.20).
Seat 3: IamPhamous (156.97).
Seat 4: PANDAisEVIL (209).
Seat 5: Iia007 (261.81).
Seat 6: AgSweep (177.88).
Seat 7: MadLifeGrinder (205.45).
Seat 9: shokerAAss (241.31).
Player AgSweep has small blind (1)
Player MadLifeGrinder has big blind (2)
Player IlxxxlI received card: [6c]
Player IlxxxlI received card: [Jd]
Player shokerAAss folds
Player IlxxxlI folds
Player loolu folds
Player IamPhamous folds
Player PANDAisEVIL raises (5)
Player Iia007 folds
Player AgSweep calls (4)
Player MadLifeGrinder calls (3)
*** FLOP ***: [Jh 10h 3s]
Player AgSweep checks
Player MadLifeGrinder checks
Player PANDAisEVIL bets (8.84)
Player AgSweep folds
Player MadLifeGrinder folds
Uncalled bet (8.84) returned to PANDAisEVIL
Player PANDAisEVIL mucks cards
------ Summary ------
Pot: 14.25. Rake 0.51. JP fee 0.24
Board: [Jh 10h 3s]
Player IlxxxlI does not show cards.Bets: 0. Collects: 0. Wins: 0.
Player loolu does not show cards.Bets: 0. Collects: 0. Wins: 0.
Player IamPhamous does not show cards.Bets: 0. Collects: 0. Wins: 0.
*Player PANDAisEVIL mucks (does not show cards). Bets: 5. Collects: 14.25. Wins: 9.25.
Player Iia007 does not show cards.Bets: 0. Collects: 0. Wins: 0.
Player AgSweep does not show cards.Bets: 5. Collects: 0. Loses: 5.
Player MadLifeGrinder does not show cards.Bets: 5. Collects: 0. Loses: 5.
Player shokerAAss does not show cards.Bets: 0. Collects: 0. Wins: 0.
Game ended at: 2016/11/29 8:22:9

Game started
Game ID: 786741072 1/2 (PRR) Longana - 2 (Hold'em)
Seat 4 is the button
Seat 1: IlxxxlI (80).
Seat 2: loolu (217.20).
Seat 3: IamPhamous (162.97).
Seat 4: PANDAisEVIL (200).
Seat 5: Iia007 (262.81).
Seat 6: AgSweep (179.88).
Seat 7: MadLifeGrinder (205.45).
Seat 9: shokerAAss (241.31).
Player Iia007 has small blind (1)
Player AgSweep has big blind (2)
Player IlxxxlI received card: [6c]
Player IlxxxlI received card: [5c]
Player MadLifeGrinder folds
Player shokerAAss folds
Player IlxxxlI folds
Player loolu folds
Player IamPhamous raises (6)
Player PANDAisEVIL raises (16.02)
Player Iia007 folds
Player AgSweep folds
Player IamPhamous folds
Uncalled bet (10.02) returned to PANDAisEVIL
Player PANDAisEVIL mucks cards
------ Summary ------
Pot: 15. Rake 0
Player IlxxxlI does not show cards.Bets: 0. Collects: 0. Wins: 0.
Player loolu does not show cards.Bets: 0. Collects: 0. Wins: 0.
Player IamPhamous does not show cards.Bets: 6. Collects: 0. Loses: 6.
*Player PANDAisEVIL mucks (does not show cards). Bets: 6. Collects: 15. Wins: 9.
Player Iia007 does not show cards.Bets: 1. Collects: 0. Loses: 1.
Player AgSweep does not show cards.Bets: 2. Collects: 0. Loses: 2.
Player MadLifeGrinder does not show cards.Bets: 0. Collects: 0. Wins: 0.
Player shokerAAss does not show cards.Bets: 0. Collects: 0. Wins: 0.
Game ended at: 2016/11/29 8:20:44

Game started
Game ID: 786740891 0.50/1 (PRR) Karkadann (Hold'em)
Seat 3 is the button
Seat 2: Qrenor (126.49).
Seat 3: IlxxxlI (59.92).
Seat 4: IamPhamous (165.42).
Seat 6: Log_in (29.60).
Seat 7: PeLanpapa (100).
Seat 9: Iia007 (125.82).
Player IamPhamous has small blind (0.50)
Player Log_in has big blind (1)
Player IlxxxlI received card: [4h]
Player IlxxxlI received card: [10s]
Player PeLanpapa folds
Player Iia007 folds
Player Qrenor folds
Player IlxxxlI folds
Player IamPhamous raises (1.50)
Player Log_in calls (1)
*** FLOP ***: [Ad 10h Ks]
Player IamPhamous checks
Player Log_in checks
*** TURN ***: [Ad 10h Ks] [3s]
Player IamPhamous checks
Player Log_in bets (1.90)
Player IamPhamous folds
Uncalled bet (1.90) returned to Log_in
Player Log_in mucks cards
------ Summary ------
Pot: 3.80. Rake 0.14. JP fee 0.06
Board: [Ad 10h Ks 3s]
Player Qrenor does not show cards.Bets: 0. Collects: 0. Wins: 0.
Player IlxxxlI does not show cards.Bets: 0. Collects: 0. Wins: 0.
Player IamPhamous does not show cards.Bets: 2. Collects: 0. Loses: 2.
*Player Log_in mucks (does not show cards). Bets: 2. Collects: 3.80. Wins: 1.80.
Player PeLanpapa does not show cards.Bets: 0. Collects: 0. Wins: 0.
Player Iia007 does not show cards.Bets: 0. Collects: 0. Wins: 0.
Game ended at: 2016/11/29 8:21:10

Game started
Game ID: 786740630 0.50/1 (PRR) Karkadann - 2 (Hold'em)
Seat 1 is the button
Seat 1: SoMeFarmer (102.50).
Seat 2: shokerAAss (114.11).
Seat 4: IlxxxlI (63.06).
Seat 5: Iia007 (100).
Seat 6: Winter is here (200.64).
Seat 8: Qrenor (272.17).
Seat 9: PeLanpapa (198).
Player shokerAAss has small blind (0.50)
Player IlxxxlI has big blind (1)
Player IlxxxlI received card: [Qs]
Player IlxxxlI received card: [Ad]
Player Iia007 folds
Player Winter is here folds
Player Qrenor folds
Player PeLanpapa raises (3)
Player SoMeFarmer calls (3)
Player shokerAAss folds
Player IlxxxlI raises (9.59)
Player PeLanpapa folds
Player SoMeFarmer calls (7.59)
*** FLOP ***: [As 4d Kd]
Player IlxxxlI bets (7.81)
Player SoMeFarmer is timed out.
Player SoMeFarmer folds
Uncalled bet (7.81) returned to IlxxxlI
Player IlxxxlI mucks cards
------ Summary ------
Pot: 23.45. Rake 0.99. JP fee 0.24
Board: [As 4d Kd]
Player SoMeFarmer does not show cards.Bets: 10.59. Collects: 0. Loses: 10.59.
Player shokerAAss does not show cards.Bets: 0.50. Collects: 0. Loses: 0.50.
*Player IlxxxlI mucks (does not show cards). Bets: 10.59. Collects: 23.45. Wins: 12.86.
Player Iia007 does not show cards.Bets: 0. Collects: 0. Wins: 0.
Player Winter is here does not show cards.Bets: 0. Collects: 0. Wins: 0.
Player Qrenor does not show cards.Bets: 0. Collects: 0. Wins: 0.
Player PeLanpapa does not show cards.Bets: 3. Collects: 0. Loses: 3.
Game ended at: 2016/11/29 8:21:8

Game started
Game ID: 786740232 1/2 (PRR) Longana - 2 (Hold'em)
Seat 3 is the button
Seat 1: IlxxxlI (80).
Seat 2: loolu (217.20).
Seat 3: IamPhamous (162.97).
Seat 4: PANDAisEVIL (200).
Seat 5: Iia007 (264.81).
Seat 6: AgSweep (193).
Seat 7: MadLifeGrinder (205.45).
Seat 9: shokerAAss (226.65).
Player PANDAisEVIL has small blind (1)
Player Iia007 has big blind (2)
Player IlxxxlI received card: [10s]
Player IlxxxlI received card: [7c]
Player AgSweep raises (6)
Player MadLifeGrinder folds
Player shokerAAss calls (6)
Player IlxxxlI folds
Player loolu folds
Player IamPhamous folds
Player PANDAisEVIL folds
Player Iia007 folds
*** FLOP ***: [9h 10d 9c]
Player AgSweep checks
Player shokerAAss checks
*** TURN ***: [9h 10d 9c] [8h]
Player AgSweep checks
Player shokerAAss bets (7.12)
Player AgSweep calls (7.12)
*** RIVER ***: [9h 10d 9c 8h] [8c]
Player AgSweep checks
Player shokerAAss checks
Player AgSweep mucks cards
------ Summary ------
Pot: 27.78. Rake 1.22. JP fee 0.24
Board: [9h 10d 9c 8h 8c]
Player IlxxxlI does not show cards.Bets: 0. Collects: 0. Wins: 0.
Player loolu does not show cards.Bets: 0. Collects: 0. Wins: 0.
Player IamPhamous does not show cards.Bets: 0. Collects: 0. Wins: 0.
Player PANDAisEVIL does not show cards.Bets: 1. Collects: 0. Loses: 1.
Player Iia007 does not show cards.Bets: 2. Collects: 0. Loses: 2.
Player AgSweep mucks (does not show cards). Bets: 13.12. Collects: 0. Loses: 13.12.
Player MadLifeGrinder does not show cards.Bets: 0. Collects: 0. Wins: 0.
*Player shokerAAss shows: Two pairs. 9s and 8s [Ad Qs]. Bets: 13.12. Collects: 27.78. Wins: 14.66.
Game ended at: 2016/11/29 8:20:6

Game started
Game ID: 786739724 0.50/1 (PRR) Karkadann (Hold'em)
Seat 2 is the button
Seat 2: Qrenor (126.49).
Seat 3: IlxxxlI (40).
Seat 4: IamPhamous (166.42).
Seat 6: Log_in (29.60).
Seat 7: PeLanpapa (100).
Seat 9: Iia007 (146.89).
Player IlxxxlI has small blind (0.50)
Player IamPhamous has big blind (1)
Player IlxxxlI received card: [4c]
Player IlxxxlI received card: [4s]
Player Log_in folds
Player PeLanpapa folds
Player Iia007 raises (3)
Player Qrenor folds
Player IlxxxlI raises (7.09)
Player IamPhamous folds
Player Iia007 calls (4.59)
*** FLOP ***: [4h 3d 6s]
Player IlxxxlI bets (5.12)
Player Iia007 calls (5.12)
*** TURN ***: [4h 3d 6s] [7h]
Player IlxxxlI checks
Player Iia007 bets (8.36)
Player IlxxxlI calls (8.36)
*** RIVER ***: [4h 3d 6s 7h] [6h]
Player IlxxxlI allin (18.93)
Player Iia007 folds
Uncalled bet (18.93) returned to IlxxxlI
Player IlxxxlI mucks cards
------ Summary ------
Pot: 40.99. Rake 1.91. JP fee 0.24
Board: [4h 3d 6s 7h 6h]
Player Qrenor does not show cards.Bets: 0. Collects: 0. Wins: 0.
*Player IlxxxlI mucks (does not show cards). Bets: 21.07. Collects: 40.99. Wins: 19.92.
Player IamPhamous does not show cards.Bets: 1. Collects: 0. Loses: 1.
Player Log_in does not show cards.Bets: 0. Collects: 0. Wins: 0.
Player PeLanpapa does not show cards.Bets: 0. Collects: 0. Wins: 0.
Player Iia007 does not show cards.Bets: 21.07. Collects: 0. Loses: 21.07.
Game ended at: 2016/11/29 8:19:57

Game started
Game ID: 786739184 0.50/1 (PRR) Karkadann (Hold'em)
Seat 9 is the button
Seat 2: Qrenor (126.99).
Seat 3: IlxxxlI (40).
Seat 4: IamPhamous (164.92).
Seat 5: coldkilla (37).
Seat 6: Log_in (29.60).
Seat 7: PeLanpapa (100).
Seat 9: Iia007 (146.89).
Player Qrenor has small blind (0.50)
Player IlxxxlI has big blind (1)
Player IlxxxlI received card: [Kd]
Player IlxxxlI received card: [Js]
Player IamPhamous raises (3)
Player coldkilla folds
Player Log_in folds
Player PeLanpapa folds
Player Iia007 folds
Player Qrenor folds
Player IlxxxlI folds
Uncalled bet (2) returned to IamPhamous
Player IamPhamous mucks cards
------ Summary ------
Pot: 2.50. Rake 0
Player Qrenor does not show cards.Bets: 0.50. Collects: 0. Loses: 0.50.
Player IlxxxlI does not show cards.Bets: 1. Collects: 0. Loses: 1.
*Player IamPhamous mucks (does not show cards). Bets: 1. Collects: 2.50. Wins: 1.50.
Player coldkilla does not show cards.Bets: 0. Collects: 0. Wins: 0.
Player Log_in does not show cards.Bets: 0. Collects: 0. Wins: 0.
Player PeLanpapa does not show cards.Bets: 0. Collects: 0. Wins: 0.
Player Iia007 does not show cards.Bets: 0. Collects: 0. Wins: 0.
Game ended at: 2016/11/29 8:18:37

Game started
Game ID: 786739033 1/2 (PRR) Longana - 2 (Hold'em)
Seat 2 is the button
Seat 1: IlxxxlI (80).
Seat 2: loolu (217.20).
Seat 3: IamPhamous (163.97).
Seat 4: PANDAisEVIL (200).
Seat 5: Iia007 (264.81).
Seat 6: AgSweep (200).
Seat 7: MadLifeGrinder (205.45).
Seat 9: shokerAAss (217.50).
Player IamPhamous has small blind (1)
Player PANDAisEVIL has big blind (2)
Player AgSweep posts (2)
Player IlxxxlI received card: [8d]
Player IlxxxlI received card: [9d]
Player Iia007 folds
Player AgSweep checks
Player MadLifeGrinder folds
Player shokerAAss raises (7)
Player IlxxxlI folds
Player loolu folds
Player IamPhamous folds
Player PANDAisEVIL folds
Player AgSweep calls (5)
*** FLOP ***: [3d Qd 4c]
Player AgSweep checks
Player shokerAAss bets (10)
Player AgSweep folds
Uncalled bet (10) returned to shokerAAss
Player shokerAAss mucks cards
------ Summary ------
Pot: 16.15. Rake 0.61. JP fee 0.24
Board: [3d Qd 4c]
Player IlxxxlI does not show cards.Bets: 0. Collects: 0. Wins: 0.
Player loolu does not show cards.Bets: 0. Collects: 0. Wins: 0.
Player IamPhamous does not show cards.Bets: 1. Collects: 0. Loses: 1.
Player PANDAisEVIL does not show cards.Bets: 2. Collects: 0. Loses: 2.
Player Iia007 does not show cards.Bets: 0. Collects: 0. Wins: 0.
Player AgSweep does not show cards.Bets: 7. Collects: 0. Loses: 7.
Player MadLifeGrinder does not show cards.Bets: 0. Collects: 0. Wins: 0.
*Player shokerAAss mucks (does not show cards). Bets: 7. Collects: 16.15. Wins: 9.15.
Game ended at: 2016/11/29 8:19:12

Game started
Game ID: 786738141 1/2 (PRR) Longana - 2 (Hold'em)
Seat 1 is the button
Seat 1: IlxxxlI (80).
Seat 2: loolu (223.20).
Seat 3: IamPhamous (158.57).
Seat 4: PANDAisEVIL (200).
Seat 5: Iia007 (264.81).
Seat 6: AgSweep (200).
Seat 7: MadLifeGrinder (205.45).
Seat 9: shokerAAss (217.50).
Player loolu has small blind (1)
Player IamPhamous has big blind (2)
Player AgSweep is timed out.
Player AgSweep wait BB
Player IlxxxlI received card: [7c]
Player IlxxxlI received card: [Jh]
Player PANDAisEVIL folds
Player Iia007 folds
Player MadLifeGrinder folds
Player shokerAAss folds
Player IlxxxlI folds
Player loolu raises (5)
Player IamPhamous calls (4)
*** FLOP ***: [2s Jc Ad]
Player loolu checks
Player IamPhamous bets (5.70)
Player loolu folds
Uncalled bet (5.70) returned to IamPhamous
Player IamPhamous mucks cards
------ Summary ------
Pot: 11.40. Rake 0.40. JP fee 0.20
Board: [2s Jc Ad]
Player IlxxxlI does not show cards.Bets: 0. Collects: 0. Wins: 0.
Player loolu does not show cards.Bets: 6. Collects: 0. Loses: 6.
*Player IamPhamous mucks (does not show cards). Bets: 6. Collects: 11.40. Wins: 5.40.
Player PANDAisEVIL does not show cards.Bets: 0. Collects: 0. Wins: 0.
Player Iia007 does not show cards.Bets: 0. Collects: 0. Wins: 0.
Player AgSweep does not show cards.Bets: 0. Collects: 0. Wins: 0.
Player MadLifeGrinder does not show cards.Bets: 0. Collects: 0. Wins: 0.
Player shokerAAss does not show cards.Bets: 0. Collects: 0. Wins: 0.
Game ended at: 2016/11/29 8:17:53

Game started
Game ID: 786738017 0.50/1 (PRR) Karkadann (Hold'em)
Seat 7 is the button
Seat 2: Qrenor (127.99).
Seat 3: IlxxxlI (40).
Seat 4: IamPhamous (167.92).
Seat 5: coldkilla (32.87).
Seat 6: Log_in (29.60).
Seat 7: PeLanpapa (100).
Seat 9: Iia007 (147.39).
Player Iia007 has small blind (0.50)
Player Qrenor has big blind (1)
Player IlxxxlI received card: [Kh]
Player IlxxxlI received card: [2c]
Player IlxxxlI folds
Player IamPhamous raises (3)
Player coldkilla calls (3)
Player Log_in folds
Player PeLanpapa folds
Player Iia007 folds
Player Qrenor folds
*** FLOP ***: [3h 6c 4c]
Player IamPhamous checks
Player coldkilla checks
*** TURN ***: [3h 6c 4c] [9d]
Player IamPhamous checks
Player coldkilla bets (4.75)
Player IamPhamous folds
Uncalled bet (4.75) returned to coldkilla
Player coldkilla mucks cards
------ Summary ------
Pot: 7.13. Rake 0.25. JP fee 0.12
Board: [3h 6c 4c 9d]
Player Qrenor does not show cards.Bets: 1. Collects: 0. Loses: 1.
Player IlxxxlI does not show cards.Bets: 0. Collects: 0. Wins: 0.
Player IamPhamous does not show cards.Bets: 3. Collects: 0. Loses: 3.
*Player coldkilla mucks (does not show cards). Bets: 3. Collects: 7.13. Wins: 4.13.
Player Log_in does not show cards.Bets: 0. Collects: 0. Wins: 0.
Player PeLanpapa does not show cards.Bets: 0. Collects: 0. Wins: 0.
Player Iia007 does not show cards.Bets: 0.50. Collects: 0. Loses: 0.50.
Game ended at: 2016/11/29 8:18:3

Game started
Game ID: 786737233 1/2 (PRR) Longana - 2 (Hold'em)
Seat 9 is the button
Seat 1: IlxxxlI (80).
Seat 2: loolu (228.20).
Seat 3: IamPhamous (158.57).
Seat 4: PANDAisEVIL (200).
Seat 5: Iia007 (264.81).
Seat 6: AgSweep (200).
Seat 7: MadLifeGrinder (205.45).
Seat 9: shokerAAss (212.05).
Player IlxxxlI has small blind (1)
Player loolu has big blind (2)
Player AgSweep is timed out.
Player AgSweep wait BB
Player IlxxxlI received card: [3d]
Player IlxxxlI received card: [4c]
Player IamPhamous folds
Player PANDAisEVIL folds
Player Iia007 folds
Player MadLifeGrinder folds
Player shokerAAss raises (5)
Player IlxxxlI folds
Player loolu calls (3)
*** FLOP ***: [9s 5s 9c]
Player loolu checks
Player shokerAAss checks
*** TURN ***: [9s 5s 9c] [2h]
Player loolu checks
Player shokerAAss bets (6)
Player loolu folds
Uncalled bet (6) returned to shokerAAss
Player shokerAAss mucks cards
------ Summary ------
Pot: 10.45. Rake 0.37. JP fee 0.18
Board: [9s 5s 9c 2h]
Player IlxxxlI does not show cards.Bets: 1. Collects: 0. Loses: 1.
Player loolu does not show cards.Bets: 5. Collects: 0. Loses: 5.
Player IamPhamous does not show cards.Bets: 0. Collects: 0. Wins: 0.
Player PANDAisEVIL does not show cards.Bets: 0. Collects: 0. Wins: 0.
Player Iia007 does not show cards.Bets: 0. Collects: 0. Wins: 0.
Player AgSweep does not show cards.Bets: 0. Collects: 0. Wins: 0.
Player MadLifeGrinder does not show cards.Bets: 0. Collects: 0. Wins: 0.
*Player shokerAAss mucks (does not show cards). Bets: 5. Collects: 10.45. Wins: 5.45.
Game ended at: 2016/11/29 8:16:55

Game started
Game ID: 786736904 0.50/1 (PRR) Karkadann (Hold'em)
Seat 6 is the button
Seat 2: Qrenor (122.03).
Seat 3: IlxxxlI (40).
Seat 4: IamPhamous (167.92).
Seat 5: coldkilla (32.87).
Seat 6: Log_in (29.60).
Seat 7: PeLanpapa (100).
Seat 8: St3p04ka (119.93).
Seat 9: Iia007 (153.48).
Player PeLanpapa has small blind (0.50)
Player St3p04ka sitting out
Player Iia007 has big blind (1)
Player IlxxxlI received card: [10s]
Player IlxxxlI received card: [2d]
Player Qrenor raises (3)
Player IlxxxlI folds
Player IamPhamous folds
Player coldkilla folds
Player Log_in folds
Player PeLanpapa folds
Player Iia007 calls (2)
*** FLOP ***: [Kc 3h 2s]
Player Iia007 checks
Player Qrenor bets (3.09)
Player Iia007 calls (3.09)
*** TURN ***: [Kc 3h 2s] [8h]
Player Iia007 checks
Player Qrenor bets (10)
Player Iia007 folds
Uncalled bet (10) returned to Qrenor
Player Qrenor mucks cards
------ Summary ------
Pot: 12.05. Rake 0.43. JP fee 0.20
Board: [Kc 3h 2s 8h]
*Player Qrenor mucks (does not show cards). Bets: 6.09. Collects: 12.05. Wins: 5.96.
Player IlxxxlI does not show cards.Bets: 0. Collects: 0. Wins: 0.
Player IamPhamous does not show cards.Bets: 0. Collects: 0. Wins: 0.
Player coldkilla does not show cards.Bets: 0. Collects: 0. Wins: 0.
Player Log_in does not show cards.Bets: 0. Collects: 0. Wins: 0.
Player PeLanpapa does not show cards.Bets: 0.50. Collects: 0. Loses: 0.50.
Player St3p04ka does not show cards.Bets: 0. Collects: 0. Wins: 0.
Player Iia007 does not show cards.Bets: 6.09. Collects: 0. Loses: 6.09.
Game ended at: 2016/11/29 8:16:48

Game started
Game ID: 786736588 1/2 (PRR) Longana - 2 (Hold'em)
Seat 7 is the button
Seat 1: IlxxxlI (80.98).
Seat 2: loolu (228.20).
Seat 3: IamPhamous (158.57).
Seat 4: PANDAisEVIL (200).
Seat 5: Iia007 (264.81).
Seat 7: MadLifeGrinder (200).
Seat 9: shokerAAss (213.05).
Player shokerAAss has small blind (1)
Player IlxxxlI has big blind (2)
Player IlxxxlI received card: [10h]
Player IlxxxlI received card: [Js]
Player loolu folds
Player IamPhamous folds
Player PANDAisEVIL folds
Player Iia007 folds
Player MadLifeGrinder raises (5)
Player shokerAAss folds
Player IlxxxlI calls (3)
*** FLOP ***: [6c 5c 5h]
Player IlxxxlI checks
Player MadLifeGrinder bets (5.22)
Player IlxxxlI folds
Uncalled bet (5.22) returned to MadLifeGrinder
Player MadLifeGrinder mucks cards
------ Summary ------
Pot: 10.45. Rake 0.37. JP fee 0.18
Board: [6c 5c 5h]
Player IlxxxlI does not show cards.Bets: 5. Collects: 0. Loses: 5.
Player loolu does not show cards.Bets: 0. Collects: 0. Wins: 0.
Player IamPhamous does not show cards.Bets: 0. Collects: 0. Wins: 0.
Player PANDAisEVIL does not show cards.Bets: 0. Collects: 0. Wins: 0.
Player Iia007 does not show cards.Bets: 0. Collects: 0. Wins: 0.
*Player MadLifeGrinder mucks (does not show cards). Bets: 5. Collects: 10.45. Wins: 5.45.
Player shokerAAss does not show cards.Bets: 1. Collects: 0. Loses: 1.
Game ended at: 2016/11/29 8:15:55

Game started
Game ID: 786736571 0.50/1 (PRR) Kraken (short) (Hold'em)
Seat 4 is the button
Seat 2: AironVega (50).
Seat 4: IlxxxlI (21).
Player IlxxxlI has small blind (0.50)
Player AironVega has big blind (1)
Player IlxxxlI received card: [9h]
Player IlxxxlI received card: [8d]
Player IlxxxlI calls (0.50)
Player AironVega checks
*** FLOP ***: [Ah 3h Ks]
Player AironVega checks
Player IlxxxlI bets (1.26)
Player AironVega folds
Uncalled bet (1.26) returned to IlxxxlI
Player IlxxxlI mucks cards
------ Summary ------
Pot: 1.90. Rake 0.08. JP fee 0.02
Board: [Ah 3h Ks]
Player AironVega does not show cards.Bets: 1. Collects: 0. Loses: 1.
*Player IlxxxlI mucks (does not show cards). Bets: 1. Collects: 1.90. Wins: 0.90.
Game ended at: 2016/11/29 8:15:51

Game started
Game ID: 786736211 0.50/1 (PRR) Kraken (short) (Hold'em)
Seat 5 is the button
Seat 1: mr.fargo (41.55).
Seat 3: PANDAisEVIL (54.60).
Seat 4: IlxxxlI (20.50).
Seat 5: Qrenor (86.70).
Player mr.fargo has small blind (0.50)
Player PANDAisEVIL sitting out
Player IlxxxlI has big blind (1)
Player IlxxxlI received card: [3s]
Player IlxxxlI received card: [As]
Player Qrenor folds
Player mr.fargo folds
Uncalled bet (0.50) returned to IlxxxlI
Player IlxxxlI mucks cards
------ Summary ------
Pot: 1. Rake 0
Player mr.fargo does not show cards.Bets: 0.50. Collects: 0. Loses: 0.50.
Player PANDAisEVIL does not show cards.Bets: 0. Collects: 0. Wins: 0.
*Player IlxxxlI mucks (does not show cards). Bets: 0.50. Collects: 1. Wins: 0.50.
Player Qrenor does not show cards.Bets: 0. Collects: 0. Wins: 0.
Game ended at: 2016/11/29 8:15:5

Game started
Game ID: 786736151 1/2 (PRR) Longana - 2 (Hold'em)
Seat 5 is the button
Seat 1: IlxxxlI (80.98).
Seat 2: loolu (225.20).
Seat 3: IamPhamous (158.57).
Seat 4: PANDAisEVIL (200).
Seat 5: Iia007 (264.81).
Seat 7: MadLifeGrinder (200).
Seat 9: shokerAAss (215.05).
Player MadLifeGrinder has small blind (1)
Player shokerAAss has big blind (2)
Player IlxxxlI received card: [Qh]
Player IlxxxlI received card: [6s]
Player IlxxxlI folds
Player loolu raises (6)
Player IamPhamous folds
Player PANDAisEVIL folds
Player Iia007 folds
Player MadLifeGrinder folds
Player shokerAAss folds
Uncalled bet (4) returned to loolu
Player loolu mucks cards
------ Summary ------
Pot: 5. Rake 0
Player IlxxxlI does not show cards.Bets: 0. Collects: 0. Wins: 0.
*Player loolu mucks (does not show cards). Bets: 2. Collects: 5. Wins: 3.
Player IamPhamous does not show cards.Bets: 0. Collects: 0. Wins: 0.
Player PANDAisEVIL does not show cards.Bets: 0. Collects: 0. Wins: 0.
Player Iia007 does not show cards.Bets: 0. Collects: 0. Wins: 0.
Player MadLifeGrinder does not show cards.Bets: 1. Collects: 0. Loses: 1.
Player shokerAAss does not show cards.Bets: 2. Collects: 0. Loses: 2.
Game ended at: 2016/11/29 8:15:11

Game started
Game ID: 786735426 0.50/1 (PRR) Kraken (short) (Hold'em)
Seat 3 is the button
Seat 2: St3p04ka (44.90).
Seat 3: PANDAisEVIL (54.60).
Seat 4: IlxxxlI (21).
Seat 5: Qrenor (85.20).
Seat 6: badboy85 (95.68).
Player IlxxxlI has small blind (0.50)
Player Qrenor has big blind (1)
Player IlxxxlI received card: [4c]
Player IlxxxlI received card: [6d]
Player badboy85 folds
Player St3p04ka folds
Player PANDAisEVIL folds
Player IlxxxlI folds
Uncalled bet (0.50) returned to Qrenor
Player Qrenor mucks cards
------ Summary ------
Pot: 1. Rake 0
Player St3p04ka does not show cards.Bets: 0. Collects: 0. Wins: 0.
Player PANDAisEVIL does not show cards.Bets: 0. Collects: 0. Wins: 0.
Player IlxxxlI does not show cards.Bets: 0.50. Collects: 0. Loses: 0.50.
*Player Qrenor mucks (does not show cards). Bets: 0.50. Collects: 1. Wins: 0.50.
Player badboy85 does not show cards.Bets: 0. Collects: 0. Wins: 0.
Game ended at: 2016/11/29 8:14:6

Game started
Game ID: 786735183 0.50/1 (PRR) Karkadann (Hold'em)
Seat 5 is the button
Seat 2: Qrenor (124.53).
Seat 3: IlxxxlI (40).
Seat 4: IamPhamous (151.30).
Seat 5: coldkilla (32.87).
Seat 6: Log_in (30.10).
Seat 7: PeLanpapa (104.07).
Seat 8: St3p04ka (119.93).
Seat 9: Iia007 (153.48).
Player Log_in has small blind (0.50)
Player PeLanpapa has big blind (1)
Player IlxxxlI received card: [Qd]
Player IlxxxlI received card: [7d]
Player St3p04ka folds
Player Iia007 folds
Player Qrenor raises (2.50)
Player IlxxxlI folds
Player IamPhamous calls (2.50)
Player coldkilla folds
Player Log_in folds
Player PeLanpapa calls (1.50)
*** FLOP ***: [9d 5d 9s]
Player PeLanpapa checks
Player Qrenor checks
Player IamPhamous checks
*** TURN ***: [9d 5d 9s] [3h]
Player PeLanpapa bets (3.80)
Player Qrenor folds
Player IamPhamous calls (3.80)
*** RIVER ***: [9d 5d 9s 3h] [4d]
Player PeLanpapa bets (9)
Player IamPhamous raises (27)
Player PeLanpapa folds
Uncalled bet (18) returned to IamPhamous
Player IamPhamous mucks cards
------ Summary ------
Pot: 31.92. Rake 1.44. JP fee 0.24
Board: [9d 5d 9s 3h 4d]
Player Qrenor does not show cards.Bets: 2.50. Collects: 0. Loses: 2.50.
Player IlxxxlI does not show cards.Bets: 0. Collects: 0. Wins: 0.
*Player IamPhamous mucks (does not show cards). Bets: 15.30. Collects: 31.92. Wins: 16.62.
Player coldkilla does not show cards.Bets: 0. Collects: 0. Wins: 0.
Player Log_in does not show cards.Bets: 0.50. Collects: 0. Loses: 0.50.
Player PeLanpapa does not show cards.Bets: 15.30. Collects: 0. Loses: 15.30.
Player St3p04ka does not show cards.Bets: 0. Collects: 0. Wins: 0.
Player Iia007 does not show cards.Bets: 0. Collects: 0. Wins: 0.
Game ended at: 2016/11/29 8:15:33

Game started
Game ID: 786734874 1/2 (PRR) Longana - 2 (Hold'em)
Seat 3 is the button
Seat 1: IlxxxlI (80.98).
Seat 2: loolu (225.20).
Seat 3: IamPhamous (164.57).
Seat 4: PANDAisEVIL (201).
Seat 5: Iia007 (264.81).
Seat 6: Gronkowski69 (300.25).
Seat 9: shokerAAss (203).
Player PANDAisEVIL has small blind (1)
Player Iia007 has big blind (2)
Player IlxxxlI received card: [Ah]
Player IlxxxlI received card: [6c]
Player Gronkowski69 folds
Player shokerAAss folds
Player IlxxxlI folds
Player loolu folds
Player IamPhamous folds
Player PANDAisEVIL folds
Uncalled bet (1) returned to Iia007
Player Iia007 mucks cards
------ Summary ------
Pot: 2. Rake 0
Player IlxxxlI does not show cards.Bets: 0. Collects: 0. Wins: 0.
Player loolu does not show cards.Bets: 0. Collects: 0. Wins: 0.
Player IamPhamous does not show cards.Bets: 0. Collects: 0. Wins: 0.
Player PANDAisEVIL does not show cards.Bets: 1. Collects: 0. Loses: 1.
*Player Iia007 mucks (does not show cards). Bets: 1. Collects: 2. Wins: 1.
Player Gronkowski69 does not show cards.Bets: 0. Collects: 0. Wins: 0.
Player shokerAAss does not show cards.Bets: 0. Collects: 0. Wins: 0.
Game ended at: 2016/11/29 8:13:36

Game started
Game ID: 786734555 1/2 (PRR) Longana - 2 (Hold'em)
Seat 2 is the button
Seat 1: IlxxxlI (80.98).
Seat 2: loolu (225.20).
Seat 3: IamPhamous (165.57).
Seat 4: PANDAisEVIL (200).
Seat 5: Iia007 (264.81).
Seat 6: Gronkowski69 (300.25).
Seat 9: shokerAAss (203).
Player IamPhamous has small blind (1)
Player PANDAisEVIL has big blind (2)
Player IlxxxlI received card: [Qs]
Player IlxxxlI received card: [8d]
Player Iia007 folds
Player Gronkowski69 folds
Player shokerAAss folds
Player IlxxxlI folds
Player loolu folds
Player IamPhamous folds
Uncalled bet (1) returned to PANDAisEVIL
Player PANDAisEVIL mucks cards
------ Summary ------
Pot: 2. Rake 0
Player IlxxxlI does not show cards.Bets: 0. Collects: 0. Wins: 0.
Player loolu does not show cards.Bets: 0. Collects: 0. Wins: 0.
Player IamPhamous does not show cards.Bets: 1. Collects: 0. Loses: 1.
*Player PANDAisEVIL mucks (does not show cards). Bets: 1. Collects: 2. Wins: 1.
Player Iia007 does not show cards.Bets: 0. Collects: 0. Wins: 0.
Player Gronkowski69 does not show cards.Bets: 0. Collects: 0. Wins: 0.
Player shokerAAss does not show cards.Bets: 0. Collects: 0. Wins: 0.
Game ended at: 2016/11/29 8:13:19

Game started
Game ID: 786734327 0.50/1 (PRR) Kraken (short) (Hold'em)
Seat 2 is the button
Seat 2: St3p04ka (48).
Seat 3: PANDAisEVIL (50.50).
Seat 4: IlxxxlI (22).
Seat 5: Qrenor (85.20).
Seat 6: badboy85 (95.68).
Player PANDAisEVIL has small blind (0.50)
Player IlxxxlI has big blind (1)
Player IlxxxlI received card: [Js]
Player IlxxxlI received card: [4h]
Player Qrenor folds
Player badboy85 folds
Player St3p04ka raises (3.10)
Player PANDAisEVIL raises (8.90)
Player IlxxxlI folds
Player St3p04ka folds
Uncalled bet (6.30) returned to PANDAisEVIL
Player PANDAisEVIL mucks cards
------ Summary ------
Pot: 7.20. Rake 0
Player St3p04ka does not show cards.Bets: 3.10. Collects: 0. Loses: 3.10.
*Player PANDAisEVIL mucks (does not show cards). Bets: 3.10. Collects: 7.20. Wins: 4.10.
Player IlxxxlI does not show cards.Bets: 1. Collects: 0. Loses: 1.
Player Qrenor does not show cards.Bets: 0. Collects: 0. Wins: 0.
Player badboy85 does not show cards.Bets: 0. Collects: 0. Wins: 0.
Game ended at: 2016/11/29 8:13:56

Game started
Game ID: 786734057 0.50/1 (PRR) Kraken (short) (Hold'em)
Seat 6 is the button
Seat 2: St3p04ka (48.50).
Seat 3: PANDAisEVIL (50).
Seat 4: IlxxxlI (22).
Seat 5: Qrenor (85.20).
Seat 6: badboy85 (95.68).
Player St3p04ka has small blind (0.50)
Player PANDAisEVIL has big blind (1)
Player IlxxxlI received card: [Jc]
Player IlxxxlI received card: [3d]
Player IlxxxlI folds
Player Qrenor folds
Player badboy85 folds
Player St3p04ka folds
Uncalled bet (0.50) returned to PANDAisEVIL
Player PANDAisEVIL mucks cards
------ Summary ------
Pot: 1. Rake 0
Player St3p04ka does not show cards.Bets: 0.50. Collects: 0. Loses: 0.50.
*Player PANDAisEVIL mucks (does not show cards). Bets: 0.50. Collects: 1. Wins: 0.50.
Player IlxxxlI does not show cards.Bets: 0. Collects: 0. Wins: 0.
Player Qrenor does not show cards.Bets: 0. Collects: 0. Wins: 0.
Player badboy85 does not show cards.Bets: 0. Collects: 0. Wins: 0.
Game ended at: 2016/11/29 8:12:44

Game started
Game ID: 786733540 0.50/1 (PRR) Karkadann (Hold'em)
Seat 4 is the button
Seat 1: aleaga (109.15).
Seat 2: Qrenor (118.07).
Seat 3: IlxxxlI (45.55).
Seat 4: IamPhamous (151.30).
Seat 5: coldkilla (33.37).
Seat 6: Log_in (31.10).
Seat 7: PeLanpapa (104.07).
Seat 8: St3p04ka (119.93).
Seat 9: Iia007 (153.48).
Player coldkilla has small blind (0.50)
Player Log_in has big blind (1)
Player IlxxxlI received card: [6d]
Player IlxxxlI received card: [6h]
Player PeLanpapa folds
Player St3p04ka folds
Player Iia007 folds
Player aleaga is timed out.
Player aleaga folds
Player Qrenor raises (2.50)
Player IlxxxlI calls (2.50)
Player IamPhamous folds
Player coldkilla folds
Player Log_in folds
*** FLOP ***: [Jd Qs Jc]
Player Qrenor bets (3.09)
Player IlxxxlI calls (3.09)
*** TURN ***: [Jd Qs Jc] [Ad]
Player Qrenor bets (7)
Player IlxxxlI folds
Uncalled bet (7) returned to Qrenor
Player Qrenor mucks cards
------ Summary ------
Pot: 12.05. Rake 0.43. JP fee 0.20
Board: [Jd Qs Jc Ad]
Player aleaga does not show cards.Bets: 0. Collects: 0. Wins: 0.
*Player Qrenor mucks (does not show cards). Bets: 5.59. Collects: 12.05. Wins: 6.46.
Player IlxxxlI does not show cards.Bets: 5.59. Collects: 0. Loses: 5.59.
Player IamPhamous does not show cards.Bets: 0. Collects: 0. Wins: 0.
Player coldkilla does not show cards.Bets: 0.50. Collects: 0. Loses: 0.50.
Player Log_in does not show cards.Bets: 1. Collects: 0. Loses: 1.
Player PeLanpapa does not show cards.Bets: 0. Collects: 0. Wins: 0.
Player St3p04ka does not show cards.Bets: 0. Collects: 0. Wins: 0.
Player Iia007 does not show cards.Bets: 0. Collects: 0. Wins: 0.
Game ended at: 2016/11/29 8:13:40

Game started
Game ID: 786732801 0.50/1 (PRR) Kraken (short) (Hold'em)
Seat 5 is the button
Seat 2: St3p04ka (50.50).
Seat 4: IlxxxlI (22).
Seat 5: Qrenor (77.81).
Seat 6: badboy85 (101.78).
Player badboy85 has small blind (0.50)
Player St3p04ka has big blind (1)
Player IlxxxlI received card: [Kh]
Player IlxxxlI received card: [5d]
Player IlxxxlI folds
Player Qrenor raises (2)
Player badboy85 calls (1.50)
Player St3p04ka calls (1)
*** FLOP ***: [7s 3s 6s]
Player badboy85 checks
Player St3p04ka checks
Player Qrenor checks
*** TURN ***: [7s 3s 6s] [7h]
Player badboy85 bets (4.10)
Player St3p04ka folds
Player Qrenor calls (4.10)
*** RIVER ***: [7s 3s 6s 7h] [Ad]
Player badboy85 checks
Player Qrenor bets (10.12)
Player badboy85 folds
Uncalled bet (10.12) returned to Qrenor
Player Qrenor mucks cards
------ Summary ------
Pot: 13.49. Rake 0.49. JP fee 0.22
Board: [7s 3s 6s 7h Ad]
Player St3p04ka does not show cards.Bets: 2. Collects: 0. Loses: 2.
Player IlxxxlI does not show cards.Bets: 0. Collects: 0. Wins: 0.
*Player Qrenor mucks (does not show cards). Bets: 6.10. Collects: 13.49. Wins: 7.39.
Player badboy85 does not show cards.Bets: 6.10. Collects: 0. Loses: 6.10.
Game ended at: 2016/11/29 8:12:26

Game started
Game ID: 786732778 1/2 (PRR) Longana - 2 (Hold'em)
Seat 1 is the button
Seat 1: IlxxxlI (86.98).
Seat 2: loolu (217.20).
Seat 3: IamPhamous (167.57).
Seat 5: Iia007 (264.81).
Seat 6: Gronkowski69 (300.25).
Seat 8: aleaga (588.68).
Seat 9: shokerAAss (203).
Player loolu has small blind (1)
Player IamPhamous has big blind (2)
Player IlxxxlI received card: [Ad]
Player IlxxxlI received card: [6h]
Player Iia007 folds
Player Gronkowski69 folds
Player aleaga is timed out.
Player aleaga folds
Player shokerAAss folds
Player IlxxxlI raises (6)
Player loolu raises (18)
Player IamPhamous folds
Player IlxxxlI folds
Uncalled bet (13) returned to loolu
Player loolu mucks cards
------ Summary ------
Pot: 14. Rake 0
Player IlxxxlI does not show cards.Bets: 6. Collects: 0. Loses: 6.
*Player loolu mucks (does not show cards). Bets: 6. Collects: 14. Wins: 8.
Player IamPhamous does not show cards.Bets: 2. Collects: 0. Loses: 2.
Player Iia007 does not show cards.Bets: 0. Collects: 0. Wins: 0.
Player Gronkowski69 does not show cards.Bets: 0. Collects: 0. Wins: 0.
Player aleaga does not show cards.Bets: 0. Collects: 0. Wins: 0.
Player shokerAAss does not show cards.Bets: 0. Collects: 0. Wins: 0.
Game ended at: 2016/11/29 8:12:58

Game started
Game ID: 786732434 0.50/1 (PRR) Karkadann (Hold'em)
Seat 3 is the button
Seat 1: aleaga (109.15).
Seat 2: Qrenor (118.07).
Seat 3: IlxxxlI (40).
Seat 4: IamPhamous (154.30).
Seat 5: coldkilla (36.37).
Seat 6: Log_in (31.10).
Seat 7: PeLanpapa (104.07).
Seat 8: St3p04ka (119.93).
Seat 9: Iia007 (153.48).
Player IamPhamous has small blind (0.50)
Player coldkilla has big blind (1)
Player IlxxxlI received card: [Ad]
Player IlxxxlI received card: [Jh]
Player Log_in folds
Player PeLanpapa folds
Player St3p04ka folds
Player Iia007 folds
Player aleaga folds
Player Qrenor folds
Player IlxxxlI raises (3)
Player IamPhamous calls (2.50)
Player coldkilla calls (2)
*** FLOP ***: [3c 9d Ah]
Player IamPhamous checks
Player coldkilla checks
Player IlxxxlI bets (4.45)
Player IamPhamous folds
Player coldkilla folds
Uncalled bet (4.45) returned to IlxxxlI
Player IlxxxlI mucks cards
------ Summary ------
Pot: 8.55. Rake 0.31. JP fee 0.14
Board: [3c 9d Ah]
Player aleaga does not show cards.Bets: 0. Collects: 0. Wins: 0.
Player Qrenor does not show cards.Bets: 0. Collects: 0. Wins: 0.
*Player IlxxxlI mucks (does not show cards). Bets: 3. Collects: 8.55. Wins: 5.55.
Player IamPhamous does not show cards.Bets: 3. Collects: 0. Loses: 3.
Player coldkilla does not show cards.Bets: 3. Collects: 0. Loses: 3.
Player Log_in does not show cards.Bets: 0. Collects: 0. Wins: 0.
Player PeLanpapa does not show cards.Bets: 0. Collects: 0. Wins: 0.
Player St3p04ka does not show cards.Bets: 0. Collects: 0. Wins: 0.
Player Iia007 does not show cards.Bets: 0. Collects: 0. Wins: 0.
Game ended at: 2016/11/29 8:11:52

Game started
Game ID: 786732325 1/2 (PRR) Longana - 2 (Hold'em)
Seat 9 is the button
Seat 1: IlxxxlI (87.98).
Seat 2: loolu (219.20).
Seat 3: IamPhamous (167.57).
Seat 5: Iia007 (264.81).
Seat 6: Gronkowski69 (300.25).
Seat 8: aleaga (588.68).
Seat 9: shokerAAss (200).
Player IlxxxlI has small blind (1)
Player loolu has big blind (2)
Player IlxxxlI received card: [7h]
Player IlxxxlI received card: [2h]
Player IamPhamous folds
Player Iia007 folds
Player Gronkowski69 folds
Player aleaga folds
Player shokerAAss raises (5)
Player IlxxxlI folds
Player loolu folds
Uncalled bet (3) returned to shokerAAss
Player shokerAAss mucks cards
------ Summary ------
Pot: 5. Rake 0
Player IlxxxlI does not show cards.Bets: 1. Collects: 0. Loses: 1.
Player loolu does not show cards.Bets: 2. Collects: 0. Loses: 2.
Player IamPhamous does not show cards.Bets: 0. Collects: 0. Wins: 0.
Player Iia007 does not show cards.Bets: 0. Collects: 0. Wins: 0.
Player Gronkowski69 does not show cards.Bets: 0. Collects: 0. Wins: 0.
Player aleaga does not show cards.Bets: 0. Collects: 0. Wins: 0.
*Player shokerAAss mucks (does not show cards). Bets: 2. Collects: 5. Wins: 3.
Game ended at: 2016/11/29 8:11:2

Game started
Game ID: 786732048 0.50/1 (PRR) Karkadann - 2 (Hold'em)
Seat 1 is the button
Seat 1: SoMeFarmer (98.50).
Seat 2: shokerAAss (100.44).
Seat 3: St3p04ka (174.36).
Seat 4: IlxxxlI (66.56).
Seat 5: Iia007 (100).
Seat 6: Winter is here (203.64).
Seat 7: aleaga (205.96).
Seat 8: Qrenor (267.58).
Seat 9: PeLanpapa (100).
Player shokerAAss has small blind (0.50)
Player St3p04ka has big blind (1)
Player IlxxxlI received card: [Qs]
Player IlxxxlI received card: [Ks]
Player IlxxxlI raises (3.50)
Player Iia007 folds
Player Winter is here folds
Player aleaga folds
Player Qrenor folds
Player PeLanpapa raises (13.50)
Player SoMeFarmer folds
Player shokerAAss folds
Player St3p04ka allin (173.36)
Player IlxxxlI folds
Player PeLanpapa allin (86.50)
Uncalled bet (74.36) returned to St3p04ka
*** FLOP ***: [4d 4h 3h]
*** TURN ***: [4d 4h 3h] [7c]
*** RIVER ***: [4d 4h 3h 7c] [5d]
------ Summary ------
Pot: 201. Rake 2.76. JP fee 0.24
Board: [4d 4h 3h 7c 5d]
Player SoMeFarmer does not show cards.Bets: 0. Collects: 0. Wins: 0.
Player shokerAAss does not show cards.Bets: 0.50. Collects: 0. Loses: 0.50.
Player St3p04ka shows: One pair of 4s [Kh Ad]. Bets: 100. Collects: 0. Loses: 100.
Player IlxxxlI does not show cards.Bets: 3.50. Collects: 0. Loses: 3.50.
Player Iia007 does not show cards.Bets: 0. Collects: 0. Wins: 0.
Player Winter is here does not show cards.Bets: 0. Collects: 0. Wins: 0.
Player aleaga does not show cards.Bets: 0. Collects: 0. Wins: 0.
Player Qrenor does not show cards.Bets: 0. Collects: 0. Wins: 0.
*Player PeLanpapa shows: Two pairs. As and 4s [Ah As]. Bets: 100. Collects: 201. Wins: 101.
Game ended at: 2016/11/29 8:11:20

Game started
Game ID: 786732017 0.50/1 (PRR) Kraken (short) (Hold'em)
Seat 4 is the button
Seat 2: St3p04ka (50.50).
Seat 4: IlxxxlI (20.50).
Seat 5: Qrenor (78.31).
Seat 6: badboy85 (102.78).
Player Qrenor has small blind (0.50)
Player badboy85 has big blind (1)
Player IlxxxlI received card: [4d]
Player IlxxxlI received card: [4h]
Player St3p04ka folds
Player IlxxxlI allin (20.50)
Player Qrenor folds
Player badboy85 folds
Uncalled bet (19.50) returned to IlxxxlI
Player IlxxxlI mucks cards
------ Summary ------
Pot: 2.50. Rake 0
Player St3p04ka does not show cards.Bets: 0. Collects: 0. Wins: 0.
*Player IlxxxlI mucks (does not show cards). Bets: 1. Collects: 2.50. Wins: 1.50.
Player Qrenor does not show cards.Bets: 0.50. Collects: 0. Loses: 0.50.
Player badboy85 does not show cards.Bets: 1. Collects: 0. Loses: 1.
Game ended at: 2016/11/29 8:11:4

Game started
Game ID: 786731705 0.50/1 (PRR) Karkadann (Hold'em)
Seat 2 is the button
Seat 1: aleaga (107.65).
Seat 2: Qrenor (118.07).
Seat 3: IlxxxlI (40).
Seat 4: IamPhamous (155.30).
Seat 5: coldkilla (36.37).
Seat 6: Log_in (31.10).
Seat 7: PeLanpapa (104.07).
Seat 8: St3p04ka (119.93).
Seat 9: Iia007 (153.48).
Player IlxxxlI has small blind (0.50)
Player IamPhamous has big blind (1)
Player IlxxxlI received card: [2h]
Player IlxxxlI received card: [10h]
Player coldkilla folds
Player Log_in folds
Player PeLanpapa folds
Player St3p04ka folds
Player Iia007 folds
Player aleaga raises (3)
Player Qrenor folds
Player IlxxxlI folds
Player IamPhamous folds
Uncalled bet (2) returned to aleaga
Player aleaga mucks cards
------ Summary ------
Pot: 2.50. Rake 0
*Player aleaga mucks (does not show cards). Bets: 1. Collects: 2.50. Wins: 1.50.
Player Qrenor does not show cards.Bets: 0. Collects: 0. Wins: 0.
Player IlxxxlI does not show cards.Bets: 0.50. Collects: 0. Loses: 0.50.
Player IamPhamous does not show cards.Bets: 1. Collects: 0. Loses: 1.
Player coldkilla does not show cards.Bets: 0. Collects: 0. Wins: 0.
Player Log_in does not show cards.Bets: 0. Collects: 0. Wins: 0.
Player PeLanpapa does not show cards.Bets: 0. Collects: 0. Wins: 0.
Player St3p04ka does not show cards.Bets: 0. Collects: 0. Wins: 0.
Player Iia007 does not show cards.Bets: 0. Collects: 0. Wins: 0.
Game ended at: 2016/11/29 8:10:39

Game started
Game ID: 786731566 0.50/1 (PRR) Kraken (short) (Hold'em)
Seat 2 is the button
Seat 2: St3p04ka (50.50).
Seat 4: IlxxxlI (23).
Seat 5: Qrenor (75.81).
Seat 6: badboy85 (102.78).
Player IlxxxlI has small blind (0.50)
Player Qrenor has big blind (1)
Player IlxxxlI received card: [Ks]
Player IlxxxlI received card: [8s]
Player badboy85 folds
Player St3p04ka folds
Player IlxxxlI raises (2)
Player Qrenor raises (6.50)
Player IlxxxlI folds
Uncalled bet (5) returned to Qrenor
Player Qrenor mucks cards
------ Summary ------
Pot: 5. Rake 0
Player St3p04ka does not show cards.Bets: 0. Collects: 0. Wins: 0.
Player IlxxxlI does not show cards.Bets: 2.50. Collects: 0. Loses: 2.50.
*Player Qrenor mucks (does not show cards). Bets: 2.50. Collects: 5. Wins: 2.50.
Player badboy85 does not show cards.Bets: 0. Collects: 0. Wins: 0.
Game ended at: 2016/11/29 8:10:11

Game started
Game ID: 786731330 1/2 (PRR) Longana - 2 (Hold'em)
Seat 8 is the button
Seat 1: IlxxxlI (89.98).
Seat 2: loolu (219.20).
Seat 3: IamPhamous (193.57).
Seat 5: Iia007 (264.81).
Seat 6: Gronkowski69 (300.25).
Seat 8: aleaga (336.24).
Seat 9: shokerAAss (227.44).
Player shokerAAss has small blind (1)
Player IlxxxlI has big blind (2)
Player IlxxxlI received card: [6s]
Player IlxxxlI received card: [9d]
Player loolu folds
Player IamPhamous raises (6)
Player Iia007 folds
Player Gronkowski69 folds
Player aleaga calls (6)
Player shokerAAss raises (25)
Player IlxxxlI folds
Player IamPhamous calls (20)
Player aleaga raises (79)
Player shokerAAss allin (201.44)
Player IamPhamous folds
Player aleaga calls (142.44)
*** FLOP ***: [Jd 7d 3h]
*** TURN ***: [Jd 7d 3h] [4s]
*** RIVER ***: [Jd 7d 3h 4s] [3c]
------ Summary ------
Pot: 479.88. Rake 2.76. JP fee 0.24
Board: [Jd 7d 3h 4s 3c]
Player IlxxxlI does not show cards.Bets: 2. Collects: 0. Loses: 2.
Player loolu does not show cards.Bets: 0. Collects: 0. Wins: 0.
Player IamPhamous does not show cards.Bets: 26. Collects: 0. Loses: 26.
Player Iia007 does not show cards.Bets: 0. Collects: 0. Wins: 0.
Player Gronkowski69 does not show cards.Bets: 0. Collects: 0. Wins: 0.
*Player aleaga shows: Two pairs. As and 3s [As Ah]. Bets: 227.44. Collects: 479.88. Wins: 252.44.
Player shokerAAss shows: Two pairs. 9s and 3s [9s 9c]. Bets: 227.44. Collects: 0. Loses: 227.44.
Game ended at: 2016/11/29 8:10:30

Game started
Game ID: 786730943 0.50/1 (PRR) Kraken (short) (Hold'em)
Seat 6 is the button
Seat 1: thethinmanlb (92.43).
Seat 2: St3p04ka (51.50).
Seat 4: IlxxxlI (23).
Seat 5: Qrenor (75.81).
Seat 6: badboy85 (101.28).
Player thethinmanlb has small blind (0.50)
Player St3p04ka has big blind (1)
Player IlxxxlI received card: [4d]
Player IlxxxlI received card: [4s]
Player IlxxxlI folds
Player Qrenor folds
Player badboy85 raises (2.50)
Player thethinmanlb is timed out.
Player thethinmanlb folds
Player St3p04ka folds
Uncalled bet (1.50) returned to badboy85
Player badboy85 mucks cards
------ Summary ------
Pot: 2.50. Rake 0
Player thethinmanlb does not show cards.Bets: 0.50. Collects: 0. Loses: 0.50.
Player St3p04ka does not show cards.Bets: 1. Collects: 0. Loses: 1.
Player IlxxxlI does not show cards.Bets: 0. Collects: 0. Wins: 0.
Player Qrenor does not show cards.Bets: 0. Collects: 0. Wins: 0.
*Player badboy85 mucks (does not show cards). Bets: 1. Collects: 2.50. Wins: 1.50.
Game ended at: 2016/11/29 8:9:41

Game started
Game ID: 786730906 0.50/1 (PRR) Karkadann (Hold'em)
Seat 1 is the button
Seat 1: aleaga (103.15).
Seat 2: Qrenor (118.57).
Seat 3: IlxxxlI (40).
Seat 4: IamPhamous (155.30).
Seat 5: coldkilla (36.37).
Seat 6: Log_in (31.10).
Seat 7: PeLanpapa (107.07).
Seat 8: St3p04ka (119.93).
Seat 9: Iia007 (153.48).
Player Qrenor has small blind (0.50)
Player IlxxxlI has big blind (1)
Player IlxxxlI received card: [Qs]
Player IlxxxlI received card: [2c]
Player IamPhamous folds
Player coldkilla folds
Player Log_in folds
Player PeLanpapa raises (3)
Player St3p04ka folds
Player Iia007 folds
Player aleaga raises (10)
Player Qrenor folds
Player IlxxxlI folds
Player PeLanpapa folds
Uncalled bet (7) returned to aleaga
Player aleaga mucks cards
------ Summary ------
Pot: 7.50. Rake 0
*Player aleaga mucks (does not show cards). Bets: 3. Collects: 7.50. Wins: 4.50.
Player Qrenor does not show cards.Bets: 0.50. Collects: 0. Loses: 0.50.
Player IlxxxlI does not show cards.Bets: 1. Collects: 0. Loses: 1.
Player IamPhamous does not show cards.Bets: 0. Collects: 0. Wins: 0.
Player coldkilla does not show cards.Bets: 0. Collects: 0. Wins: 0.
Player Log_in does not show cards.Bets: 0. Collects: 0. Wins: 0.
Player PeLanpapa does not show cards.Bets: 3. Collects: 0. Loses: 3.
Player St3p04ka does not show cards.Bets: 0. Collects: 0. Wins: 0.
Player Iia007 does not show cards.Bets: 0. Collects: 0. Wins: 0.
Game ended at: 2016/11/29 8:9:52

Game started
Game ID: 786730813 0.50/1 (PRR) Kraken - 2 (Hold'em)
Seat 4 is the button
Seat 1: MrCRABS333 (221.05).
Seat 4: Qrenor (338.94).
Seat 6: IlxxxlI (41.80).
Player IlxxxlI has small blind (0.50)
Player MrCRABS333 has big blind (1)
Player IlxxxlI received card: [2c]
Player IlxxxlI received card: [9h]
Player Qrenor folds
Player IlxxxlI folds
Uncalled bet (0.50) returned to MrCRABS333
Player MrCRABS333 mucks cards
------ Summary ------
Pot: 1. Rake 0
*Player MrCRABS333 mucks (does not show cards). Bets: 0.50. Collects: 1. Wins: 0.50.
Player Qrenor does not show cards.Bets: 0. Collects: 0. Wins: 0.
Player IlxxxlI does not show cards.Bets: 0.50. Collects: 0. Loses: 0.50.
Game ended at: 2016/11/29 8:9:23

Game started
Game ID: 786730460 0.50/1 (PRR) Kraken - 2 (Hold'em)
Seat 1 is the button
Seat 1: MrCRABS333 (221.05).
Seat 4: Qrenor (339.44).
Seat 6: IlxxxlI (41.30).
Player Qrenor has small blind (0.50)
Player IlxxxlI has big blind (1)
Player IlxxxlI received card: [Ac]
Player IlxxxlI received card: [2s]
Player MrCRABS333 folds
Player Qrenor folds
Uncalled bet (0.50) returned to IlxxxlI
Player IlxxxlI mucks cards
------ Summary ------
Pot: 1. Rake 0
Player MrCRABS333 does not show cards.Bets: 0. Collects: 0. Wins: 0.
Player Qrenor does not show cards.Bets: 0.50. Collects: 0. Loses: 0.50.
*Player IlxxxlI mucks (does not show cards). Bets: 0.50. Collects: 1. Wins: 0.50.
Game ended at: 2016/11/29 8:8:52

Game started
Game ID: 786730165 1/2 (PRR) Longana - 2 (Hold'em)
Seat 6 is the button
Seat 1: IlxxxlI (89.98).
Seat 2: loolu (225.20).
Seat 3: IamPhamous (193.57).
Seat 5: Iia007 (250.86).
Seat 6: Gronkowski69 (306.25).
Seat 8: aleaga (337.24).
Seat 9: shokerAAss (229.44).
Player aleaga has small blind (1)
Player shokerAAss has big blind (2)
Player IlxxxlI received card: [As]
Player IlxxxlI received card: [8c]
Player IlxxxlI folds
Player loolu raises (6)
Player IamPhamous folds
Player Iia007 calls (6)
Player Gronkowski69 calls (6)
Player aleaga folds
Player shokerAAss folds
*** FLOP ***: [5h Ah Kc]
Player loolu checks
Player Iia007 bets (9.97)
Player Gronkowski69 folds
Player loolu folds
Uncalled bet (9.97) returned to Iia007
Player Iia007 mucks cards
------ Summary ------
Pot: 19.95. Rake 0.81. JP fee 0.24
Board: [5h Ah Kc]
Player IlxxxlI does not show cards.Bets: 0. Collects: 0. Wins: 0.
Player loolu does not show cards.Bets: 6. Collects: 0. Loses: 6.
Player IamPhamous does not show cards.Bets: 0. Collects: 0. Wins: 0.
*Player Iia007 mucks (does not show cards). Bets: 6. Collects: 19.95. Wins: 13.95.
Player Gronkowski69 does not show cards.Bets: 6. Collects: 0. Loses: 6.
Player aleaga does not show cards.Bets: 1. Collects: 0. Loses: 1.
Player shokerAAss does not show cards.Bets: 2. Collects: 0. Loses: 2.
Game ended at: 2016/11/29 8:9:26

Game started
Game ID: 786730077 0.50/1 (PRR) Karkadann - 2 (Hold'em)
Seat 9 is the button
Seat 1: SoMeFarmer (99).
Seat 2: shokerAAss (101.44).
Seat 3: St3p04ka (174.36).
Seat 4: IlxxxlI (66.56).
Seat 5: Iia007 (100).
Seat 6: Winter is here (203.64).
Seat 7: aleaga (205.96).
Seat 8: Qrenor (248.15).
Seat 9: PeLanpapa (100).
Player SoMeFarmer has small blind (0.50)
Player shokerAAss has big blind (1)
Player IlxxxlI received card: [4c]
Player IlxxxlI received card: [5h]
Player St3p04ka folds
Player IlxxxlI folds
Player Iia007 folds
Player Winter is here folds
Player aleaga folds
Player Qrenor raises (2.50)
Player PeLanpapa raises (9)
Player SoMeFarmer folds
Player shokerAAss folds
Player Qrenor calls (6.50)
*** FLOP ***: [5c Ad 4s]
Player Qrenor checks
Player PeLanpapa bets (11)
Player Qrenor calls (11)
*** TURN ***: [5c Ad 4s] [2c]
Player Qrenor checks
Player PeLanpapa checks
*** RIVER ***: [5c Ad 4s 2c] [2s]
Player Qrenor allin (228.15)
Player PeLanpapa folds
Uncalled bet (228.15) returned to Qrenor
Player Qrenor mucks cards
------ Summary ------
Pot: 39.43. Rake 1.83. JP fee 0.24
Board: [5c Ad 4s 2c 2s]
Player SoMeFarmer does not show cards.Bets: 0.50. Collects: 0. Loses: 0.50.
Player shokerAAss does not show cards.Bets: 1. Collects: 0. Loses: 1.
Player St3p04ka does not show cards.Bets: 0. Collects: 0. Wins: 0.
Player IlxxxlI does not show cards.Bets: 0. Collects: 0. Wins: 0.
Player Iia007 does not show cards.Bets: 0. Collects: 0. Wins: 0.
Player Winter is here does not show cards.Bets: 0. Collects: 0. Wins: 0.
Player aleaga does not show cards.Bets: 0. Collects: 0. Wins: 0.
*Player Qrenor mucks (does not show cards). Bets: 20. Collects: 39.43. Wins: 19.43.
Player PeLanpapa does not show cards.Bets: 20. Collects: 0. Loses: 20.
Game ended at: 2016/11/29 8:10:14

Game started
Game ID: 786729997 0.50/1 (PRR) Kraken - 2 (Hold'em)
Seat 6 is the button
Seat 1: MrCRABS333 (217.05).
Seat 4: Qrenor (340.44).
Seat 6: IlxxxlI (44.30).
Player MrCRABS333 has small blind (0.50)
Player Qrenor has big blind (1)
Player IlxxxlI received card: [Jc]
Player IlxxxlI received card: [Qh]
Player IlxxxlI raises (3)
Player MrCRABS333 raises (9.50)
Player Qrenor folds
Player IlxxxlI folds
Uncalled bet (7) returned to MrCRABS333
Player MrCRABS333 mucks cards
------ Summary ------
Pot: 7. Rake 0
*Player MrCRABS333 mucks (does not show cards). Bets: 3. Collects: 7. Wins: 4.
Player Qrenor does not show cards.Bets: 1. Collects: 0. Loses: 1.
Player IlxxxlI does not show cards.Bets: 3. Collects: 0. Loses: 3.
Game ended at: 2016/11/29 8:8:28

Game started
Game ID: 786729961 0.50/1 (PRR) Kraken - 3 (Hold'em)
Seat 1 is the button
Seat 1: shokerAAss (100).
Seat 2: IlxxxlI (40).
Seat 3: Qrenor (292.15).
Player IlxxxlI has small blind (0.50)
Player Qrenor sitting out
Player shokerAAss has big blind (1)
Player IlxxxlI received card: [8c]
Player IlxxxlI received card: [10d]
Player IlxxxlI calls (0.50)
Player shokerAAss raises (2)
Player IlxxxlI folds
Uncalled bet (2) returned to shokerAAss
Player shokerAAss mucks cards
------ Summary ------
Pot: 2. Rake 0
*Player shokerAAss mucks (does not show cards). Bets: 1. Collects: 2. Wins: 1.
Player IlxxxlI does not show cards.Bets: 1. Collects: 0. Loses: 1.
Player Qrenor does not show cards.Bets: 0. Collects: 0. Wins: 0.
Game ended at: 2016/11/29 8:8:13

Game started
Game ID: 786729730 0.50/1 (PRR) Kraken (short) (Hold'em)
Seat 5 is the button
Seat 1: thethinmanlb (96.57).
Seat 2: St3p04ka (51.50).
Seat 4: IlxxxlI (23).
Seat 5: Qrenor (71.60).
Seat 6: badboy85 (101.78).
Player badboy85 has small blind (0.50)
Player thethinmanlb has big blind (1)
Player IlxxxlI received card: [3c]
Player IlxxxlI received card: [4d]
Player St3p04ka folds
Player IlxxxlI folds
Player Qrenor raises (2)
Player badboy85 folds
Player thethinmanlb calls (1)
*** FLOP ***: [5s 8d Jh]
Player thethinmanlb checks
Player Qrenor bets (2.14)
Player thethinmanlb calls (2.14)
*** TURN ***: [5s 8d Jh] [7s]
Player thethinmanlb checks
Player Qrenor checks
*** RIVER ***: [5s 8d Jh 7s] [Jd]
Player thethinmanlb checks
Player Qrenor bets (16)
Player thethinmanlb folds
Uncalled bet (16) returned to Qrenor
Player Qrenor mucks cards
------ Summary ------
Pot: 8.35. Rake 0.29. JP fee 0.14
Board: [5s 8d Jh 7s Jd]
Player thethinmanlb does not show cards.Bets: 4.14. Collects: 0. Loses: 4.14.
Player St3p04ka does not show cards.Bets: 0. Collects: 0. Wins: 0.
Player IlxxxlI does not show cards.Bets: 0. Collects: 0. Wins: 0.
*Player Qrenor mucks (does not show cards). Bets: 4.14. Collects: 8.35. Wins: 4.21.
Player badboy85 does not show cards.Bets: 0.50. Collects: 0. Loses: 0.50.
Game ended at: 2016/11/29 8:9:1

Game started
Game ID: 786729681 1/2 (PRR) Longana - 2 (Hold'em)
Seat 5 is the button
Seat 1: IlxxxlI (89.98).
Seat 2: loolu (222.20).
Seat 3: IamPhamous (193.57).
Seat 5: Iia007 (250.86).
Seat 6: Gronkowski69 (307.25).
Seat 8: aleaga (339.24).
Seat 9: shokerAAss (229.44).
Player Gronkowski69 has small blind (1)
Player aleaga has big blind (2)
Player IlxxxlI received card: [9d]
Player IlxxxlI received card: [4c]
Player shokerAAss folds
Player IlxxxlI folds
Player loolu raises (6)
Player IamPhamous folds
Player Iia007 folds
Player Gronkowski69 folds
Player aleaga folds
Uncalled bet (4) returned to loolu
Player loolu mucks cards
------ Summary ------
Pot: 5. Rake 0
Player IlxxxlI does not show cards.Bets: 0. Collects: 0. Wins: 0.
*Player loolu mucks (does not show cards). Bets: 2. Collects: 5. Wins: 3.
Player IamPhamous does not show cards.Bets: 0. Collects: 0. Wins: 0.
Player Iia007 does not show cards.Bets: 0. Collects: 0. Wins: 0.
Player Gronkowski69 does not show cards.Bets: 1. Collects: 0. Loses: 1.
Player aleaga does not show cards.Bets: 2. Collects: 0. Loses: 2.
Player shokerAAss does not show cards.Bets: 0. Collects: 0. Wins: 0.
Game ended at: 2016/11/29 8:8:8

Game started
Game ID: 786729438 0.50/1 (PRR) Kraken (short) (Hold'em)
Seat 4 is the button
Seat 1: thethinmanlb (96.57).
Seat 2: St3p04ka (50).
Seat 4: IlxxxlI (23).
Seat 5: Qrenor (72.10).
Seat 6: badboy85 (102.78).
Player Qrenor has small blind (0.50)
Player badboy85 has big blind (1)
Player IlxxxlI received card: [4s]
Player IlxxxlI received card: [7c]
Player thethinmanlb folds
Player St3p04ka raises (3.10)
Player IlxxxlI folds
Player Qrenor folds
Player badboy85 folds
Uncalled bet (2.10) returned to St3p04ka
Player St3p04ka mucks cards
------ Summary ------
Pot: 2.50. Rake 0
Player thethinmanlb does not show cards.Bets: 0. Collects: 0. Wins: 0.
*Player St3p04ka mucks (does not show cards). Bets: 1. Collects: 2.50. Wins: 1.50.
Player IlxxxlI does not show cards.Bets: 0. Collects: 0. Wins: 0.
Player Qrenor does not show cards.Bets: 0.50. Collects: 0. Loses: 0.50.
Player badboy85 does not show cards.Bets: 1. Collects: 0. Loses: 1.
Game ended at: 2016/11/29 8:7:40

Game started
Game ID: 786729381 0.50/1 (PRR) Kraken - 2 (Hold'em)
Seat 4 is the button
Seat 1: MrCRABS333 (218.05).
Seat 4: Qrenor (338.94).
Seat 6: IlxxxlI (44.80).
Player IlxxxlI has small blind (0.50)
Player MrCRABS333 has big blind (1)
Player IlxxxlI received card: [9d]
Player IlxxxlI received card: [6c]
Player Qrenor raises (2)
Player IlxxxlI folds
Player MrCRABS333 folds
Uncalled bet (1) returned to Qrenor
Player Qrenor mucks cards
------ Summary ------
Pot: 2.50. Rake 0
Player MrCRABS333 does not show cards.Bets: 1. Collects: 0. Loses: 1.
*Player Qrenor mucks (does not show cards). Bets: 1. Collects: 2.50. Wins: 1.50.
Player IlxxxlI does not show cards.Bets: 0.50. Collects: 0. Loses: 0.50.
Game ended at: 2016/11/29 8:7:57

Game started
Game ID: 786729266 0.50/1 (PRR) Kraken - 3 (Hold'em)
Seat 3 is the button
Seat 1: shokerAAss (100).
Seat 2: IlxxxlI (40).
Seat 3: Qrenor (290.65).
Player shokerAAss has small blind (0.50)
Player IlxxxlI has big blind (1)
Player IlxxxlI received card: [9c]
Player IlxxxlI received card: [4d]
Player Qrenor raises (2)
Player shokerAAss folds
Player IlxxxlI folds
Uncalled bet (1) returned to Qrenor
Player Qrenor mucks cards
------ Summary ------
Pot: 2.50. Rake 0
Player shokerAAss does not show cards.Bets: 0.50. Collects: 0. Loses: 0.50.
Player IlxxxlI does not show cards.Bets: 1. Collects: 0. Loses: 1.
*Player Qrenor mucks (does not show cards). Bets: 1. Collects: 2.50. Wins: 1.50.
Game ended at: 2016/11/29 8:7:55

Game started
Game ID: 786729086 0.50/1 (PRR) Karkadann - 2 (Hold'em)
Seat 8 is the button
Seat 1: SoMeFarmer (100).
Seat 2: shokerAAss (101.44).
Seat 3: St3p04ka (174.36).
Seat 4: IlxxxlI (66.56).
Seat 5: Iia007 (100).
Seat 6: Winter is here (202.14).
Seat 7: aleaga (205.96).
Seat 8: Qrenor (248.15).
Seat 9: PeLanpapa (100.50).
Player PeLanpapa has small blind (0.50)
Player SoMeFarmer has big blind (1)
Player IlxxxlI received card: [6s]
Player IlxxxlI received card: [4d]
Player shokerAAss folds
Player St3p04ka folds
Player IlxxxlI folds
Player Iia007 folds
Player Winter is here raises (2)
Player aleaga folds
Player Qrenor folds
Player PeLanpapa folds
Player SoMeFarmer folds
Uncalled bet (1) returned to Winter is here
Player Winter is here is timed out.
Player Winter is here mucks cards
------ Summary ------
Pot: 2.50. Rake 0
Player SoMeFarmer does not show cards.Bets: 1. Collects: 0. Loses: 1.
Player shokerAAss does not show cards.Bets: 0. Collects: 0. Wins: 0.
Player St3p04ka does not show cards.Bets: 0. Collects: 0. Wins: 0.
Player IlxxxlI does not show cards.Bets: 0. Collects: 0. Wins: 0.
Player Iia007 does not show cards.Bets: 0. Collects: 0. Wins: 0.
*Player Winter is here mucks (does not show cards). Bets: 1. Collects: 2.50. Wins: 1.50.
Player aleaga does not show cards.Bets: 0. Collects: 0. Wins: 0.
Player Qrenor does not show cards.Bets: 0. Collects: 0. Wins: 0.
Player PeLanpapa does not show cards.Bets: 0.50. Collects: 0. Loses: 0.50.
Game ended at: 2016/11/29 8:8:4

Game started
Game ID: 786728937 0.50/1 (PRR) Kraken (short) (Hold'em)
Seat 2 is the button
Seat 1: thethinmanlb (95.07).
Seat 2: St3p04ka (50).
Seat 4: IlxxxlI (23.50).
Seat 5: Qrenor (73.10).
Seat 6: badboy85 (102.78).
Player IlxxxlI has small blind (0.50)
Player Qrenor has big blind (1)
Player IlxxxlI received card: [3s]
Player IlxxxlI received card: [9d]
Player badboy85 folds
Player thethinmanlb raises (2)
Player St3p04ka folds
Player IlxxxlI folds
Player Qrenor folds
Uncalled bet (1) returned to thethinmanlb
Player thethinmanlb mucks cards
------ Summary ------
Pot: 2.50. Rake 0
*Player thethinmanlb mucks (does not show cards). Bets: 1. Collects: 2.50. Wins: 1.50.
Player St3p04ka does not show cards.Bets: 0. Collects: 0. Wins: 0.
Player IlxxxlI does not show cards.Bets: 0.50. Collects: 0. Loses: 0.50.
Player Qrenor does not show cards.Bets: 1. Collects: 0. Loses: 1.
Player badboy85 does not show cards.Bets: 0. Collects: 0. Wins: 0.
Game ended at: 2016/11/29 8:7:20

Game started
Game ID: 786728838 1/2 (PRR) Longana - 2 (Hold'em)
Seat 3 is the button
Seat 1: IlxxxlI (89.98).
Seat 2: loolu (222.20).
Seat 3: IamPhamous (193.57).
Seat 5: Iia007 (256.86).
Seat 6: Gronkowski69 (301.25).
Seat 8: aleaga (339.24).
Seat 9: shokerAAss (229.44).
Player Iia007 has small blind (1)
Player Gronkowski69 has big blind (2)
Player IlxxxlI received card: [2h]
Player IlxxxlI received card: [3d]
Player aleaga folds
Player shokerAAss folds
Player IlxxxlI folds
Player loolu folds
Player IamPhamous folds
Player Iia007 raises (5)
Player Gronkowski69 raises (18)
Player Iia007 folds
Uncalled bet (14) returned to Gronkowski69
Player Gronkowski69 mucks cards
------ Summary ------
Pot: 12. Rake 0
Player IlxxxlI does not show cards.Bets: 0. Collects: 0. Wins: 0.
Player loolu does not show cards.Bets: 0. Collects: 0. Wins: 0.
Player IamPhamous does not show cards.Bets: 0. Collects: 0. Wins: 0.
Player Iia007 does not show cards.Bets: 6. Collects: 0. Loses: 6.
*Player Gronkowski69 mucks (does not show cards). Bets: 6. Collects: 12. Wins: 6.
Player aleaga does not show cards.Bets: 0. Collects: 0. Wins: 0.
Player shokerAAss does not show cards.Bets: 0. Collects: 0. Wins: 0.
Game ended at: 2016/11/29 8:7:37

Game started
Game ID: 786728603 0.50/1 (PRR) Karkadann - 2 (Hold'em)
Seat 7 is the button
Seat 2: shokerAAss (101.44).
Seat 3: St3p04ka (174.36).
Seat 4: IlxxxlI (65.06).
Seat 5: Iia007 (86).
Seat 6: Winter is here (202.14).
Seat 7: aleaga (205.96).
Seat 8: Qrenor (248.65).
Seat 9: PeLanpapa (101.50).
Player Qrenor has small blind (0.50)
Player PeLanpapa has big blind (1)
Player IlxxxlI received card: [Jc]
Player IlxxxlI received card: [Jd]
Player shokerAAss folds
Player St3p04ka folds
Player IlxxxlI raises (3.50)
Player Iia007 folds
Player Winter is here folds
Player aleaga folds
Player Qrenor folds
Player PeLanpapa folds
Uncalled bet (2.50) returned to IlxxxlI
Player IlxxxlI mucks cards
------ Summary ------
Pot: 2.50. Rake 0
Player shokerAAss does not show cards.Bets: 0. Collects: 0. Wins: 0.
Player St3p04ka does not show cards.Bets: 0. Collects: 0. Wins: 0.
*Player IlxxxlI mucks (does not show cards). Bets: 1. Collects: 2.50. Wins: 1.50.
Player Iia007 does not show cards.Bets: 0. Collects: 0. Wins: 0.
Player Winter is here does not show cards.Bets: 0. Collects: 0. Wins: 0.
Player aleaga does not show cards.Bets: 0. Collects: 0. Wins: 0.
Player Qrenor does not show cards.Bets: 0.50. Collects: 0. Loses: 0.50.
Player PeLanpapa does not show cards.Bets: 1. Collects: 0. Loses: 1.
Game ended at: 2016/11/29 8:7:0

Game started
Game ID: 786728062 0.50/1 (PRR) Karkadann - 2 (Hold'em)
Seat 6 is the button
Seat 2: shokerAAss (101.44).
Seat 3: St3p04ka (174.36).
Seat 4: IlxxxlI (65.06).
Seat 5: Iia007 (86).
Seat 6: Winter is here (202.14).
Seat 7: aleaga (206.46).
Seat 8: Qrenor (249.65).
Seat 9: PeLanpapa (100).
Player aleaga has small blind (0.50)
Player Qrenor has big blind (1)
Player IlxxxlI received card: [6s]
Player IlxxxlI received card: [Ad]
Player PeLanpapa raises (3)
Player shokerAAss folds
Player St3p04ka folds
Player IlxxxlI folds
Player Iia007 folds
Player Winter is here folds
Player aleaga folds
Player Qrenor folds
Uncalled bet (2) returned to PeLanpapa
Player PeLanpapa mucks cards
------ Summary ------
Pot: 2.50. Rake 0
Player shokerAAss does not show cards.Bets: 0. Collects: 0. Wins: 0.
Player St3p04ka does not show cards.Bets: 0. Collects: 0. Wins: 0.
Player IlxxxlI does not show cards.Bets: 0. Collects: 0. Wins: 0.
Player Iia007 does not show cards.Bets: 0. Collects: 0. Wins: 0.
Player Winter is here does not show cards.Bets: 0. Collects: 0. Wins: 0.
Player aleaga does not show cards.Bets: 0.50. Collects: 0. Loses: 0.50.
Player Qrenor does not show cards.Bets: 1. Collects: 0. Loses: 1.
*Player PeLanpapa mucks (does not show cards). Bets: 1. Collects: 2.50. Wins: 1.50.
Game ended at: 2016/11/29 8:6:27

Game started
Game ID: 786728001 0.50/1 (PRR) Kraken - 2 (Hold'em)
Seat 3 is the button
Seat 1: MrCRABS333 (218.05).
Seat 3: St3p04ka (180.72).
Seat 4: Qrenor (341.94).
Seat 6: IlxxxlI (42.10).
Player Qrenor has small blind (0.50)
Player IlxxxlI has big blind (1)
Player IlxxxlI received card: [9s]
Player IlxxxlI received card: [7h]
Player MrCRABS333 folds
Player St3p04ka folds
Player Qrenor raises (2.50)
Player IlxxxlI calls (2)
*** FLOP ***: [2h Ah 9c]
Player Qrenor checks
Player IlxxxlI checks
*** TURN ***: [2h Ah 9c] [4c]
Player Qrenor checks
Player IlxxxlI bets (9)
Player Qrenor folds
Uncalled bet (9) returned to IlxxxlI
Player IlxxxlI mucks cards
------ Summary ------
Pot: 5.70. Rake 0.20. JP fee 0.10
Board: [2h Ah 9c 4c]
Player MrCRABS333 does not show cards.Bets: 0. Collects: 0. Wins: 0.
Player St3p04ka does not show cards.Bets: 0. Collects: 0. Wins: 0.
Player Qrenor does not show cards.Bets: 3. Collects: 0. Loses: 3.
*Player IlxxxlI mucks (does not show cards). Bets: 3. Collects: 5.70. Wins: 2.70.
Game ended at: 2016/11/29 8:7:17

Game started
Game ID: 786727993 1/2 (PRR) Longana - 2 (Hold'em)
Seat 2 is the button
Seat 1: IlxxxlI (94.78).
Seat 2: loolu (214.40).
Seat 3: IamPhamous (194.57).
Seat 5: Iia007 (258.86).
Seat 6: Gronkowski69 (301.25).
Seat 8: aleaga (339.24).
Seat 9: shokerAAss (229.44).
Player IamPhamous has small blind (1)
Player Iia007 has big blind (2)
Player IlxxxlI received card: [Ad]
Player IlxxxlI received card: [6d]
Player Gronkowski69 folds
Player aleaga folds
Player shokerAAss folds
Player IlxxxlI raises (4.80)
Player loolu raises (15)
Player IamPhamous folds
Player Iia007 folds
Player IlxxxlI folds
Uncalled bet (10.20) returned to loolu
Player loolu mucks cards
------ Summary ------
Pot: 12.60. Rake 0
Player IlxxxlI does not show cards.Bets: 4.80. Collects: 0. Loses: 4.80.
*Player loolu mucks (does not show cards). Bets: 4.80. Collects: 12.60. Wins: 7.80.
Player IamPhamous does not show cards.Bets: 1. Collects: 0. Loses: 1.
Player Iia007 does not show cards.Bets: 2. Collects: 0. Loses: 2.
Player Gronkowski69 does not show cards.Bets: 0. Collects: 0. Wins: 0.
Player aleaga does not show cards.Bets: 0. Collects: 0. Wins: 0.
Player shokerAAss does not show cards.Bets: 0. Collects: 0. Wins: 0.
Game ended at: 2016/11/29 8:6:43

Game started
Game ID: 786727329 0.50/1 (PRR) Kraken (short) (Hold'em)
Seat 1 is the button
Seat 1: thethinmanlb (78.97).
Seat 2: St3p04ka (64.19).
Seat 4: IlxxxlI (24.50).
Seat 5: Qrenor (73.10).
Seat 6: badboy85 (102.78).
Player St3p04ka has small blind (0.50)
Player IlxxxlI has big blind (1)
Player IlxxxlI received card: [Jc]
Player IlxxxlI received card: [6s]
Player Qrenor folds
Player badboy85 folds
Player thethinmanlb raises (3)
Player St3p04ka raises (8.50)
Player IlxxxlI folds
Player thethinmanlb calls (6)
*** FLOP ***: [3c 9s 6d]
Player St3p04ka bets (7.83)
Player thethinmanlb calls (7.83)
*** TURN ***: [3c 9s 6d] [3d]
Player St3p04ka checks
Player thethinmanlb allin (62.14)
Player St3p04ka folds
Uncalled bet (62.14) returned to thethinmanlb
Player thethinmanlb mucks cards
------ Summary ------
Pot: 32.93. Rake 1.49. JP fee 0.24
Board: [3c 9s 6d 3d]
*Player thethinmanlb mucks (does not show cards). Bets: 16.83. Collects: 32.93. Wins: 16.10.
Player St3p04ka does not show cards.Bets: 16.83. Collects: 0. Loses: 16.83.
Player IlxxxlI does not show cards.Bets: 1. Collects: 0. Loses: 1.
Player Qrenor does not show cards.Bets: 0. Collects: 0. Wins: 0.
Player badboy85 does not show cards.Bets: 0. Collects: 0. Wins: 0.
Game ended at: 2016/11/29 8:6:50

Game started
Game ID: 786727265 1/2 (PRR) Longana - 2 (Hold'em)
Seat 1 is the button
Seat 1: IlxxxlI (94.78).
Seat 2: loolu (215.40).
Seat 3: IamPhamous (196.57).
Seat 4: TonnaMunz (268.35).
Seat 5: Iia007 (258.86).
Seat 6: Gronkowski69 (301.25).
Seat 7: MadLifeGrinder (200).
Seat 8: aleaga (336.24).
Seat 9: shokerAAss (229.44).
Player loolu has small blind (1)
Player IamPhamous has big blind (2)
Player IlxxxlI received card: [Jc]
Player IlxxxlI received card: [6h]
Player TonnaMunz folds
Player Iia007 folds
Player Gronkowski69 folds
Player MadLifeGrinder folds
Player aleaga raises (5)
Player shokerAAss folds
Player IlxxxlI folds
Player loolu folds
Player IamPhamous folds
Uncalled bet (3) returned to aleaga
Player aleaga mucks cards
------ Summary ------
Pot: 5. Rake 0
Player IlxxxlI does not show cards.Bets: 0. Collects: 0. Wins: 0.
Player loolu does not show cards.Bets: 1. Collects: 0. Loses: 1.
Player IamPhamous does not show cards.Bets: 2. Collects: 0. Loses: 2.
Player TonnaMunz does not show cards.Bets: 0. Collects: 0. Wins: 0.
Player Iia007 does not show cards.Bets: 0. Collects: 0. Wins: 0.
Player Gronkowski69 does not show cards.Bets: 0. Collects: 0. Wins: 0.
Player MadLifeGrinder does not show cards.Bets: 0. Collects: 0. Wins: 0.
*Player aleaga mucks (does not show cards). Bets: 2. Collects: 5. Wins: 3.
Player shokerAAss does not show cards.Bets: 0. Collects: 0. Wins: 0.
Game ended at: 2016/11/29 8:5:48

Game started
Game ID: 786727027 0.50/1 (PRR) Karkadann - 2 (Hold'em)
Seat 5 is the button
Seat 2: shokerAAss (104.44).
Seat 3: St3p04ka (174.36).
Seat 4: IlxxxlI (65.06).
Seat 5: Iia007 (86).
Seat 6: Winter is here (198.49).
Seat 7: aleaga (207.46).
Seat 8: Qrenor (249.65).
Seat 9: PeLanpapa (100).
Player Winter is here has small blind (0.50)
Player aleaga has big blind (1)
Player IlxxxlI received card: [Qh]
Player IlxxxlI received card: [Jd]
Player Qrenor folds
Player PeLanpapa folds
Player shokerAAss raises (3)
Player St3p04ka folds
Player IlxxxlI folds
Player Iia007 folds
Player Winter is here calls (2.50)
Player aleaga folds
*** FLOP ***: [5c Ks Ac]
Player Winter is here checks
Player shokerAAss checks
*** TURN ***: [5c Ks Ac] [Ad]
Player Winter is here bets (3.32)
Player shokerAAss folds
Uncalled bet (3.32) returned to Winter is here
Player Winter is here is timed out.
Player Winter is here mucks cards
------ Summary ------
Pot: 6.65. Rake 0.25. JP fee 0.10
Board: [5c Ks Ac Ad]
Player shokerAAss does not show cards.Bets: 3. Collects: 0. Loses: 3.
Player St3p04ka does not show cards.Bets: 0. Collects: 0. Wins: 0.
Player IlxxxlI does not show cards.Bets: 0. Collects: 0. Wins: 0.
Player Iia007 does not show cards.Bets: 0. Collects: 0. Wins: 0.
*Player Winter is here mucks (does not show cards). Bets: 3. Collects: 6.65. Wins: 3.65.
Player aleaga does not show cards.Bets: 1. Collects: 0. Loses: 1.
Player Qrenor does not show cards.Bets: 0. Collects: 0. Wins: 0.
Player PeLanpapa does not show cards.Bets: 0. Collects: 0. Wins: 0.
Game ended at: 2016/11/29 8:5:53

Game started
Game ID: 786726283 0.50/1 (PRR) Kraken (short) (Hold'em)
Seat 6 is the button
Seat 1: thethinmanlb (74.83).
Seat 2: St3p04ka (68.79).
Seat 3: BigBlat (45.07).
Seat 4: IlxxxlI (24.50).
Seat 5: Qrenor (73.10).
Seat 6: badboy85 (102.78).
Player thethinmanlb has small blind (0.50)
Player St3p04ka has big blind (1)
Player IlxxxlI received card: [Qd]
Player IlxxxlI received card: [2s]
Player BigBlat folds
Player IlxxxlI folds
Player Qrenor folds
Player badboy85 folds
Player thethinmanlb calls (0.50)
Player St3p04ka raises (3.60)
Player thethinmanlb calls (3.60)
*** FLOP ***: [2h Ad 10d]
Player thethinmanlb checks
Player St3p04ka checks
*** TURN ***: [2h Ad 10d] [6c]
Player thethinmanlb checks
Player St3p04ka checks
*** RIVER ***: [2h Ad 10d 6c] [2d]
Player thethinmanlb checks
Player St3p04ka checks
Player St3p04ka mucks cards
------ Summary ------
Pot: 8.74. Rake 0.32. JP fee 0.14
Board: [2h Ad 10d 6c 2d]
*Player thethinmanlb shows: One pair of 2s [8d Qh]. Bets: 4.60. Collects: 8.74. Wins: 4.14.
Player St3p04ka mucks (does not show cards). Bets: 4.60. Collects: 0. Loses: 4.60.
Player BigBlat does not show cards.Bets: 0. Collects: 0. Wins: 0.
Player IlxxxlI does not show cards.Bets: 0. Collects: 0. Wins: 0.
Player Qrenor does not show cards.Bets: 0. Collects: 0. Wins: 0.
Player badboy85 does not show cards.Bets: 0. Collects: 0. Wins: 0.
Game ended at: 2016/11/29 8:5:3

Game started
Game ID: 786726268 0.50/1 (PRR) Kraken - 2 (Hold'em)
Seat 1 is the button
Seat 1: MrCRABS333 (218.05).
Seat 3: St3p04ka (140.29).
Seat 4: Qrenor (385.37).
Seat 5: MadLifeGrinder (100).
Seat 6: IlxxxlI (42.10).
Player St3p04ka has small blind (0.50)
Player Qrenor has big blind (1)
Player IlxxxlI received card: [4h]
Player IlxxxlI received card: [3c]
Player MadLifeGrinder folds
Player IlxxxlI folds
Player MrCRABS333 folds
Player St3p04ka raises (2.60)
Player Qrenor raises (8.30)
Player St3p04ka raises (18.36)
Player Qrenor calls (12.16)
*** FLOP ***: [5c 8s 6d]
Player St3p04ka bets (21.97)
Player Qrenor calls (21.97)
*** TURN ***: [5c 8s 6d] [5h]
Player St3p04ka checks
Player Qrenor checks
*** RIVER ***: [5c 8s 6d 5h] [2h]
Player St3p04ka allin (96.86)
Player Qrenor folds
Uncalled bet (96.86) returned to St3p04ka
Player St3p04ka mucks cards
------ Summary ------
Pot: 83.86. Rake 2.76. JP fee 0.24
Board: [5c 8s 6d 5h 2h]
Player MrCRABS333 does not show cards.Bets: 0. Collects: 0. Wins: 0.
*Player St3p04ka mucks (does not show cards). Bets: 43.43. Collects: 83.86. Wins: 40.43.
Player Qrenor does not show cards.Bets: 43.43. Collects: 0. Loses: 43.43.
Player MadLifeGrinder does not show cards.Bets: 0. Collects: 0. Wins: 0.
Player IlxxxlI does not show cards.Bets: 0. Collects: 0. Wins: 0.
Game ended at: 2016/11/29 8:5:48

Game started
Game ID: 786725908 0.50/1 (PRR) Kraken - 2 (Hold'em)
Seat 6 is the button
Seat 1: MrCRABS333 (218.55).
Seat 2: AironVega (103.62).
Seat 3: St3p04ka (139.79).
Seat 4: Qrenor (385.37).
Seat 5: MadLifeGrinder (100).
Seat 6: IlxxxlI (42.10).
Player MrCRABS333 has small blind (0.50)
Player AironVega sitting out
Player St3p04ka has big blind (1)
Player IlxxxlI received card: [4s]
Player IlxxxlI received card: [8s]
Player Qrenor folds
Player MadLifeGrinder folds
Player IlxxxlI folds
Player MrCRABS333 folds
Uncalled bet (0.50) returned to St3p04ka
Player St3p04ka mucks cards
------ Summary ------
Pot: 1. Rake 0
Player MrCRABS333 does not show cards.Bets: 0.50. Collects: 0. Loses: 0.50.
Player AironVega does not show cards.Bets: 0. Collects: 0. Wins: 0.
*Player St3p04ka mucks (does not show cards). Bets: 0.50. Collects: 1. Wins: 0.50.
Player Qrenor does not show cards.Bets: 0. Collects: 0. Wins: 0.
Player MadLifeGrinder does not show cards.Bets: 0. Collects: 0. Wins: 0.
Player IlxxxlI does not show cards.Bets: 0. Collects: 0. Wins: 0.
Game ended at: 2016/11/29 8:3:56

Game started
Game ID: 786725905 0.50/1 (PRR) Kraken (short) (Hold'em)
Seat 5 is the button
Seat 1: thethinmanlb (74.33).
Seat 2: St3p04ka (68.79).
Seat 3: BigBlat (45.07).
Seat 4: IlxxxlI (24.50).
Seat 5: Qrenor (73.10).
Seat 6: badboy85 (103.28).
Player badboy85 has small blind (0.50)
Player thethinmanlb has big blind (1)
Player IlxxxlI received card: [10h]
Player IlxxxlI received card: [4s]
Player St3p04ka folds
Player BigBlat folds
Player IlxxxlI folds
Player Qrenor folds
Player badboy85 folds
Uncalled bet (0.50) returned to thethinmanlb
Player thethinmanlb mucks cards
------ Summary ------
Pot: 1. Rake 0
*Player thethinmanlb mucks (does not show cards). Bets: 0.50. Collects: 1. Wins: 0.50.
Player St3p04ka does not show cards.Bets: 0. Collects: 0. Wins: 0.
Player BigBlat does not show cards.Bets: 0. Collects: 0. Wins: 0.
Player IlxxxlI does not show cards.Bets: 0. Collects: 0. Wins: 0.
Player Qrenor does not show cards.Bets: 0. Collects: 0. Wins: 0.
Player badboy85 does not show cards.Bets: 0.50. Collects: 0. Loses: 0.50.
Game ended at: 2016/11/29 8:3:57

Game started
Game ID: 786725349 1/2 (PRR) Longana - 2 (Hold'em)
Seat 9 is the button
Seat 1: IlxxxlI (95.78).
Seat 2: loolu (207).
Seat 3: IamPhamous (196.57).
Seat 4: TonnaMunz (268.35).
Seat 5: Iia007 (258.86).
Seat 6: Gronkowski69 (301.25).
Seat 7: MadLifeGrinder (200).
Seat 8: aleaga (344.51).
Seat 9: shokerAAss (229.44).
Player IlxxxlI has small blind (1)
Player loolu has big blind (2)
Player IlxxxlI received card: [3h]
Player IlxxxlI received card: [As]
Player IamPhamous folds
Player TonnaMunz folds
Player Iia007 folds
Player Gronkowski69 folds
Player MadLifeGrinder folds
Player aleaga raises (4)
Player shokerAAss folds
Player IlxxxlI folds
Player loolu calls (2)
*** FLOP ***: [Kd Ad 5s]
Player loolu checks
Player aleaga checks
*** TURN ***: [Kd Ad 5s] [2c]
Player loolu bets (4.27)
Player aleaga calls (4.27)
*** RIVER ***: [Kd Ad 5s 2c] [Kh]
Player loolu bets (8.33)
Player aleaga folds
Uncalled bet (8.33) returned to loolu
Player loolu mucks cards
------ Summary ------
Pot: 16.67. Rake 0.63. JP fee 0.24
Board: [Kd Ad 5s 2c Kh]
Player IlxxxlI does not show cards.Bets: 1. Collects: 0. Loses: 1.
*Player loolu mucks (does not show cards). Bets: 8.27. Collects: 16.67. Wins: 8.40.
Player IamPhamous does not show cards.Bets: 0. Collects: 0. Wins: 0.
Player TonnaMunz does not show cards.Bets: 0. Collects: 0. Wins: 0.
Player Iia007 does not show cards.Bets: 0. Collects: 0. Wins: 0.
Player Gronkowski69 does not show cards.Bets: 0. Collects: 0. Wins: 0.
Player MadLifeGrinder does not show cards.Bets: 0. Collects: 0. Wins: 0.
Player aleaga does not show cards.Bets: 8.27. Collects: 0. Loses: 8.27.
Player shokerAAss does not show cards.Bets: 0. Collects: 0. Wins: 0.
Game ended at: 2016/11/29 8:5:2

Game started
Game ID: 786725254 0.50/1 (PRR) Kraken - 2 (Hold'em)
Seat 5 is the button
Seat 1: MrCRABS333 (219.55).
Seat 2: AironVega (103.62).
Seat 3: St3p04ka (139.79).
Seat 4: Qrenor (383.87).
Seat 5: MadLifeGrinder (100).
Seat 6: IlxxxlI (42.60).
Player IlxxxlI has small blind (0.50)
Player MrCRABS333 has big blind (1)
Player IlxxxlI received card: [6d]
Player IlxxxlI received card: [8c]
Player AironVega folds
Player St3p04ka folds
Player Qrenor raises (2.50)
Player MadLifeGrinder folds
Player IlxxxlI folds
Player MrCRABS333 folds
Uncalled bet (1.50) returned to Qrenor
Player Qrenor mucks cards
------ Summary ------
Pot: 2.50. Rake 0
Player MrCRABS333 does not show cards.Bets: 1. Collects: 0. Loses: 1.
Player AironVega does not show cards.Bets: 0. Collects: 0. Wins: 0.
Player St3p04ka does not show cards.Bets: 0. Collects: 0. Wins: 0.
*Player Qrenor mucks (does not show cards). Bets: 1. Collects: 2.50. Wins: 1.50.
Player MadLifeGrinder does not show cards.Bets: 0. Collects: 0. Wins: 0.
Player IlxxxlI does not show cards.Bets: 0.50. Collects: 0. Loses: 0.50.
Game ended at: 2016/11/29 8:3:32

Game started
Game ID: 786725031 0.50/1 (PRR) Karkadann - 2 (Hold'em)
Seat 4 is the button
Seat 2: shokerAAss (104.44).
Seat 3: St3p04ka (174.36).
Seat 4: IlxxxlI (49.71).
Seat 5: Iia007 (102).
Seat 6: Winter is here (199.49).
Seat 7: aleaga (207.46).
Seat 8: Qrenor (249.65).
Seat 9: PeLanpapa (100).
Player Iia007 has small blind (0.50)
Player Winter is here has big blind (1)
Player IlxxxlI received card: [Jc]
Player IlxxxlI received card: [Jd]
Player aleaga folds
Player Qrenor folds
Player PeLanpapa folds
Player shokerAAss folds
Player St3p04ka folds
Player IlxxxlI raises (3)
Player Iia007 raises (8.50)
Player Winter is here folds
Player IlxxxlI calls (6)
*** FLOP ***: [9s 3s 9h]
Player Iia007 bets (7)
Player IlxxxlI calls (7)
*** TURN ***: [9s 3s 9h] [Kc]
Player Iia007 checks
Player IlxxxlI checks
*** RIVER ***: [9s 3s 9h Kc] [4c]
Player Iia007 checks
Player IlxxxlI bets (7.52)
Player Iia007 folds
Uncalled bet (7.52) returned to IlxxxlI
Player IlxxxlI mucks cards
------ Summary ------
Pot: 31.35. Rake 1.41. JP fee 0.24
Board: [9s 3s 9h Kc 4c]
Player shokerAAss does not show cards.Bets: 0. Collects: 0. Wins: 0.
Player St3p04ka does not show cards.Bets: 0. Collects: 0. Wins: 0.
*Player IlxxxlI mucks (does not show cards). Bets: 16. Collects: 31.35. Wins: 15.35.
Player Iia007 does not show cards.Bets: 16. Collects: 0. Loses: 16.
Player Winter is here does not show cards.Bets: 1. Collects: 0. Loses: 1.
Player aleaga does not show cards.Bets: 0. Collects: 0. Wins: 0.
Player Qrenor does not show cards.Bets: 0. Collects: 0. Wins: 0.
Player PeLanpapa does not show cards.Bets: 0. Collects: 0. Wins: 0.
Game ended at: 2016/11/29 8:4:45

Game started
Game ID: 786724967 0.50/1 (PRR) Kraken (short) (Hold'em)
Seat 4 is the button
Seat 1: thethinmanlb (77.33).
Seat 2: St3p04ka (68.79).
Seat 3: BigBlat (45.07).
Seat 4: IlxxxlI (20).
Seat 5: Qrenor (73.60).
Seat 6: badboy85 (104.28).
Player Qrenor has small blind (0.50)
Player badboy85 has big blind (1)
Player IlxxxlI received card: [Kc]
Player IlxxxlI received card: [Ac]
Player thethinmanlb raises (3)
Player St3p04ka folds
Player BigBlat folds
Player IlxxxlI allin (20)
Player Qrenor folds
Player badboy85 folds
Player thethinmanlb folds
Uncalled bet (17) returned to IlxxxlI
Player IlxxxlI mucks cards
------ Summary ------
Pot: 7.50. Rake 0
Player thethinmanlb does not show cards.Bets: 3. Collects: 0. Loses: 3.
Player St3p04ka does not show cards.Bets: 0. Collects: 0. Wins: 0.
Player BigBlat does not show cards.Bets: 0. Collects: 0. Wins: 0.
*Player IlxxxlI mucks (does not show cards). Bets: 3. Collects: 7.50. Wins: 4.50.
Player Qrenor does not show cards.Bets: 0.50. Collects: 0. Loses: 0.50.
Player badboy85 does not show cards.Bets: 1. Collects: 0. Loses: 1.
Game ended at: 2016/11/29 8:3:31

Game started
Game ID: 786724663 0.50/1 (PRR) Kraken - 2 (Hold'em)
Seat 4 is the button
Seat 1: MrCRABS333 (219.55).
Seat 2: AironVega (103.62).
Seat 3: St3p04ka (139.79).
Seat 4: Qrenor (382.37).
Seat 5: MadLifeGrinder (100).
Seat 6: IlxxxlI (43.60).
Player MadLifeGrinder has small blind (0.50)
Player IlxxxlI has big blind (1)
Player IlxxxlI received card: [Ks]
Player IlxxxlI received card: [8d]
Player MrCRABS333 folds
Player AironVega folds
Player St3p04ka folds
Player Qrenor raises (2)
Player MadLifeGrinder folds
Player IlxxxlI folds
Uncalled bet (1) returned to Qrenor
Player Qrenor mucks cards
------ Summary ------
Pot: 2.50. Rake 0
Player MrCRABS333 does not show cards.Bets: 0. Collects: 0. Wins: 0.
Player AironVega does not show cards.Bets: 0. Collects: 0. Wins: 0.
Player St3p04ka does not show cards.Bets: 0. Collects: 0. Wins: 0.
*Player Qrenor mucks (does not show cards). Bets: 1. Collects: 2.50. Wins: 1.50.
Player MadLifeGrinder does not show cards.Bets: 0.50. Collects: 0. Loses: 0.50.
Player IlxxxlI does not show cards.Bets: 1. Collects: 0. Loses: 1.
Game ended at: 2016/11/29 8:2:48

Game started
Game ID: 786724597 0.50/1 (PRR) Karkadann - 2 (Hold'em)
Seat 3 is the button
Seat 2: shokerAAss (104.44).
Seat 3: St3p04ka (174.36).
Seat 4: IlxxxlI (50.21).
Seat 5: Iia007 (101.50).
Seat 6: Winter is here (199.49).
Seat 7: aleaga (207.46).
Seat 8: Qrenor (249.65).
Seat 9: PeLanpapa (100).
Player IlxxxlI has small blind (0.50)
Player Iia007 has big blind (1)
Player IlxxxlI received card: [Kd]
Player IlxxxlI received card: [6s]
Player Winter is here folds
Player aleaga folds
Player Qrenor folds
Player PeLanpapa folds
Player shokerAAss folds
Player St3p04ka folds
Player IlxxxlI folds
Uncalled bet (0.50) returned to Iia007
Player Iia007 mucks cards
------ Summary ------
Pot: 1. Rake 0
Player shokerAAss does not show cards.Bets: 0. Collects: 0. Wins: 0.
Player St3p04ka does not show cards.Bets: 0. Collects: 0. Wins: 0.
Player IlxxxlI does not show cards.Bets: 0.50. Collects: 0. Loses: 0.50.
*Player Iia007 mucks (does not show cards). Bets: 0.50. Collects: 1. Wins: 0.50.
Player Winter is here does not show cards.Bets: 0. Collects: 0. Wins: 0.
Player aleaga does not show cards.Bets: 0. Collects: 0. Wins: 0.
Player Qrenor does not show cards.Bets: 0. Collects: 0. Wins: 0.
Player PeLanpapa does not show cards.Bets: 0. Collects: 0. Wins: 0.
Game ended at: 2016/11/29 8:2:34

Game started
Game ID: 786724422 0.50/1 (PRR) Kraken (short) (Hold'em)
Seat 3 is the button
Seat 1: thethinmanlb (77.33).
Seat 2: St3p04ka (68.79).
Seat 3: BigBlat (47.07).
Seat 4: IlxxxlI (20.50).
Seat 5: Qrenor (71.10).
Seat 6: badboy85 (104.28).
Player IlxxxlI has small blind (0.50)
Player Qrenor has big blind (1)
Player IlxxxlI received card: [Qd]
Player IlxxxlI received card: [4s]
Player badboy85 folds
Player thethinmanlb folds
Player St3p04ka folds
Player BigBlat raises (2)
Player IlxxxlI folds
Player Qrenor raises (6)
Player BigBlat folds
Uncalled bet (5) returned to Qrenor
Player Qrenor mucks cards
------ Summary ------
Pot: 4.50. Rake 0
Player thethinmanlb does not show cards.Bets: 0. Collects: 0. Wins: 0.
Player St3p04ka does not show cards.Bets: 0. Collects: 0. Wins: 0.
Player BigBlat does not show cards.Bets: 2. Collects: 0. Loses: 2.
Player IlxxxlI does not show cards.Bets: 0.50. Collects: 0. Loses: 0.50.
*Player Qrenor mucks (does not show cards). Bets: 2. Collects: 4.50. Wins: 2.50.
Player badboy85 does not show cards.Bets: 0. Collects: 0. Wins: 0.
Game ended at: 2016/11/29 8:2:28

Game started
Game ID: 786724376 1/2 (PRR) Longana - 2 (Hold'em)
Seat 8 is the button
Seat 1: IlxxxlI (85.04).
Seat 2: loolu (207).
Seat 3: IamPhamous (196.57).
Seat 4: TonnaMunz (268.35).
Seat 5: Iia007 (258.86).
Seat 6: Gronkowski69 (301.25).
Seat 7: MadLifeGrinder (200).
Seat 8: aleaga (344.51).
Seat 9: shokerAAss (241.37).
Player shokerAAss has small blind (1)
Player IlxxxlI has big blind (2)
Player IlxxxlI received card: [Kd]
Player IlxxxlI received card: [10c]
Player loolu folds
Player IamPhamous folds
Player TonnaMunz folds
Player Iia007 folds
Player Gronkowski69 folds
Player MadLifeGrinder folds
Player aleaga folds
Player shokerAAss raises (5)
Player IlxxxlI calls (4)
*** FLOP ***: [7s Qh Jh]
Player shokerAAss checks
Player IlxxxlI bets (5.93)
Player shokerAAss calls (5.93)
*** TURN ***: [7s Qh Jh] [9c]
Player shokerAAss checks
Player IlxxxlI bets (12.47)
Player shokerAAss folds
Uncalled bet (12.47) returned to IlxxxlI
Player IlxxxlI mucks cards
------ Summary ------
Pot: 22.67. Rake 0.95. JP fee 0.24
Board: [7s Qh Jh 9c]
*Player IlxxxlI mucks (does not show cards). Bets: 11.93. Collects: 22.67. Wins: 10.74.
Player loolu does not show cards.Bets: 0. Collects: 0. Wins: 0.
Player IamPhamous does not show cards.Bets: 0. Collects: 0. Wins: 0.
Player TonnaMunz does not show cards.Bets: 0. Collects: 0. Wins: 0.
Player Iia007 does not show cards.Bets: 0. Collects: 0. Wins: 0.
Player Gronkowski69 does not show cards.Bets: 0. Collects: 0. Wins: 0.
Player MadLifeGrinder does not show cards.Bets: 0. Collects: 0. Wins: 0.
Player aleaga does not show cards.Bets: 0. Collects: 0. Wins: 0.
Player shokerAAss does not show cards.Bets: 11.93. Collects: 0. Loses: 11.93.
Game ended at: 2016/11/29 8:2:54

Game started
Game ID: 786724344 0.50/1 (PRR) Kraken - 2 (Hold'em)
Seat 3 is the button
Seat 1: MrCRABS333 (219.55).
Seat 2: AironVega (103.62).
Seat 3: St3p04ka (138.29).
Seat 4: Qrenor (382.87).
Seat 5: MadLifeGrinder (100).
Seat 6: IlxxxlI (43.60).
Player Qrenor has small blind (0.50)
Player MadLifeGrinder has big blind (1)
Player IlxxxlI received card: [Ac]
Player IlxxxlI received card: [5d]
Player IlxxxlI folds
Player MrCRABS333 folds
Player AironVega folds
Player St3p04ka raises (3.10)
Player Qrenor folds
Player MadLifeGrinder folds
Uncalled bet (2.10) returned to St3p04ka
Player St3p04ka mucks cards
------ Summary ------
Pot: 2.50. Rake 0
Player MrCRABS333 does not show cards.Bets: 0. Collects: 0. Wins: 0.
Player AironVega does not show cards.Bets: 0. Collects: 0. Wins: 0.
*Player St3p04ka mucks (does not show cards). Bets: 1. Collects: 2.50. Wins: 1.50.
Player Qrenor does not show cards.Bets: 0.50. Collects: 0. Loses: 0.50.
Player MadLifeGrinder does not show cards.Bets: 1. Collects: 0. Loses: 1.
Player IlxxxlI does not show cards.Bets: 0. Collects: 0. Wins: 0.
Game ended at: 2016/11/29 8:2:7

Game started
Game ID: 786724103 0.50/1 (PRR) Karkadann - 2 (Hold'em)
Seat 2 is the button
Seat 2: shokerAAss (104.44).
Seat 3: St3p04ka (174.86).
Seat 4: IlxxxlI (49.71).
Seat 5: Iia007 (101.50).
Seat 6: Winter is here (199.49).
Seat 7: aleaga (207.46).
Seat 8: Qrenor (249.65).
Seat 9: PeLanpapa (100).
Player St3p04ka has small blind (0.50)
Player IlxxxlI has big blind (1)
Player IlxxxlI received card: [Ac]
Player IlxxxlI received card: [4d]
Player Iia007 folds
Player Winter is here folds
Player aleaga folds
Player Qrenor folds
Player PeLanpapa folds
Player shokerAAss folds
Player St3p04ka folds
Uncalled bet (0.50) returned to IlxxxlI
Player IlxxxlI mucks cards
------ Summary ------
Pot: 1. Rake 0
Player shokerAAss does not show cards.Bets: 0. Collects: 0. Wins: 0.
Player St3p04ka does not show cards.Bets: 0.50. Collects: 0. Loses: 0.50.
*Player IlxxxlI mucks (does not show cards). Bets: 0.50. Collects: 1. Wins: 0.50.
Player Iia007 does not show cards.Bets: 0. Collects: 0. Wins: 0.
Player Winter is here does not show cards.Bets: 0. Collects: 0. Wins: 0.
Player aleaga does not show cards.Bets: 0. Collects: 0. Wins: 0.
Player Qrenor does not show cards.Bets: 0. Collects: 0. Wins: 0.
Player PeLanpapa does not show cards.Bets: 0. Collects: 0. Wins: 0.
Game ended at: 2016/11/29 8:2:1

Game started
Game ID: 786724019 0.50/1 (PRR) Kraken (short) (Hold'em)
Seat 2 is the button
Seat 1: thethinmanlb (77.33).
Seat 2: St3p04ka (67.29).
Seat 3: BigBlat (47.57).
Seat 4: IlxxxlI (21.50).
Seat 5: Qrenor (71.10).
Seat 6: badboy85 (104.28).
Player BigBlat has small blind (0.50)
Player IlxxxlI has big blind (1)
Player IlxxxlI received card: [7h]
Player IlxxxlI received card: [Qc]
Player Qrenor folds
Player badboy85 folds
Player thethinmanlb folds
Player St3p04ka raises (3.10)
Player BigBlat folds
Player IlxxxlI folds
Uncalled bet (2.10) returned to St3p04ka
Player St3p04ka mucks cards
------ Summary ------
Pot: 2.50. Rake 0
Player thethinmanlb does not show cards.Bets: 0. Collects: 0. Wins: 0.
*Player St3p04ka mucks (does not show cards). Bets: 1. Collects: 2.50. Wins: 1.50.
Player BigBlat does not show cards.Bets: 0.50. Collects: 0. Loses: 0.50.
Player IlxxxlI does not show cards.Bets: 1. Collects: 0. Loses: 1.
Player Qrenor does not show cards.Bets: 0. Collects: 0. Wins: 0.
Player badboy85 does not show cards.Bets: 0. Collects: 0. Wins: 0.
Game ended at: 2016/11/29 8:1:46

Game started
Game ID: 786723955 0.50/1 (PRR) Kraken - 2 (Hold'em)
Seat 2 is the button
Seat 1: MrCRABS333 (219.55).
Seat 2: AironVega (103.62).
Seat 3: St3p04ka (138.79).
Seat 4: Qrenor (382.37).
Seat 5: MadLifeGrinder (100).
Seat 6: IlxxxlI (43.60).
Player St3p04ka has small blind (0.50)
Player Qrenor has big blind (1)
Player IlxxxlI received card: [Jd]
Player IlxxxlI received card: [4d]
Player MadLifeGrinder folds
Player IlxxxlI folds
Player MrCRABS333 folds
Player AironVega folds
Player St3p04ka folds
Uncalled bet (0.50) returned to Qrenor
Player Qrenor mucks cards
------ Summary ------
Pot: 1. Rake 0
Player MrCRABS333 does not show cards.Bets: 0. Collects: 0. Wins: 0.
Player AironVega does not show cards.Bets: 0. Collects: 0. Wins: 0.
Player St3p04ka does not show cards.Bets: 0.50. Collects: 0. Loses: 0.50.
*Player Qrenor mucks (does not show cards). Bets: 0.50. Collects: 1. Wins: 0.50.
Player MadLifeGrinder does not show cards.Bets: 0. Collects: 0. Wins: 0.
Player IlxxxlI does not show cards.Bets: 0. Collects: 0. Wins: 0.
Game ended at: 2016/11/29 8:1:39

Game started
Game ID: 786723688 0.50/1 (PRR) Karkadann - 2 (Hold'em)
Seat 9 is the button
Seat 2: shokerAAss (104.94).
Seat 3: St3p04ka (175.86).
Seat 4: IlxxxlI (49.71).
Seat 5: Iia007 (100).
Seat 6: Winter is here (199.49).
Seat 7: aleaga (207.46).
Seat 8: Qrenor (249.65).
Seat 9: PeLanpapa (100).
Player shokerAAss has small blind (0.50)
Player St3p04ka has big blind (1)
Player IlxxxlI received card: [2s]
Player IlxxxlI received card: [6d]
Player IlxxxlI folds
Player Iia007 raises (3)
Player Winter is here folds
Player aleaga folds
Player Qrenor folds
Player PeLanpapa folds
Player shokerAAss folds
Player St3p04ka folds
Uncalled bet (2) returned to Iia007
Player Iia007 mucks cards
------ Summary ------
Pot: 2.50. Rake 0
Player shokerAAss does not show cards.Bets: 0.50. Collects: 0. Loses: 0.50.
Player St3p04ka does not show cards.Bets: 1. Collects: 0. Loses: 1.
Player IlxxxlI does not show cards.Bets: 0. Collects: 0. Wins: 0.
*Player Iia007 mucks (does not show cards). Bets: 1. Collects: 2.50. Wins: 1.50.
Player Winter is here does not show cards.Bets: 0. Collects: 0. Wins: 0.
Player aleaga does not show cards.Bets: 0. Collects: 0. Wins: 0.
Player Qrenor does not show cards.Bets: 0. Collects: 0. Wins: 0.
Player PeLanpapa does not show cards.Bets: 0. Collects: 0. Wins: 0.
Game ended at: 2016/11/29 8:1:26

Game started
Game ID: 786723548 0.50/1 (PRR) Kraken (short) (Hold'em)
Seat 1 is the button
Seat 1: thethinmanlb (75.83).
Seat 2: St3p04ka (67.79).
Seat 3: BigBlat (48.57).
Seat 4: IlxxxlI (21.50).
Seat 5: Qrenor (71.10).
Seat 6: badboy85 (104.28).
Player St3p04ka has small blind (0.50)
Player BigBlat has big blind (1)
Player IlxxxlI received card: [4c]
Player IlxxxlI received card: [3c]
Player IlxxxlI folds
Player Qrenor folds
Player badboy85 folds
Player thethinmanlb raises (3)
Player St3p04ka folds
Player BigBlat folds
Uncalled bet (2) returned to thethinmanlb
Player thethinmanlb mucks cards
------ Summary ------
Pot: 2.50. Rake 0
*Player thethinmanlb mucks (does not show cards). Bets: 1. Collects: 2.50. Wins: 1.50.
Player St3p04ka does not show cards.Bets: 0.50. Collects: 0. Loses: 0.50.
Player BigBlat does not show cards.Bets: 1. Collects: 0. Loses: 1.
Player IlxxxlI does not show cards.Bets: 0. Collects: 0. Wins: 0.
Player Qrenor does not show cards.Bets: 0. Collects: 0. Wins: 0.
Player badboy85 does not show cards.Bets: 0. Collects: 0. Wins: 0.
Game ended at: 2016/11/29 8:1:18

Game started
Game ID: 786723306 0.50/1 (PRR) Kraken - 2 (Hold'em)
Seat 1 is the button
Seat 1: MrCRABS333 (222.05).
Seat 2: AironVega (104.12).
Seat 3: St3p04ka (136.06).
Seat 4: Qrenor (382.37).
Seat 5: MadLifeGrinder (100).
Seat 6: IlxxxlI (43.60).
Player AironVega has small blind (0.50)
Player St3p04ka has big blind (1)
Player IlxxxlI received card: [10c]
Player IlxxxlI received card: [4d]
Player Qrenor folds
Player MadLifeGrinder folds
Player IlxxxlI folds
Player MrCRABS333 raises (2.50)
Player AironVega folds
Player St3p04ka calls (1.50)
*** FLOP ***: [Kh 9c 10d]
Player St3p04ka checks
Player MrCRABS333 checks
*** TURN ***: [Kh 9c 10d] [3c]
Player St3p04ka bets (3.95)
Player MrCRABS333 folds
Uncalled bet (3.95) returned to St3p04ka
Player St3p04ka mucks cards
------ Summary ------
Pot: 5.23. Rake 0.19. JP fee 0.08
Board: [Kh 9c 10d 3c]
Player MrCRABS333 does not show cards.Bets: 2.50. Collects: 0. Loses: 2.50.
Player AironVega does not show cards.Bets: 0.50. Collects: 0. Loses: 0.50.
*Player St3p04ka mucks (does not show cards). Bets: 2.50. Collects: 5.23. Wins: 2.73.
Player Qrenor does not show cards.Bets: 0. Collects: 0. Wins: 0.
Player MadLifeGrinder does not show cards.Bets: 0. Collects: 0. Wins: 0.
Player IlxxxlI does not show cards.Bets: 0. Collects: 0. Wins: 0.
Game ended at: 2016/11/29 8:1:16

Game started
Game ID: 786723027 0.50/1 (PRR) Karkadann - 2 (Hold'em)
Seat 8 is the button
Seat 1: MadLifeGrinder (100).
Seat 2: shokerAAss (105.94).
Seat 3: St3p04ka (183.39).
Seat 4: IlxxxlI (41.50).
Seat 5: Iia007 (100).
Seat 6: Winter is here (199.49).
Seat 7: aleaga (207.46).
Seat 8: Qrenor (249.65).
Seat 9: PeLanpapa (100).
Player PeLanpapa has small blind (0.50)
Player MadLifeGrinder sitting out
Player shokerAAss has big blind (1)
Player IlxxxlI received card: [Ah]
Player IlxxxlI received card: [Ks]
Player St3p04ka raises (3.10)
Player IlxxxlI raises (7.53)
Player Iia007 folds
Player Winter is here folds
Player aleaga folds
Player Qrenor folds
Player PeLanpapa folds
Player shokerAAss folds
Player St3p04ka calls (4.43)
*** FLOP ***: [6h Ad 9d]
Player St3p04ka checks
Player IlxxxlI bets (5.24)
Player St3p04ka folds
Uncalled bet (5.24) returned to IlxxxlI
Player IlxxxlI mucks cards
------ Summary ------
Pot: 15.74. Rake 0.58. JP fee 0.24
Board: [6h Ad 9d]
Player MadLifeGrinder does not show cards.Bets: 0. Collects: 0. Wins: 0.
Player shokerAAss does not show cards.Bets: 1. Collects: 0. Loses: 1.
Player St3p04ka does not show cards.Bets: 7.53. Collects: 0. Loses: 7.53.
*Player IlxxxlI mucks (does not show cards). Bets: 7.53. Collects: 15.74. Wins: 8.21.
Player Iia007 does not show cards.Bets: 0. Collects: 0. Wins: 0.
Player Winter is here does not show cards.Bets: 0. Collects: 0. Wins: 0.
Player aleaga does not show cards.Bets: 0. Collects: 0. Wins: 0.
Player Qrenor does not show cards.Bets: 0. Collects: 0. Wins: 0.
Player PeLanpapa does not show cards.Bets: 0.50. Collects: 0. Loses: 0.50.
Game ended at: 2016/11/29 8:0:53

Game started
Game ID: 786722851 1/2 (PRR) Longana - 2 (Hold'em)
Seat 7 is the button
Seat 1: IlxxxlI (85.04).
Seat 2: loolu (207).
Seat 3: IamPhamous (196.57).
Seat 4: TonnaMunz (268.35).
Seat 5: Iia007 (202.25).
Seat 6: Gronkowski69 (301.25).
Seat 7: MadLifeGrinder (200).
Seat 8: aleaga (345.51).
Seat 9: shokerAAss (299.98).
Player aleaga has small blind (1)
Player shokerAAss has big blind (2)
Player IlxxxlI received card: [Ad]
Player IlxxxlI received card: [3s]
Player IlxxxlI folds
Player loolu folds
Player IamPhamous folds
Player TonnaMunz folds
Player Iia007 raises (6)
Player Gronkowski69 folds
Player MadLifeGrinder folds
Player aleaga folds
Player shokerAAss raises (16)
Player Iia007 calls (12)
*** FLOP ***: [6c 6d Kh]
Player shokerAAss bets (17.57)
Player Iia007 calls (17.57)
*** TURN ***: [6c 6d Kh] [7c]
Player shokerAAss checks
Player Iia007 bets (23.04)
Player shokerAAss calls (23.04)
*** RIVER ***: [6c 6d Kh 7c] [Jh]
Player shokerAAss checks
Player Iia007 bets (76.81)
Player shokerAAss folds
Uncalled bet (76.81) returned to Iia007
Player Iia007 mucks cards
------ Summary ------
Pot: 115.22. Rake 2.76. JP fee 0.24
Board: [6c 6d Kh 7c Jh]
Player IlxxxlI does not show cards.Bets: 0. Collects: 0. Wins: 0.
Player loolu does not show cards.Bets: 0. Collects: 0. Wins: 0.
Player IamPhamous does not show cards.Bets: 0. Collects: 0. Wins: 0.
Player TonnaMunz does not show cards.Bets: 0. Collects: 0. Wins: 0.
*Player Iia007 mucks (does not show cards). Bets: 58.61. Collects: 115.22. Wins: 56.61.
Player Gronkowski69 does not show cards.Bets: 0. Collects: 0. Wins: 0.
Player MadLifeGrinder does not show cards.Bets: 0. Collects: 0. Wins: 0.
Player aleaga does not show cards.Bets: 1. Collects: 0. Loses: 1.
Player shokerAAss does not show cards.Bets: 58.61. Collects: 0. Loses: 58.61.
Game ended at: 2016/11/29 8:1:42

Game started
Game ID: 786722663 0.50/1 (PRR) Karkadann - 2 (Hold'em)
Seat 7 is the button
Seat 1: MadLifeGrinder (100).
Seat 2: shokerAAss (104.44).
Seat 3: St3p04ka (183.39).
Seat 4: IlxxxlI (41.50).
Seat 5: Iia007 (100).
Seat 6: Winter is here (199.49).
Seat 7: aleaga (207.46).
Seat 8: Qrenor (250.15).
Seat 9: PeLanpapa (100).
Player Qrenor has small blind (0.50)
Player PeLanpapa has big blind (1)
Player IlxxxlI received card: [Ks]
Player IlxxxlI received card: [8h]
Player MadLifeGrinder folds
Player shokerAAss raises (3)
Player St3p04ka folds
Player IlxxxlI folds
Player Iia007 folds
Player Winter is here folds
Player aleaga folds
Player Qrenor folds
Player PeLanpapa folds
Uncalled bet (2) returned to shokerAAss
Player shokerAAss mucks cards
------ Summary ------
Pot: 2.50. Rake 0
Player MadLifeGrinder does not show cards.Bets: 0. Collects: 0. Wins: 0.
*Player shokerAAss mucks (does not show cards). Bets: 1. Collects: 2.50. Wins: 1.50.
Player St3p04ka does not show cards.Bets: 0. Collects: 0. Wins: 0.
Player IlxxxlI does not show cards.Bets: 0. Collects: 0. Wins: 0.
Player Iia007 does not show cards.Bets: 0. Collects: 0. Wins: 0.
Player Winter is here does not show cards.Bets: 0. Collects: 0. Wins: 0.
Player aleaga does not show cards.Bets: 0. Collects: 0. Wins: 0.
Player Qrenor does not show cards.Bets: 0.50. Collects: 0. Loses: 0.50.
Player PeLanpapa does not show cards.Bets: 1. Collects: 0. Loses: 1.
Game ended at: 2016/11/29 7:59:50

Game started
Game ID: 786722646 1/2 (PRR) Longana - 2 (Hold'em)
Seat 6 is the button
Seat 1: IlxxxlI (85.04).
Seat 2: loolu (207).
Seat 3: IamPhamous (196.57).
Seat 4: TonnaMunz (268.35).
Seat 5: Iia007 (202.25).
Seat 6: Gronkowski69 (301.25).
Seat 7: MadLifeGrinder (200).
Seat 8: aleaga (347.51).
Seat 9: shokerAAss (296.98).
Player MadLifeGrinder has small blind (1)
Player aleaga has big blind (2)
Player IlxxxlI received card: [10s]
Player IlxxxlI received card: [Kc]
Player shokerAAss raises (6)
Player IlxxxlI folds
Player loolu folds
Player IamPhamous folds
Player TonnaMunz folds
Player Iia007 folds
Player Gronkowski69 folds
Player MadLifeGrinder folds
Player aleaga folds
Uncalled bet (4) returned to shokerAAss
Player shokerAAss mucks cards
------ Summary ------
Pot: 5. Rake 0
Player IlxxxlI does not show cards.Bets: 0. Collects: 0. Wins: 0.
Player loolu does not show cards.Bets: 0. Collects: 0. Wins: 0.
Player IamPhamous does not show cards.Bets: 0. Collects: 0. Wins: 0.
Player TonnaMunz does not show cards.Bets: 0. Collects: 0. Wins: 0.
Player Iia007 does not show cards.Bets: 0. Collects: 0. Wins: 0.
Player Gronkowski69 does not show cards.Bets: 0. Collects: 0. Wins: 0.
Player MadLifeGrinder does not show cards.Bets: 1. Collects: 0. Loses: 1.
Player aleaga does not show cards.Bets: 2. Collects: 0. Loses: 2.
*Player shokerAAss mucks (does not show cards). Bets: 2. Collects: 5. Wins: 3.
Game ended at: 2016/11/29 7:59:29

Game started
Game ID: 786722510 0.50/1 (PRR) Kraken (short) (Hold'em)
Seat 6 is the button
Seat 1: thethinmanlb (66.97).
Seat 2: St3p04ka (77.63).
Seat 3: BigBlat (48.57).
Seat 4: IlxxxlI (21.50).
Seat 5: Qrenor (71.10).
Seat 6: badboy85 (104.28).
Player thethinmanlb has small blind (0.50)
Player St3p04ka has big blind (1)
Player IlxxxlI received card: [4c]
Player IlxxxlI received card: [8c]
Player BigBlat folds
Player IlxxxlI folds
Player Qrenor folds
Player badboy85 folds
Player thethinmanlb calls (0.50)
Player St3p04ka raises (3.60)
Player thethinmanlb calls (3.60)
*** FLOP ***: [5s Qd 8d]
Player thethinmanlb checks
Player St3p04ka bets (5.24)
Player thethinmanlb calls (5.24)
*** TURN ***: [5s Qd 8d] [9d]
Player thethinmanlb checks
Player St3p04ka checks
*** RIVER ***: [5s Qd 8d 9d] [3s]
Player thethinmanlb bets (14)
Player St3p04ka folds
Uncalled bet (14) returned to thethinmanlb
Player thethinmanlb mucks cards
------ Summary ------
Pot: 18.70. Rake 0.74. JP fee 0.24
Board: [5s Qd 8d 9d 3s]
*Player thethinmanlb mucks (does not show cards). Bets: 9.84. Collects: 18.70. Wins: 8.86.
Player St3p04ka does not show cards.Bets: 9.84. Collects: 0. Loses: 9.84.
Player BigBlat does not show cards.Bets: 0. Collects: 0. Wins: 0.
Player IlxxxlI does not show cards.Bets: 0. Collects: 0. Wins: 0.
Player Qrenor does not show cards.Bets: 0. Collects: 0. Wins: 0.
Player badboy85 does not show cards.Bets: 0. Collects: 0. Wins: 0.
Game ended at: 2016/11/29 8:0:42

Game started
Game ID: 786722208 0.50/1 (PRR) Kraken - 2 (Hold'em)
Seat 6 is the button
Seat 1: MrCRABS333 (222.55).
Seat 2: AironVega (110.20).
Seat 3: St3p04ka (136.06).
Seat 4: Qrenor (370.64).
Seat 5: MadLifeGrinder (100).
Seat 6: IlxxxlI (49.68).
Player MrCRABS333 has small blind (0.50)
Player AironVega has big blind (1)
Player IlxxxlI received card: [Qh]
Player IlxxxlI received card: [Ad]
Player St3p04ka is timed out.
Player St3p04ka folds
Player Qrenor raises (2.50)
Player MadLifeGrinder folds
Player IlxxxlI raises (6.08)
Player MrCRABS333 folds
Player AironVega calls (5.08)
Player Qrenor calls (3.58)
*** FLOP ***: [9h 5h 2h]
Player AironVega checks
Player Qrenor allin (364.56)
Player IlxxxlI folds
Player AironVega folds
Uncalled bet (364.56) returned to Qrenor
Player Qrenor mucks cards
------ Summary ------
Pot: 17.81. Rake 0.69. JP fee 0.24
Board: [9h 5h 2h]
Player MrCRABS333 does not show cards.Bets: 0.50. Collects: 0. Loses: 0.50.
Player AironVega does not show cards.Bets: 6.08. Collects: 0. Loses: 6.08.
Player St3p04ka does not show cards.Bets: 0. Collects: 0. Wins: 0.
*Player Qrenor mucks (does not show cards). Bets: 6.08. Collects: 17.81. Wins: 11.73.
Player MadLifeGrinder does not show cards.Bets: 0. Collects: 0. Wins: 0.
Player IlxxxlI does not show cards.Bets: 6.08. Collects: 0. Loses: 6.08.
Game ended at: 2016/11/29 8:0:19

Game started
Game ID: 786722176 0.50/1 (PRR) Kraken (short) (Hold'em)
Seat 5 is the button
Seat 1: thethinmanlb (62.76).
Seat 2: St3p04ka (77.63).
Seat 3: BigBlat (48.57).
Seat 4: IlxxxlI (21.50).
Seat 5: Qrenor (75.24).
Seat 6: badboy85 (104.78).
Player badboy85 has small blind (0.50)
Player thethinmanlb has big blind (1)
Player IlxxxlI received card: [8c]
Player IlxxxlI received card: [5c]
Player St3p04ka folds
Player BigBlat folds
Player IlxxxlI folds
Player Qrenor raises (2)
Player badboy85 folds
Player thethinmanlb calls (1)
*** FLOP ***: [3h 10s 6d]
Player thethinmanlb checks
Player Qrenor bets (2.14)
Player thethinmanlb raises (6.42)
Player Qrenor folds
Uncalled bet (4.28) returned to thethinmanlb
Player thethinmanlb mucks cards
------ Summary ------
Pot: 8.35. Rake 0.29. JP fee 0.14
Board: [3h 10s 6d]
*Player thethinmanlb mucks (does not show cards). Bets: 4.14. Collects: 8.35. Wins: 4.21.
Player St3p04ka does not show cards.Bets: 0. Collects: 0. Wins: 0.
Player BigBlat does not show cards.Bets: 0. Collects: 0. Wins: 0.
Player IlxxxlI does not show cards.Bets: 0. Collects: 0. Wins: 0.
Player Qrenor does not show cards.Bets: 4.14. Collects: 0. Loses: 4.14.
Player badboy85 does not show cards.Bets: 0.50. Collects: 0. Loses: 0.50.
Game ended at: 2016/11/29 7:58:49

Game started
Game ID: 786722067 0.50/1 (PRR) Karkadann - 2 (Hold'em)
Seat 6 is the button
Seat 1: MadLifeGrinder (100).
Seat 2: shokerAAss (104.44).
Seat 3: St3p04ka (183.39).
Seat 4: IlxxxlI (40).
Seat 5: Iia007 (100).
Seat 6: Winter is here (199.49).
Seat 7: aleaga (207.96).
Seat 8: Qrenor (251.15).
Player aleaga has small blind (0.50)
Player Qrenor has big blind (1)
Player IlxxxlI received card: [Kd]
Player IlxxxlI received card: [Js]
Player MadLifeGrinder folds
Player shokerAAss folds
Player St3p04ka folds
Player IlxxxlI raises (3.50)
Player Iia007 folds
Player Winter is here folds
Player aleaga folds
Player Qrenor folds
Uncalled bet (2.50) returned to IlxxxlI
Player IlxxxlI mucks cards
------ Summary ------
Pot: 2.50. Rake 0
Player MadLifeGrinder does not show cards.Bets: 0. Collects: 0. Wins: 0.
Player shokerAAss does not show cards.Bets: 0. Collects: 0. Wins: 0.
Player St3p04ka does not show cards.Bets: 0. Collects: 0. Wins: 0.
*Player IlxxxlI mucks (does not show cards). Bets: 1. Collects: 2.50. Wins: 1.50.
Player Iia007 does not show cards.Bets: 0. Collects: 0. Wins: 0.
Player Winter is here does not show cards.Bets: 0. Collects: 0. Wins: 0.
Player aleaga does not show cards.Bets: 0.50. Collects: 0. Loses: 0.50.
Player Qrenor does not show cards.Bets: 1. Collects: 0. Loses: 1.
Game ended at: 2016/11/29 7:59:7

Game started
Game ID: 786721971 1/2 (PRR) Longana - 2 (Hold'em)
Seat 5 is the button
Seat 1: IlxxxlI (85.04).
Seat 2: loolu (213).
Seat 3: IamPhamous (133.55).
Seat 4: TonnaMunz (268.35).
Seat 5: Iia007 (202.25).
Seat 6: Gronkowski69 (302.25).
Seat 7: MadLifeGrinder (205.40).
Seat 8: aleaga (347.51).
Seat 9: shokerAAss (296.98).
Player Gronkowski69 has small blind (1)
Player MadLifeGrinder has big blind (2)
Player IlxxxlI received card: [7h]
Player IlxxxlI received card: [8c]
Player aleaga folds
Player shokerAAss folds
Player IlxxxlI folds
Player loolu raises (6)
Player IamPhamous calls (6)
Player TonnaMunz folds
Player Iia007 folds
Player Gronkowski69 folds
Player MadLifeGrinder calls (4)
*** FLOP ***: [Qd 3d Ac]
Player MadLifeGrinder checks
Player loolu checks
Player IamPhamous bets (9.02)
Player MadLifeGrinder calls (9.02)
Player loolu folds
*** TURN ***: [Qd 3d Ac] [9c]
Player MadLifeGrinder checks
Player IamPhamous bets (17.59)
Player MadLifeGrinder raises (44)
Player IamPhamous allin (100.94)
Player MadLifeGrinder folds
Uncalled bet (74.53) returned to IamPhamous
Player IamPhamous mucks cards
------ Summary ------
Pot: 122.04. Rake 2.76. JP fee 0.24
Board: [Qd 3d Ac 9c]
Player IlxxxlI does not show cards.Bets: 0. Collects: 0. Wins: 0.
Player loolu does not show cards.Bets: 6. Collects: 0. Loses: 6.
*Player IamPhamous mucks (does not show cards). Bets: 59.02. Collects: 122.04. Wins: 63.02.
Player TonnaMunz does not show cards.Bets: 0. Collects: 0. Wins: 0.
Player Iia007 does not show cards.Bets: 0. Collects: 0. Wins: 0.
Player Gronkowski69 does not show cards.Bets: 1. Collects: 0. Loses: 1.
Player MadLifeGrinder does not show cards.Bets: 59.02. Collects: 0. Loses: 59.02.
Player aleaga does not show cards.Bets: 0. Collects: 0. Wins: 0.
Player shokerAAss does not show cards.Bets: 0. Collects: 0. Wins: 0.
Game ended at: 2016/11/29 7:59:6

Game started
Game ID: 786721880 0.50/1 (PRR) Kraken - 2 (Hold'em)
Seat 5 is the button
Seat 1: MrCRABS333 (221.55).
Seat 2: AironVega (110.20).
Seat 3: St3p04ka (136.06).
Seat 4: Qrenor (370.64).
Seat 5: MadLifeGrinder (100).
Seat 6: IlxxxlI (50.68).
Player IlxxxlI has small blind (0.50)
Player MrCRABS333 has big blind (1)
Player IlxxxlI received card: [9d]
Player IlxxxlI received card: [Js]
Player AironVega folds
Player St3p04ka folds
Player Qrenor folds
Player MadLifeGrinder folds
Player IlxxxlI calls (0.50)
Player MrCRABS333 raises (2)
Player IlxxxlI folds
Uncalled bet (2) returned to MrCRABS333
Player MrCRABS333 mucks cards
------ Summary ------
Pot: 2. Rake 0
*Player MrCRABS333 mucks (does not show cards). Bets: 1. Collects: 2. Wins: 1.
Player AironVega does not show cards.Bets: 0. Collects: 0. Wins: 0.
Player St3p04ka does not show cards.Bets: 0. Collects: 0. Wins: 0.
Player Qrenor does not show cards.Bets: 0. Collects: 0. Wins: 0.
Player MadLifeGrinder does not show cards.Bets: 0. Collects: 0. Wins: 0.
Player IlxxxlI does not show cards.Bets: 1. Collects: 0. Loses: 1.
Game ended at: 2016/11/29 7:58:10

Game started
Game ID: 786721802 0.50/1 (PRR) Kraken (short) (Hold'em)
Seat 4 is the button
Seat 1: thethinmanlb (62.76).
Seat 2: St3p04ka (77.63).
Seat 3: BigBlat (48.57).
Seat 4: IlxxxlI (20).
Seat 5: Qrenor (75.74).
Seat 6: badboy85 (105.78).
Player Qrenor has small blind (0.50)
Player badboy85 has big blind (1)
Player IlxxxlI received card: [5h]
Player IlxxxlI received card: [5s]
Player thethinmanlb folds
Player St3p04ka folds
Player BigBlat folds
Player IlxxxlI allin (20)
Player Qrenor folds
Player badboy85 folds
Uncalled bet (19) returned to IlxxxlI
Player IlxxxlI mucks cards
------ Summary ------
Pot: 2.50. Rake 0
Player thethinmanlb does not show cards.Bets: 0. Collects: 0. Wins: 0.
Player St3p04ka does not show cards.Bets: 0. Collects: 0. Wins: 0.
Player BigBlat does not show cards.Bets: 0. Collects: 0. Wins: 0.
*Player IlxxxlI mucks (does not show cards). Bets: 1. Collects: 2.50. Wins: 1.50.
Player Qrenor does not show cards.Bets: 0.50. Collects: 0. Loses: 0.50.
Player badboy85 does not show cards.Bets: 1. Collects: 0. Loses: 1.
Game ended at: 2016/11/29 7:58:7

Game started
Game ID: 786721695 1/2 (PRR) Longana - 2 (Hold'em)
Seat 4 is the button
Seat 1: IlxxxlI (85.04).
Seat 2: loolu (213).
Seat 3: IamPhamous (133.55).
Seat 4: TonnaMunz (268.35).
Seat 5: Iia007 (203.25).
Seat 6: Gronkowski69 (301.25).
Seat 7: MadLifeGrinder (205.40).
Seat 8: aleaga (347.51).
Seat 9: shokerAAss (296.98).
Player Iia007 has small blind (1)
Player Gronkowski69 has big blind (2)
Player IlxxxlI received card: [Ac]
Player IlxxxlI received card: [9h]
Player MadLifeGrinder folds
Player aleaga folds
Player shokerAAss folds
Player IlxxxlI folds
Player loolu folds
Player IamPhamous folds
Player TonnaMunz folds
Player Iia007 folds
Uncalled bet (1) returned to Gronkowski69
Player Gronkowski69 mucks cards
------ Summary ------
Pot: 2. Rake 0
Player IlxxxlI does not show cards.Bets: 0. Collects: 0. Wins: 0.
Player loolu does not show cards.Bets: 0. Collects: 0. Wins: 0.
Player IamPhamous does not show cards.Bets: 0. Collects: 0. Wins: 0.
Player TonnaMunz does not show cards.Bets: 0. Collects: 0. Wins: 0.
Player Iia007 does not show cards.Bets: 1. Collects: 0. Loses: 1.
*Player Gronkowski69 mucks (does not show cards). Bets: 1. Collects: 2. Wins: 1.
Player MadLifeGrinder does not show cards.Bets: 0. Collects: 0. Wins: 0.
Player aleaga does not show cards.Bets: 0. Collects: 0. Wins: 0.
Player shokerAAss does not show cards.Bets: 0. Collects: 0. Wins: 0.
Game ended at: 2016/11/29 7:57:44

Game started
Game ID: 786721388 0.50/1 (PRR) Kraken (short) (Hold'em)
Seat 3 is the button
Seat 1: thethinmanlb (62.76).
Seat 2: St3p04ka (76.13).
Seat 3: BigBlat (48.57).
Seat 4: IlxxxlI (20).
Seat 5: Qrenor (76.74).
Seat 6: badboy85 (105.78).
Player IlxxxlI has small blind (0.50)
Player Qrenor has big blind (1)
Player IlxxxlI received card: [10s]
Player IlxxxlI received card: [10d]
Player badboy85 folds
Player thethinmanlb folds
Player St3p04ka raises (3.10)
Player BigBlat folds
Player IlxxxlI folds
Player Qrenor folds
Uncalled bet (2.10) returned to St3p04ka
Player St3p04ka mucks cards
------ Summary ------
Pot: 2.50. Rake 0
Player thethinmanlb does not show cards.Bets: 0. Collects: 0. Wins: 0.
*Player St3p04ka mucks (does not show cards). Bets: 1. Collects: 2.50. Wins: 1.50.
Player BigBlat does not show cards.Bets: 0. Collects: 0. Wins: 0.
Player IlxxxlI does not show cards.Bets: 0.50. Collects: 0. Loses: 0.50.
Player Qrenor does not show cards.Bets: 1. Collects: 0. Loses: 1.
Player badboy85 does not show cards.Bets: 0. Collects: 0. Wins: 0.
Game ended at: 2016/11/29 7:57:23

Game started
Game ID: 786721295 0.50/1 (PRR) Karkadann - 2 (Hold'em)
Seat 5 is the button
Seat 1: MadLifeGrinder (100).
Seat 2: shokerAAss (104.44).
Seat 3: St3p04ka (183.39).
Seat 4: IlxxxlI (40).
Seat 5: Iia007 (100).
Seat 6: Winter is here (199.99).
Seat 7: aleaga (203.75).
Seat 8: Qrenor (251.15).
Player Winter is here has small blind (0.50)
Player aleaga has big blind (1)
Player IlxxxlI received card: [2s]
Player IlxxxlI received card: [Kd]
Player Qrenor folds
Player MadLifeGrinder folds
Player shokerAAss folds
Player St3p04ka folds
Player IlxxxlI folds
Player Iia007 raises (2)
Player Winter is here folds
Player aleaga calls (1)
*** FLOP ***: [5h 10s 3s]
Player aleaga checks
Player Iia007 checks
*** TURN ***: [5h 10s 3s] [4d]
Player aleaga checks
Player Iia007 bets (2.14)
Player aleaga raises (8.50)
Player Iia007 folds
Uncalled bet (6.36) returned to aleaga
Player aleaga mucks cards
------ Summary ------
Pot: 8.35. Rake 0.29. JP fee 0.14
Board: [5h 10s 3s 4d]
Player MadLifeGrinder does not show cards.Bets: 0. Collects: 0. Wins: 0.
Player shokerAAss does not show cards.Bets: 0. Collects: 0. Wins: 0.
Player St3p04ka does not show cards.Bets: 0. Collects: 0. Wins: 0.
Player IlxxxlI does not show cards.Bets: 0. Collects: 0. Wins: 0.
Player Iia007 does not show cards.Bets: 4.14. Collects: 0. Loses: 4.14.
Player Winter is here does not show cards.Bets: 0.50. Collects: 0. Loses: 0.50.
*Player aleaga mucks (does not show cards). Bets: 4.14. Collects: 8.35. Wins: 4.21.
Player Qrenor does not show cards.Bets: 0. Collects: 0. Wins: 0.
Game ended at: 2016/11/29 7:57:55

Game started
Game ID: 786721122 0.50/1 (PRR) Kraken - 2 (Hold'em)
Seat 4 is the button
Seat 1: MrCRABS333 (179.55).
Seat 2: AironVega (110.20).
Seat 3: St3p04ka (143.56).
Seat 4: Qrenor (378.14).
Seat 5: MadLifeGrinder (103.05).
Seat 6: IlxxxlI (51.68).
Player MadLifeGrinder has small blind (0.50)
Player IlxxxlI has big blind (1)
Player IlxxxlI received card: [Qs]
Player IlxxxlI received card: [2s]
Player MrCRABS333 raises (3)
Player AironVega folds
Player St3p04ka raises (7.50)
Player Qrenor calls (7.50)
Player MadLifeGrinder raises (25.50)
Player IlxxxlI folds
Player MrCRABS333 allin (176.55)
Player St3p04ka folds
Player Qrenor folds
Player MadLifeGrinder folds
Uncalled bet (153.55) returned to MrCRABS333
Player MrCRABS333 mucks cards
------ Summary ------
Pot: 68. Rake 0
*Player MrCRABS333 mucks (does not show cards). Bets: 26. Collects: 68. Wins: 42.
Player AironVega does not show cards.Bets: 0. Collects: 0. Wins: 0.
Player St3p04ka does not show cards.Bets: 7.50. Collects: 0. Loses: 7.50.
Player Qrenor does not show cards.Bets: 7.50. Collects: 0. Loses: 7.50.
Player MadLifeGrinder does not show cards.Bets: 26. Collects: 0. Loses: 26.
Player IlxxxlI does not show cards.Bets: 1. Collects: 0. Loses: 1.
Game ended at: 2016/11/29 7:57:33

Game started
Game ID: 786720997 0.50/1 (PRR) Kraken (short) (Hold'em)
Seat 2 is the button
Seat 1: thethinmanlb (62.76).
Seat 2: St3p04ka (74.63).
Seat 3: BigBlat (49.07).
Seat 4: IlxxxlI (20).
Seat 5: Qrenor (76.74).
Seat 6: badboy85 (105.78).
Player BigBlat has small blind (0.50)
Player IlxxxlI has big blind (1)
Player IlxxxlI received card: [Qd]
Player IlxxxlI received card: [5s]
Player Qrenor folds
Player badboy85 folds
Player thethinmanlb folds
Player St3p04ka raises (3.10)
Player BigBlat folds
Player IlxxxlI folds
Uncalled bet (2.10) returned to St3p04ka
Player St3p04ka mucks cards
------ Summary ------
Pot: 2.50. Rake 0
Player thethinmanlb does not show cards.Bets: 0. Collects: 0. Wins: 0.
*Player St3p04ka mucks (does not show cards). Bets: 1. Collects: 2.50. Wins: 1.50.
Player BigBlat does not show cards.Bets: 0.50. Collects: 0. Loses: 0.50.
Player IlxxxlI does not show cards.Bets: 1. Collects: 0. Loses: 1.
Player Qrenor does not show cards.Bets: 0. Collects: 0. Wins: 0.
Player badboy85 does not show cards.Bets: 0. Collects: 0. Wins: 0.
Game ended at: 2016/11/29 7:56:32

Game started
Game ID: 786720965 1/2 (PRR) Longana - 2 (Hold'em)
Seat 3 is the button
Seat 1: IlxxxlI (85.04).
Seat 2: loolu (219).
Seat 3: IamPhamous (124.55).
Seat 4: TonnaMunz (269.35).
Seat 5: Iia007 (205.25).
Seat 6: Gronkowski69 (301.25).
Seat 7: MadLifeGrinder (205.40).
Seat 8: aleaga (347.51).
Seat 9: shokerAAss (296.98).
Player TonnaMunz has small blind (1)
Player Iia007 has big blind (2)
Player IlxxxlI received card: [9h]
Player IlxxxlI received card: [6s]
Player Gronkowski69 folds
Player MadLifeGrinder folds
Player aleaga folds
Player shokerAAss folds
Player IlxxxlI folds
Player loolu raises (6)
Player IamPhamous raises (18)
Player TonnaMunz folds
Player Iia007 folds
Player loolu folds
Uncalled bet (12) returned to IamPhamous
Player IamPhamous mucks cards
------ Summary ------
Pot: 15. Rake 0
Player IlxxxlI does not show cards.Bets: 0. Collects: 0. Wins: 0.
Player loolu does not show cards.Bets: 6. Collects: 0. Loses: 6.
*Player IamPhamous mucks (does not show cards). Bets: 6. Collects: 15. Wins: 9.
Player TonnaMunz does not show cards.Bets: 1. Collects: 0. Loses: 1.
Player Iia007 does not show cards.Bets: 2. Collects: 0. Loses: 2.
Player Gronkowski69 does not show cards.Bets: 0. Collects: 0. Wins: 0.
Player MadLifeGrinder does not show cards.Bets: 0. Collects: 0. Wins: 0.
Player aleaga does not show cards.Bets: 0. Collects: 0. Wins: 0.
Player shokerAAss does not show cards.Bets: 0. Collects: 0. Wins: 0.
Game ended at: 2016/11/29 7:57:9

Game started
Game ID: 786720794 0.50/1 (PRR) Karkadann - 2 (Hold'em)
Seat 4 is the button
Seat 1: MadLifeGrinder (100).
Seat 2: shokerAAss (104.44).
Seat 3: St3p04ka (183.39).
Seat 4: IlxxxlI (40).
Seat 5: Iia007 (100).
Seat 6: Winter is here (200.99).
Seat 7: aleaga (203.75).
Seat 8: Qrenor (249.65).
Player Iia007 has small blind (0.50)
Player Winter is here has big blind (1)
Player IlxxxlI received card: [4h]
Player IlxxxlI received card: [Qd]
Player aleaga folds
Player Qrenor raises (3)
Player MadLifeGrinder folds
Player shokerAAss folds
Player St3p04ka folds
Player IlxxxlI folds
Player Iia007 folds
Player Winter is here folds
Uncalled bet (2) returned to Qrenor
Player Qrenor mucks cards
------ Summary ------
Pot: 2.50. Rake 0
Player MadLifeGrinder does not show cards.Bets: 0. Collects: 0. Wins: 0.
Player shokerAAss does not show cards.Bets: 0. Collects: 0. Wins: 0.
Player St3p04ka does not show cards.Bets: 0. Collects: 0. Wins: 0.
Player IlxxxlI does not show cards.Bets: 0. Collects: 0. Wins: 0.
Player Iia007 does not show cards.Bets: 0.50. Collects: 0. Loses: 0.50.
Player Winter is here does not show cards.Bets: 1. Collects: 0. Loses: 1.
Player aleaga does not show cards.Bets: 0. Collects: 0. Wins: 0.
*Player Qrenor mucks (does not show cards). Bets: 1. Collects: 2.50. Wins: 1.50.
Game ended at: 2016/11/29 7:56:20

Game started
Game ID: 786720602 1/2 (PRR) Lakhey (Cap) (Hold'em)
Seat 1 is the button
Seat 1: wethco (154.40).
Seat 2: plin777 (105.10).
Seat 3: BigBlat (107.66).
Seat 5: coldkilla (69.83).
Seat 6: IlxxxlI (110.95).
Player plin777 has small blind (1)
Player BigBlat has big blind (2)
Player IlxxxlI received card: [10d]
Player IlxxxlI received card: [8s]
Player coldkilla folds
Player IlxxxlI folds
Player wethco folds
Player plin777 raises (3)
Player BigBlat folds
Uncalled bet (2) returned to plin777
Player plin777 mucks cards
------ Summary ------
Pot: 4. Rake 0
Player wethco does not show cards.Bets: 0. Collects: 0. Wins: 0.
*Player plin777 mucks (does not show cards). Bets: 2. Collects: 4. Wins: 2.
Player BigBlat does not show cards.Bets: 2. Collects: 0. Loses: 2.
Player coldkilla does not show cards.Bets: 0. Collects: 0. Wins: 0.
Player IlxxxlI does not show cards.Bets: 0. Collects: 0. Wins: 0.
Game ended at: 2016/11/29 7:55:32

Game started
Game ID: 786720488 0.50/1 (PRR) Kraken (short) (Hold'em)
Seat 1 is the button
Seat 1: thethinmanlb (71.26).
Seat 2: St3p04ka (66.03).
Seat 3: BigBlat (50.07).
Seat 4: IlxxxlI (20).
Seat 5: Qrenor (76.74).
Seat 6: badboy85 (105.78).
Player St3p04ka has small blind (0.50)
Player BigBlat has big blind (1)
Player IlxxxlI received card: [7d]
Player IlxxxlI received card: [Qc]
Player IlxxxlI folds
Player Qrenor folds
Player badboy85 folds
Player thethinmanlb raises (3)
Player St3p04ka raises (8)
Player BigBlat folds
Player thethinmanlb calls (5.50)
*** FLOP ***: [Js 8c 9d]
Player St3p04ka bets (8.76)
Player thethinmanlb folds
Uncalled bet (8.76) returned to St3p04ka
Player St3p04ka mucks cards
------ Summary ------
Pot: 17.10. Rake 0.66. JP fee 0.24
Board: [Js 8c 9d]
Player thethinmanlb does not show cards.Bets: 8.50. Collects: 0. Loses: 8.50.
*Player St3p04ka mucks (does not show cards). Bets: 8.50. Collects: 17.10. Wins: 8.60.
Player BigBlat does not show cards.Bets: 1. Collects: 0. Loses: 1.
Player IlxxxlI does not show cards.Bets: 0. Collects: 0. Wins: 0.
Player Qrenor does not show cards.Bets: 0. Collects: 0. Wins: 0.
Player badboy85 does not show cards.Bets: 0. Collects: 0. Wins: 0.
Game ended at: 2016/11/29 7:55:46

Game started
Game ID: 786720170 1/2 (PRR) Lakhey (Cap) (Hold'em)
Seat 6 is the button
Seat 1: wethco (152.60).
Seat 2: plin777 (107.10).
Seat 3: BigBlat (107.66).
Seat 5: coldkilla (69.83).
Seat 6: IlxxxlI (110.95).
Player wethco has small blind (1)
Player plin777 has big blind (2)
Player IlxxxlI received card: [9c]
Player IlxxxlI received card: [5h]
Player BigBlat folds
Player coldkilla folds
Player IlxxxlI folds
Player wethco calls (1)
Player plin777 checks
*** FLOP ***: [3s Qh 8h]
Player wethco bets (2)
Player plin777 folds
Uncalled bet (2) returned to wethco
Player wethco mucks cards
------ Summary ------
Pot: 3.80. Rake 0.14. JP fee 0.06
Board: [3s Qh 8h]
*Player wethco mucks (does not show cards). Bets: 2. Collects: 3.80. Wins: 1.80.
Player plin777 does not show cards.Bets: 2. Collects: 0. Loses: 2.
Player BigBlat does not show cards.Bets: 0. Collects: 0. Wins: 0.
Player coldkilla does not show cards.Bets: 0. Collects: 0. Wins: 0.
Player IlxxxlI does not show cards.Bets: 0. Collects: 0. Wins: 0.
Game ended at: 2016/11/29 7:55:3

Game started
Game ID: 786720155 0.50/1 (PRR) Karkadann - 2 (Hold'em)
Seat 3 is the button
Seat 1: MadLifeGrinder (100).
Seat 2: shokerAAss (102.94).
Seat 3: St3p04ka (183.39).
Seat 4: IlxxxlI (40).
Seat 5: Iia007 (100).
Seat 6: Winter is here (200.99).
Seat 7: aleaga (203.75).
Seat 8: Qrenor (249.65).
Player IlxxxlI has small blind (0.50)
Player Iia007 has big blind (1)
Player IlxxxlI received card: [3s]
Player IlxxxlI received card: [5d]
Player Winter is here folds
Player aleaga folds
Player Qrenor folds
Player MadLifeGrinder folds
Player shokerAAss raises (3)
Player St3p04ka folds
Player IlxxxlI folds
Player Iia007 folds
Uncalled bet (2) returned to shokerAAss
Player shokerAAss mucks cards
------ Summary ------
Pot: 2.50. Rake 0
Player MadLifeGrinder does not show cards.Bets: 0. Collects: 0. Wins: 0.
*Player shokerAAss mucks (does not show cards). Bets: 1. Collects: 2.50. Wins: 1.50.
Player St3p04ka does not show cards.Bets: 0. Collects: 0. Wins: 0.
Player IlxxxlI does not show cards.Bets: 0.50. Collects: 0. Loses: 0.50.
Player Iia007 does not show cards.Bets: 1. Collects: 0. Loses: 1.
Player Winter is here does not show cards.Bets: 0. Collects: 0. Wins: 0.
Player aleaga does not show cards.Bets: 0. Collects: 0. Wins: 0.
Player Qrenor does not show cards.Bets: 0. Collects: 0. Wins: 0.
Game ended at: 2016/11/29 7:55:23

Game started
Game ID: 786720015 1/2 (PRR) Longana - 2 (Hold'em)
Seat 2 is the button
Seat 1: IlxxxlI (85.04).
Seat 2: loolu (198).
Seat 3: IamPhamous (125.55).
Seat 4: TonnaMunz (271.35).
Seat 5: Iia007 (211.25).
Seat 6: Gronkowski69 (301.25).
Seat 7: MadLifeGrinder (205.40).
Seat 8: aleaga (353.51).
Seat 9: shokerAAss (302.98).
Player IamPhamous has small blind (1)
Player TonnaMunz has big blind (2)
Player IlxxxlI received card: [Jh]
Player IlxxxlI received card: [5c]
Player Iia007 raises (6)
Player Gronkowski69 folds
Player MadLifeGrinder folds
Player aleaga calls (6)
Player shokerAAss calls (6)
Player IlxxxlI folds
Player loolu raises (22)
Player IamPhamous folds
Player TonnaMunz folds
Player Iia007 folds
Player aleaga folds
Player shokerAAss folds
Uncalled bet (16) returned to loolu
Player loolu mucks cards
------ Summary ------
Pot: 27. Rake 0
Player IlxxxlI does not show cards.Bets: 0. Collects: 0. Wins: 0.
*Player loolu mucks (does not show cards). Bets: 6. Collects: 27. Wins: 21.
Player IamPhamous does not show cards.Bets: 1. Collects: 0. Loses: 1.
Player TonnaMunz does not show cards.Bets: 2. Collects: 0. Loses: 2.
Player Iia007 does not show cards.Bets: 6. Collects: 0. Loses: 6.
Player Gronkowski69 does not show cards.Bets: 0. Collects: 0. Wins: 0.
Player MadLifeGrinder does not show cards.Bets: 0. Collects: 0. Wins: 0.
Player aleaga does not show cards.Bets: 6. Collects: 0. Loses: 6.
Player shokerAAss does not show cards.Bets: 6. Collects: 0. Loses: 6.
Game ended at: 2016/11/29 7:55:42

Game started
Game ID: 786719947 0.50/1 (PRR) Kraken - 2 (Hold'em)
Seat 3 is the button
Seat 1: MrCRABS333 (179.55).
Seat 2: AironVega (110.20).
Seat 3: St3p04ka (100).
Seat 4: Qrenor (423.70).
Seat 5: MadLifeGrinder (104.05).
Seat 6: IlxxxlI (51.68).
Player Qrenor has small blind (0.50)
Player MadLifeGrinder has big blind (1)
Player IlxxxlI received card: [6d]
Player IlxxxlI received card: [7d]
Player IlxxxlI folds
Player MrCRABS333 folds
Player AironVega folds
Player St3p04ka raises (3.10)
Player Qrenor raises (9.80)
Player MadLifeGrinder folds
Player St3p04ka calls (7.20)
*** FLOP ***: [Ac 2h 6s]
Player Qrenor bets (10.26)
Player St3p04ka calls (10.26)
*** TURN ***: [Ac 2h 6s] [5h]
Player Qrenor bets (25)
Player St3p04ka allin (79.44)
Player Qrenor folds
Uncalled bet (54.44) returned to St3p04ka
Player St3p04ka mucks cards
------ Summary ------
Pot: 89.12. Rake 2.76. JP fee 0.24
Board: [Ac 2h 6s 5h]
Player MrCRABS333 does not show cards.Bets: 0. Collects: 0. Wins: 0.
Player AironVega does not show cards.Bets: 0. Collects: 0. Wins: 0.
*Player St3p04ka mucks (does not show cards). Bets: 45.56. Collects: 89.12. Wins: 43.56.
Player Qrenor does not show cards.Bets: 45.56. Collects: 0. Loses: 45.56.
Player MadLifeGrinder does not show cards.Bets: 1. Collects: 0. Loses: 1.
Player IlxxxlI does not show cards.Bets: 0. Collects: 0. Wins: 0.
Game ended at: 2016/11/29 7:56:0

Game started
Game ID: 786719770 0.50/1 (PRR) Kraken (short) (Hold'em)
Seat 6 is the button
Seat 1: thethinmanlb (69.33).
Seat 2: St3p04ka (68.17).
Seat 3: BigBlat (50.07).
Seat 4: IlxxxlI (20).
Seat 5: Qrenor (76.74).
Seat 6: badboy85 (105.78).
Player thethinmanlb has small blind (0.50)
Player St3p04ka has big blind (1)
Player IlxxxlI received card: [Ks]
Player IlxxxlI received card: [6d]
Player BigBlat folds
Player IlxxxlI folds
Player Qrenor folds
Player badboy85 folds
Player thethinmanlb calls (0.50)
Player St3p04ka checks
*** FLOP ***: [8s 4c 4d]
Player thethinmanlb checks
Player St3p04ka bets (1.14)
Player thethinmanlb raises (3.42)
Player St3p04ka folds
Uncalled bet (2.28) returned to thethinmanlb
Player thethinmanlb mucks cards
------ Summary ------
Pot: 4.07. Rake 0.15. JP fee 0.06
Board: [8s 4c 4d]
*Player thethinmanlb mucks (does not show cards). Bets: 2.14. Collects: 4.07. Wins: 1.93.
Player St3p04ka does not show cards.Bets: 2.14. Collects: 0. Loses: 2.14.
Player BigBlat does not show cards.Bets: 0. Collects: 0. Wins: 0.
Player IlxxxlI does not show cards.Bets: 0. Collects: 0. Wins: 0.
Player Qrenor does not show cards.Bets: 0. Collects: 0. Wins: 0.
Player badboy85 does not show cards.Bets: 0. Collects: 0. Wins: 0.
Game ended at: 2016/11/29 7:54:50

Game started
Game ID: 786719672 0.50/1 (PRR) Karkadann - 2 (Hold'em)
Seat 2 is the button
Seat 1: MadLifeGrinder (100).
Seat 2: shokerAAss (102.94).
Seat 3: St3p04ka (182.39).
Seat 4: IlxxxlI (40).
Seat 5: Iia007 (100).
Seat 6: Winter is here (200.99).
Seat 7: aleaga (203.75).
Seat 8: Qrenor (249.65).
Player St3p04ka has small blind (0.50)
Player IlxxxlI has big blind (1)
Player IlxxxlI received card: [7s]
Player IlxxxlI received card: [2c]
Player Iia007 folds
Player Winter is here folds
Player aleaga folds
Player Qrenor folds
Player MadLifeGrinder folds
Player shokerAAss folds
Player St3p04ka raises (2.60)
Player IlxxxlI folds
Uncalled bet (2.10) returned to St3p04ka
Player St3p04ka mucks cards
------ Summary ------
Pot: 2. Rake 0
Player MadLifeGrinder does not show cards.Bets: 0. Collects: 0. Wins: 0.
Player shokerAAss does not show cards.Bets: 0. Collects: 0. Wins: 0.
*Player St3p04ka mucks (does not show cards). Bets: 1. Collects: 2. Wins: 1.
Player IlxxxlI does not show cards.Bets: 1. Collects: 0. Loses: 1.
Player Iia007 does not show cards.Bets: 0. Collects: 0. Wins: 0.
Player Winter is here does not show cards.Bets: 0. Collects: 0. Wins: 0.
Player aleaga does not show cards.Bets: 0. Collects: 0. Wins: 0.
Player Qrenor does not show cards.Bets: 0. Collects: 0. Wins: 0.
Game ended at: 2016/11/29 7:54:27

Game started
Game ID: 786719511 0.50/1 (PRR) Kraken (short) (Hold'em)
Seat 5 is the button
Seat 1: thethinmanlb (68.83).
Seat 2: St3p04ka (68.17).
Seat 3: BigBlat (50.07).
Seat 4: IlxxxlI (20).
Seat 5: Qrenor (76.74).
Seat 6: badboy85 (106.28).
Player badboy85 has small blind (0.50)
Player thethinmanlb has big blind (1)
Player IlxxxlI received card: [7s]
Player IlxxxlI received card: [2d]
Player St3p04ka folds
Player BigBlat folds
Player IlxxxlI folds
Player Qrenor folds
Player badboy85 folds
Uncalled bet (0.50) returned to thethinmanlb
Player thethinmanlb mucks cards
------ Summary ------
Pot: 1. Rake 0
*Player thethinmanlb mucks (does not show cards). Bets: 0.50. Collects: 1. Wins: 0.50.
Player St3p04ka does not show cards.Bets: 0. Collects: 0. Wins: 0.
Player BigBlat does not show cards.Bets: 0. Collects: 0. Wins: 0.
Player IlxxxlI does not show cards.Bets: 0. Collects: 0. Wins: 0.
Player Qrenor does not show cards.Bets: 0. Collects: 0. Wins: 0.
Player badboy85 does not show cards.Bets: 0.50. Collects: 0. Loses: 0.50.
Game ended at: 2016/11/29 7:53:59

Game started
Game ID: 786719417 1/2 (PRR) Longana - 2 (Hold'em)
Seat 1 is the button
Seat 1: IlxxxlI (85.04).
Seat 2: loolu (199).
Seat 3: IamPhamous (127.55).
Seat 4: TonnaMunz (271.35).
Seat 5: Iia007 (203).
Seat 6: Gronkowski69 (301.25).
Seat 7: MadLifeGrinder (211.40).
Seat 8: aleaga (353.51).
Seat 9: shokerAAss (302.98).
Player loolu has small blind (1)
Player IamPhamous has big blind (2)
Player IlxxxlI received card: [Kd]
Player IlxxxlI received card: [7c]
Player TonnaMunz folds
Player Iia007 raises (6)
Player Gronkowski69 folds
Player MadLifeGrinder calls (6)
Player aleaga folds
Player shokerAAss folds
Player IlxxxlI folds
Player loolu folds
Player IamPhamous folds
*** FLOP ***: [3d 10c 5d]
Player Iia007 bets (10)
Player MadLifeGrinder folds
Uncalled bet (10) returned to Iia007
Player Iia007 mucks cards
------ Summary ------
Pot: 14.25. Rake 0.51. JP fee 0.24
Board: [3d 10c 5d]
Player IlxxxlI does not show cards.Bets: 0. Collects: 0. Wins: 0.
Player loolu does not show cards.Bets: 1. Collects: 0. Loses: 1.
Player IamPhamous does not show cards.Bets: 2. Collects: 0. Loses: 2.
Player TonnaMunz does not show cards.Bets: 0. Collects: 0. Wins: 0.
*Player Iia007 mucks (does not show cards). Bets: 6. Collects: 14.25. Wins: 8.25.
Player Gronkowski69 does not show cards.Bets: 0. Collects: 0. Wins: 0.
Player MadLifeGrinder does not show cards.Bets: 6. Collects: 0. Loses: 6.
Player aleaga does not show cards.Bets: 0. Collects: 0. Wins: 0.
Player shokerAAss does not show cards.Bets: 0. Collects: 0. Wins: 0.
Game ended at: 2016/11/29 7:54:17

Game started
Game ID: 786719080 0.50/1 (PRR) Kraken (short) (Hold'em)
Seat 4 is the button
Seat 1: thethinmanlb (67.33).
Seat 2: St3p04ka (68.17).
Seat 3: BigBlat (50.07).
Seat 4: IlxxxlI (20).
Seat 5: Qrenor (77.24).
Seat 6: badboy85 (107.28).
Player Qrenor has small blind (0.50)
Player badboy85 has big blind (1)
Player IlxxxlI received card: [Qd]
Player IlxxxlI received card: [4s]
Player thethinmanlb raises (3)
Player St3p04ka folds
Player BigBlat folds
Player IlxxxlI folds
Player Qrenor folds
Player badboy85 folds
Uncalled bet (2) returned to thethinmanlb
Player thethinmanlb mucks cards
------ Summary ------
Pot: 2.50. Rake 0
*Player thethinmanlb mucks (does not show cards). Bets: 1. Collects: 2.50. Wins: 1.50.
Player St3p04ka does not show cards.Bets: 0. Collects: 0. Wins: 0.
Player BigBlat does not show cards.Bets: 0. Collects: 0. Wins: 0.
Player IlxxxlI does not show cards.Bets: 0. Collects: 0. Wins: 0.
Player Qrenor does not show cards.Bets: 0.50. Collects: 0. Loses: 0.50.
Player badboy85 does not show cards.Bets: 1. Collects: 0. Loses: 1.
Game ended at: 2016/11/29 7:53:42

Game started
Game ID: 786718969 1/2 (PRR) Lakhey (Cap) (Hold'em)
Seat 5 is the button
Seat 1: wethco (166.73).
Seat 2: plin777 (111.10).
Seat 3: BigBlat (121.79).
Seat 5: coldkilla (69.83).
Seat 6: IlxxxlI (81).
Player IlxxxlI has small blind (1)
Player wethco has big blind (2)
Player IlxxxlI received card: [7s]
Player IlxxxlI received card: [7c]
Player plin777 raises (4)
Player BigBlat calls (4)
Player coldkilla folds
Player IlxxxlI calls (3)
Player wethco calls (2)
*** FLOP ***: [10s 5c 7d]
Player IlxxxlI checks
Player wethco checks
Player plin777 checks
Player BigBlat bets (10.13)
Player IlxxxlI calls (10.13)
Player wethco calls (10.13)
Player plin777 folds
*** TURN ***: [10s 5c 7d] [9d]
Player IlxxxlI bets (26)
Player wethco folds
Player BigBlat folds
Uncalled bet (26) returned to IlxxxlI
Player IlxxxlI mucks cards
------ Summary ------
Pot: 44.08. Rake 2.07. JP fee 0.24
Board: [10s 5c 7d 9d]
Player wethco does not show cards.Bets: 14.13. Collects: 0. Loses: 14.13.
Player plin777 does not show cards.Bets: 4. Collects: 0. Loses: 4.
Player BigBlat does not show cards.Bets: 14.13. Collects: 0. Loses: 14.13.
Player coldkilla does not show cards.Bets: 0. Collects: 0. Wins: 0.
*Player IlxxxlI mucks (does not show cards). Bets: 14.13. Collects: 44.08. Wins: 29.95.
Game ended at: 2016/11/29 7:54:28

Game started
Game ID: 786718932 1/2 (PRR) Longana - 2 (Hold'em)
Seat 9 is the button
Seat 1: IlxxxlI (86.04).
Seat 2: loolu (201).
Seat 3: IamPhamous (127.55).
Seat 4: TonnaMunz (271.35).
Seat 5: Iia007 (203).
Seat 6: Gronkowski69 (301.25).
Seat 7: MadLifeGrinder (208.40).
Seat 8: aleaga (353.51).
Seat 9: shokerAAss (302.98).
Player IlxxxlI has small blind (1)
Player loolu has big blind (2)
Player IlxxxlI received card: [Kh]
Player IlxxxlI received card: [6h]
Player IamPhamous folds
Player TonnaMunz folds
Player Iia007 folds
Player Gronkowski69 folds
Player MadLifeGrinder raises (5)
Player aleaga folds
Player shokerAAss folds
Player IlxxxlI folds
Player loolu folds
Uncalled bet (3) returned to MadLifeGrinder
Player MadLifeGrinder mucks cards
------ Summary ------
Pot: 5. Rake 0
Player IlxxxlI does not show cards.Bets: 1. Collects: 0. Loses: 1.
Player loolu does not show cards.Bets: 2. Collects: 0. Loses: 2.
Player IamPhamous does not show cards.Bets: 0. Collects: 0. Wins: 0.
Player TonnaMunz does not show cards.Bets: 0. Collects: 0. Wins: 0.
Player Iia007 does not show cards.Bets: 0. Collects: 0. Wins: 0.
Player Gronkowski69 does not show cards.Bets: 0. Collects: 0. Wins: 0.
*Player MadLifeGrinder mucks (does not show cards). Bets: 2. Collects: 5. Wins: 3.
Player aleaga does not show cards.Bets: 0. Collects: 0. Wins: 0.
Player shokerAAss does not show cards.Bets: 0. Collects: 0. Wins: 0.
Game ended at: 2016/11/29 7:53:36

Game started
Game ID: 786718653 0.50/1 (PRR) Kraken - 2 (Hold'em)
Seat 2 is the button
Seat 1: MrCRABS333 (179.55).
Seat 2: AironVega (106.65).
Seat 3: St3p04ka (100).
Seat 4: Qrenor (427.11).
Seat 5: MadLifeGrinder (104.05).
Seat 6: IlxxxlI (51.68).
Player St3p04ka has small blind (0.50)
Player Qrenor has big blind (1)
Player IlxxxlI received card: [3c]
Player IlxxxlI received card: [6d]
Player MadLifeGrinder folds
Player IlxxxlI folds
Player MrCRABS333 folds
Player AironVega raises (2)
Player St3p04ka folds
Player Qrenor calls (1)
*** FLOP ***: [2s Qd 8h]
Player Qrenor checks
Player AironVega bets (1.41)
Player Qrenor calls (1.41)
*** TURN ***: [2s Qd 8h] [5c]
Player Qrenor checks
Player AironVega bets (4.59)
Player Qrenor folds
Uncalled bet (4.59) returned to AironVega
Player AironVega mucks cards
------ Summary ------
Pot: 6.96. Rake 0.24. JP fee 0.12
Board: [2s Qd 8h 5c]
Player MrCRABS333 does not show cards.Bets: 0. Collects: 0. Wins: 0.
*Player AironVega mucks (does not show cards). Bets: 3.41. Collects: 6.96. Wins: 3.55.
Player St3p04ka does not show cards.Bets: 0.50. Collects: 0. Loses: 0.50.
Player Qrenor does not show cards.Bets: 3.41. Collects: 0. Loses: 3.41.
Player MadLifeGrinder does not show cards.Bets: 0. Collects: 0. Wins: 0.
Player IlxxxlI does not show cards.Bets: 0. Collects: 0. Wins: 0.
Game ended at: 2016/11/29 7:54:11

Game started
Game ID: 786718137 0.50/1 (PRR) Karkadann - 2 (Hold'em)
Seat 1 is the button
Seat 1: MadLifeGrinder (100).
Seat 2: shokerAAss (103.44).
Seat 3: St3p04ka (185.39).
Seat 4: IlxxxlI (40).
Seat 5: Iia007 (103.50).
Seat 6: Winter is here (175.16).
Seat 7: aleaga (203.75).
Seat 8: Qrenor (249.65).
Player shokerAAss has small blind (0.50)
Player St3p04ka has big blind (1)
Player IlxxxlI received card: [8d]
Player IlxxxlI received card: [3d]
Player IlxxxlI folds
Player Iia007 raises (3)
Player Winter is here calls (3)
Player aleaga folds
Player Qrenor folds
Player MadLifeGrinder folds
Player shokerAAss folds
Player St3p04ka calls (2)
*** FLOP ***: [Jd 10h 7d]
Player St3p04ka checks
Player Iia007 bets (7)
Player Winter is here calls (7)
Player St3p04ka folds
*** TURN ***: [Jd 10h 7d] [10s]
Player Iia007 bets (15)
Player Winter is here calls (15)
*** RIVER ***: [Jd 10h 7d 10s] [6c]
Player Iia007 checks
Player Winter is here bets (25.41)
Player Iia007 folds
Uncalled bet (25.41) returned to Winter is here
Player Winter is here mucks cards
------ Summary ------
Pot: 50.83. Rake 2.43. JP fee 0.24
Board: [Jd 10h 7d 10s 6c]
Player MadLifeGrinder does not show cards.Bets: 0. Collects: 0. Wins: 0.
Player shokerAAss does not show cards.Bets: 0.50. Collects: 0. Loses: 0.50.
Player St3p04ka does not show cards.Bets: 3. Collects: 0. Loses: 3.
Player IlxxxlI does not show cards.Bets: 0. Collects: 0. Wins: 0.
Player Iia007 does not show cards.Bets: 25. Collects: 0. Loses: 25.
*Player Winter is here mucks (does not show cards). Bets: 25. Collects: 50.83. Wins: 25.83.
Player aleaga does not show cards.Bets: 0. Collects: 0. Wins: 0.
Player Qrenor does not show cards.Bets: 0. Collects: 0. Wins: 0.
Game ended at: 2016/11/29 7:53:52

Game started
Game ID: 786718086 0.50/1 (PRR) Kraken - 2 (Hold'em)
Seat 1 is the button
Seat 1: MrCRABS333 (175.55).
Seat 2: AironVega (107.15).
Seat 3: St3p04ka (100).
Seat 4: Qrenor (427.11).
Seat 5: MadLifeGrinder (106.55).
Seat 6: IlxxxlI (51.68).
Player AironVega has small blind (0.50)
Player St3p04ka has big blind (1)
Player IlxxxlI received card: [5s]
Player IlxxxlI received card: [2h]
Player Qrenor folds
Player MadLifeGrinder raises (2.50)
Player IlxxxlI folds
Player MrCRABS333 raises (8.50)
Player AironVega folds
Player St3p04ka folds
Player MadLifeGrinder folds
Uncalled bet (6) returned to MrCRABS333
Player MrCRABS333 mucks cards
------ Summary ------
Pot: 6.50. Rake 0
*Player MrCRABS333 mucks (does not show cards). Bets: 2.50. Collects: 6.50. Wins: 4.
Player AironVega does not show cards.Bets: 0.50. Collects: 0. Loses: 0.50.
Player St3p04ka does not show cards.Bets: 1. Collects: 0. Loses: 1.
Player Qrenor does not show cards.Bets: 0. Collects: 0. Wins: 0.
Player MadLifeGrinder does not show cards.Bets: 2.50. Collects: 0. Loses: 2.50.
Player IlxxxlI does not show cards.Bets: 0. Collects: 0. Wins: 0.
Game ended at: 2016/11/29 7:52:42

Game started
Game ID: 786718064 0.50/1 (PRR) Kraken (short) (Hold'em)
Seat 3 is the button
Seat 1: thethinmanlb (67.33).
Seat 2: St3p04ka (68.17).
Seat 3: BigBlat (47.79).
Seat 4: IlxxxlI (20).
Seat 5: Qrenor (79.24).
Seat 6: badboy85 (107.28).
Player IlxxxlI has small blind (0.50)
Player Qrenor has big blind (1)
Player IlxxxlI received card: [2h]
Player IlxxxlI received card: [8h]
Player badboy85 folds
Player thethinmanlb folds
Player St3p04ka folds
Player BigBlat raises (2)
Player IlxxxlI folds
Player Qrenor calls (1)
*** FLOP ***: [6h 5s Kh]
Player Qrenor checks
Player BigBlat bets (1.42)
Player Qrenor folds
Uncalled bet (1.42) returned to BigBlat
Player BigBlat mucks cards
------ Summary ------
Pot: 4.28. Rake 0.16. JP fee 0.06
Board: [6h 5s Kh]
Player thethinmanlb does not show cards.Bets: 0. Collects: 0. Wins: 0.
Player St3p04ka does not show cards.Bets: 0. Collects: 0. Wins: 0.
*Player BigBlat mucks (does not show cards). Bets: 2. Collects: 4.28. Wins: 2.28.
Player IlxxxlI does not show cards.Bets: 0.50. Collects: 0. Loses: 0.50.
Player Qrenor does not show cards.Bets: 2. Collects: 0. Loses: 2.
Player badboy85 does not show cards.Bets: 0. Collects: 0. Wins: 0.
Game ended at: 2016/11/29 7:53:11

Game started
Game ID: 786717923 1/2 (PRR) Lakhey (Cap) (Hold'em)
Seat 3 is the button
Seat 1: wethco (166.73).
Seat 2: plin777 (99.90).
Seat 3: BigBlat (121.79).
Seat 5: coldkilla (80.16).
Seat 6: IlxxxlI (83).
Player coldkilla has small blind (1)
Player IlxxxlI has big blind (2)
Player IlxxxlI received card: [10s]
Player IlxxxlI received card: [2d]
Player wethco folds
Player plin777 raises (4)
Player BigBlat folds
Player coldkilla calls (3)
Player IlxxxlI folds
*** FLOP ***: [Ac 4d Qh]
Player coldkilla bets (6.33)
Player plin777 calls (6.33)
*** TURN ***: [Ac 4d Qh] [8h]
Player coldkilla checks
Player plin777 bets (14.35)
Player coldkilla folds
Uncalled bet (14.35) returned to plin777
Player plin777 mucks cards
------ Summary ------
Pot: 21.53. Rake 0.89. JP fee 0.24
Board: [Ac 4d Qh 8h]
Player wethco does not show cards.Bets: 0. Collects: 0. Wins: 0.
*Player plin777 mucks (does not show cards). Bets: 10.33. Collects: 21.53. Wins: 11.20.
Player BigBlat does not show cards.Bets: 0. Collects: 0. Wins: 0.
Player coldkilla does not show cards.Bets: 10.33. Collects: 0. Loses: 10.33.
Player IlxxxlI does not show cards.Bets: 2. Collects: 0. Loses: 2.
Game ended at: 2016/11/29 7:53:4

Game started
Game ID: 786717478 0.50/1 (PRR) Kraken (short) (Hold'em)
Seat 2 is the button
Seat 1: thethinmanlb (65.83).
Seat 2: St3p04ka (68.17).
Seat 3: BigBlat (48.29).
Seat 4: IlxxxlI (20).
Seat 5: Qrenor (79.24).
Seat 6: badboy85 (107.28).
Player BigBlat has small blind (0.50)
Player IlxxxlI has big blind (1)
Player IlxxxlI received card: [9h]
Player IlxxxlI received card: [Jd]
Player Qrenor folds
Player badboy85 folds
Player thethinmanlb raises (3)
Player St3p04ka folds
Player BigBlat folds
Player IlxxxlI folds
Uncalled bet (2) returned to thethinmanlb
Player thethinmanlb mucks cards
------ Summary ------
Pot: 2.50. Rake 0
*Player thethinmanlb mucks (does not show cards). Bets: 1. Collects: 2.50. Wins: 1.50.
Player St3p04ka does not show cards.Bets: 0. Collects: 0. Wins: 0.
Player BigBlat does not show cards.Bets: 0.50. Collects: 0. Loses: 0.50.
Player IlxxxlI does not show cards.Bets: 1. Collects: 0. Loses: 1.
Player Qrenor does not show cards.Bets: 0. Collects: 0. Wins: 0.
Player badboy85 does not show cards.Bets: 0. Collects: 0. Wins: 0.
Game ended at: 2016/11/29 7:52:1

Game started
Game ID: 786717367 0.50/1 (PRR) Kraken - 2 (Hold'em)
Seat 6 is the button
Seat 1: MrCRABS333 (176.05).
Seat 2: AironVega (106.65).
Seat 3: St3p04ka (100).
Seat 4: Qrenor (427.11).
Seat 5: MadLifeGrinder (106.55).
Seat 6: IlxxxlI (51.68).
Player MrCRABS333 has small blind (0.50)
Player AironVega has big blind (1)
Player IlxxxlI received card: [7h]
Player IlxxxlI received card: [10c]
Player St3p04ka is timed out.
Player St3p04ka folds
Player Qrenor folds
Player MadLifeGrinder folds
Player IlxxxlI folds
Player MrCRABS333 folds
Uncalled bet (0.50) returned to AironVega
Player AironVega mucks cards
------ Summary ------
Pot: 1. Rake 0
Player MrCRABS333 does not show cards.Bets: 0.50. Collects: 0. Loses: 0.50.
*Player AironVega mucks (does not show cards). Bets: 0.50. Collects: 1. Wins: 0.50.
Player St3p04ka does not show cards.Bets: 0. Collects: 0. Wins: 0.
Player Qrenor does not show cards.Bets: 0. Collects: 0. Wins: 0.
Player MadLifeGrinder does not show cards.Bets: 0. Collects: 0. Wins: 0.
Player IlxxxlI does not show cards.Bets: 0. Collects: 0. Wins: 0.
Game ended at: 2016/11/29 7:52:2

Game started
Game ID: 786717193 1/2 (PRR) Lakhey (Cap) (Hold'em)
Seat 2 is the button
Seat 1: wethco (157.63).
Seat 2: plin777 (99.90).
Seat 3: BigBlat (129.79).
Seat 5: coldkilla (82.16).
Seat 6: IlxxxlI (83).
Player BigBlat has small blind (1)
Player coldkilla has big blind (2)
Player IlxxxlI received card: [7d]
Player IlxxxlI received card: [Jc]
Player IlxxxlI folds
Player wethco calls (2)
Player plin777 folds
Player BigBlat raises (7)
Player coldkilla folds
Player wethco calls (6)
*** FLOP ***: [Ac Kc 4h]
Player BigBlat checks
Player wethco bets (5.70)
Player BigBlat folds
Uncalled bet (5.70) returned to wethco
Player wethco mucks cards
------ Summary ------
Pot: 17.10. Rake 0.66. JP fee 0.24
Board: [Ac Kc 4h]
*Player wethco mucks (does not show cards). Bets: 8. Collects: 17.10. Wins: 9.10.
Player plin777 does not show cards.Bets: 0. Collects: 0. Wins: 0.
Player BigBlat does not show cards.Bets: 8. Collects: 0. Loses: 8.
Player coldkilla does not show cards.Bets: 2. Collects: 0. Loses: 2.
Player IlxxxlI does not show cards.Bets: 0. Collects: 0. Wins: 0.
Game ended at: 2016/11/29 7:51:52

Game started
Game ID: 786717132 0.50/1 (PRR) Karkadann - 2 (Hold'em)
Seat 8 is the button
Seat 1: MadLifeGrinder (100).
Seat 2: shokerAAss (104.44).
Seat 3: St3p04ka (185.39).
Seat 4: IlxxxlI (40).
Seat 5: Iia007 (103.50).
Seat 6: Winter is here (175.16).
Seat 7: aleaga (202.25).
Seat 8: Qrenor (249.65).
Player MadLifeGrinder has small blind (0.50)
Player shokerAAss has big blind (1)
Player IlxxxlI received card: [3s]
Player IlxxxlI received card: [2d]
Player St3p04ka folds
Player IlxxxlI folds
Player Iia007 folds
Player Winter is here folds
Player aleaga raises (3)
Player Qrenor folds
Player MadLifeGrinder folds
Player shokerAAss folds
Uncalled bet (2) returned to aleaga
Player aleaga mucks cards
------ Summary ------
Pot: 2.50. Rake 0
Player MadLifeGrinder does not show cards.Bets: 0.50. Collects: 0. Loses: 0.50.
Player shokerAAss does not show cards.Bets: 1. Collects: 0. Loses: 1.
Player St3p04ka does not show cards.Bets: 0. Collects: 0. Wins: 0.
Player IlxxxlI does not show cards.Bets: 0. Collects: 0. Wins: 0.
Player Iia007 does not show cards.Bets: 0. Collects: 0. Wins: 0.
Player Winter is here does not show cards.Bets: 0. Collects: 0. Wins: 0.
*Player aleaga mucks (does not show cards). Bets: 1. Collects: 2.50. Wins: 1.50.
Player Qrenor does not show cards.Bets: 0. Collects: 0. Wins: 0.
Game ended at: 2016/11/29 7:52:6

Game started
Game ID: 786716917 1/2 (PRR) Lakhey (Cap) (Hold'em)
Seat 1 is the button
Seat 1: wethco (157.63).
Seat 2: plin777 (100.90).
Seat 3: BigBlat (131.79).
Seat 5: coldkilla (82.16).
Seat 6: IlxxxlI (80).
Player plin777 has small blind (1)
Player BigBlat has big blind (2)
Player IlxxxlI received card: [Kd]
Player IlxxxlI received card: [Ac]
Player coldkilla folds
Player IlxxxlI raises (4.80)
Player wethco folds
Player plin777 folds
Player BigBlat folds
Uncalled bet (2.80) returned to IlxxxlI
Player IlxxxlI mucks cards
------ Summary ------
Pot: 5. Rake 0
Player wethco does not show cards.Bets: 0. Collects: 0. Wins: 0.
Player plin777 does not show cards.Bets: 1. Collects: 0. Loses: 1.
Player BigBlat does not show cards.Bets: 2. Collects: 0. Loses: 2.
Player coldkilla does not show cards.Bets: 0. Collects: 0. Wins: 0.
*Player IlxxxlI mucks (does not show cards). Bets: 2. Collects: 5. Wins: 3.
Game ended at: 2016/11/29 7:50:58

Game started
Game ID: 786716746 1/2 (PRR) Lakhey (Cap) (Hold'em)
Seat 6 is the button
Seat 1: wethco (158.63).
Seat 2: plin777 (99.90).
Seat 3: BigBlat (131.79).
Seat 5: coldkilla (82.16).
Seat 6: IlxxxlI (80).
Player wethco has small blind (1)
Player plin777 has big blind (2)
Player IlxxxlI received card: [2h]
Player IlxxxlI received card: [4s]
Player BigBlat folds
Player coldkilla folds
Player IlxxxlI folds
Player wethco folds
Uncalled bet (1) returned to plin777
Player plin777 mucks cards
------ Summary ------
Pot: 2. Rake 0
Player wethco does not show cards.Bets: 1. Collects: 0. Loses: 1.
*Player plin777 mucks (does not show cards). Bets: 1. Collects: 2. Wins: 1.
Player BigBlat does not show cards.Bets: 0. Collects: 0. Wins: 0.
Player coldkilla does not show cards.Bets: 0. Collects: 0. Wins: 0.
Player IlxxxlI does not show cards.Bets: 0. Collects: 0. Wins: 0.
Game ended at: 2016/11/29 7:50:40

Game started
Game ID: 786716495 1/2 (PRR) Longana - 2 (Hold'em)
Seat 8 is the button
Seat 1: IlxxxlI (120.60).
Seat 2: loolu (201).
Seat 3: IamPhamous (127.55).
Seat 4: TonnaMunz (271.35).
Seat 5: Iia007 (203).
Seat 6: Gronkowski69 (301.25).
Seat 7: MadLifeGrinder (213.40).
Seat 8: aleaga (315.95).
Seat 9: shokerAAss (303.98).
Player shokerAAss has small blind (1)
Player IlxxxlI has big blind (2)
Player IlxxxlI received card: [Kh]
Player IlxxxlI received card: [Ad]
Player loolu folds
Player IamPhamous folds
Player TonnaMunz folds
Player Iia007 folds
Player Gronkowski69 folds
Player MadLifeGrinder raises (5)
Player aleaga calls (5)
Player shokerAAss folds
Player IlxxxlI raises (18)
Player MadLifeGrinder folds
Player aleaga calls (15)
*** FLOP ***: [4h 9c 10h]
Player IlxxxlI bets (14.56)
Player aleaga calls (14.56)
*** TURN ***: [4h 9c 10h] [8d]
Player IlxxxlI checks
Player aleaga checks
*** RIVER ***: [4h 9c 10h 8d] [Qc]
Player IlxxxlI checks
Player aleaga checks
Player IlxxxlI mucks cards
------ Summary ------
Pot: 72.12. Rake 2.76. JP fee 0.24
Board: [4h 9c 10h 8d Qc]
Player IlxxxlI mucks (does not show: [Kh Ad]). Bets: 34.56. Collects: 0. Loses: 34.56.
Player loolu does not show cards.Bets: 0. Collects: 0. Wins: 0.
Player IamPhamous does not show cards.Bets: 0. Collects: 0. Wins: 0.
Player TonnaMunz does not show cards.Bets: 0. Collects: 0. Wins: 0.
Player Iia007 does not show cards.Bets: 0. Collects: 0. Wins: 0.
Player Gronkowski69 does not show cards.Bets: 0. Collects: 0. Wins: 0.
Player MadLifeGrinder does not show cards.Bets: 5. Collects: 0. Loses: 5.
*Player aleaga shows: One pair of 5s [5h 5s]. Bets: 34.56. Collects: 72.12. Wins: 37.56.
Player shokerAAss does not show cards.Bets: 1. Collects: 0. Loses: 1.
Game ended at: 2016/11/29 7:53:0

Game started
Game ID: 786716228 1/2 (PRR) Lakhey (Cap) (Hold'em)
Seat 5 is the button
Seat 1: wethco (162.63).
Seat 2: plin777 (95.35).
Seat 3: BigBlat (131.79).
Seat 5: coldkilla (82.16).
Seat 6: IlxxxlI (80).
Player IlxxxlI has small blind (1)
Player wethco has big blind (2)
Player IlxxxlI received card: [Jc]
Player IlxxxlI received card: [4c]
Player plin777 raises (4)
Player BigBlat folds
Player coldkilla folds
Player IlxxxlI folds
Player wethco calls (2)
*** FLOP ***: [2d 8c 5h]
Player wethco checks
Player plin777 bets (5.70)
Player wethco folds
Uncalled bet (5.70) returned to plin777
Player plin777 mucks cards
------ Summary ------
Pot: 8.55. Rake 0.31. JP fee 0.14
Board: [2d 8c 5h]
Player wethco does not show cards.Bets: 4. Collects: 0. Loses: 4.
*Player plin777 mucks (does not show cards). Bets: 4. Collects: 8.55. Wins: 4.55.
Player BigBlat does not show cards.Bets: 0. Collects: 0. Wins: 0.
Player coldkilla does not show cards.Bets: 0. Collects: 0. Wins: 0.
Player IlxxxlI does not show cards.Bets: 1. Collects: 0. Loses: 1.
Game ended at: 2016/11/29 7:50:26

Game started
Game ID: 786716222 0.50/1 (PRR) Kraken - 2 (Hold'em)
Seat 5 is the button
Seat 1: MrCRABS333 (165.07).
Seat 2: AironVega (118.32).
Seat 3: St3p04ka (100).
Seat 4: Qrenor (427.11).
Seat 5: MadLifeGrinder (106.55).
Seat 6: IlxxxlI (52.18).
Player IlxxxlI has small blind (0.50)
Player MrCRABS333 has big blind (1)
Player IlxxxlI received card: [9h]
Player IlxxxlI received card: [10d]
Player AironVega raises (3)
Player St3p04ka folds
Player Qrenor folds
Player MadLifeGrinder folds
Player IlxxxlI folds
Player MrCRABS333 calls (2)
*** FLOP ***: [5h 8c 5d]
Player MrCRABS333 checks
Player AironVega bets (2.04)
Player MrCRABS333 calls (2.04)
*** TURN ***: [5h 8c 5d] [3c]
Player MrCRABS333 checks
Player AironVega bets (6.63)
Player MrCRABS333 calls (6.63)
*** RIVER ***: [5h 8c 5d 3c] [Js]
Player MrCRABS333 checks
Player AironVega checks
------ Summary ------
Pot: 22.65. Rake 0.95. JP fee 0.24
Board: [5h 8c 5d 3c Js]
*Player MrCRABS333 shows: Two pairs. 5s and 2s [2c 2d]. Bets: 11.67. Collects: 22.65. Wins: 10.98.
Player AironVega shows: One pair of 5s [Ac 10c]. Bets: 11.67. Collects: 0. Loses: 11.67.
Player St3p04ka does not show cards.Bets: 0. Collects: 0. Wins: 0.
Player Qrenor does not show cards.Bets: 0. Collects: 0. Wins: 0.
Player MadLifeGrinder does not show cards.Bets: 0. Collects: 0. Wins: 0.
Player IlxxxlI does not show cards.Bets: 0.50. Collects: 0. Loses: 0.50.
Game ended at: 2016/11/29 7:51:9

Game started
Game ID: 786716053 0.50/1 (PRR) Karkadann - 2 (Hold'em)
Seat 7 is the button
Seat 1: MadLifeGrinder (100).
Seat 2: shokerAAss (104.44).
Seat 3: St3p04ka (185.39).
Seat 4: IlxxxlI (40).
Seat 5: Iia007 (102).
Seat 6: Winter is here (175.16).
Seat 7: aleaga (202.25).
Seat 8: Qrenor (250.15).
Seat 9: Log_in (40).
Player Qrenor has small blind (0.50)
Player Log_in sitting out
Player MadLifeGrinder has big blind (1)
Player IlxxxlI received card: [5d]
Player IlxxxlI received card: [Jc]
Player shokerAAss folds
Player St3p04ka folds
Player IlxxxlI folds
Player Iia007 raises (3)
Player Winter is here folds
Player aleaga folds
Player Qrenor folds
Player MadLifeGrinder folds
Uncalled bet (2) returned to Iia007
Player Iia007 mucks cards
------ Summary ------
Pot: 2.50. Rake 0
Player MadLifeGrinder does not show cards.Bets: 1. Collects: 0. Loses: 1.
Player shokerAAss does not show cards.Bets: 0. Collects: 0. Wins: 0.
Player St3p04ka does not show cards.Bets: 0. Collects: 0. Wins: 0.
Player IlxxxlI does not show cards.Bets: 0. Collects: 0. Wins: 0.
*Player Iia007 mucks (does not show cards). Bets: 1. Collects: 2.50. Wins: 1.50.
Player Winter is here does not show cards.Bets: 0. Collects: 0. Wins: 0.
Player aleaga does not show cards.Bets: 0. Collects: 0. Wins: 0.
Player Qrenor does not show cards.Bets: 0.50. Collects: 0. Loses: 0.50.
Player Log_in does not show cards.Bets: 0. Collects: 0. Wins: 0.
Game ended at: 2016/11/29 7:50:55

Game started
Game ID: 786715923 1/2 (PRR) Longana - 2 (Hold'em)
Seat 7 is the button
Seat 1: IlxxxlI (120.60).
Seat 2: loolu (201).
Seat 3: IamPhamous (127.55).
Seat 4: TonnaMunz (271.35).
Seat 5: Iia007 (200).
Seat 6: Gronkowski69 (301.25).
Seat 7: MadLifeGrinder (213.40).
Seat 8: aleaga (316.95).
Seat 9: shokerAAss (305.98).
Player aleaga has small blind (1)
Player shokerAAss has big blind (2)
Player IlxxxlI received card: [6d]
Player IlxxxlI received card: [Qs]
Player IlxxxlI folds
Player loolu folds
Player IamPhamous folds
Player TonnaMunz folds
Player Iia007 raises (6)
Player Gronkowski69 folds
Player MadLifeGrinder folds
Player aleaga folds
Player shokerAAss folds
Uncalled bet (4) returned to Iia007
Player Iia007 mucks cards
------ Summary ------
Pot: 5. Rake 0
Player IlxxxlI does not show cards.Bets: 0. Collects: 0. Wins: 0.
Player loolu does not show cards.Bets: 0. Collects: 0. Wins: 0.
Player IamPhamous does not show cards.Bets: 0. Collects: 0. Wins: 0.
Player TonnaMunz does not show cards.Bets: 0. Collects: 0. Wins: 0.
*Player Iia007 mucks (does not show cards). Bets: 2. Collects: 5. Wins: 3.
Player Gronkowski69 does not show cards.Bets: 0. Collects: 0. Wins: 0.
Player MadLifeGrinder does not show cards.Bets: 0. Collects: 0. Wins: 0.
Player aleaga does not show cards.Bets: 1. Collects: 0. Loses: 1.
Player shokerAAss does not show cards.Bets: 2. Collects: 0. Loses: 2.
Game ended at: 2016/11/29 7:50:7

Game started
Game ID: 786715576 1/2 (PRR) Longana - 2 (Hold'em)
Seat 6 is the button
Seat 1: IlxxxlI (120.60).
Seat 2: loolu (198).
Seat 3: IamPhamous (127.55).
Seat 4: TonnaMunz (271.35).
Seat 5: Iia007 (200).
Seat 6: Gronkowski69 (301.25).
Seat 7: MadLifeGrinder (214.40).
Seat 8: aleaga (318.95).
Seat 9: shokerAAss (305.98).
Player MadLifeGrinder has small blind (1)
Player aleaga has big blind (2)
Player IlxxxlI received card: [Ad]
Player IlxxxlI received card: [2c]
Player shokerAAss folds
Player IlxxxlI folds
Player loolu raises (6)
Player IamPhamous folds
Player TonnaMunz folds
Player Iia007 folds
Player Gronkowski69 folds
Player MadLifeGrinder folds
Player aleaga folds
Uncalled bet (4) returned to loolu
Player loolu mucks cards
------ Summary ------
Pot: 5. Rake 0
Player IlxxxlI does not show cards.Bets: 0. Collects: 0. Wins: 0.
*Player loolu mucks (does not show cards). Bets: 2. Collects: 5. Wins: 3.
Player IamPhamous does not show cards.Bets: 0. Collects: 0. Wins: 0.
Player TonnaMunz does not show cards.Bets: 0. Collects: 0. Wins: 0.
Player Iia007 does not show cards.Bets: 0. Collects: 0. Wins: 0.
Player Gronkowski69 does not show cards.Bets: 0. Collects: 0. Wins: 0.
Player MadLifeGrinder does not show cards.Bets: 1. Collects: 0. Loses: 1.
Player aleaga does not show cards.Bets: 2. Collects: 0. Loses: 2.
Player shokerAAss does not show cards.Bets: 0. Collects: 0. Wins: 0.
Game ended at: 2016/11/29 7:49:25

Game started
Game ID: 786715521 1/2 (PRR) Lakhey (Cap) (Hold'em)
Seat 3 is the button
Seat 1: wethco (162.63).
Seat 2: plin777 (95.35).
Seat 3: BigBlat (131.79).
Seat 5: coldkilla (78.56).
Seat 6: IlxxxlI (80).
Player coldkilla has small blind (1)
Player IlxxxlI has big blind (2)
Player IlxxxlI received card: [8h]
Player IlxxxlI received card: [Kh]
Player wethco folds
Player plin777 folds
Player BigBlat folds
Player coldkilla raises (3)
Player IlxxxlI calls (2)
*** FLOP ***: [6d Qd 3s]
Player coldkilla checks
Player IlxxxlI checks
*** TURN ***: [6d Qd 3s] [2s]
Player coldkilla bets (2)
Player IlxxxlI folds
Uncalled bet (2) returned to coldkilla
Player coldkilla mucks cards
------ Summary ------
Pot: 7.60. Rake 0.28. JP fee 0.12
Board: [6d Qd 3s 2s]
Player wethco does not show cards.Bets: 0. Collects: 0. Wins: 0.
Player plin777 does not show cards.Bets: 0. Collects: 0. Wins: 0.
Player BigBlat does not show cards.Bets: 0. Collects: 0. Wins: 0.
*Player coldkilla mucks (does not show cards). Bets: 4. Collects: 7.60. Wins: 3.60.
Player IlxxxlI does not show cards.Bets: 4. Collects: 0. Loses: 4.
Game ended at: 2016/11/29 7:49:47

Game started
Game ID: 786715379 0.50/1 (PRR) Karkadann - 2 (Hold'em)
Seat 6 is the button
Seat 1: MadLifeGrinder (100).
Seat 2: shokerAAss (104.44).
Seat 3: St3p04ka (185.39).
Seat 4: IlxxxlI (40).
Seat 5: Iia007 (102).
Seat 6: Winter is here (173.66).
Seat 7: aleaga (202.75).
Seat 8: Qrenor (251.15).
Seat 9: Log_in (40).
Player aleaga has small blind (0.50)
Player Qrenor has big blind (1)
Player IlxxxlI received card: [7s]
Player IlxxxlI received card: [Ac]
Player Log_in folds
Player MadLifeGrinder folds
Player shokerAAss folds
Player St3p04ka folds
Player IlxxxlI folds
Player Iia007 folds
Player Winter is here raises (2)
Player aleaga folds
Player Qrenor folds
Uncalled bet (1) returned to Winter is here
Player Winter is here mucks cards
------ Summary ------
Pot: 2.50. Rake 0
Player MadLifeGrinder does not show cards.Bets: 0. Collects: 0. Wins: 0.
Player shokerAAss does not show cards.Bets: 0. Collects: 0. Wins: 0.
Player St3p04ka does not show cards.Bets: 0. Collects: 0. Wins: 0.
Player IlxxxlI does not show cards.Bets: 0. Collects: 0. Wins: 0.
Player Iia007 does not show cards.Bets: 0. Collects: 0. Wins: 0.
*Player Winter is here mucks (does not show cards). Bets: 1. Collects: 2.50. Wins: 1.50.
Player aleaga does not show cards.Bets: 0.50. Collects: 0. Loses: 0.50.
Player Qrenor does not show cards.Bets: 1. Collects: 0. Loses: 1.
Player Log_in does not show cards.Bets: 0. Collects: 0. Wins: 0.
Game ended at: 2016/11/29 7:49:35

Game started
Game ID: 786715210 0.50/1 (PRR) Kraken - 2 (Hold'em)
Seat 4 is the button
Seat 1: MrCRABS333 (165.07).
Seat 2: AironVega (118.32).
Seat 3: St3p04ka (100).
Seat 4: Qrenor (440.11).
Seat 5: MadLifeGrinder (107.05).
Seat 6: IlxxxlI (40).
Player MadLifeGrinder has small blind (0.50)
Player IlxxxlI has big blind (1)
Player IlxxxlI received card: [9c]
Player IlxxxlI received card: [Jc]
Player MrCRABS333 folds
Player AironVega folds
Player St3p04ka folds
Player Qrenor raises (2)
Player MadLifeGrinder folds
Player IlxxxlI calls (1)
*** FLOP ***: [4c 7h Qd]
Player IlxxxlI checks
Player Qrenor checks
*** TURN ***: [4c 7h Qd] [8h]
Player IlxxxlI bets (1)
Player Qrenor calls (1)
*** RIVER ***: [4c 7h Qd 8h] [10s]
Player IlxxxlI bets (10)
Player Qrenor calls (10)
Player Qrenor mucks cards
------ Summary ------
Pot: 25.18. Rake 1.08. JP fee 0.24
Board: [4c 7h Qd 8h 10s]
Player MrCRABS333 does not show cards.Bets: 0. Collects: 0. Wins: 0.
Player AironVega does not show cards.Bets: 0. Collects: 0. Wins: 0.
Player St3p04ka does not show cards.Bets: 0. Collects: 0. Wins: 0.
Player Qrenor mucks (does not show cards). Bets: 13. Collects: 0. Loses: 13.
Player MadLifeGrinder does not show cards.Bets: 0.50. Collects: 0. Loses: 0.50.
*Player IlxxxlI shows: Straight to Q [9c Jc]. Bets: 13. Collects: 25.18. Wins: 12.18.
Game ended at: 2016/11/29 7:49:44

Game started
Game ID: 786715053 1/2 (PRR) Longana - 2 (Hold'em)
Seat 5 is the button
Seat 1: IlxxxlI (120.60).
Seat 2: loolu (198).
Seat 3: IamPhamous (127.55).
Seat 4: TonnaMunz (271.35).
Seat 5: Iia007 (200).
Seat 6: Gronkowski69 (302.25).
Seat 7: MadLifeGrinder (219.40).
Seat 8: aleaga (313.50).
Seat 9: shokerAAss (305.98).
Player Gronkowski69 has small blind (1)
Player MadLifeGrinder has big blind (2)
Player IlxxxlI received card: [4h]
Player IlxxxlI received card: [2h]
Player aleaga raises (5)
Player shokerAAss folds
Player IlxxxlI folds
Player loolu folds
Player IamPhamous folds
Player TonnaMunz folds
Player Iia007 folds
Player Gronkowski69 folds
Player MadLifeGrinder calls (3)
*** FLOP ***: [10d 6s 2d]
Player MadLifeGrinder checks
Player aleaga bets (5)
Player MadLifeGrinder folds
Uncalled bet (5) returned to aleaga
Player aleaga mucks cards
------ Summary ------
Pot: 10.45. Rake 0.37. JP fee 0.18
Board: [10d 6s 2d]
Player IlxxxlI does not show cards.Bets: 0. Collects: 0. Wins: 0.
Player loolu does not show cards.Bets: 0. Collects: 0. Wins: 0.
Player IamPhamous does not show cards.Bets: 0. Collects: 0. Wins: 0.
Player TonnaMunz does not show cards.Bets: 0. Collects: 0. Wins: 0.
Player Iia007 does not show cards.Bets: 0. Collects: 0. Wins: 0.
Player Gronkowski69 does not show cards.Bets: 1. Collects: 0. Loses: 1.
Player MadLifeGrinder does not show cards.Bets: 5. Collects: 0. Loses: 5.
*Player aleaga mucks (does not show cards). Bets: 5. Collects: 10.45. Wins: 5.45.
Player shokerAAss does not show cards.Bets: 0. Collects: 0. Wins: 0.
Game ended at: 2016/11/29 7:48:59

Game started
Game ID: 786714957 1/2 (PRR) Lakhey (Cap) (Hold'em)
Seat 2 is the button
Seat 1: wethco (162.63).
Seat 2: plin777 (95.35).
Seat 3: BigBlat (135.79).
Seat 5: coldkilla (74.96).
Seat 6: IlxxxlI (80).
Player BigBlat has small blind (1)
Player coldkilla has big blind (2)
Player IlxxxlI received card: [6c]
Player IlxxxlI received card: [Kc]
Player IlxxxlI folds
Player wethco folds
Player plin777 folds
Player BigBlat calls (1)
Player coldkilla checks
*** FLOP ***: [As 2d 7s]
Player BigBlat bets (2)
Player coldkilla raises (6)
Player BigBlat folds
Uncalled bet (4) returned to coldkilla
Player coldkilla mucks cards
------ Summary ------
Pot: 7.60. Rake 0.28. JP fee 0.12
Board: [As 2d 7s]
Player wethco does not show cards.Bets: 0. Collects: 0. Wins: 0.
Player plin777 does not show cards.Bets: 0. Collects: 0. Wins: 0.
Player BigBlat does not show cards.Bets: 4. Collects: 0. Loses: 4.
*Player coldkilla mucks (does not show cards). Bets: 4. Collects: 7.60. Wins: 3.60.
Player IlxxxlI does not show cards.Bets: 0. Collects: 0. Wins: 0.
Game ended at: 2016/11/29 7:48:56

Game started
Game ID: 786714855 0.50/1 (PRR) Karkadann - 2 (Hold'em)
Seat 5 is the button
Seat 1: MadLifeGrinder (100).
Seat 2: shokerAAss (104.44).
Seat 3: St3p04ka (185.39).
Seat 4: IlxxxlI (40).
Seat 5: Iia007 (102).
Seat 6: Winter is here (174.16).
Seat 7: aleaga (203.75).
Seat 8: Qrenor (249.65).
Seat 9: Log_in (40).
Player Winter is here has small blind (0.50)
Player aleaga has big blind (1)
Player IlxxxlI received card: [9s]
Player IlxxxlI received card: [7d]
Player Qrenor raises (3)
Player Log_in folds
Player MadLifeGrinder folds
Player shokerAAss folds
Player St3p04ka folds
Player IlxxxlI folds
Player Iia007 folds
Player Winter is here folds
Player aleaga folds
Uncalled bet (2) returned to Qrenor
Player Qrenor mucks cards
------ Summary ------
Pot: 2.50. Rake 0
Player MadLifeGrinder does not show cards.Bets: 0. Collects: 0. Wins: 0.
Player shokerAAss does not show cards.Bets: 0. Collects: 0. Wins: 0.
Player St3p04ka does not show cards.Bets: 0. Collects: 0. Wins: 0.
Player IlxxxlI does not show cards.Bets: 0. Collects: 0. Wins: 0.
Player Iia007 does not show cards.Bets: 0. Collects: 0. Wins: 0.
Player Winter is here does not show cards.Bets: 0.50. Collects: 0. Loses: 0.50.
Player aleaga does not show cards.Bets: 1. Collects: 0. Loses: 1.
*Player Qrenor mucks (does not show cards). Bets: 1. Collects: 2.50. Wins: 1.50.
Player Log_in does not show cards.Bets: 0. Collects: 0. Wins: 0.
Game ended at: 2016/11/29 7:48:46

Game started
Game ID: 786714704 0.50/1 (PRR) Kraken - 2 (Hold'em)
Seat 3 is the button
Seat 1: MrCRABS333 (165.07).
Seat 2: AironVega (116.82).
Seat 3: St3p04ka (100).
Seat 4: Qrenor (440.61).
Seat 5: MadLifeGrinder (108.05).
Seat 6: IlxxxlI (40).
Player Qrenor has small blind (0.50)
Player MadLifeGrinder has big blind (1)
Player IlxxxlI received card: [7s]
Player IlxxxlI received card: [4c]
Player IlxxxlI folds
Player MrCRABS333 folds
Player AironVega raises (2.50)
Player St3p04ka folds
Player Qrenor folds
Player MadLifeGrinder folds
Uncalled bet (1.50) returned to AironVega
Player AironVega mucks cards
------ Summary ------
Pot: 2.50. Rake 0
Player MrCRABS333 does not show cards.Bets: 0. Collects: 0. Wins: 0.
*Player AironVega mucks (does not show cards). Bets: 1. Collects: 2.50. Wins: 1.50.
Player St3p04ka does not show cards.Bets: 0. Collects: 0. Wins: 0.
Player Qrenor does not show cards.Bets: 0.50. Collects: 0. Loses: 0.50.
Player MadLifeGrinder does not show cards.Bets: 1. Collects: 0. Loses: 1.
Player IlxxxlI does not show cards.Bets: 0. Collects: 0. Wins: 0.
Game ended at: 2016/11/29 7:48:32

Game started
Game ID: 786714689 1/2 (PRR) Lakhey (Cap) (Hold'em)
Seat 1 is the button
Seat 1: wethco (162.63).
Seat 2: plin777 (93.35).
Seat 3: BigBlat (137.79).
Seat 4: dbrinker (276.85).
Seat 5: coldkilla (74.96).
Seat 6: IlxxxlI (80).
Player plin777 has small blind (1)
Player BigBlat has big blind (2)
Player IlxxxlI received card: [3d]
Player IlxxxlI received card: [6d]
Player dbrinker folds
Player coldkilla folds
Player IlxxxlI folds
Player wethco folds
Player plin777 raises (3)
Player BigBlat folds
Uncalled bet (2) returned to plin777
Player plin777 mucks cards
------ Summary ------
Pot: 4. Rake 0
Player wethco does not show cards.Bets: 0. Collects: 0. Wins: 0.
*Player plin777 mucks (does not show cards). Bets: 2. Collects: 4. Wins: 2.
Player BigBlat does not show cards.Bets: 2. Collects: 0. Loses: 2.
Player dbrinker does not show cards.Bets: 0. Collects: 0. Wins: 0.
Player coldkilla does not show cards.Bets: 0. Collects: 0. Wins: 0.
Player IlxxxlI does not show cards.Bets: 0. Collects: 0. Wins: 0.
Game ended at: 2016/11/29 7:48:14

Game started
Game ID: 786714253 1/2 (PRR) Lakhey (Cap) (Hold'em)
Seat 6 is the button
Seat 1: wethco (163.63).
Seat 2: plin777 (95.35).
Seat 3: BigBlat (137.79).
Seat 4: dbrinker (276.85).
Seat 5: coldkilla (71.96).
Seat 6: IlxxxlI (80).
Player wethco has small blind (1)
Player plin777 has big blind (2)
Player IlxxxlI received card: [Ac]
Player IlxxxlI received card: [9d]
Player BigBlat folds
Player dbrinker folds
Player coldkilla raises (4)
Player IlxxxlI folds
Player wethco folds
Player plin777 folds
Uncalled bet (2) returned to coldkilla
Player coldkilla mucks cards
------ Summary ------
Pot: 5. Rake 0
Player wethco does not show cards.Bets: 1. Collects: 0. Loses: 1.
Player plin777 does not show cards.Bets: 2. Collects: 0. Loses: 2.
Player BigBlat does not show cards.Bets: 0. Collects: 0. Wins: 0.
Player dbrinker does not show cards.Bets: 0. Collects: 0. Wins: 0.
*Player coldkilla mucks (does not show cards). Bets: 2. Collects: 5. Wins: 3.
Player IlxxxlI does not show cards.Bets: 0. Collects: 0. Wins: 0.
Game ended at: 2016/11/29 7:47:53

Game started
Game ID: 786714217 0.50/1 (PRR) Kraken - 2 (Hold'em)
Seat 2 is the button
Seat 1: MrCRABS333 (163.57).
Seat 2: AironVega (116.82).
Seat 3: St3p04ka (100.50).
Seat 4: Qrenor (441.61).
Seat 5: MadLifeGrinder (108.05).
Seat 6: IlxxxlI (40).
Player St3p04ka has small blind (0.50)
Player Qrenor has big blind (1)
Player IlxxxlI received card: [10s]
Player IlxxxlI received card: [2c]
Player MadLifeGrinder folds
Player IlxxxlI folds
Player MrCRABS333 raises (3)
Player AironVega folds
Player St3p04ka folds
Player Qrenor folds
Uncalled bet (2) returned to MrCRABS333
Player MrCRABS333 mucks cards
------ Summary ------
Pot: 2.50. Rake 0
*Player MrCRABS333 mucks (does not show cards). Bets: 1. Collects: 2.50. Wins: 1.50.
Player AironVega does not show cards.Bets: 0. Collects: 0. Wins: 0.
Player St3p04ka does not show cards.Bets: 0.50. Collects: 0. Loses: 0.50.
Player Qrenor does not show cards.Bets: 1. Collects: 0. Loses: 1.
Player MadLifeGrinder does not show cards.Bets: 0. Collects: 0. Wins: 0.
Player IlxxxlI does not show cards.Bets: 0. Collects: 0. Wins: 0.
Game ended at: 2016/11/29 7:47:54

Game started
Game ID: 786714162 0.50/1 (PRR) Karkadann - 2 (Hold'em)
Seat 4 is the button
Seat 1: MadLifeGrinder (100).
Seat 2: shokerAAss (104.44).
Seat 3: St3p04ka (185.39).
Seat 4: IlxxxlI (40).
Seat 5: Iia007 (102.50).
Seat 6: Winter is here (175.16).
Seat 7: aleaga (203.75).
Seat 8: Qrenor (249.65).
Seat 9: Log_in (38.50).
Player Iia007 has small blind (0.50)
Player Winter is here has big blind (1)
Player IlxxxlI received card: [3s]
Player IlxxxlI received card: [8d]
Player aleaga folds
Player Qrenor folds
Player Log_in raises (3)
Player MadLifeGrinder folds
Player shokerAAss folds
Player St3p04ka folds
Player IlxxxlI folds
Player Iia007 folds
Player Winter is here folds
Uncalled bet (2) returned to Log_in
Player Log_in mucks cards
------ Summary ------
Pot: 2.50. Rake 0
Player MadLifeGrinder does not show cards.Bets: 0. Collects: 0. Wins: 0.
Player shokerAAss does not show cards.Bets: 0. Collects: 0. Wins: 0.
Player St3p04ka does not show cards.Bets: 0. Collects: 0. Wins: 0.
Player IlxxxlI does not show cards.Bets: 0. Collects: 0. Wins: 0.
Player Iia007 does not show cards.Bets: 0.50. Collects: 0. Loses: 0.50.
Player Winter is here does not show cards.Bets: 1. Collects: 0. Loses: 1.
Player aleaga does not show cards.Bets: 0. Collects: 0. Wins: 0.
Player Qrenor does not show cards.Bets: 0. Collects: 0. Wins: 0.
*Player Log_in mucks (does not show cards). Bets: 1. Collects: 2.50. Wins: 1.50.
Game ended at: 2016/11/29 7:48:7

Game started
Game ID: 786713759 1/2 (PRR) Lakhey (Cap) (Hold'em)
Seat 5 is the button
Seat 1: wethco (165.63).
Seat 3: BigBlat (173.77).
Seat 4: dbrinker (276.85).
Seat 5: coldkilla (35.98).
Seat 6: IlxxxlI (80).
Player IlxxxlI has small blind (1)
Player wethco has big blind (2)
Player IlxxxlI received card: [Qs]
Player IlxxxlI received card: [Js]
Player BigBlat raises (4)
Player dbrinker folds
Player coldkilla allin (35.98)
Player IlxxxlI folds
Player wethco folds
Player BigBlat calls (31.98)
*** FLOP ***: [8d 8h Jh]
*** TURN ***: [8d 8h Jh] [7d]
*** RIVER ***: [8d 8h Jh 7d] [Jd]
------ Summary ------
Pot: 71.96. Rake 2.76. JP fee 0.24
Board: [8d 8h Jh 7d Jd]
Player wethco does not show cards.Bets: 2. Collects: 0. Loses: 2.
Player BigBlat shows: Two pairs. Js and 8s [Ah 10c]. Bets: 35.98. Collects: 0. Loses: 35.98.
Player dbrinker does not show cards.Bets: 0. Collects: 0. Wins: 0.
*Player coldkilla shows: Full House (8/J) [8s As]. Bets: 35.98. Collects: 71.96. Wins: 35.98.
Player IlxxxlI does not show cards.Bets: 1. Collects: 0. Loses: 1.
Game ended at: 2016/11/29 7:47:18

Game started
Game ID: 786713513 0.50/1 (PRR) Kraken - 2 (Hold'em)
Seat 1 is the button
Seat 1: MrCRABS333 (163.57).
Seat 2: AironVega (115.82).
Seat 3: St3p04ka (101.50).
Seat 4: Qrenor (441.61).
Seat 5: MadLifeGrinder (108.05).
Seat 6: IlxxxlI (40).
Player AironVega has small blind (0.50)
Player St3p04ka has big blind (1)
Player IlxxxlI received card: [10s]
Player IlxxxlI received card: [8d]
Player Qrenor folds
Player MadLifeGrinder folds
Player IlxxxlI folds
Player MrCRABS333 folds
Player AironVega raises (2.50)
Player St3p04ka is timed out.
Player St3p04ka folds
Uncalled bet (2) returned to AironVega
Player AironVega mucks cards
------ Summary ------
Pot: 2. Rake 0
Player MrCRABS333 does not show cards.Bets: 0. Collects: 0. Wins: 0.
*Player AironVega mucks (does not show cards). Bets: 1. Collects: 2. Wins: 1.
Player St3p04ka does not show cards.Bets: 1. Collects: 0. Loses: 1.
Player Qrenor does not show cards.Bets: 0. Collects: 0. Wins: 0.
Player MadLifeGrinder does not show cards.Bets: 0. Collects: 0. Wins: 0.
Player IlxxxlI does not show cards.Bets: 0. Collects: 0. Wins: 0.
Game ended at: 2016/11/29 7:47:17

Game started
Game ID: 786713212 0.50/1 (PRR) Kraken - 2 (Hold'em)
Seat 6 is the button
Seat 1: MrCRABS333 (162.57).
Seat 2: AironVega (116.82).
Seat 4: Qrenor (441.61).
Seat 5: MadLifeGrinder (108.05).
Seat 6: IlxxxlI (40).
Player MrCRABS333 has small blind (0.50)
Player AironVega has big blind (1)
Player IlxxxlI received card: [7d]
Player IlxxxlI received card: [8h]
Player Qrenor folds
Player MadLifeGrinder folds
Player IlxxxlI folds
Player MrCRABS333 raises (3)
Player AironVega folds
Uncalled bet (2.50) returned to MrCRABS333
Player MrCRABS333 mucks cards
------ Summary ------
Pot: 2. Rake 0
*Player MrCRABS333 mucks (does not show cards). Bets: 1. Collects: 2. Wins: 1.
Player AironVega does not show cards.Bets: 1. Collects: 0. Loses: 1.
Player Qrenor does not show cards.Bets: 0. Collects: 0. Wins: 0.
Player MadLifeGrinder does not show cards.Bets: 0. Collects: 0. Wins: 0.
Player IlxxxlI does not show cards.Bets: 0. Collects: 0. Wins: 0.
Game ended at: 2016/11/29 7:46:26

Game started
Game ID: 786713043 1/2 (PRR) Longana - 2 (Hold'em)
Seat 4 is the button
Seat 1: IlxxxlI (120.60).
Seat 2: loolu (198).
Seat 3: IamPhamous (127.55).
Seat 4: TonnaMunz (271.35).
Seat 5: Iia007 (200).
Seat 6: Gronkowski69 (211.25).
Seat 7: MadLifeGrinder (219.40).
Seat 8: aleaga (313.50).
Seat 9: shokerAAss (305.98).
Player Iia007 has small blind (1)
Player Gronkowski69 has big blind (2)
Player IlxxxlI received card: [7d]
Player IlxxxlI received card: [6s]
Player MadLifeGrinder folds
Player aleaga folds
Player shokerAAss folds
Player IlxxxlI folds
Player loolu folds
Player IamPhamous folds
Player TonnaMunz folds
Player Iia007 raises (5)
Player Gronkowski69 calls (4)
*** FLOP ***: [Kh 7h 6d]
Player Iia007 bets (8)
Player Gronkowski69 calls (8)
*** TURN ***: [Kh 7h 6d] [4s]
Player Iia007 bets (18)
Player Gronkowski69 calls (18)
*** RIVER ***: [Kh 7h 6d 4s] [5s]
Player Iia007 checks
Player Gronkowski69 bets (62)
Player Iia007 calls (62)
Player Iia007 mucks cards
------ Summary ------
Pot: 185. Rake 2.76. JP fee 0.24
Board: [Kh 7h 6d 4s 5s]
Player IlxxxlI does not show cards.Bets: 0. Collects: 0. Wins: 0.
Player loolu does not show cards.Bets: 0. Collects: 0. Wins: 0.
Player IamPhamous does not show cards.Bets: 0. Collects: 0. Wins: 0.
Player TonnaMunz does not show cards.Bets: 0. Collects: 0. Wins: 0.
Player Iia007 mucks (does not show cards). Bets: 94. Collects: 0. Loses: 94.
*Player Gronkowski69 shows: Straight to 8 [10h 8h]. Bets: 94. Collects: 185. Wins: 91.
Player MadLifeGrinder does not show cards.Bets: 0. Collects: 0. Wins: 0.
Player aleaga does not show cards.Bets: 0. Collects: 0. Wins: 0.
Player shokerAAss does not show cards.Bets: 0. Collects: 0. Wins: 0.
Game ended at: 2016/11/29 7:48:19

Game started
Game ID: 786713010 1/2 (PRR) Lakhey (Cap) (Hold'em)
Seat 4 is the button
Seat 1: wethco (165.63).
Seat 3: BigBlat (165.42).
Seat 4: dbrinker (276.85).
Seat 5: coldkilla (43.14).
Seat 6: IlxxxlI (80).
Player coldkilla has small blind (1)
Player IlxxxlI has big blind (2)
Player IlxxxlI received card: [2s]
Player IlxxxlI received card: [8h]
Player wethco folds
Player BigBlat raises (4)
Player dbrinker folds
Player coldkilla calls (3)
Player IlxxxlI folds
*** FLOP ***: [3c 3h 10h]
Player coldkilla checks
Player BigBlat checks
*** TURN ***: [3c 3h 10h] [Ah]
Player coldkilla checks
Player BigBlat bets (3.16)
Player coldkilla calls (3.16)
*** RIVER ***: [3c 3h 10h Ah] [4c]
Player coldkilla checks
Player BigBlat checks
Player coldkilla mucks cards
------ Summary ------
Pot: 15.51. Rake 0.57. JP fee 0.24
Board: [3c 3h 10h Ah 4c]
Player wethco does not show cards.Bets: 0. Collects: 0. Wins: 0.
*Player BigBlat shows: Two pairs. As and 3s [6s As]. Bets: 7.16. Collects: 15.51. Wins: 8.35.
Player dbrinker does not show cards.Bets: 0. Collects: 0. Wins: 0.
Player coldkilla mucks (does not show cards). Bets: 7.16. Collects: 0. Loses: 7.16.
Player IlxxxlI does not show cards.Bets: 2. Collects: 0. Loses: 2.
Game ended at: 2016/11/29 7:46:41

Game started
Game ID: 786712848 0.50/1 (PRR) Kraken - 2 (Hold'em)
Seat 5 is the button
Seat 1: MrCRABS333 (163.57).
Seat 2: AironVega (116.82).
Seat 4: Qrenor (441.61).
Seat 5: MadLifeGrinder (106.55).
Seat 6: IlxxxlI (40).
Player IlxxxlI has small blind (0.50)
Player MrCRABS333 has big blind (1)
Player IlxxxlI received card: [5d]
Player IlxxxlI received card: [Qs]
Player AironVega folds
Player Qrenor folds
Player MadLifeGrinder raises (2.50)
Player IlxxxlI folds
Player MrCRABS333 folds
Uncalled bet (1.50) returned to MadLifeGrinder
Player MadLifeGrinder mucks cards
------ Summary ------
Pot: 2.50. Rake 0
Player MrCRABS333 does not show cards.Bets: 1. Collects: 0. Loses: 1.
Player AironVega does not show cards.Bets: 0. Collects: 0. Wins: 0.
Player Qrenor does not show cards.Bets: 0. Collects: 0. Wins: 0.
*Player MadLifeGrinder mucks (does not show cards). Bets: 1. Collects: 2.50. Wins: 1.50.
Player IlxxxlI does not show cards.Bets: 0.50. Collects: 0. Loses: 0.50.
Game ended at: 2016/11/29 7:46:4

Game started
Game ID: 786712435 0.50/1 (PRR) Kraken - 2 (Hold'em)
Seat 4 is the button
Seat 1: MrCRABS333 (163.57).
Seat 2: AironVega (116.82).
Seat 4: Qrenor (440.11).
Seat 5: MadLifeGrinder (107.05).
Seat 6: IlxxxlI (40).
Player MadLifeGrinder has small blind (0.50)
Player IlxxxlI has big blind (1)
Player IlxxxlI received card: [Ks]
Player IlxxxlI received card: [5h]
Player MrCRABS333 folds
Player AironVega folds
Player Qrenor raises (2)
Player MadLifeGrinder folds
Player IlxxxlI folds
Uncalled bet (1) returned to Qrenor
Player Qrenor mucks cards
------ Summary ------
Pot: 2.50. Rake 0
Player MrCRABS333 does not show cards.Bets: 0. Collects: 0. Wins: 0.
Player AironVega does not show cards.Bets: 0. Collects: 0. Wins: 0.
*Player Qrenor mucks (does not show cards). Bets: 1. Collects: 2.50. Wins: 1.50.
Player MadLifeGrinder does not show cards.Bets: 0.50. Collects: 0. Loses: 0.50.
Player IlxxxlI does not show cards.Bets: 1. Collects: 0. Loses: 1.
Game ended at: 2016/11/29 7:45:36

Game started
Game ID: 786712411 1/2 (PRR) Lakhey (Cap) (Hold'em)
Seat 3 is the button
Seat 1: wethco (165.63).
Seat 3: BigBlat (107.42).
Seat 4: dbrinker (277.85).
Seat 5: coldkilla (103.14).
Seat 6: IlxxxlI (80).
Player dbrinker has small blind (1)
Player coldkilla has big blind (2)
Player IlxxxlI received card: [9c]
Player IlxxxlI received card: [6c]
Player IlxxxlI folds
Player wethco folds
Player BigBlat raises (4)
Player dbrinker folds
Player coldkilla caps (58)
Player BigBlat calls (56)
*** FLOP ***: [Kh Qc 8c]
*** TURN ***: [Kh Qc 8c] [Ks]
*** RIVER ***: [Kh Qc 8c Ks] [2s]
------ Summary ------
Pot: 118. Rake 2.76. JP fee 0.24
Board: [Kh Qc 8c Ks 2s]
Player wethco does not show cards.Bets: 0. Collects: 0. Wins: 0.
*Player BigBlat shows: Three Of Kind of Ks [Kc Ad]. Bets: 60. Collects: 118. Wins: 58.
Player dbrinker does not show cards.Bets: 1. Collects: 0. Loses: 1.
Player coldkilla shows: Two pairs. Ks and 3s [3c 3s]. Bets: 60. Collects: 0. Loses: 60.
Player IlxxxlI does not show cards.Bets: 0. Collects: 0. Wins: 0.
Game ended at: 2016/11/29 7:45:48

Game started
Game ID: 786712086 0.50/1 (PRR) Karkadann - 2 (Hold'em)
Seat 3 is the button
Seat 1: MadLifeGrinder (145.79).
Seat 2: shokerAAss (104.44).
Seat 3: St3p04ka (185.39).
Seat 4: IlxxxlI (40.50).
Seat 5: Iia007 (103.50).
Seat 6: Winter is here (181.41).
Seat 7: aleaga (99.50).
Seat 8: Qrenor (249.65).
Seat 9: Log_in (38.50).
Player IlxxxlI has small blind (0.50)
Player Iia007 has big blind (1)
Player IlxxxlI received card: [7h]
Player IlxxxlI received card: [Js]
Player Winter is here raises (2)
Player aleaga raises (6.25)
Player Qrenor folds
Player Log_in folds
Player MadLifeGrinder calls (6.25)
Player shokerAAss folds
Player St3p04ka folds
Player IlxxxlI folds
Player Iia007 folds
Player Winter is here calls (4.25)
*** FLOP ***: [9d 6c Ac]
Player Winter is here checks
Player aleaga checks
Player MadLifeGrinder bets (12)
Player Winter is here folds
Player aleaga raises (32.25)
Player MadLifeGrinder calls (20.25)
*** TURN ***: [9d 6c Ac] [Kd]
Player aleaga checks
Player MadLifeGrinder checks
*** RIVER ***: [9d 6c Ac Kd] [3d]
Player aleaga allin (61)
Player MadLifeGrinder calls (61)
------ Summary ------
Pot: 203.75. Rake 2.76. JP fee 0.24
Board: [9d 6c Ac Kd 3d]
Player MadLifeGrinder shows: Two pairs. As and Ks [Ks Ad]. Bets: 99.50. Collects: 0. Loses: 99.50.
Player shokerAAss does not show cards.Bets: 0. Collects: 0. Wins: 0.
Player St3p04ka does not show cards.Bets: 0. Collects: 0. Wins: 0.
Player IlxxxlI does not show cards.Bets: 0.50. Collects: 0. Loses: 0.50.
Player Iia007 does not show cards.Bets: 1. Collects: 0. Loses: 1.
Player Winter is here does not show cards.Bets: 6.25. Collects: 0. Loses: 6.25.
*Player aleaga shows: Three Of Kind of 3s [3s 3h]. Bets: 99.50. Collects: 203.75. Wins: 104.25.
Player Qrenor does not show cards.Bets: 0. Collects: 0. Wins: 0.
Player Log_in does not show cards.Bets: 0. Collects: 0. Wins: 0.
Game ended at: 2016/11/29 7:47:12

Game started
Game ID: 786711532 1/2 (PRR) Longana - 2 (Hold'em)
Seat 3 is the button
Seat 1: IlxxxlI (120.60).
Seat 2: loolu (200).
Seat 3: IamPhamous (169.55).
Seat 4: TonnaMunz (272.35).
Seat 5: Iia007 (200).
Seat 7: MadLifeGrinder (219.40).
Seat 8: aleaga (313.50).
Seat 9: shokerAAss (261.98).
Player TonnaMunz has small blind (1)
Player Iia007 has big blind (2)
Player loolu posts (2)
Player IlxxxlI received card: [8d]
Player IlxxxlI received card: [Qh]
Player MadLifeGrinder folds
Player aleaga folds
Player shokerAAss raises (6)
Player IlxxxlI folds
Player loolu folds
Player IamPhamous raises (14)
Player TonnaMunz folds
Player Iia007 folds
Player shokerAAss raises (36)
Player IamPhamous calls (28)
*** FLOP ***: [Kd Qd 7c]
Player shokerAAss checks
Player IamPhamous checks
*** TURN ***: [Kd Qd 7c] [Jc]
Player shokerAAss checks
Player IamPhamous checks
*** RIVER ***: [Kd Qd 7c Jc] [Qc]
Player shokerAAss allin (219.98)
Player IamPhamous folds
Uncalled bet (219.98) returned to shokerAAss
Player shokerAAss mucks cards
------ Summary ------
Pot: 86. Rake 2.76. JP fee 0.24
Board: [Kd Qd 7c Jc Qc]
Player IlxxxlI does not show cards.Bets: 0. Collects: 0. Wins: 0.
Player loolu does not show cards.Bets: 2. Collects: 0. Loses: 2.
Player IamPhamous does not show cards.Bets: 42. Collects: 0. Loses: 42.
Player TonnaMunz does not show cards.Bets: 1. Collects: 0. Loses: 1.
Player Iia007 does not show cards.Bets: 2. Collects: 0. Loses: 2.
Player MadLifeGrinder does not show cards.Bets: 0. Collects: 0. Wins: 0.
Player aleaga does not show cards.Bets: 0. Collects: 0. Wins: 0.
*Player shokerAAss mucks (does not show cards). Bets: 42. Collects: 86. Wins: 44.
Game ended at: 2016/11/29 7:45:52

Game started
Game ID: 786711448 1/2 (PRR) Lakhey (Cap) (Hold'em)
Seat 1 is the button
Seat 1: wethco (161.93).
Seat 3: BigBlat (109.42).
Seat 4: dbrinker (279.85).
Seat 5: coldkilla (103.14).
Seat 6: IlxxxlI (80).
Player BigBlat has small blind (1)
Player dbrinker has big blind (2)
Player IlxxxlI received card: [Js]
Player IlxxxlI received card: [9h]
Player coldkilla folds
Player IlxxxlI folds
Player wethco calls (2)
Player BigBlat calls (1)
Player dbrinker checks
*** FLOP ***: [9c 8h Jc]
Player BigBlat checks
Player dbrinker checks
Player wethco checks
*** TURN ***: [9c 8h Jc] [10h]
Player BigBlat checks
Player dbrinker checks
Player wethco checks
*** RIVER ***: [9c 8h Jc 10h] [3h]
Player BigBlat checks
Player dbrinker checks
Player wethco checks
Player BigBlat mucks cards
Player dbrinker mucks cards
------ Summary ------
Pot: 5.70. Rake 0.20. JP fee 0.10
Board: [9c 8h Jc 10h 3h]
*Player wethco shows: One pair of 4s [4s 4d]. Bets: 2. Collects: 5.70. Wins: 3.70.
Player BigBlat mucks (does not show cards). Bets: 2. Collects: 0. Loses: 2.
Player dbrinker mucks (does not show cards). Bets: 2. Collects: 0. Loses: 2.
Player coldkilla does not show cards.Bets: 0. Collects: 0. Wins: 0.
Player IlxxxlI does not show cards.Bets: 0. Collects: 0. Wins: 0.
Game ended at: 2016/11/29 7:45:4

Game started
Game ID: 786711296 0.50/1 (PRR) Karkadann - 2 (Hold'em)
Seat 2 is the button
Seat 1: MadLifeGrinder (145.79).
Seat 2: shokerAAss (104.44).
Seat 3: St3p04ka (185.89).
Seat 4: IlxxxlI (40).
Seat 5: Iia007 (103.50).
Seat 6: Winter is here (181.41).
Seat 7: aleaga (99.50).
Seat 8: Qrenor (249.65).
Seat 9: Log_in (38.50).
Player St3p04ka has small blind (0.50)
Player IlxxxlI has big blind (1)
Player IlxxxlI received card: [6c]
Player IlxxxlI received card: [7d]
Player Iia007 folds
Player Winter is here folds
Player aleaga folds
Player Qrenor folds
Player Log_in folds
Player MadLifeGrinder folds
Player shokerAAss folds
Player St3p04ka folds
Uncalled bet (0.50) returned to IlxxxlI
Player IlxxxlI mucks cards
------ Summary ------
Pot: 1. Rake 0
Player MadLifeGrinder does not show cards.Bets: 0. Collects: 0. Wins: 0.
Player shokerAAss does not show cards.Bets: 0. Collects: 0. Wins: 0.
Player St3p04ka does not show cards.Bets: 0.50. Collects: 0. Loses: 0.50.
*Player IlxxxlI mucks (does not show cards). Bets: 0.50. Collects: 1. Wins: 0.50.
Player Iia007 does not show cards.Bets: 0. Collects: 0. Wins: 0.
Player Winter is here does not show cards.Bets: 0. Collects: 0. Wins: 0.
Player aleaga does not show cards.Bets: 0. Collects: 0. Wins: 0.
Player Qrenor does not show cards.Bets: 0. Collects: 0. Wins: 0.
Player Log_in does not show cards.Bets: 0. Collects: 0. Wins: 0.
Game ended at: 2016/11/29 7:44:43

Game started
Game ID: 786710817 1/2 (PRR) Lakhey (Cap) (Hold'em)
Seat 6 is the button
Seat 1: wethco (162.93).
Seat 2: plin777 (95.35).
Seat 3: BigBlat (111.42).
Seat 4: dbrinker (279.85).
Seat 5: coldkilla (100.14).
Seat 6: IlxxxlI (80).
Player wethco has small blind (1)
Player plin777 is timed out.
Player plin777 sitting out
Player BigBlat has big blind (2)
Player IlxxxlI received card: [2c]
Player IlxxxlI received card: [Ad]
Player dbrinker folds
Player coldkilla raises (4)
Player IlxxxlI folds
Player wethco folds
Player BigBlat folds
Uncalled bet (2) returned to coldkilla
Player coldkilla mucks cards
------ Summary ------
Pot: 5. Rake 0
Player wethco does not show cards.Bets: 1. Collects: 0. Loses: 1.
Player plin777 does not show cards.Bets: 0. Collects: 0. Wins: 0.
Player BigBlat does not show cards.Bets: 2. Collects: 0. Loses: 2.
Player dbrinker does not show cards.Bets: 0. Collects: 0. Wins: 0.
*Player coldkilla mucks (does not show cards). Bets: 2. Collects: 5. Wins: 3.
Player IlxxxlI does not show cards.Bets: 0. Collects: 0. Wins: 0.
Game ended at: 2016/11/29 7:43:57

Game started
Game ID: 786710425 1/2 (PRR) Longana - 2 (Hold'em)
Seat 1 is the button
Seat 1: IlxxxlI (120.60).
Seat 3: IamPhamous (170.55).
Seat 4: TonnaMunz (274.35).
Seat 5: Iia007 (200).
Seat 7: MadLifeGrinder (219.40).
Seat 8: aleaga (313.50).
Seat 9: shokerAAss (244.73).
Player IamPhamous has small blind (1)
Player TonnaMunz has big blind (2)
Player IlxxxlI received card: [10c]
Player IlxxxlI received card: [Ad]
Player Iia007 raises (6)
Player MadLifeGrinder folds
Player aleaga folds
Player shokerAAss calls (6)
Player IlxxxlI folds
Player IamPhamous folds
Player TonnaMunz folds
*** FLOP ***: [5s 8s 6h]
Player Iia007 bets (10)
Player shokerAAss calls (10)
*** TURN ***: [5s 8s 6h] [7c]
Player Iia007 checks
Player shokerAAss bets (21)
Player Iia007 folds
Uncalled bet (21) returned to shokerAAss
Player shokerAAss mucks cards
------ Summary ------
Pot: 33.25. Rake 1.51. JP fee 0.24
Board: [5s 8s 6h 7c]
Player IlxxxlI does not show cards.Bets: 0. Collects: 0. Wins: 0.
Player IamPhamous does not show cards.Bets: 1. Collects: 0. Loses: 1.
Player TonnaMunz does not show cards.Bets: 2. Collects: 0. Loses: 2.
Player Iia007 does not show cards.Bets: 16. Collects: 0. Loses: 16.
Player MadLifeGrinder does not show cards.Bets: 0. Collects: 0. Wins: 0.
Player aleaga does not show cards.Bets: 0. Collects: 0. Wins: 0.
*Player shokerAAss mucks (does not show cards). Bets: 16. Collects: 33.25. Wins: 17.25.
Game ended at: 2016/11/29 7:44:3

Game started
Game ID: 786710387 1/2 (PRR) Lakhey (Cap) (Hold'em)
Seat 5 is the button
Seat 1: wethco (166.93).
Seat 2: plin777 (95.35).
Seat 3: BigBlat (111.42).
Seat 4: dbrinker (279.85).
Seat 5: coldkilla (95.59).
Seat 6: IlxxxlI (80).
Player IlxxxlI has small blind (1)
Player wethco has big blind (2)
Player IlxxxlI received card: [10c]
Player IlxxxlI received card: [6c]
Player plin777 folds
Player BigBlat folds
Player dbrinker folds
Player coldkilla raises (4)
Player IlxxxlI folds
Player wethco calls (2)
*** FLOP ***: [Qh 7d Kd]
Player wethco checks
Player coldkilla bets (4.27)
Player wethco folds
Uncalled bet (4.27) returned to coldkilla
Player coldkilla mucks cards
------ Summary ------
Pot: 8.55. Rake 0.31. JP fee 0.14
Board: [Qh 7d Kd]
Player wethco does not show cards.Bets: 4. Collects: 0. Loses: 4.
Player plin777 does not show cards.Bets: 0. Collects: 0. Wins: 0.
Player BigBlat does not show cards.Bets: 0. Collects: 0. Wins: 0.
Player dbrinker does not show cards.Bets: 0. Collects: 0. Wins: 0.
*Player coldkilla mucks (does not show cards). Bets: 4. Collects: 8.55. Wins: 4.55.
Player IlxxxlI does not show cards.Bets: 1. Collects: 0. Loses: 1.
Game ended at: 2016/11/29 7:43:12

Game started
Game ID: 786709918 1/2 (PRR) Lakhey (Cap) (Hold'em)
Seat 4 is the button
Seat 1: wethco (166.93).
Seat 2: plin777 (95.35).
Seat 3: BigBlat (108.42).
Seat 4: dbrinker (279.85).
Seat 5: coldkilla (96.59).
Seat 6: IlxxxlI (80).
Player coldkilla has small blind (1)
Player IlxxxlI has big blind (2)
Player IlxxxlI received card: [Jh]
Player IlxxxlI received card: [8d]
Player wethco folds
Player plin777 folds
Player BigBlat raises (4)
Player dbrinker folds
Player coldkilla folds
Player IlxxxlI folds
Uncalled bet (2) returned to BigBlat
Player BigBlat mucks cards
------ Summary ------
Pot: 5. Rake 0
Player wethco does not show cards.Bets: 0. Collects: 0. Wins: 0.
Player plin777 does not show cards.Bets: 0. Collects: 0. Wins: 0.
*Player BigBlat mucks (does not show cards). Bets: 2. Collects: 5. Wins: 3.
Player dbrinker does not show cards.Bets: 0. Collects: 0. Wins: 0.
Player coldkilla does not show cards.Bets: 1. Collects: 0. Loses: 1.
Player IlxxxlI does not show cards.Bets: 2. Collects: 0. Loses: 2.
Game ended at: 2016/11/29 7:42:40

Game started
Game ID: 786709570 1/2 (PRR) Longana - 2 (Hold'em)
Seat 9 is the button
Seat 1: IlxxxlI (118.80).
Seat 3: IamPhamous (172.55).
Seat 4: TonnaMunz (274.35).
Seat 5: Iia007 (200).
Seat 7: MadLifeGrinder (219.40).
Seat 8: aleaga (313.50).
Seat 9: shokerAAss (244.73).
Player IlxxxlI has small blind (1)
Player IamPhamous has big blind (2)
Player IlxxxlI received card: [7c]
Player IlxxxlI received card: [2c]
Player TonnaMunz folds
Player Iia007 folds
Player MadLifeGrinder folds
Player aleaga folds
Player shokerAAss folds
Player IlxxxlI calls (1)
Player IamPhamous checks
*** FLOP ***: [2d 9s Qh]
Player IlxxxlI checks
Player IamPhamous checks
*** TURN ***: [2d 9s Qh] [2s]
Player IlxxxlI bets (2.53)
Player IamPhamous folds
Uncalled bet (2.53) returned to IlxxxlI
Player IlxxxlI mucks cards
------ Summary ------
Pot: 3.80. Rake 0.14. JP fee 0.06
Board: [2d 9s Qh 2s]
*Player IlxxxlI mucks (does not show cards). Bets: 2. Collects: 3.80. Wins: 1.80.
Player IamPhamous does not show cards.Bets: 2. Collects: 0. Loses: 2.
Player TonnaMunz does not show cards.Bets: 0. Collects: 0. Wins: 0.
Player Iia007 does not show cards.Bets: 0. Collects: 0. Wins: 0.
Player MadLifeGrinder does not show cards.Bets: 0. Collects: 0. Wins: 0.
Player aleaga does not show cards.Bets: 0. Collects: 0. Wins: 0.
Player shokerAAss does not show cards.Bets: 0. Collects: 0. Wins: 0.
Game ended at: 2016/11/29 7:42:43

Game started
Game ID: 786709283 1/2 (PRR) Lakhey (Cap) (Hold'em)
Seat 3 is the button
Seat 1: wethco (166.93).
Seat 2: plin777 (95.35).
Seat 3: BigBlat (103.87).
Seat 4: dbrinker (280.85).
Seat 5: coldkilla (100.59).
Seat 6: IlxxxlI (80).
Player dbrinker has small blind (1)
Player coldkilla has big blind (2)
Player IlxxxlI received card: [6s]
Player IlxxxlI received card: [7h]
Player IlxxxlI folds
Player wethco folds
Player plin777 folds
Player BigBlat raises (4)
Player dbrinker folds
Player coldkilla calls (2)
*** FLOP ***: [2d Ah 3c]
Player coldkilla checks
Player BigBlat bets (2.85)
Player coldkilla folds
Uncalled bet (2.85) returned to BigBlat
Player BigBlat mucks cards
------ Summary ------
Pot: 8.55. Rake 0.31. JP fee 0.14
Board: [2d Ah 3c]
Player wethco does not show cards.Bets: 0. Collects: 0. Wins: 0.
Player plin777 does not show cards.Bets: 0. Collects: 0. Wins: 0.
*Player BigBlat mucks (does not show cards). Bets: 4. Collects: 8.55. Wins: 4.55.
Player dbrinker does not show cards.Bets: 1. Collects: 0. Loses: 1.
Player coldkilla does not show cards.Bets: 4. Collects: 0. Loses: 4.
Player IlxxxlI does not show cards.Bets: 0. Collects: 0. Wins: 0.
Game ended at: 2016/11/29 7:42:5

Game started
Game ID: 786709093 1/2 (PRR) Longana - 2 (Hold'em)
Seat 8 is the button
Seat 1: IlxxxlI (120.80).
Seat 3: IamPhamous (172.55).
Seat 4: TonnaMunz (274.35).
Seat 5: Iia007 (200).
Seat 7: MadLifeGrinder (219.40).
Seat 8: aleaga (310.50).
Seat 9: shokerAAss (245.73).
Player shokerAAss has small blind (1)
Player IlxxxlI has big blind (2)
Player IlxxxlI received card: [3c]
Player IlxxxlI received card: [Ks]
Player IamPhamous folds
Player TonnaMunz folds
Player Iia007 folds
Player MadLifeGrinder folds
Player aleaga raises (4.50)
Player shokerAAss folds
Player IlxxxlI folds
Uncalled bet (2.50) returned to aleaga
Player aleaga mucks cards
------ Summary ------
Pot: 5. Rake 0
Player IlxxxlI does not show cards.Bets: 2. Collects: 0. Loses: 2.
Player IamPhamous does not show cards.Bets: 0. Collects: 0. Wins: 0.
Player TonnaMunz does not show cards.Bets: 0. Collects: 0. Wins: 0.
Player Iia007 does not show cards.Bets: 0. Collects: 0. Wins: 0.
Player MadLifeGrinder does not show cards.Bets: 0. Collects: 0. Wins: 0.
*Player aleaga mucks (does not show cards). Bets: 2. Collects: 5. Wins: 3.
Player shokerAAss does not show cards.Bets: 1. Collects: 0. Loses: 1.
Game ended at: 2016/11/29 7:41:38

Game started
Game ID: 786708201 1/2 (PRR) Longana - 2 (Hold'em)
Seat 7 is the button
Seat 1: IlxxxlI (120.80).
Seat 3: IamPhamous (178.55).
Seat 4: TonnaMunz (292.35).
Seat 5: Iia007 (200).
Seat 7: MadLifeGrinder (219.40).
Seat 8: aleaga (284.50).
Seat 9: shokerAAss (247.73).
Player aleaga has small blind (1)
Player shokerAAss has big blind (2)
Player IlxxxlI received card: [Qh]
Player IlxxxlI received card: [3c]
Player IlxxxlI folds
Player IamPhamous raises (6)
Player TonnaMunz raises (18)
Player Iia007 folds
Player MadLifeGrinder folds
Player aleaga raises (41)
Player shokerAAss folds
Player IamPhamous folds
Player TonnaMunz folds
Uncalled bet (24) returned to aleaga
Player aleaga mucks cards
------ Summary ------
Pot: 44. Rake 0
Player IlxxxlI does not show cards.Bets: 0. Collects: 0. Wins: 0.
Player IamPhamous does not show cards.Bets: 6. Collects: 0. Loses: 6.
Player TonnaMunz does not show cards.Bets: 18. Collects: 0. Loses: 18.
Player Iia007 does not show cards.Bets: 0. Collects: 0. Wins: 0.
Player MadLifeGrinder does not show cards.Bets: 0. Collects: 0. Wins: 0.
*Player aleaga mucks (does not show cards). Bets: 18. Collects: 44. Wins: 26.
Player shokerAAss does not show cards.Bets: 2. Collects: 0. Loses: 2.
Game ended at: 2016/11/29 7:41:4

Game started
Game ID: 786708069 1/2 (PRR) Lakhey (Cap) (Hold'em)
Seat 2 is the button
Seat 1: wethco (149.67).
Seat 2: plin777 (95.35).
Seat 3: BigBlat (104.87).
Seat 4: dbrinker (282.85).
Seat 5: coldkilla (116.60).
Seat 6: IlxxxlI (80).
Player BigBlat has small blind (1)
Player dbrinker has big blind (2)
Player IlxxxlI received card: [5s]
Player IlxxxlI received card: [Js]
Player coldkilla raises (4)
Player IlxxxlI folds
Player wethco calls (4)
Player plin777 folds
Player BigBlat folds
Player dbrinker folds
*** FLOP ***: [Qs 4c 9h]
Player coldkilla checks
Player wethco bets (3.48)
Player coldkilla calls (3.48)
*** TURN ***: [Qs 4c 9h] [8c]
Player coldkilla bets (8.53)
Player wethco calls (8.53)
*** RIVER ***: [Qs 4c 9h 8c] [Ad]
Player coldkilla checks
Player wethco checks
------ Summary ------
Pot: 33.27. Rake 1.51. JP fee 0.24
Board: [Qs 4c 9h 8c Ad]
*Player wethco shows: One pair of 9s [10d 9d]. Bets: 16.01. Collects: 33.27. Wins: 17.26.
Player plin777 does not show cards.Bets: 0. Collects: 0. Wins: 0.
Player BigBlat does not show cards.Bets: 1. Collects: 0. Loses: 1.
Player dbrinker does not show cards.Bets: 2. Collects: 0. Loses: 2.
Player coldkilla shows: High card A [Jc Kh]. Bets: 16.01. Collects: 0. Loses: 16.01.
Player IlxxxlI does not show cards.Bets: 0. Collects: 0. Wins: 0.
Game ended at: 2016/11/29 7:41:16

Game started
Game ID: 786707836 1/2 (PRR) Longana - 2 (Hold'em)
Seat 5 is the button
Seat 1: IlxxxlI (120.80).
Seat 2: Randall5 (80).
Seat 3: IamPhamous (178.55).
Seat 4: TonnaMunz (292.35).
Seat 5: Iia007 (200).
Seat 7: MadLifeGrinder (220.40).
Seat 8: aleaga (286.50).
Seat 9: shokerAAss (247.73).
Player MadLifeGrinder has small blind (1)
Player aleaga has big blind (2)
Player IlxxxlI received card: [9s]
Player IlxxxlI received card: [2h]
Player shokerAAss folds
Player IlxxxlI folds
Player Randall5 raises (5)
Player IamPhamous folds
Player TonnaMunz folds
Player Iia007 folds
Player MadLifeGrinder folds
Player aleaga folds
Uncalled bet (3) returned to Randall5
Player Randall5 is timed out.
Player Randall5 mucks cards
------ Summary ------
Pot: 5. Rake 0
Player IlxxxlI does not show cards.Bets: 0. Collects: 0. Wins: 0.
*Player Randall5 mucks (does not show cards). Bets: 2. Collects: 5. Wins: 3.
Player IamPhamous does not show cards.Bets: 0. Collects: 0. Wins: 0.
Player TonnaMunz does not show cards.Bets: 0. Collects: 0. Wins: 0.
Player Iia007 does not show cards.Bets: 0. Collects: 0. Wins: 0.
Player MadLifeGrinder does not show cards.Bets: 1. Collects: 0. Loses: 1.
Player aleaga does not show cards.Bets: 2. Collects: 0. Loses: 2.
Player shokerAAss does not show cards.Bets: 0. Collects: 0. Wins: 0.
Game ended at: 2016/11/29 7:39:56

Game started
Game ID: 786707652 1/2 (PRR) Longana - 3 (Hold'em)
Seat 1 is the button
Seat 1: IlxxxlI (82).
Seat 3: shokerAAss (208.35).
Player IlxxxlI has small blind (1)
Player shokerAAss has big blind (2)
Player IlxxxlI received card: [10d]
Player IlxxxlI received card: [8h]
Player IlxxxlI raises (4)
Player shokerAAss raises (14)
Player IlxxxlI folds
Uncalled bet (11) returned to shokerAAss
Player shokerAAss mucks cards
------ Summary ------
Pot: 10. Rake 0
Player IlxxxlI does not show cards.Bets: 5. Collects: 0. Loses: 5.
*Player shokerAAss mucks (does not show cards). Bets: 5. Collects: 10. Wins: 5.
Game ended at: 2016/11/29 7:39:35

Game started
Game ID: 786707316 1/2 (PRR) Longana - 3 (Hold'em)
Seat 9 is the button
Seat 1: IlxxxlI (84).
Seat 3: shokerAAss (206.35).
Seat 9: TonnaMunz (298.43).
Player IlxxxlI has small blind (1)
Player shokerAAss has big blind (2)
Player IlxxxlI received card: [8s]
Player IlxxxlI received card: [Jh]
Player TonnaMunz folds
Player IlxxxlI calls (1)
Player shokerAAss raises (4)
Player IlxxxlI folds
Uncalled bet (4) returned to shokerAAss
Player shokerAAss mucks cards
------ Summary ------
Pot: 4. Rake 0
Player IlxxxlI does not show cards.Bets: 2. Collects: 0. Loses: 2.
*Player shokerAAss mucks (does not show cards). Bets: 2. Collects: 4. Wins: 2.
Player TonnaMunz does not show cards.Bets: 0. Collects: 0. Wins: 0.
Game ended at: 2016/11/29 7:39:16

Game started
Game ID: 786707113 1/2 (PRR) Longana - 3 (Hold'em)
Seat 3 is the button
Seat 1: IlxxxlI (83).
Seat 3: shokerAAss (206.35).
Seat 9: TonnaMunz (299.43).
Player TonnaMunz has small blind (1)
Player IlxxxlI has big blind (2)
Player IlxxxlI received card: [2s]
Player IlxxxlI received card: [4h]
Player shokerAAss folds
Player TonnaMunz folds
Uncalled bet (1) returned to IlxxxlI
Player IlxxxlI mucks cards
------ Summary ------
Pot: 2. Rake 0
*Player IlxxxlI mucks (does not show cards). Bets: 1. Collects: 2. Wins: 1.
Player shokerAAss does not show cards.Bets: 0. Collects: 0. Wins: 0.
Player TonnaMunz does not show cards.Bets: 1. Collects: 0. Loses: 1.
Game ended at: 2016/11/29 7:38:50

Game started
Game ID: 786706999 1/2 (PRR) Longana - 2 (Hold'em)
Seat 4 is the button
Seat 1: IlxxxlI (105).
Seat 2: Randall5 (80).
Seat 3: IamPhamous (185.55).
Seat 4: TonnaMunz (299.35).
Seat 5: Iia007 (200).
Seat 6: Gronkowski69 (211.25).
Seat 7: MadLifeGrinder (222.40).
Seat 8: aleaga (286.50).
Seat 9: shokerAAss (247.73).
Player Iia007 has small blind (1)
Player Gronkowski69 sitting out
Player MadLifeGrinder has big blind (2)
Player IlxxxlI received card: [Kd]
Player IlxxxlI received card: [Ac]
Player aleaga folds
Player shokerAAss folds
Player IlxxxlI raises (7)
Player Randall5 folds
Player IamPhamous calls (7)
Player TonnaMunz calls (7)
Player Iia007 folds
Player MadLifeGrinder folds
*** FLOP ***: [Kh 10d 7s]
Player IlxxxlI bets (18)
Player IamPhamous folds
Player TonnaMunz folds
Uncalled bet (18) returned to IlxxxlI
Player IlxxxlI mucks cards
------ Summary ------
Pot: 22.80. Rake 0.96. JP fee 0.24
Board: [Kh 10d 7s]
*Player IlxxxlI mucks (does not show cards). Bets: 7. Collects: 22.80. Wins: 15.80.
Player Randall5 does not show cards.Bets: 0. Collects: 0. Wins: 0.
Player IamPhamous does not show cards.Bets: 7. Collects: 0. Loses: 7.
Player TonnaMunz does not show cards.Bets: 7. Collects: 0. Loses: 7.
Player Iia007 does not show cards.Bets: 1. Collects: 0. Loses: 1.
Player Gronkowski69 does not show cards.Bets: 0. Collects: 0. Wins: 0.
Player MadLifeGrinder does not show cards.Bets: 2. Collects: 0. Loses: 2.
Player aleaga does not show cards.Bets: 0. Collects: 0. Wins: 0.
Player shokerAAss does not show cards.Bets: 0. Collects: 0. Wins: 0.
Game ended at: 2016/11/29 7:39:29

Game started
Game ID: 786706925 1/2 (PRR) Lakhey (Cap) (Hold'em)
Seat 1 is the button
Seat 1: wethco (149.67).
Seat 2: plin777 (96.35).
Seat 3: BigBlat (86).
Seat 4: dbrinker (282.85).
Seat 5: coldkilla (116.60).
Seat 6: IlxxxlI (80).
Player plin777 has small blind (1)
Player BigBlat has big blind (2)
Player IlxxxlI received card: [Js]
Player IlxxxlI received card: [9s]
Player dbrinker folds
Player coldkilla folds
Player IlxxxlI raises (4)
Player wethco folds
Player plin777 folds
Player BigBlat raises (10)
Player IlxxxlI calls (8)
*** FLOP ***: [Jc Qs 9d]
Player BigBlat bets (7.91)
Player IlxxxlI calls (7.91)
*** TURN ***: [Jc Qs 9d] [Qd]
Player BigBlat bets (25.85)
Player IlxxxlI folds
Uncalled bet (25.85) returned to BigBlat
Player BigBlat mucks cards
------ Summary ------
Pot: 38.78. Rake 1.80. JP fee 0.24
Board: [Jc Qs 9d Qd]
Player wethco does not show cards.Bets: 0. Collects: 0. Wins: 0.
Player plin777 does not show cards.Bets: 1. Collects: 0. Loses: 1.
*Player BigBlat mucks (does not show cards). Bets: 19.91. Collects: 38.78. Wins: 18.87.
Player dbrinker does not show cards.Bets: 0. Collects: 0. Wins: 0.
Player coldkilla does not show cards.Bets: 0. Collects: 0. Wins: 0.
Player IlxxxlI does not show cards.Bets: 19.91. Collects: 0. Loses: 19.91.
Game ended at: 2016/11/29 7:39:47

Game started
Game ID: 786706330 1/2 (PRR) Longana - 2 (Hold'em)
Seat 3 is the button
Seat 1: IlxxxlI (105).
Seat 2: Randall5 (80).
Seat 3: IamPhamous (182.55).
Seat 4: TonnaMunz (300.35).
Seat 5: Iia007 (200).
Seat 6: Gronkowski69 (211.25).
Seat 7: MadLifeGrinder (222.40).
Seat 8: aleaga (286.50).
Seat 9: shokerAAss (247.73).
Player TonnaMunz has small blind (1)
Player Iia007 has big blind (2)
Player IlxxxlI received card: [4c]
Player IlxxxlI received card: [Qh]
Player Gronkowski69 folds
Player MadLifeGrinder folds
Player aleaga folds
Player shokerAAss folds
Player IlxxxlI folds
Player Randall5 folds
Player IamPhamous raises (6)
Player TonnaMunz folds
Player Iia007 folds
Uncalled bet (4) returned to IamPhamous
Player IamPhamous mucks cards
------ Summary ------
Pot: 5. Rake 0
Player IlxxxlI does not show cards.Bets: 0. Collects: 0. Wins: 0.
Player Randall5 does not show cards.Bets: 0. Collects: 0. Wins: 0.
*Player IamPhamous mucks (does not show cards). Bets: 2. Collects: 5. Wins: 3.
Player TonnaMunz does not show cards.Bets: 1. Collects: 0. Loses: 1.
Player Iia007 does not show cards.Bets: 2. Collects: 0. Loses: 2.
Player Gronkowski69 does not show cards.Bets: 0. Collects: 0. Wins: 0.
Player MadLifeGrinder does not show cards.Bets: 0. Collects: 0. Wins: 0.
Player aleaga does not show cards.Bets: 0. Collects: 0. Wins: 0.
Player shokerAAss does not show cards.Bets: 0. Collects: 0. Wins: 0.
Game ended at: 2016/11/29 7:38:25

Game started
Game ID: 786705751 1/2 (PRR) Lakhey (Cap) (Hold'em)
Seat 6 is the button
Seat 1: wethco (174.97).
Seat 2: plin777 (69.78).
Seat 3: BigBlat (90).
Seat 4: dbrinker (282.85).
Seat 5: coldkilla (116.60).
Seat 6: IlxxxlI (80).
Player wethco has small blind (1)
Player plin777 has big blind (2)
Player IlxxxlI received card: [6h]
Player IlxxxlI received card: [Jh]
Player BigBlat raises (4)
Player dbrinker folds
Player coldkilla folds
Player IlxxxlI folds
Player wethco calls (3)
Player plin777 raises (10)
Player BigBlat folds
Player wethco calls (8)
*** FLOP ***: [6d 8s 8c]
Player wethco checks
Player plin777 bets (13.30)
Player wethco calls (13.30)
*** TURN ***: [6d 8s 8c] [7s]
Player wethco checks
Player plin777 checks
*** RIVER ***: [6d 8s 8c 7s] [2c]
Player wethco checks
Player plin777 caps (34.70)
Player wethco folds
Uncalled bet (34.70) returned to plin777
Player plin777 mucks cards
------ Summary ------
Pot: 51.87. Rake 2.49. JP fee 0.24
Board: [6d 8s 8c 7s 2c]
Player wethco does not show cards.Bets: 25.30. Collects: 0. Loses: 25.30.
*Player plin777 mucks (does not show cards). Bets: 25.30. Collects: 51.87. Wins: 26.57.
Player BigBlat does not show cards.Bets: 4. Collects: 0. Loses: 4.
Player dbrinker does not show cards.Bets: 0. Collects: 0. Wins: 0.
Player coldkilla does not show cards.Bets: 0. Collects: 0. Wins: 0.
Player IlxxxlI does not show cards.Bets: 0. Collects: 0. Wins: 0.
Game ended at: 2016/11/29 7:38:21

Game started
Game ID: 786705674 1/2 (PRR) Longana - 2 (Hold'em)
Seat 2 is the button
Seat 1: IlxxxlI (80).
Seat 2: Randall5 (80).
Seat 3: IamPhamous (183.55).
Seat 4: TonnaMunz (302.35).
Seat 5: Iia007 (200).
Seat 6: Gronkowski69 (211.25).
Seat 7: MadLifeGrinder (222.40).
Seat 8: aleaga (291.50).
Seat 9: shokerAAss (264.73).
Player IamPhamous has small blind (1)
Player TonnaMunz has big blind (2)
Player IlxxxlI received card: [Kc]
Player IlxxxlI received card: [Ah]
Player Iia007 folds
Player Gronkowski69 folds
Player MadLifeGrinder folds
Player aleaga raises (5)
Player shokerAAss raises (17)
Player IlxxxlI allin (80)
Player Randall5 folds
Player IamPhamous folds
Player TonnaMunz folds
Player aleaga folds
Player shokerAAss folds
Uncalled bet (63) returned to IlxxxlI
Player IlxxxlI mucks cards
------ Summary ------
Pot: 42. Rake 0
*Player IlxxxlI mucks (does not show cards). Bets: 17. Collects: 42. Wins: 25.
Player Randall5 does not show cards.Bets: 0. Collects: 0. Wins: 0.
Player IamPhamous does not show cards.Bets: 1. Collects: 0. Loses: 1.
Player TonnaMunz does not show cards.Bets: 2. Collects: 0. Loses: 2.
Player Iia007 does not show cards.Bets: 0. Collects: 0. Wins: 0.
Player Gronkowski69 does not show cards.Bets: 0. Collects: 0. Wins: 0.
Player MadLifeGrinder does not show cards.Bets: 0. Collects: 0. Wins: 0.
Player aleaga does not show cards.Bets: 5. Collects: 0. Loses: 5.
Player shokerAAss does not show cards.Bets: 17. Collects: 0. Loses: 17.
Game ended at: 2016/11/29 7:37:38

Game started
Game ID: 786705647 1/2 (PRR) Longana - 3 (Hold'em)
Seat 1 is the button
Seat 1: IlxxxlI (80).
Seat 3: shokerAAss (250.35).
Seat 9: TonnaMunz (259.43).
Player shokerAAss has small blind (1)
Player TonnaMunz has big blind (2)
Player IlxxxlI received card: [Js]
Player IlxxxlI received card: [Jh]
Player IlxxxlI raises (6)
Player shokerAAss folds
Player TonnaMunz folds
Uncalled bet (4) returned to IlxxxlI
Player IlxxxlI mucks cards
------ Summary ------
Pot: 5. Rake 0
*Player IlxxxlI mucks (does not show cards). Bets: 2. Collects: 5. Wins: 3.
Player shokerAAss does not show cards.Bets: 1. Collects: 0. Loses: 1.
Player TonnaMunz does not show cards.Bets: 2. Collects: 0. Loses: 2.
Game ended at: 2016/11/29 7:37:4

Game started
Game ID: 786705515 1/2 (PRR) Longana - 3 (Hold'em)
Seat 9 is the button
Seat 1: IlxxxlI (80).
Seat 3: shokerAAss (249.35).
Seat 9: TonnaMunz (259.43).
Player IlxxxlI has small blind (1)
Player shokerAAss has big blind (2)
Player IlxxxlI received card: [7c]
Player IlxxxlI received card: [4s]
Player TonnaMunz folds
Player IlxxxlI folds
Uncalled bet (1) returned to shokerAAss
Player shokerAAss mucks cards
------ Summary ------
Pot: 2. Rake 0
Player IlxxxlI does not show cards.Bets: 1. Collects: 0. Loses: 1.
*Player shokerAAss mucks (does not show cards). Bets: 1. Collects: 2. Wins: 1.
Player TonnaMunz does not show cards.Bets: 0. Collects: 0. Wins: 0.
Game ended at: 2016/11/29 7:36:48

Game started
Game ID: 786705326 0.50/1 (PRR) Kajsa (short) (Hold'em)
Seat 6 is the button
Seat 1: IlxxxlI (20).
Seat 2: Gargantuatua (59).
Seat 4: BigBlat (49.21).
Seat 5: badboy85 (42.28).
Seat 6: Qrenor (52.96).
Player IlxxxlI has small blind (0.50)
Player Gargantuatua sitting out
Player BigBlat has big blind (1)
Player IlxxxlI received card: [Jh]
Player IlxxxlI received card: [Kh]
Player badboy85 folds
Player Qrenor raises (2)
Player IlxxxlI allin (19.50)
Player BigBlat folds
Player Qrenor folds
Uncalled bet (18) returned to IlxxxlI
Player IlxxxlI mucks cards
------ Summary ------
Pot: 5. Rake 0
*Player IlxxxlI mucks (does not show cards). Bets: 2. Collects: 5. Wins: 3.
Player Gargantuatua does not show cards.Bets: 0. Collects: 0. Wins: 0.
Player BigBlat does not show cards.Bets: 1. Collects: 0. Loses: 1.
Player badboy85 does not show cards.Bets: 0. Collects: 0. Wins: 0.
Player Qrenor does not show cards.Bets: 2. Collects: 0. Loses: 2.
Game ended at: 2016/11/29 7:37:0

Game started
Game ID: 786705061 1/2 (PRR) Longana - 3 (Hold'em)
Seat 3 is the button
Seat 1: IlxxxlI (80).
Seat 3: shokerAAss (249.35).
Seat 9: TonnaMunz (257.43).
Player TonnaMunz has small blind (1)
Player IlxxxlI has big blind (2)
Player IlxxxlI received card: [Jc]
Player IlxxxlI received card: [3s]
Player shokerAAss folds
Player TonnaMunz raises (5)
Player IlxxxlI folds
Uncalled bet (4) returned to TonnaMunz
Player TonnaMunz mucks cards
------ Summary ------
Pot: 4. Rake 0
Player IlxxxlI does not show cards.Bets: 2. Collects: 0. Loses: 2.
Player shokerAAss does not show cards.Bets: 0. Collects: 0. Wins: 0.
*Player TonnaMunz mucks (does not show cards). Bets: 2. Collects: 4. Wins: 2.
Game ended at: 2016/11/29 7:36:36

Game started
Game ID: 786704953 1/2 (PRR) Lakhey (Cap) (Hold'em)
Seat 5 is the button
Seat 1: wethco (176.97).
Seat 2: plin777 (69.78).
Seat 3: BigBlat (90).
Seat 4: dbrinker (282.85).
Seat 5: coldkilla (101.29).
Seat 6: IlxxxlI (80).
Player IlxxxlI has small blind (1)
Player wethco has big blind (2)
Player IlxxxlI received card: [10d]
Player IlxxxlI received card: [Ac]
Player plin777 folds
Player BigBlat folds
Player dbrinker folds
Player coldkilla calls (2)
Player IlxxxlI raises (6)
Player wethco folds
Player coldkilla calls (5)
*** FLOP ***: [2h Kh 8s]
Player IlxxxlI bets (7.90)
Player coldkilla raises (15.80)
Player IlxxxlI folds
Uncalled bet (7.90) returned to coldkilla
Player coldkilla mucks cards
------ Summary ------
Pot: 30.21. Rake 1.35. JP fee 0.24
Board: [2h Kh 8s]
Player wethco does not show cards.Bets: 2. Collects: 0. Loses: 2.
Player plin777 does not show cards.Bets: 0. Collects: 0. Wins: 0.
Player BigBlat does not show cards.Bets: 0. Collects: 0. Wins: 0.
Player dbrinker does not show cards.Bets: 0. Collects: 0. Wins: 0.
*Player coldkilla mucks (does not show cards). Bets: 14.90. Collects: 30.21. Wins: 15.31.
Player IlxxxlI does not show cards.Bets: 14.90. Collects: 0. Loses: 14.90.
Game ended at: 2016/11/29 7:36:57

Game started
Game ID: 786704756 1/2 (PRR) Lakhey (Cap) (Hold'em)
Seat 4 is the button
Seat 1: wethco (176.97).
Seat 2: plin777 (69.78).
Seat 3: BigBlat (90).
Seat 4: dbrinker (282.85).
Seat 5: coldkilla (99.29).
Seat 6: IlxxxlI (80).
Player coldkilla has small blind (1)
Player IlxxxlI has big blind (2)
Player IlxxxlI received card: [5d]
Player IlxxxlI received card: [Jh]
Player wethco folds
Player plin777 folds
Player BigBlat folds
Player dbrinker folds
Player coldkilla raises (3)
Player IlxxxlI folds
Uncalled bet (2) returned to coldkilla
Player coldkilla mucks cards
------ Summary ------
Pot: 4. Rake 0
Player wethco does not show cards.Bets: 0. Collects: 0. Wins: 0.
Player plin777 does not show cards.Bets: 0. Collects: 0. Wins: 0.
Player BigBlat does not show cards.Bets: 0. Collects: 0. Wins: 0.
Player dbrinker does not show cards.Bets: 0. Collects: 0. Wins: 0.
*Player coldkilla mucks (does not show cards). Bets: 2. Collects: 4. Wins: 2.
Player IlxxxlI does not show cards.Bets: 2. Collects: 0. Loses: 2.
Game ended at: 2016/11/29 7:35:53

Game started
Game ID: 786704728 1/2 (PRR) Longana - 2 (Hold'em)
Seat 1 is the button
Seat 1: IlxxxlI (80).
Seat 2: Randall5 (80).
Seat 3: IamPhamous (188.55).
Seat 4: TonnaMunz (302.35).
Seat 5: Iia007 (200).
Seat 6: Gronkowski69 (211.25).
Seat 7: MadLifeGrinder (216.95).
Seat 8: aleaga (291.50).
Seat 9: shokerAAss (264.73).
Player Randall5 has small blind (1)
Player IamPhamous has big blind (2)
Player IlxxxlI received card: [9h]
Player IlxxxlI received card: [Qh]
Player TonnaMunz folds
Player Iia007 folds
Player Gronkowski69 folds
Player MadLifeGrinder raises (5)
Player aleaga folds
Player shokerAAss folds
Player IlxxxlI folds
Player Randall5 folds
Player IamPhamous calls (3)
*** FLOP ***: [4s Jh 8s]
Player IamPhamous checks
Player MadLifeGrinder checks
*** TURN ***: [4s Jh 8s] [7s]
Player IamPhamous checks
Player MadLifeGrinder checks
*** RIVER ***: [4s Jh 8s 7s] [Ks]
Player IamPhamous checks
Player MadLifeGrinder bets (6)
Player IamPhamous folds
Uncalled bet (6) returned to MadLifeGrinder
Player MadLifeGrinder mucks cards
------ Summary ------
Pot: 10.45. Rake 0.37. JP fee 0.18
Board: [4s Jh 8s 7s Ks]
Player IlxxxlI does not show cards.Bets: 0. Collects: 0. Wins: 0.
Player Randall5 does not show cards.Bets: 1. Collects: 0. Loses: 1.
Player IamPhamous does not show cards.Bets: 5. Collects: 0. Loses: 5.
Player TonnaMunz does not show cards.Bets: 0. Collects: 0. Wins: 0.
Player Iia007 does not show cards.Bets: 0. Collects: 0. Wins: 0.
Player Gronkowski69 does not show cards.Bets: 0. Collects: 0. Wins: 0.
*Player MadLifeGrinder mucks (does not show cards). Bets: 5. Collects: 10.45. Wins: 5.45.
Player aleaga does not show cards.Bets: 0. Collects: 0. Wins: 0.
Player shokerAAss does not show cards.Bets: 0. Collects: 0. Wins: 0.
Game ended at: 2016/11/29 7:36:51

Game started
Game ID: 786704688 0.50/1 (PRR) Kajsa (short) (Hold'em)
Seat 5 is the button
Seat 1: IlxxxlI (20).
Seat 2: Gargantuatua (59).
Seat 3: Bikurjim (33.84).
Seat 4: BigBlat (49.21).
Seat 5: badboy85 (40).
Seat 6: Qrenor (53.46).
Player Qrenor has small blind (0.50)
Player IlxxxlI has big blind (1)
Player IlxxxlI received card: [9d]
Player IlxxxlI received card: [Js]
Player Gargantuatua folds
Player Bikurjim folds
Player BigBlat folds
Player badboy85 raises (2)
Player Qrenor folds
Player IlxxxlI calls (1)
*** FLOP ***: [7s 5s 7c]
Player IlxxxlI checks
Player badboy85 bets (2.14)
Player IlxxxlI folds
Uncalled bet (2.14) returned to badboy85
Player badboy85 mucks cards
------ Summary ------
Pot: 4.28. Rake 0.16. JP fee 0.06
Board: [7s 5s 7c]
Player IlxxxlI does not show cards.Bets: 2. Collects: 0. Loses: 2.
Player Gargantuatua does not show cards.Bets: 0. Collects: 0. Wins: 0.
Player Bikurjim does not show cards.Bets: 0. Collects: 0. Wins: 0.
Player BigBlat does not show cards.Bets: 0. Collects: 0. Wins: 0.
*Player badboy85 mucks (does not show cards). Bets: 2. Collects: 4.28. Wins: 2.28.
Player Qrenor does not show cards.Bets: 0.50. Collects: 0. Loses: 0.50.
Game ended at: 2016/11/29 7:36:21

Game started
Game ID: 786704632 1/2 (PRR) Longana - 3 (Hold'em)
Seat 1 is the button
Seat 1: IlxxxlI (80).
Seat 3: shokerAAss (256.35).
Seat 7: BigBlat (132.62).
Seat 9: TonnaMunz (250.43).
Player shokerAAss has small blind (1)
Player BigBlat sitting out
Player TonnaMunz has big blind (2)
Player IlxxxlI received card: [6c]
Player IlxxxlI received card: [7h]
Player IlxxxlI folds
Player shokerAAss raises (6)
Player TonnaMunz raises (22)
Player shokerAAss folds
Uncalled bet (17) returned to TonnaMunz
Player TonnaMunz mucks cards
------ Summary ------
Pot: 14. Rake 0
Player IlxxxlI does not show cards.Bets: 0. Collects: 0. Wins: 0.
Player shokerAAss does not show cards.Bets: 7. Collects: 0. Loses: 7.
Player BigBlat does not show cards.Bets: 0. Collects: 0. Wins: 0.
*Player TonnaMunz mucks (does not show cards). Bets: 7. Collects: 14. Wins: 7.
Game ended at: 2016/11/29 7:36:0

Game started
Game ID: 786704422 1/2 (PRR) Longana - 3 (Hold'em)
Seat 9 is the button
Seat 1: IlxxxlI (80).
Seat 3: shokerAAss (255.35).
Seat 7: BigBlat (132.62).
Seat 9: TonnaMunz (250.43).
Player IlxxxlI has small blind (1)
Player shokerAAss has big blind (2)
Player IlxxxlI received card: [Qd]
Player IlxxxlI received card: [2h]
Player BigBlat folds
Player TonnaMunz folds
Player IlxxxlI folds
Uncalled bet (1) returned to shokerAAss
Player shokerAAss mucks cards
------ Summary ------
Pot: 2. Rake 0
Player IlxxxlI does not show cards.Bets: 1. Collects: 0. Loses: 1.
*Player shokerAAss mucks (does not show cards). Bets: 1. Collects: 2. Wins: 1.
Player BigBlat does not show cards.Bets: 0. Collects: 0. Wins: 0.
Player TonnaMunz does not show cards.Bets: 0. Collects: 0. Wins: 0.
Game ended at: 2016/11/29 7:35:29

Game started
Game ID: 786703700 1/2 (PRR) Longana - 3 (Hold'em)
Seat 7 is the button
Seat 1: IlxxxlI (83).
Seat 3: shokerAAss (255.35).
Seat 7: BigBlat (132.62).
Seat 9: TonnaMunz (245.03).
Player TonnaMunz has small blind (1)
Player IlxxxlI has big blind (2)
Player IlxxxlI received card: [5c]
Player IlxxxlI received card: [Ah]
Player shokerAAss folds
Player BigBlat folds
Player TonnaMunz raises (5)
Player IlxxxlI calls (4)
*** FLOP ***: [Kc 6h Qh]
Player TonnaMunz checks
Player IlxxxlI checks
*** TURN ***: [Kc 6h Qh] [8d]
Player TonnaMunz checks
Player IlxxxlI checks
*** RIVER ***: [Kc 6h Qh 8d] [9c]
Player TonnaMunz bets (7.60)
Player IlxxxlI folds
Uncalled bet (7.60) returned to TonnaMunz
Player TonnaMunz mucks cards
------ Summary ------
Pot: 11.40. Rake 0.40. JP fee 0.20
Board: [Kc 6h Qh 8d 9c]
Player IlxxxlI does not show cards.Bets: 6. Collects: 0. Loses: 6.
Player shokerAAss does not show cards.Bets: 0. Collects: 0. Wins: 0.
Player BigBlat does not show cards.Bets: 0. Collects: 0. Wins: 0.
*Player TonnaMunz mucks (does not show cards). Bets: 6. Collects: 11.40. Wins: 5.40.
Game ended at: 2016/11/29 7:35:15

Game started
Game ID: 786703541 1/2 (PRR) Longana - 3 (Hold'em)
Seat 3 is the button
Seat 1: IlxxxlI (80).
Seat 3: shokerAAss (255.35).
Seat 7: BigBlat (133.62).
Seat 9: TonnaMunz (247.03).
Player BigBlat has small blind (1)
Player TonnaMunz has big blind (2)
Player IlxxxlI received card: [Jh]
Player IlxxxlI received card: [10h]
Player IlxxxlI raises (4.80)
Player shokerAAss folds
Player BigBlat folds
Player TonnaMunz folds
Uncalled bet (2.80) returned to IlxxxlI
Player IlxxxlI mucks cards
------ Summary ------
Pot: 5. Rake 0
*Player IlxxxlI mucks (does not show cards). Bets: 2. Collects: 5. Wins: 3.
Player shokerAAss does not show cards.Bets: 0. Collects: 0. Wins: 0.
Player BigBlat does not show cards.Bets: 1. Collects: 0. Loses: 1.
Player TonnaMunz does not show cards.Bets: 2. Collects: 0. Loses: 2.
Game ended at: 2016/11/29 7:34:17

Game started
Game ID: 786703395 1/2 (PRR) Longana - 2 (Hold'em)
Seat 9 is the button
Seat 1: IlxxxlI (81).
Seat 2: Randall5 (80).
Seat 3: IamPhamous (168.38).
Seat 4: TonnaMunz (302.35).
Seat 5: Iia007 (200).
Seat 6: Gronkowski69 (211.25).
Seat 7: MadLifeGrinder (216.95).
Seat 8: aleaga (291.50).
Seat 9: shokerAAss (279.75).
Player IlxxxlI has small blind (1)
Player Randall5 has big blind (2)
Player IlxxxlI received card: [8c]
Player IlxxxlI received card: [Jc]
Player IamPhamous raises (6)
Player TonnaMunz folds
Player Iia007 folds
Player Gronkowski69 folds
Player MadLifeGrinder folds
Player aleaga folds
Player shokerAAss calls (6)
Player IlxxxlI folds
Player Randall5 calls (4)
*** FLOP ***: [2s 2h Qs]
Player Randall5 checks
Player IamPhamous bets (9.02)
Player shokerAAss calls (9.02)
Player Randall5 folds
*** TURN ***: [2s 2h Qs] [Qh]
Player IamPhamous bets (17.59)
Player shokerAAss folds
Uncalled bet (17.59) returned to IamPhamous
Player IamPhamous mucks cards
------ Summary ------
Pot: 35.19. Rake 1.61. JP fee 0.24
Board: [2s 2h Qs Qh]
Player IlxxxlI does not show cards.Bets: 1. Collects: 0. Loses: 1.
Player Randall5 does not show cards.Bets: 6. Collects: 0. Loses: 6.
*Player IamPhamous mucks (does not show cards). Bets: 15.02. Collects: 35.19. Wins: 20.17.
Player TonnaMunz does not show cards.Bets: 0. Collects: 0. Wins: 0.
Player Iia007 does not show cards.Bets: 0. Collects: 0. Wins: 0.
Player Gronkowski69 does not show cards.Bets: 0. Collects: 0. Wins: 0.
Player MadLifeGrinder does not show cards.Bets: 0. Collects: 0. Wins: 0.
Player aleaga does not show cards.Bets: 0. Collects: 0. Wins: 0.
Player shokerAAss does not show cards.Bets: 15.02. Collects: 0. Loses: 15.02.
Game ended at: 2016/11/29 7:35:36

Game started
Game ID: 786703361 1/2 (PRR) Longana - 3 (Hold'em)
Seat 1 is the button
Seat 1: IlxxxlI (80).
Seat 3: shokerAAss (256.35).
Seat 7: BigBlat (132.62).
Seat 9: TonnaMunz (247.03).
Player shokerAAss has small blind (1)
Player BigBlat has big blind (2)
Player IlxxxlI received card: [Jd]
Player IlxxxlI received card: [3c]
Player TonnaMunz folds
Player IlxxxlI folds
Player shokerAAss folds
Uncalled bet (1) returned to BigBlat
Player BigBlat mucks cards
------ Summary ------
Pot: 2. Rake 0
Player IlxxxlI does not show cards.Bets: 0. Collects: 0. Wins: 0.
Player shokerAAss does not show cards.Bets: 1. Collects: 0. Loses: 1.
*Player BigBlat mucks (does not show cards). Bets: 1. Collects: 2. Wins: 1.
Player TonnaMunz does not show cards.Bets: 0. Collects: 0. Wins: 0.
Game ended at: 2016/11/29 7:34:5

Game started
Game ID: 786703004 1/2 (PRR) Longana - 2 (Hold'em)
Seat 8 is the button
Seat 1: IlxxxlI (80).
Seat 3: IamPhamous (168.38).
Seat 4: TonnaMunz (302.35).
Seat 5: Iia007 (200).
Seat 6: Gronkowski69 (211.25).
Seat 7: MadLifeGrinder (216.95).
Seat 8: aleaga (291.50).
Seat 9: shokerAAss (280.75).
Player shokerAAss has small blind (1)
Player IlxxxlI has big blind (2)
Player IlxxxlI received card: [3d]
Player IlxxxlI received card: [4c]
Player IamPhamous folds
Player TonnaMunz folds
Player Iia007 folds
Player Gronkowski69 folds
Player MadLifeGrinder folds
Player aleaga folds
Player shokerAAss folds
Uncalled bet (1) returned to IlxxxlI
Player IlxxxlI mucks cards
------ Summary ------
Pot: 2. Rake 0
*Player IlxxxlI mucks (does not show cards). Bets: 1. Collects: 2. Wins: 1.
Player IamPhamous does not show cards.Bets: 0. Collects: 0. Wins: 0.
Player TonnaMunz does not show cards.Bets: 0. Collects: 0. Wins: 0.
Player Iia007 does not show cards.Bets: 0. Collects: 0. Wins: 0.
Player Gronkowski69 does not show cards.Bets: 0. Collects: 0. Wins: 0.
Player MadLifeGrinder does not show cards.Bets: 0. Collects: 0. Wins: 0.
Player aleaga does not show cards.Bets: 0. Collects: 0. Wins: 0.
Player shokerAAss does not show cards.Bets: 1. Collects: 0. Loses: 1.
Game ended at: 2016/11/29 7:33:54

Game started
Game ID: 786702947 1/2 (PRR) Longana - 3 (Hold'em)
Seat 9 is the button
Seat 1: IlxxxlI (80).
Seat 3: shokerAAss (250.41).
Seat 7: BigBlat (132.62).
Seat 9: TonnaMunz (251.97).
Player IlxxxlI has small blind (1)
Player shokerAAss has big blind (2)
Player IlxxxlI received card: [Qc]
Player IlxxxlI received card: [10h]
Player BigBlat folds
Player TonnaMunz raises (4.94)
Player IlxxxlI folds
Player shokerAAss raises (13)
Player TonnaMunz folds
Uncalled bet (10.06) returned to shokerAAss
Player shokerAAss mucks cards
------ Summary ------
Pot: 10.88. Rake 0
Player IlxxxlI does not show cards.Bets: 1. Collects: 0. Loses: 1.
*Player shokerAAss mucks (does not show cards). Bets: 4.94. Collects: 10.88. Wins: 5.94.
Player BigBlat does not show cards.Bets: 0. Collects: 0. Wins: 0.
Player TonnaMunz does not show cards.Bets: 4.94. Collects: 0. Loses: 4.94.
Game ended at: 2016/11/29 7:33:52

Game started
Game ID: 786702749 1/2 (PRR) Longana - 3 (Hold'em)
Seat 7 is the button
Seat 1: IlxxxlI (80).
Seat 3: shokerAAss (250.41).
Seat 7: BigBlat (132.62).
Seat 9: TonnaMunz (249.97).
Player TonnaMunz has small blind (1)
Player IlxxxlI has big blind (2)
Player IlxxxlI received card: [Kc]
Player IlxxxlI received card: [3h]
Player shokerAAss folds
Player BigBlat folds
Player TonnaMunz raises (5)
Player IlxxxlI folds
Uncalled bet (4) returned to TonnaMunz
Player TonnaMunz mucks cards
------ Summary ------
Pot: 4. Rake 0
Player IlxxxlI does not show cards.Bets: 2. Collects: 0. Loses: 2.
Player shokerAAss does not show cards.Bets: 0. Collects: 0. Wins: 0.
Player BigBlat does not show cards.Bets: 0. Collects: 0. Wins: 0.
*Player TonnaMunz mucks (does not show cards). Bets: 2. Collects: 4. Wins: 2.
Game ended at: 2016/11/29 7:33:21

Game started
Game ID: 786378797 1/2 (PRR) Lakhey (Short) (Hold'em)
Seat 3 is the button
Seat 1: IlxxxlI (40.70).
Seat 2: gfclbv (107.40).
Seat 3: dscshift (6.01).
Seat 4: AligateR (100).
Seat 5: meandkids (77.44).
Player AligateR has small blind (1)
Player meandkids has big blind (2)
Player IlxxxlI received card: [Ks]
Player IlxxxlI received card: [7h]
Player IlxxxlI folds
Player gfclbv folds
Player dscshift folds
Player AligateR raises (6)
Player meandkids folds
Uncalled bet (5) returned to AligateR
Player AligateR mucks cards
------ Summary ------
Pot: 4. Rake 0
Player IlxxxlI does not show cards.Bets: 0. Collects: 0. Wins: 0.
Player gfclbv does not show cards.Bets: 0. Collects: 0. Wins: 0.
Player dscshift does not show cards.Bets: 0. Collects: 0. Wins: 0.
*Player AligateR mucks (does not show cards). Bets: 2. Collects: 4. Wins: 2.
Player meandkids does not show cards.Bets: 2. Collects: 0. Loses: 2.
Game ended at: 2016/11/28 20:50:31

Game started
Game ID: 786378667 1/2 (PRR) Lakhey (Short) (Hold'em)
Seat 2 is the button
Seat 1: IlxxxlI (40.70).
Seat 2: gfclbv (101.90).
Seat 3: dscshift (10.01).
Seat 4: AligateR (100).
Seat 5: meandkids (77.44).
Player dscshift has small blind (1)
Player AligateR has big blind (2)
Player IlxxxlI received card: [10c]
Player IlxxxlI received card: [4d]
Player meandkids folds
Player IlxxxlI folds
Player gfclbv raises (4)
Player dscshift calls (3)
Player AligateR folds
*** FLOP ***: [4c 3d 7d]
Player dscshift checks
Player gfclbv bets (8)
Player dscshift folds
Uncalled bet (8) returned to gfclbv
Player gfclbv mucks cards
------ Summary ------
Pot: 9.50. Rake 0.34. JP fee 0.16
Board: [4c 3d 7d]
Player IlxxxlI does not show cards.Bets: 0. Collects: 0. Wins: 0.
*Player gfclbv mucks (does not show cards). Bets: 4. Collects: 9.50. Wins: 5.50.
Player dscshift does not show cards.Bets: 4. Collects: 0. Loses: 4.
Player AligateR does not show cards.Bets: 2. Collects: 0. Loses: 2.
Player meandkids does not show cards.Bets: 0. Collects: 0. Wins: 0.
Game ended at: 2016/11/28 20:50:15

Game started
Game ID: 786378580 1/2 (PRR) Lakhey (Short) (Hold'em)
Seat 1 is the button
Seat 1: IlxxxlI (40.70).
Seat 2: gfclbv (102.90).
Seat 3: dscshift (12.01).
Seat 5: meandkids (74.44).
Player gfclbv has small blind (1)
Player dscshift has big blind (2)
Player IlxxxlI received card: [9d]
Player IlxxxlI received card: [9h]
Player meandkids raises (10)
Player IlxxxlI folds
Player gfclbv folds
Player dscshift folds
Uncalled bet (8) returned to meandkids
Player meandkids mucks cards
------ Summary ------
Pot: 5. Rake 0
Player IlxxxlI does not show cards.Bets: 0. Collects: 0. Wins: 0.
Player gfclbv does not show cards.Bets: 1. Collects: 0. Loses: 1.
Player dscshift does not show cards.Bets: 2. Collects: 0. Loses: 2.
*Player meandkids mucks (does not show cards). Bets: 2. Collects: 5. Wins: 3.
Game ended at: 2016/11/28 20:49:40

Game started
Game ID: 786378501 1/2 (PRR) Lakhey (Short) (Hold'em)
Seat 5 is the button
Seat 1: IlxxxlI (41.70).
Seat 2: gfclbv (104.90).
Seat 3: dscshift (12.01).
Seat 5: meandkids (71.44).
Player IlxxxlI has small blind (1)
Player gfclbv has big blind (2)
Player IlxxxlI received card: [Kd]
Player IlxxxlI received card: [4h]
Player dscshift folds
Player meandkids raises (12)
Player IlxxxlI folds
Player gfclbv folds
Uncalled bet (10) returned to meandkids
Player meandkids mucks cards
------ Summary ------
Pot: 5. Rake 0
Player IlxxxlI does not show cards.Bets: 1. Collects: 0. Loses: 1.
Player gfclbv does not show cards.Bets: 2. Collects: 0. Loses: 2.
Player dscshift does not show cards.Bets: 0. Collects: 0. Wins: 0.
*Player meandkids mucks (does not show cards). Bets: 2. Collects: 5. Wins: 3.
Game ended at: 2016/11/28 20:49:19

Game started
Game ID: 786378434 1/2 (PRR) Lakhey (Short) (Hold'em)
Seat 3 is the button
Seat 1: IlxxxlI (43.70).
Seat 2: gfclbv (104.90).
Seat 3: dscshift (12.01).
Seat 5: meandkids (69.44).
Player meandkids has small blind (1)
Player IlxxxlI has big blind (2)
Player IlxxxlI received card: [4c]
Player IlxxxlI received card: [Ah]
Player gfclbv folds
Player dscshift folds
Player meandkids raises (11)
Player IlxxxlI folds
Uncalled bet (10) returned to meandkids
Player meandkids mucks cards
------ Summary ------
Pot: 4. Rake 0
Player IlxxxlI does not show cards.Bets: 2. Collects: 0. Loses: 2.
Player gfclbv does not show cards.Bets: 0. Collects: 0. Wins: 0.
Player dscshift does not show cards.Bets: 0. Collects: 0. Wins: 0.
*Player meandkids mucks (does not show cards). Bets: 2. Collects: 4. Wins: 2.
Game ended at: 2016/11/28 20:48:58

Game started
Game ID: 786378288 1/2 (PRR) Lakhey (Short) (Hold'em)
Seat 2 is the button
Seat 1: IlxxxlI (43.70).
Seat 2: gfclbv (104.90).
Seat 3: dscshift (14.01).
Seat 4: Wollverin (160.70).
Seat 5: meandkids (67.44).
Player dscshift has small blind (1)
Player Wollverin sitting out
Player meandkids has big blind (2)
Player IlxxxlI received card: [5d]
Player IlxxxlI received card: [9h]
Player IlxxxlI folds
Player gfclbv folds
Player dscshift calls (1)
Player meandkids raises (8)
Player dscshift folds
Uncalled bet (8) returned to meandkids
Player meandkids mucks cards
------ Summary ------
Pot: 4. Rake 0
Player IlxxxlI does not show cards.Bets: 0. Collects: 0. Wins: 0.
Player gfclbv does not show cards.Bets: 0. Collects: 0. Wins: 0.
Player dscshift does not show cards.Bets: 2. Collects: 0. Loses: 2.
Player Wollverin does not show cards.Bets: 0. Collects: 0. Wins: 0.
*Player meandkids mucks (does not show cards). Bets: 2. Collects: 4. Wins: 2.
Game ended at: 2016/11/28 20:48:41

Game started
Game ID: 786378216 1/2 (PRR) Lakhey (Short) (Hold'em)
Seat 1 is the button
Seat 1: IlxxxlI (43.70).
Seat 2: gfclbv (105.90).
Seat 3: dscshift (13.01).
Seat 4: Wollverin (160.70).
Seat 5: meandkids (67.44).
Player gfclbv has small blind (1)
Player dscshift has big blind (2)
Player IlxxxlI received card: [Ah]
Player IlxxxlI received card: [7c]
Player Wollverin folds
Player meandkids folds
Player IlxxxlI folds
Player gfclbv folds
Uncalled bet (1) returned to dscshift
Player dscshift mucks cards
------ Summary ------
Pot: 2. Rake 0
Player IlxxxlI does not show cards.Bets: 0. Collects: 0. Wins: 0.
Player gfclbv does not show cards.Bets: 1. Collects: 0. Loses: 1.
*Player dscshift mucks (does not show cards). Bets: 1. Collects: 2. Wins: 1.
Player Wollverin does not show cards.Bets: 0. Collects: 0. Wins: 0.
Player meandkids does not show cards.Bets: 0. Collects: 0. Wins: 0.
Game ended at: 2016/11/28 20:48:3

Game started
Game ID: 786378146 0.25/0.50 (PRR) Gorgons (Hold'em)
Seat 2 is the button
Seat 1: BirdieKing (43.88).
Seat 2: GreinSeint (19.79).
Seat 3: in_ur_i (44.50).
Seat 4: JoJoLoring (57.28).
Seat 5: meandkids (47).
Seat 6: IlxxxlI (22.46).
Player in_ur_i has small blind (0.25)
Player JoJoLoring has big blind (0.50)
Player IlxxxlI received card: [2d]
Player IlxxxlI received card: [8h]
Player meandkids folds
Player IlxxxlI folds
Player BirdieKing folds
Player GreinSeint raises (1.50)
Player in_ur_i folds
Player JoJoLoring calls (1)
*** FLOP ***: [Qs 2s 4s]
Player JoJoLoring bets (0.50)
Player GreinSeint calls (0.50)
*** TURN ***: [Qs 2s 4s] [Kd]
Player JoJoLoring bets (0.50)
Player GreinSeint calls (0.50)
*** RIVER ***: [Qs 2s 4s Kd] [2c]
Player JoJoLoring bets (2.49)
Player GreinSeint calls (2.49)
------ Summary ------
Pot: 9.72. Rake 0.35. JP fee 0.16
Board: [Qs 2s 4s Kd 2c]
Player BirdieKing does not show cards.Bets: 0. Collects: 0. Wins: 0.
*Player GreinSeint shows: Two pairs. Ks and 2s [9s Kh]. Bets: 4.99. Collects: 9.72. Wins: 4.73.
Player in_ur_i does not show cards.Bets: 0.25. Collects: 0. Loses: 0.25.
Player JoJoLoring shows: One pair of 2s [6c 9h]. Bets: 4.99. Collects: 0. Loses: 4.99.
Player meandkids does not show cards.Bets: 0. Collects: 0. Wins: 0.
Player IlxxxlI does not show cards.Bets: 0. Collects: 0. Wins: 0.
Game ended at: 2016/11/28 20:48:47

Game started
Game ID: 786378099 1/2 (PRR) Lakhey (Short) (Hold'em)
Seat 5 is the button
Seat 1: IlxxxlI (40).
Seat 2: gfclbv (107.90).
Seat 3: dscshift (15.01).
Seat 4: Wollverin (160.70).
Seat 5: meandkids (67.44).
Player IlxxxlI has small blind (1)
Player gfclbv has big blind (2)
Player IlxxxlI received card: [7c]
Player IlxxxlI received card: [7d]
Player dscshift calls (2)
Player Wollverin folds
Player meandkids folds
Player IlxxxlI calls (1)
Player gfclbv checks
*** FLOP ***: [6s 3h 4s]
Player IlxxxlI allin (38)
Player gfclbv folds
Player dscshift folds
Uncalled bet (38) returned to IlxxxlI
Player IlxxxlI mucks cards
------ Summary ------
Pot: 5.70. Rake 0.20. JP fee 0.10
Board: [6s 3h 4s]
*Player IlxxxlI mucks (does not show cards). Bets: 2. Collects: 5.70. Wins: 3.70.
Player gfclbv does not show cards.Bets: 2. Collects: 0. Loses: 2.
Player dscshift does not show cards.Bets: 2. Collects: 0. Loses: 2.
Player Wollverin does not show cards.Bets: 0. Collects: 0. Wins: 0.
Player meandkids does not show cards.Bets: 0. Collects: 0. Wins: 0.
Game ended at: 2016/11/28 20:47:43

Game started
Game ID: 786378021 1/2 (PRR) Lakhey (Short) (Hold'em)
Seat 4 is the button
Seat 1: IlxxxlI (40).
Seat 2: gfclbv (107.90).
Seat 3: dscshift (15.01).
Seat 4: Wollverin (157.70).
Seat 5: meandkids (68.44).
Player meandkids has small blind (1)
Player IlxxxlI has big blind (2)
Player IlxxxlI received card: [Qh]
Player IlxxxlI received card: [2c]
Player gfclbv folds
Player dscshift folds
Player Wollverin raises (4)
Player meandkids folds
Player IlxxxlI folds
Uncalled bet (2) returned to Wollverin
Player Wollverin mucks cards
------ Summary ------
Pot: 5. Rake 0
Player IlxxxlI does not show cards.Bets: 2. Collects: 0. Loses: 2.
Player gfclbv does not show cards.Bets: 0. Collects: 0. Wins: 0.
Player dscshift does not show cards.Bets: 0. Collects: 0. Wins: 0.
*Player Wollverin mucks (does not show cards). Bets: 2. Collects: 5. Wins: 3.
Player meandkids does not show cards.Bets: 1. Collects: 0. Loses: 1.
Game ended at: 2016/11/28 20:47:10

Game started
Game ID: 786377931 0.25/0.50 (PRR) Gorgons (Hold'em)
Seat 1 is the button
Seat 1: BirdieKing (43.88).
Seat 2: GreinSeint (20.04).
Seat 3: in_ur_i (46.96).
Seat 5: meandkids (47).
Seat 6: IlxxxlI (20).
Player GreinSeint has small blind (0.25)
Player in_ur_i has big blind (0.50)
Player IlxxxlI received card: [10c]
Player IlxxxlI received card: [Qd]
Player meandkids folds
Player IlxxxlI raises (1.20)
Player BirdieKing folds
Player GreinSeint folds
Player in_ur_i calls (0.70)
*** FLOP ***: [4c Kc Qs]
Player in_ur_i checks
Player IlxxxlI checks
*** TURN ***: [4c Kc Qs] [As]
Player in_ur_i bets (1.26)
Player IlxxxlI calls (1.26)
*** RIVER ***: [4c Kc Qs As] [2d]
Player in_ur_i checks
Player IlxxxlI checks
------ Summary ------
Pot: 4.92. Rake 0.17. JP fee 0.08
Board: [4c Kc Qs As 2d]
Player BirdieKing does not show cards.Bets: 0. Collects: 0. Wins: 0.
Player GreinSeint does not show cards.Bets: 0.25. Collects: 0. Loses: 0.25.
Player in_ur_i shows: High card A [8h 7h]. Bets: 2.46. Collects: 0. Loses: 2.46.
Player meandkids does not show cards.Bets: 0. Collects: 0. Wins: 0.
*Player IlxxxlI shows: One pair of Qs [10c Qd]. Bets: 2.46. Collects: 4.92. Wins: 2.46.
Game ended at: 2016/11/28 20:47:22

Game started
Game ID: 786377765 1/2 (PRR) Lakhey (Short) (Hold'em)
Seat 3 is the button
Seat 1: IlxxxlI (40).
Seat 2: gfclbv (90.75).
Seat 3: dscshift (15.01).
Seat 4: Wollverin (158.70).
Seat 5: meandkids (86.44).
Seat 6: Are you with me (108.05).
Player Wollverin has small blind (1)
Player meandkids has big blind (2)
Player IlxxxlI received card: [3s]
Player IlxxxlI received card: [9s]
Player Are you with me folds
Player IlxxxlI folds
Player gfclbv raises (4)
Player dscshift folds
Player Wollverin folds
Player meandkids calls (2)
*** FLOP ***: [10s 8c 2c]
Player meandkids checks
Player gfclbv bets (4)
Player meandkids calls (4)
*** TURN ***: [10s 8c 2c] [Qc]
Player meandkids checks
Player gfclbv bets (10)
Player meandkids calls (10)
*** RIVER ***: [10s 8c 2c Qc] [Jh]
Player meandkids checks
Player gfclbv bets (28)
Player meandkids folds
Uncalled bet (28) returned to gfclbv
Player gfclbv mucks cards
------ Summary ------
Pot: 35.15. Rake 1.61. JP fee 0.24
Board: [10s 8c 2c Qc Jh]
Player IlxxxlI does not show cards.Bets: 0. Collects: 0. Wins: 0.
*Player gfclbv mucks (does not show cards). Bets: 18. Collects: 35.15. Wins: 17.15.
Player dscshift does not show cards.Bets: 0. Collects: 0. Wins: 0.
Player Wollverin does not show cards.Bets: 1. Collects: 0. Loses: 1.
Player meandkids does not show cards.Bets: 18. Collects: 0. Loses: 18.
Player Are you with me does not show cards.Bets: 0. Collects: 0. Wins: 0.
Game ended at: 2016/11/28 20:46:49

Game started
Game ID: 786377761 0.25/0.50 (PRR) Gorgons (Hold'em)
Seat 6 is the button
Seat 1: BirdieKing (42.98).
Seat 2: GreinSeint (21.04).
Seat 3: in_ur_i (46.96).
Seat 5: meandkids (47).
Seat 6: IlxxxlI (20).
Player BirdieKing has small blind (0.25)
Player GreinSeint has big blind (0.50)
Player IlxxxlI received card: [7h]
Player IlxxxlI received card: [10c]
Player in_ur_i folds
Player meandkids folds
Player IlxxxlI folds
Player BirdieKing raises (0.75)
Player GreinSeint calls (0.50)
*** FLOP ***: [4c Qs Kd]
Player BirdieKing checks
Player GreinSeint checks
*** TURN ***: [4c Qs Kd] [9c]
Player BirdieKing bets (0.95)
Player GreinSeint folds
Uncalled bet (0.95) returned to BirdieKing
Player BirdieKing mucks cards
------ Summary ------
Pot: 1.90. Rake 0.08. JP fee 0.02
Board: [4c Qs Kd 9c]
*Player BirdieKing mucks (does not show cards). Bets: 1. Collects: 1.90. Wins: 0.90.
Player GreinSeint does not show cards.Bets: 1. Collects: 0. Loses: 1.
Player in_ur_i does not show cards.Bets: 0. Collects: 0. Wins: 0.
Player meandkids does not show cards.Bets: 0. Collects: 0. Wins: 0.
Player IlxxxlI does not show cards.Bets: 0. Collects: 0. Wins: 0.
Game ended at: 2016/11/28 20:46:26

Game started
Game ID: 786377615 0.25/0.50 (PRR) Gorgons (Hold'em)
Seat 5 is the button
Seat 1: BirdieKing (40).
Seat 2: GreinSeint (21.04).
Seat 3: in_ur_i (50).
Seat 5: meandkids (47).
Seat 6: IlxxxlI (20.25).
Player IlxxxlI has small blind (0.25)
Player BirdieKing has big blind (0.50)
Player IlxxxlI received card: [4d]
Player IlxxxlI received card: [3h]
Player GreinSeint folds
Player in_ur_i raises (1.50)
Player meandkids folds
Player IlxxxlI folds
Player BirdieKing calls (1)
*** FLOP ***: [Kd 3d 7d]
Player BirdieKing checks
Player in_ur_i bets (1.54)
Player BirdieKing raises (6.16)
Player in_ur_i folds
Uncalled bet (4.62) returned to BirdieKing
Player BirdieKing mucks cards
------ Summary ------
Pot: 6.02. Rake 0.21. JP fee 0.10
Board: [Kd 3d 7d]
*Player BirdieKing mucks (does not show cards). Bets: 3.04. Collects: 6.02. Wins: 2.98.
Player GreinSeint does not show cards.Bets: 0. Collects: 0. Wins: 0.
Player in_ur_i does not show cards.Bets: 3.04. Collects: 0. Loses: 3.04.
Player meandkids does not show cards.Bets: 0. Collects: 0. Wins: 0.
Player IlxxxlI does not show cards.Bets: 0.25. Collects: 0. Loses: 0.25.
Game ended at: 2016/11/28 20:45:38

Game started
Game ID: 786377555 0.25/0.50 (PRR) Gorgons (Hold'em)
Seat 3 is the button
Seat 2: GreinSeint (21.04).
Seat 3: in_ur_i (50).
Seat 5: meandkids (47.25).
Seat 6: IlxxxlI (20).
Player meandkids has small blind (0.25)
Player IlxxxlI has big blind (0.50)
Player IlxxxlI received card: [2c]
Player IlxxxlI received card: [10d]
Player GreinSeint folds
Player in_ur_i folds
Player meandkids folds
Uncalled bet (0.25) returned to IlxxxlI
Player IlxxxlI mucks cards
------ Summary ------
Pot: 0.50. Rake 0
Player GreinSeint does not show cards.Bets: 0. Collects: 0. Wins: 0.
Player in_ur_i does not show cards.Bets: 0. Collects: 0. Wins: 0.
Player meandkids does not show cards.Bets: 0.25. Collects: 0. Loses: 0.25.
*Player IlxxxlI mucks (does not show cards). Bets: 0.25. Collects: 0.50. Wins: 0.25.
Game ended at: 2016/11/28 20:44:59

Game started
Game ID: 786377348 1/2 (PRR) Lakhey (Short) (Hold'em)
Seat 2 is the button
Seat 1: IlxxxlI (40).
Seat 2: gfclbv (90.75).
Seat 3: dscshift (41).
Seat 4: Wollverin (163.70).
Seat 5: meandkids (86.44).
Seat 6: Are you with me (79.90).
Player dscshift has small blind (1)
Player Wollverin has big blind (2)
Player IlxxxlI received card: [10h]
Player IlxxxlI received card: [Jh]
Player meandkids folds
Player Are you with me raises (5)
Player IlxxxlI folds
Player gfclbv folds
Player dscshift calls (4)
Player Wollverin calls (3)
*** FLOP ***: [Jd Kc Jc]
Player dscshift checks
Player Wollverin checks
Player Are you with me bets (4.99)
Player dscshift calls (4.99)
Player Wollverin folds
*** TURN ***: [Jd Kc Jc] [Qs]
Player dscshift checks
Player Are you with me bets (16)
Player dscshift calls (16)
*** RIVER ***: [Jd Kc Jc Qs] [Qh]
Player dscshift checks
Player Are you with me bets (15)
Player dscshift folds
Uncalled bet (15) returned to Are you with me
Player Are you with me mucks cards
------ Summary ------
Pot: 54.14. Rake 2.60. JP fee 0.24
Board: [Jd Kc Jc Qs Qh]
Player IlxxxlI does not show cards.Bets: 0. Collects: 0. Wins: 0.
Player gfclbv does not show cards.Bets: 0. Collects: 0. Wins: 0.
Player dscshift does not show cards.Bets: 25.99. Collects: 0. Loses: 25.99.
Player Wollverin does not show cards.Bets: 5. Collects: 0. Loses: 5.
Player meandkids does not show cards.Bets: 0. Collects: 0. Wins: 0.
*Player Are you with me mucks (does not show cards). Bets: 25.99. Collects: 54.14. Wins: 28.15.
Game ended at: 2016/11/28 20:45:40

Game started
Game ID: 786377271 0.25/0.50 (PRR) Gorgons (Hold'em)
Seat 2 is the button
Seat 2: GreinSeint (24.54).
Seat 3: in_ur_i (43.52).
Seat 4: caballeroXXX (105.22).
Seat 5: meandkids (50.75).
Seat 6: IlxxxlI (20).
Player in_ur_i has small blind (0.25)
Player caballeroXXX sitting out
Player meandkids has big blind (0.50)
Player IlxxxlI received card: [Qs]
Player IlxxxlI received card: [9d]
Player IlxxxlI folds
Player GreinSeint raises (1.50)
Player in_ur_i raises (3.25)
Player meandkids calls (3)
Player GreinSeint calls (2)
*** FLOP ***: [2s Ah Kd]
Player in_ur_i bets (3.32)
Player meandkids folds
Player GreinSeint folds
Uncalled bet (3.32) returned to in_ur_i
Player in_ur_i mucks cards
------ Summary ------
Pot: 9.98. Rake 0.36. JP fee 0.16
Board: [2s Ah Kd]
Player GreinSeint does not show cards.Bets: 3.50. Collects: 0. Loses: 3.50.
*Player in_ur_i mucks (does not show cards). Bets: 3.50. Collects: 9.98. Wins: 6.48.
Player caballeroXXX does not show cards.Bets: 0. Collects: 0. Wins: 0.
Player meandkids does not show cards.Bets: 3.50. Collects: 0. Loses: 3.50.
Player IlxxxlI does not show cards.Bets: 0. Collects: 0. Wins: 0.
Game ended at: 2016/11/28 20:44:41

Game started
Game ID: 786377226 1/2 (PRR) Lakhey (Short) (Hold'em)
Seat 1 is the button
Seat 1: IlxxxlI (40).
Seat 2: gfclbv (91.75).
Seat 3: dscshift (40).
Seat 4: Wollverin (163.70).
Seat 5: meandkids (86.44).
Seat 6: Are you with me (79.90).
Player gfclbv has small blind (1)
Player dscshift has big blind (2)
Player IlxxxlI received card: [4d]
Player IlxxxlI received card: [10s]
Player Wollverin folds
Player meandkids folds
Player Are you with me folds
Player IlxxxlI folds
Player gfclbv folds
Uncalled bet (1) returned to dscshift
Player dscshift mucks cards
------ Summary ------
Pot: 2. Rake 0
Player IlxxxlI does not show cards.Bets: 0. Collects: 0. Wins: 0.
Player gfclbv does not show cards.Bets: 1. Collects: 0. Loses: 1.
*Player dscshift mucks (does not show cards). Bets: 1. Collects: 2. Wins: 1.
Player Wollverin does not show cards.Bets: 0. Collects: 0. Wins: 0.
Player meandkids does not show cards.Bets: 0. Collects: 0. Wins: 0.
Player Are you with me does not show cards.Bets: 0. Collects: 0. Wins: 0.
Game ended at: 2016/11/28 20:43:45

Game started
Game ID: 786377230 0.25/0.50 (PRR) Gorgons - 2 (Hold'em)
Seat 5 is the button
Seat 2: IlxxxlI (24).
Seat 3: SenNoSen (52.09).
Seat 4: BirdieKing (41.20).
Seat 5: in_ur_i (53.19).
Player IlxxxlI has small blind (0.25)
Player SenNoSen sitting out
Player BirdieKing has big blind (0.50)
Player IlxxxlI received card: [Jd]
Player IlxxxlI received card: [7c]
Player in_ur_i folds
Player IlxxxlI folds
Uncalled bet (0.25) returned to BirdieKing
Player BirdieKing mucks cards
------ Summary ------
Pot: 0.50. Rake 0
Player IlxxxlI does not show cards.Bets: 0.25. Collects: 0. Loses: 0.25.
Player SenNoSen does not show cards.Bets: 0. Collects: 0. Wins: 0.
*Player BirdieKing mucks (does not show cards). Bets: 0.25. Collects: 0.50. Wins: 0.25.
Player in_ur_i does not show cards.Bets: 0. Collects: 0. Wins: 0.
Game ended at: 2016/11/28 20:43:30

Game started
Game ID: 786377114 0.25/0.50 (PRR) Gorgons - 2 (Hold'em)
Seat 4 is the button
Seat 2: IlxxxlI (24.50).
Seat 3: SenNoSen (52.09).
Seat 4: BirdieKing (40.45).
Seat 5: in_ur_i (53.44).
Seat 6: caballeroXXX (73.93).
Player in_ur_i has small blind (0.25)
Player caballeroXXX sitting out
Player IlxxxlI has big blind (0.50)
Player IlxxxlI received card: [Jc]
Player IlxxxlI received card: [6d]
Player SenNoSen folds
Player BirdieKing raises (1)
Player in_ur_i folds
Player IlxxxlI folds
Uncalled bet (0.50) returned to BirdieKing
Player BirdieKing mucks cards
------ Summary ------
Pot: 1.25. Rake 0
Player IlxxxlI does not show cards.Bets: 0.50. Collects: 0. Loses: 0.50.
Player SenNoSen does not show cards.Bets: 0. Collects: 0. Wins: 0.
*Player BirdieKing mucks (does not show cards). Bets: 0.50. Collects: 1.25. Wins: 0.75.
Player in_ur_i does not show cards.Bets: 0.25. Collects: 0. Loses: 0.25.
Player caballeroXXX does not show cards.Bets: 0. Collects: 0. Wins: 0.
Game ended at: 2016/11/28 20:43:15

Game started
Game ID: 786377038 0.25/0.50 (PRR) Gorgons - 2 (Hold'em)
Seat 3 is the button
Seat 2: IlxxxlI (24.50).
Seat 3: SenNoSen (52.09).
Seat 4: BirdieKing (40.70).
Seat 5: in_ur_i (53.94).
Seat 6: caballeroXXX (73.18).
Player BirdieKing has small blind (0.25)
Player in_ur_i has big blind (0.50)
Player IlxxxlI received card: [5s]
Player IlxxxlI received card: [2h]
Player caballeroXXX raises (1.50)
Player IlxxxlI folds
Player SenNoSen folds
Player BirdieKing folds
Player in_ur_i folds
Uncalled bet (1) returned to caballeroXXX
Player caballeroXXX mucks cards
------ Summary ------
Pot: 1.25. Rake 0
Player IlxxxlI does not show cards.Bets: 0. Collects: 0. Wins: 0.
Player SenNoSen does not show cards.Bets: 0. Collects: 0. Wins: 0.
Player BirdieKing does not show cards.Bets: 0.25. Collects: 0. Loses: 0.25.
Player in_ur_i does not show cards.Bets: 0.50. Collects: 0. Loses: 0.50.
*Player caballeroXXX mucks (does not show cards). Bets: 0.50. Collects: 1.25. Wins: 0.75.
Game ended at: 2016/11/28 20:42:43

Game started
Game ID: 786376978 0.25/0.50 (PRR) Gorgons (Hold'em)
Seat 6 is the button
Seat 2: GreinSeint (24.79).
Seat 3: in_ur_i (35.28).
Seat 4: caballeroXXX (114.11).
Seat 5: meandkids (50.75).
Seat 6: IlxxxlI (20).
Player GreinSeint has small blind (0.25)
Player in_ur_i has big blind (0.50)
Player IlxxxlI received card: [5s]
Player IlxxxlI received card: [6s]
Player caballeroXXX raises (1.50)
Player meandkids folds
Player IlxxxlI folds
Player GreinSeint folds
Player in_ur_i raises (4)
Player caballeroXXX calls (3)
*** FLOP ***: [Jh 2c Js]
Player in_ur_i bets (4.39)
Player caballeroXXX calls (4.39)
*** TURN ***: [Jh 2c Js] [Ac]
Player in_ur_i checks
Player caballeroXXX checks
*** RIVER ***: [Jh 2c Js Ac] [Jc]
Player in_ur_i checks
Player caballeroXXX checks
Player caballeroXXX mucks cards
------ Summary ------
Pot: 17.13. Rake 0.66. JP fee 0.24
Board: [Jh 2c Js Ac Jc]
Player GreinSeint does not show cards.Bets: 0.25. Collects: 0. Loses: 0.25.
*Player in_ur_i shows: Full House (J/A) [Ks Ad]. Bets: 8.89. Collects: 17.13. Wins: 8.24.
Player caballeroXXX mucks (does not show cards). Bets: 8.89. Collects: 0. Loses: 8.89.
Player meandkids does not show cards.Bets: 0. Collects: 0. Wins: 0.
Player IlxxxlI does not show cards.Bets: 0. Collects: 0. Wins: 0.
Game ended at: 2016/11/28 20:43:25

Game started
Game ID: 786376937 1/2 (PRR) Lakhey (Short) (Hold'em)
Seat 6 is the button
Seat 1: IlxxxlI (40).
Seat 2: gfclbv (83).
Seat 4: Wollverin (163.70).
Seat 5: meandkids (86.44).
Seat 6: Are you with me (88.56).
Player IlxxxlI has small blind (1)
Player gfclbv has big blind (2)
Player IlxxxlI received card: [5d]
Player IlxxxlI received card: [7c]
Player Wollverin folds
Player meandkids folds
Player Are you with me raises (4.20)
Player IlxxxlI folds
Player gfclbv calls (2.20)
*** FLOP ***: [7h Ac 7s]
Player gfclbv checks
Player Are you with me checks
*** TURN ***: [7h Ac 7s] [10h]
Player gfclbv bets (4.46)
Player Are you with me calls (4.46)
*** RIVER ***: [7h Ac 7s 10h] [Qs]
Player gfclbv bets (12)
Player Are you with me folds
Uncalled bet (12) returned to gfclbv
Player gfclbv mucks cards
------ Summary ------
Pot: 17.41. Rake 0.67. JP fee 0.24
Board: [7h Ac 7s 10h Qs]
Player IlxxxlI does not show cards.Bets: 1. Collects: 0. Loses: 1.
*Player gfclbv mucks (does not show cards). Bets: 8.66. Collects: 17.41. Wins: 8.75.
Player Wollverin does not show cards.Bets: 0. Collects: 0. Wins: 0.
Player meandkids does not show cards.Bets: 0. Collects: 0. Wins: 0.
Player Are you with me does not show cards.Bets: 8.66. Collects: 0. Loses: 8.66.
Game ended at: 2016/11/28 20:43:14

Game started
Game ID: 786376912 0.25/0.50 (PRR) Gorgons - 2 (Hold'em)
Seat 2 is the button
Seat 2: IlxxxlI (24.50).
Seat 3: SenNoSen (53.59).
Seat 4: BirdieKing (39.35).
Seat 5: in_ur_i (53.94).
Seat 6: caballeroXXX (73.18).
Player SenNoSen has small blind (0.25)
Player BirdieKing has big blind (0.50)
Player IlxxxlI received card: [6d]
Player IlxxxlI received card: [10s]
Player in_ur_i folds
Player caballeroXXX folds
Player IlxxxlI folds
Player SenNoSen raises (1.25)
Player BirdieKing calls (1)
*** FLOP ***: [2c 2d Kd]
Player SenNoSen checks
Player BirdieKing bets (1.90)
Player SenNoSen folds
Uncalled bet (1.90) returned to BirdieKing
Player BirdieKing mucks cards
------ Summary ------
Pot: 2.85. Rake 0.11. JP fee 0.04
Board: [2c 2d Kd]
Player IlxxxlI does not show cards.Bets: 0. Collects: 0. Wins: 0.
Player SenNoSen does not show cards.Bets: 1.50. Collects: 0. Loses: 1.50.
*Player BirdieKing mucks (does not show cards). Bets: 1.50. Collects: 2.85. Wins: 1.35.
Player in_ur_i does not show cards.Bets: 0. Collects: 0. Wins: 0.
Player caballeroXXX does not show cards.Bets: 0. Collects: 0. Wins: 0.
Game ended at: 2016/11/28 20:42:22

Game started
Game ID: 786376882 0.25/0.50 (PRR) Gorgons - 5 (Hold'em)
Seat 2 is the button
Seat 1: caballeroXXX (76.56).
Seat 2: GreinSeint (17.75).
Seat 3: DonkReaper (59.24).
Seat 4: in_ur_i (43.38).
Seat 6: IlxxxlI (35.67).
Player DonkReaper has small blind (0.25)
Player in_ur_i has big blind (0.50)
Player IlxxxlI received card: [Ks]
Player IlxxxlI received card: [2s]
Player IlxxxlI folds
Player caballeroXXX folds
Player GreinSeint folds
Player DonkReaper folds
Uncalled bet (0.25) returned to in_ur_i
Player in_ur_i mucks cards
------ Summary ------
Pot: 0.50. Rake 0
Player caballeroXXX does not show cards.Bets: 0. Collects: 0. Wins: 0.
Player GreinSeint does not show cards.Bets: 0. Collects: 0. Wins: 0.
Player DonkReaper does not show cards.Bets: 0.25. Collects: 0. Loses: 0.25.
*Player in_ur_i mucks (does not show cards). Bets: 0.25. Collects: 0.50. Wins: 0.25.
Player IlxxxlI does not show cards.Bets: 0. Collects: 0. Wins: 0.
Game ended at: 2016/11/28 20:41:59

Game started
Game ID: 786376800 0.25/0.50 (PRR) Gorgons - 2 (Hold'em)
Seat 6 is the button
Seat 2: IlxxxlI (21).
Seat 3: SenNoSen (54.09).
Seat 4: BirdieKing (40.85).
Seat 5: in_ur_i (53.94).
Seat 6: caballeroXXX (74.68).
Player IlxxxlI has small blind (0.25)
Player SenNoSen has big blind (0.50)
Player IlxxxlI received card: [Qs]
Player IlxxxlI received card: [Qc]
Player BirdieKing raises (1.50)
Player in_ur_i folds
Player caballeroXXX calls (1.50)
Player IlxxxlI raises (5.05)
Player SenNoSen folds
Player BirdieKing folds
Player caballeroXXX folds
Uncalled bet (3.80) returned to IlxxxlI
Player IlxxxlI mucks cards
------ Summary ------
Pot: 5. Rake 0
*Player IlxxxlI mucks (does not show cards). Bets: 1.50. Collects: 5. Wins: 3.50.
Player SenNoSen does not show cards.Bets: 0.50. Collects: 0. Loses: 0.50.
Player BirdieKing does not show cards.Bets: 1.50. Collects: 0. Loses: 1.50.
Player in_ur_i does not show cards.Bets: 0. Collects: 0. Wins: 0.
Player caballeroXXX does not show cards.Bets: 1.50. Collects: 0. Loses: 1.50.
Game ended at: 2016/11/28 20:41:45

Game started
Game ID: 786376797 0.25/0.50 (PRR) Gorgons - 5 (Hold'em)
Seat 1 is the button
Seat 1: caballeroXXX (76.56).
Seat 2: GreinSeint (18).
Seat 3: DonkReaper (59.74).
Seat 4: in_ur_i (43.38).
Seat 6: IlxxxlI (34.92).
Player GreinSeint has small blind (0.25)
Player DonkReaper has big blind (0.50)
Player IlxxxlI received card: [Kc]
Player IlxxxlI received card: [Kd]
Player in_ur_i folds
Player IlxxxlI raises (1.20)
Player caballeroXXX folds
Player GreinSeint folds
Player DonkReaper folds
Uncalled bet (0.70) returned to IlxxxlI
Player IlxxxlI mucks cards
------ Summary ------
Pot: 1.25. Rake 0
Player caballeroXXX does not show cards.Bets: 0. Collects: 0. Wins: 0.
Player GreinSeint does not show cards.Bets: 0.25. Collects: 0. Loses: 0.25.
Player DonkReaper does not show cards.Bets: 0.50. Collects: 0. Loses: 0.50.
Player in_ur_i does not show cards.Bets: 0. Collects: 0. Wins: 0.
*Player IlxxxlI mucks (does not show cards). Bets: 0.50. Collects: 1.25. Wins: 0.75.
Game ended at: 2016/11/28 20:41:39

Game started
Game ID: 786376795 0.25/0.50 (PRR) Gorgons (Hold'em)
Seat 5 is the button
Seat 2: GreinSeint (21.40).
Seat 3: in_ur_i (38.78).
Seat 4: caballeroXXX (114.11).
Seat 5: meandkids (50.75).
Seat 6: IlxxxlI (20).
Player IlxxxlI has small blind (0.25)
Player GreinSeint has big blind (0.50)
Player IlxxxlI received card: [5s]
Player IlxxxlI received card: [8c]
Player in_ur_i raises (1.50)
Player caballeroXXX folds
Player meandkids folds
Player IlxxxlI folds
Player GreinSeint raises (3)
Player in_ur_i calls (2)
*** FLOP ***: [7d 4h 3s]
Player GreinSeint bets (2.29)
Player in_ur_i folds
Uncalled bet (2.29) returned to GreinSeint
Player GreinSeint mucks cards
------ Summary ------
Pot: 6.89. Rake 0.24. JP fee 0.12
Board: [7d 4h 3s]
*Player GreinSeint mucks (does not show cards). Bets: 3.50. Collects: 6.89. Wins: 3.39.
Player in_ur_i does not show cards.Bets: 3.50. Collects: 0. Loses: 3.50.
Player caballeroXXX does not show cards.Bets: 0. Collects: 0. Wins: 0.
Player meandkids does not show cards.Bets: 0. Collects: 0. Wins: 0.
Player IlxxxlI does not show cards.Bets: 0.25. Collects: 0. Loses: 0.25.
Game ended at: 2016/11/28 20:42:4

Game started
Game ID: 786376705 0.25/0.50 (PRR) Gorgons - 2 (Hold'em)
Seat 5 is the button
Seat 1: DonkReaper (61.17).
Seat 2: IlxxxlI (20.75).
Seat 3: SenNoSen (54.09).
Seat 4: BirdieKing (40.85).
Seat 5: in_ur_i (53.94).
Seat 6: caballeroXXX (74.93).
Player caballeroXXX has small blind (0.25)
Player DonkReaper sitting out
Player IlxxxlI has big blind (0.50)
Player IlxxxlI received card: [7s]
Player IlxxxlI received card: [Kc]
Player SenNoSen folds
Player BirdieKing folds
Player in_ur_i folds
Player caballeroXXX folds
Uncalled bet (0.25) returned to IlxxxlI
Player IlxxxlI mucks cards
------ Summary ------
Pot: 0.50. Rake 0
Player DonkReaper does not show cards.Bets: 0. Collects: 0. Wins: 0.
*Player IlxxxlI mucks (does not show cards). Bets: 0.25. Collects: 0.50. Wins: 0.25.
Player SenNoSen does not show cards.Bets: 0. Collects: 0. Wins: 0.
Player BirdieKing does not show cards.Bets: 0. Collects: 0. Wins: 0.
Player in_ur_i does not show cards.Bets: 0. Collects: 0. Wins: 0.
Player caballeroXXX does not show cards.Bets: 0.25. Collects: 0. Loses: 0.25.
Game ended at: 2016/11/28 20:41:16

Game started
Game ID: 786376691 0.25/0.50 (PRR) Gorgons - 5 (Hold'em)
Seat 6 is the button
Seat 1: caballeroXXX (76.81).
Seat 2: GreinSeint (18.50).
Seat 3: DonkReaper (59.74).
Seat 4: in_ur_i (42.63).
Seat 5: BBDub27 (50).
Seat 6: IlxxxlI (34.92).
Player caballeroXXX has small blind (0.25)
Player GreinSeint has big blind (0.50)
Player BBDub27 is timed out.
Player BBDub27 wait BB
Player IlxxxlI received card: [Jd]
Player IlxxxlI received card: [6h]
Player DonkReaper folds
Player in_ur_i raises (1.50)
Player IlxxxlI folds
Player caballeroXXX folds
Player GreinSeint folds
Uncalled bet (1) returned to in_ur_i
Player in_ur_i mucks cards
------ Summary ------
Pot: 1.25. Rake 0
Player caballeroXXX does not show cards.Bets: 0.25. Collects: 0. Loses: 0.25.
Player GreinSeint does not show cards.Bets: 0.50. Collects: 0. Loses: 0.50.
Player DonkReaper does not show cards.Bets: 0. Collects: 0. Wins: 0.
*Player in_ur_i mucks (does not show cards). Bets: 0.50. Collects: 1.25. Wins: 0.75.
Player BBDub27 does not show cards.Bets: 0. Collects: 0. Wins: 0.
Player IlxxxlI does not show cards.Bets: 0. Collects: 0. Wins: 0.
Game ended at: 2016/11/28 20:41:15

Game started
Game ID: 786376680 1/2 (PRR) Lakhey (Short) (Hold'em)
Seat 5 is the button
Seat 1: IlxxxlI (43.53).
Seat 2: gfclbv (83).
Seat 4: Wollverin (163.70).
Seat 5: meandkids (86.44).
Seat 6: Are you with me (81.90).
Player Are you with me has small blind (1)
Player IlxxxlI has big blind (2)
Player IlxxxlI received card: [Js]
Player IlxxxlI received card: [Qh]
Player gfclbv folds
Player Wollverin folds
Player meandkids folds
Player Are you with me raises (3.40)
Player IlxxxlI calls (2.40)
*** FLOP ***: [8h 8s 5h]
Player Are you with me bets (3)
Player IlxxxlI calls (3)
*** TURN ***: [8h 8s 5h] [8c]
Player Are you with me checks
Player IlxxxlI checks
*** RIVER ***: [8h 8s 5h 8c] [3c]
Player Are you with me checks
Player IlxxxlI checks
Player IlxxxlI mucks cards
------ Summary ------
Pot: 14.06. Rake 0.50. JP fee 0.24
Board: [8h 8s 5h 8c 3c]
Player IlxxxlI mucks (does not show: [Js Qh]). Bets: 7.40. Collects: 0. Loses: 7.40.
Player gfclbv does not show cards.Bets: 0. Collects: 0. Wins: 0.
Player Wollverin does not show cards.Bets: 0. Collects: 0. Wins: 0.
Player meandkids does not show cards.Bets: 0. Collects: 0. Wins: 0.
*Player Are you with me shows: Three Of Kind of 8s [Kh As]. Bets: 7.40. Collects: 14.06. Wins: 6.66.
Game ended at: 2016/11/28 20:41:52

Game started
Game ID: 786376633 0.25/0.50 (PRR) Gorgons (Hold'em)
Seat 4 is the button
Seat 2: GreinSeint (21.40).
Seat 3: in_ur_i (37.19).
Seat 4: caballeroXXX (114.11).
Seat 5: meandkids (51).
Seat 6: IlxxxlI (20).
Player meandkids has small blind (0.25)
Player IlxxxlI has big blind (0.50)
Player IlxxxlI received card: [Qh]
Player IlxxxlI received card: [Js]
Player GreinSeint folds
Player in_ur_i raises (1.50)
Player caballeroXXX folds
Player meandkids folds
Player IlxxxlI calls (1)
*** FLOP ***: [9s 4h 6d]
Player IlxxxlI checks
Player in_ur_i bets (1.54)
Player IlxxxlI folds
Uncalled bet (1.54) returned to in_ur_i
Player in_ur_i mucks cards
------ Summary ------
Pot: 3.09. Rake 0.12. JP fee 0.04
Board: [9s 4h 6d]
Player GreinSeint does not show cards.Bets: 0. Collects: 0. Wins: 0.
*Player in_ur_i mucks (does not show cards). Bets: 1.50. Collects: 3.09. Wins: 1.59.
Player caballeroXXX does not show cards.Bets: 0. Collects: 0. Wins: 0.
Player meandkids does not show cards.Bets: 0.25. Collects: 0. Loses: 0.25.
Player IlxxxlI does not show cards.Bets: 1.50. Collects: 0. Loses: 1.50.
Game ended at: 2016/11/28 20:41:16

Game started
Game ID: 786376617 0.25/0.50 (PRR) Gorgons - 2 (Hold'em)
Seat 4 is the button
Seat 1: DonkReaper (60.42).
Seat 2: IlxxxlI (20.75).
Seat 3: SenNoSen (54.09).
Seat 4: BirdieKing (40.85).
Seat 5: in_ur_i (54.19).
Seat 6: caballeroXXX (75.43).
Player in_ur_i has small blind (0.25)
Player caballeroXXX has big blind (0.50)
Player IlxxxlI received card: [6s]
Player IlxxxlI received card: [9h]
Player DonkReaper raises (1.50)
Player IlxxxlI folds
Player SenNoSen folds
Player BirdieKing folds
Player in_ur_i folds
Player caballeroXXX folds
Uncalled bet (1) returned to DonkReaper
Player DonkReaper mucks cards
------ Summary ------
Pot: 1.25. Rake 0
*Player DonkReaper mucks (does not show cards). Bets: 0.50. Collects: 1.25. Wins: 0.75.
Player IlxxxlI does not show cards.Bets: 0. Collects: 0. Wins: 0.
Player SenNoSen does not show cards.Bets: 0. Collects: 0. Wins: 0.
Player BirdieKing does not show cards.Bets: 0. Collects: 0. Wins: 0.
Player in_ur_i does not show cards.Bets: 0.25. Collects: 0. Loses: 0.25.
Player caballeroXXX does not show cards.Bets: 0.50. Collects: 0. Loses: 0.50.
Game ended at: 2016/11/28 20:40:50

Game started
Game ID: 786376513 1/2 (PRR) Lakhey (Short) (Hold'em)
Seat 4 is the button
Seat 1: IlxxxlI (43.53).
Seat 2: gfclbv (83).
Seat 4: Wollverin (160.70).
Seat 5: meandkids (87.44).
Seat 6: Are you with me (83.90).
Player meandkids has small blind (1)
Player Are you with me has big blind (2)
Player IlxxxlI received card: [7h]
Player IlxxxlI received card: [10c]
Player IlxxxlI folds
Player gfclbv folds
Player Wollverin raises (4)
Player meandkids folds
Player Are you with me folds
Uncalled bet (2) returned to Wollverin
Player Wollverin mucks cards
------ Summary ------
Pot: 5. Rake 0
Player IlxxxlI does not show cards.Bets: 0. Collects: 0. Wins: 0.
Player gfclbv does not show cards.Bets: 0. Collects: 0. Wins: 0.
*Player Wollverin mucks (does not show cards). Bets: 2. Collects: 5. Wins: 3.
Player meandkids does not show cards.Bets: 1. Collects: 0. Loses: 1.
Player Are you with me does not show cards.Bets: 2. Collects: 0. Loses: 2.
Game ended at: 2016/11/28 20:40:43

Game started
Game ID: 786376498 0.25/0.50 (PRR) Gorgons (Hold'em)
Seat 3 is the button
Seat 2: GreinSeint (21.40).
Seat 3: in_ur_i (36.44).
Seat 4: caballeroXXX (114.36).
Seat 5: meandkids (51.50).
Seat 6: IlxxxlI (20).
Player caballeroXXX has small blind (0.25)
Player meandkids has big blind (0.50)
Player IlxxxlI received card: [3c]
Player IlxxxlI received card: [6c]
Player IlxxxlI folds
Player GreinSeint folds
Player in_ur_i raises (1.50)
Player caballeroXXX folds
Player meandkids folds
Uncalled bet (1) returned to in_ur_i
Player in_ur_i mucks cards
------ Summary ------
Pot: 1.25. Rake 0
Player GreinSeint does not show cards.Bets: 0. Collects: 0. Wins: 0.
*Player in_ur_i mucks (does not show cards). Bets: 0.50. Collects: 1.25. Wins: 0.75.
Player caballeroXXX does not show cards.Bets: 0.25. Collects: 0. Loses: 0.25.
Player meandkids does not show cards.Bets: 0.50. Collects: 0. Loses: 0.50.
Player IlxxxlI does not show cards.Bets: 0. Collects: 0. Wins: 0.
Game ended at: 2016/11/28 20:40:31

Game started
Game ID: 786376445 0.25/0.50 (PRR) Gorgons - 2 (Hold'em)
Seat 3 is the button
Seat 1: DonkReaper (60.42).
Seat 2: IlxxxlI (20.75).
Seat 3: SenNoSen (54.09).
Seat 4: BirdieKing (39.50).
Seat 5: in_ur_i (55.69).
Seat 6: caballeroXXX (75.43).
Player BirdieKing has small blind (0.25)
Player in_ur_i has big blind (0.50)
Player IlxxxlI received card: [2h]
Player IlxxxlI received card: [Kh]
Player caballeroXXX folds
Player DonkReaper folds
Player IlxxxlI folds
Player SenNoSen folds
Player BirdieKing raises (1.25)
Player in_ur_i calls (1)
*** FLOP ***: [Kc 5c As]
Player BirdieKing bets (1.90)
Player in_ur_i folds
Uncalled bet (1.90) returned to BirdieKing
Player BirdieKing mucks cards
------ Summary ------
Pot: 2.85. Rake 0.11. JP fee 0.04
Board: [Kc 5c As]
Player DonkReaper does not show cards.Bets: 0. Collects: 0. Wins: 0.
Player IlxxxlI does not show cards.Bets: 0. Collects: 0. Wins: 0.
Player SenNoSen does not show cards.Bets: 0. Collects: 0. Wins: 0.
*Player BirdieKing mucks (does not show cards). Bets: 1.50. Collects: 2.85. Wins: 1.35.
Player in_ur_i does not show cards.Bets: 1.50. Collects: 0. Loses: 1.50.
Player caballeroXXX does not show cards.Bets: 0. Collects: 0. Wins: 0.
Game ended at: 2016/11/28 20:40:28

Game started
Game ID: 786376429 0.25/0.50 (PRR) Gorgons (Hold'em)
Seat 2 is the button
Seat 2: GreinSeint (21.40).
Seat 3: in_ur_i (36.69).
Seat 4: caballeroXXX (114.11).
Seat 5: meandkids (51.50).
Seat 6: IlxxxlI (20).
Player in_ur_i has small blind (0.25)
Player caballeroXXX has big blind (0.50)
Player IlxxxlI received card: [7s]
Player IlxxxlI received card: [3d]
Player meandkids folds
Player IlxxxlI folds
Player GreinSeint folds
Player in_ur_i folds
Uncalled bet (0.25) returned to caballeroXXX
Player caballeroXXX mucks cards
------ Summary ------
Pot: 0.50. Rake 0
Player GreinSeint does not show cards.Bets: 0. Collects: 0. Wins: 0.
Player in_ur_i does not show cards.Bets: 0.25. Collects: 0. Loses: 0.25.
*Player caballeroXXX mucks (does not show cards). Bets: 0.25. Collects: 0.50. Wins: 0.25.
Player meandkids does not show cards.Bets: 0. Collects: 0. Wins: 0.
Player IlxxxlI does not show cards.Bets: 0. Collects: 0. Wins: 0.
Game ended at: 2016/11/28 20:39:57

Game started
Game ID: 786376428 1/2 (PRR) Lakhey (Short) (Hold'em)
Seat 2 is the button
Seat 1: IlxxxlI (43.53).
Seat 2: gfclbv (80).
Seat 4: Wollverin (161.70).
Seat 5: meandkids (89.44).
Seat 6: Are you with me (83.90).
Player Wollverin has small blind (1)
Player meandkids has big blind (2)
Player IlxxxlI received card: [Qh]
Player IlxxxlI received card: [10s]
Player Are you with me folds
Player IlxxxlI folds
Player gfclbv raises (4)
Player Wollverin folds
Player meandkids folds
Uncalled bet (2) returned to gfclbv
Player gfclbv mucks cards
------ Summary ------
Pot: 5. Rake 0
Player IlxxxlI does not show cards.Bets: 0. Collects: 0. Wins: 0.
*Player gfclbv mucks (does not show cards). Bets: 2. Collects: 5. Wins: 3.
Player Wollverin does not show cards.Bets: 1. Collects: 0. Loses: 1.
Player meandkids does not show cards.Bets: 2. Collects: 0. Loses: 2.
Player Are you with me does not show cards.Bets: 0. Collects: 0. Wins: 0.
Game ended at: 2016/11/28 20:40:1

Game started
Game ID: 786376388 0.25/0.50 (PRR) Gorgons - 5 (Hold'em)
Seat 4 is the button
Seat 1: caballeroXXX (74.56).
Seat 2: GreinSeint (18.50).
Seat 3: DonkReaper (59.74).
Seat 4: in_ur_i (42.63).
Seat 6: IlxxxlI (37.41).
Player IlxxxlI has small blind (0.25)
Player caballeroXXX has big blind (0.50)
Player IlxxxlI received card: [Kd]
Player IlxxxlI received card: [Qs]
Player GreinSeint folds
Player DonkReaper folds
Player in_ur_i folds
Player IlxxxlI raises (1)
Player caballeroXXX calls (0.75)
*** FLOP ***: [8s Ad 4s]
Player IlxxxlI bets (1.24)
Player caballeroXXX calls (1.24)
*** TURN ***: [8s Ad 4s] [3h]
Player IlxxxlI is timed out.
Player IlxxxlI checks
Player caballeroXXX bets (2.37)
Player IlxxxlI folds
Uncalled bet (2.37) returned to caballeroXXX
Player caballeroXXX mucks cards
------ Summary ------
Pot: 4.74. Rake 0.16. JP fee 0.08
Board: [8s Ad 4s 3h]
*Player caballeroXXX mucks (does not show cards). Bets: 2.49. Collects: 4.74. Wins: 2.25.
Player GreinSeint does not show cards.Bets: 0. Collects: 0. Wins: 0.
Player DonkReaper does not show cards.Bets: 0. Collects: 0. Wins: 0.
Player in_ur_i does not show cards.Bets: 0. Collects: 0. Wins: 0.
Player IlxxxlI does not show cards.Bets: 2.49. Collects: 0. Loses: 2.49.
Game ended at: 2016/11/28 20:40:47

Game started
Game ID: 786376354 0.25/0.50 (PRR) Gorgons (Hold'em)
Seat 6 is the button
Seat 2: GreinSeint (20.90).
Seat 3: in_ur_i (37.19).
Seat 4: caballeroXXX (114.11).
Seat 5: meandkids (51.50).
Seat 6: IlxxxlI (20).
Player GreinSeint has small blind (0.25)
Player in_ur_i has big blind (0.50)
Player IlxxxlI received card: [Kd]
Player IlxxxlI received card: [2s]
Player caballeroXXX folds
Player meandkids folds
Player IlxxxlI folds
Player GreinSeint raises (1.25)
Player in_ur_i folds
Uncalled bet (1) returned to GreinSeint
Player GreinSeint mucks cards
------ Summary ------
Pot: 1. Rake 0
*Player GreinSeint mucks (does not show cards). Bets: 0.50. Collects: 1. Wins: 0.50.
Player in_ur_i does not show cards.Bets: 0.50. Collects: 0. Loses: 0.50.
Player caballeroXXX does not show cards.Bets: 0. Collects: 0. Wins: 0.
Player meandkids does not show cards.Bets: 0. Collects: 0. Wins: 0.
Player IlxxxlI does not show cards.Bets: 0. Collects: 0. Wins: 0.
Game ended at: 2016/11/28 20:39:39

Game started
Game ID: 786376343 1/2 (PRR) Lakhey (Short) (Hold'em)
Seat 1 is the button
Seat 1: IlxxxlI (43.53).
Seat 2: gfclbv (80).
Seat 4: Wollverin (160.70).
Seat 5: meandkids (89.44).
Seat 6: Are you with me (83.90).
Player gfclbv has small blind (1)
Player Wollverin has big blind (2)
Player IlxxxlI received card: [Jd]
Player IlxxxlI received card: [3d]
Player meandkids folds
Player Are you with me folds
Player IlxxxlI folds
Player gfclbv folds
Uncalled bet (1) returned to Wollverin
Player Wollverin mucks cards
------ Summary ------
Pot: 2. Rake 0
Player IlxxxlI does not show cards.Bets: 0. Collects: 0. Wins: 0.
Player gfclbv does not show cards.Bets: 1. Collects: 0. Loses: 1.
*Player Wollverin mucks (does not show cards). Bets: 1. Collects: 2. Wins: 1.
Player meandkids does not show cards.Bets: 0. Collects: 0. Wins: 0.
Player Are you with me does not show cards.Bets: 0. Collects: 0. Wins: 0.
Game ended at: 2016/11/28 20:39:38

Game started
Game ID: 786376317 0.25/0.50 (PRR) Gorgons - 2 (Hold'em)
Seat 2 is the button
Seat 1: DonkReaper (60.42).
Seat 2: IlxxxlI (20).
Seat 3: SenNoSen (54.34).
Seat 4: BirdieKing (40).
Seat 5: in_ur_i (55.69).
Seat 6: caballeroXXX (75.43).
Player SenNoSen has small blind (0.25)
Player BirdieKing has big blind (0.50)
Player IlxxxlI received card: [As]
Player IlxxxlI received card: [Ac]
Player in_ur_i folds
Player caballeroXXX folds
Player DonkReaper folds
Player IlxxxlI raises (1.50)
Player SenNoSen folds
Player BirdieKing folds
Uncalled bet (1) returned to IlxxxlI
Player IlxxxlI mucks cards
------ Summary ------
Pot: 1.25. Rake 0
Player DonkReaper does not show cards.Bets: 0. Collects: 0. Wins: 0.
*Player IlxxxlI mucks (does not show cards). Bets: 0.50. Collects: 1.25. Wins: 0.75.
Player SenNoSen does not show cards.Bets: 0.25. Collects: 0. Loses: 0.25.
Player BirdieKing does not show cards.Bets: 0.50. Collects: 0. Loses: 0.50.
Player in_ur_i does not show cards.Bets: 0. Collects: 0. Wins: 0.
Player caballeroXXX does not show cards.Bets: 0. Collects: 0. Wins: 0.
Game ended at: 2016/11/28 20:39:41

Game started
Game ID: 786376222 0.25/0.50 (PRR) Gorgons - 5 (Hold'em)
Seat 3 is the button
Seat 1: caballeroXXX (74.56).
Seat 2: GreinSeint (18.50).
Seat 3: DonkReaper (63.54).
Seat 4: in_ur_i (42.88).
Seat 6: IlxxxlI (33.75).
Player in_ur_i has small blind (0.25)
Player IlxxxlI has big blind (0.50)
Player IlxxxlI received card: [Ad]
Player IlxxxlI received card: [Ah]
Player caballeroXXX folds
Player GreinSeint folds
Player DonkReaper raises (1.50)
Player in_ur_i folds
Player IlxxxlI raises (3.30)
Player DonkReaper calls (2.30)
*** FLOP ***: [Qc 2d 10c]
Player IlxxxlI bets (3.73)
Player DonkReaper folds
Uncalled bet (3.73) returned to IlxxxlI
Player IlxxxlI mucks cards
------ Summary ------
Pot: 7.46. Rake 0.27. JP fee 0.12
Board: [Qc 2d 10c]
Player caballeroXXX does not show cards.Bets: 0. Collects: 0. Wins: 0.
Player GreinSeint does not show cards.Bets: 0. Collects: 0. Wins: 0.
Player DonkReaper does not show cards.Bets: 3.80. Collects: 0. Loses: 3.80.
Player in_ur_i does not show cards.Bets: 0.25. Collects: 0. Loses: 0.25.
*Player IlxxxlI mucks (does not show cards). Bets: 3.80. Collects: 7.46. Wins: 3.66.
Game ended at: 2016/11/28 20:39:29

Game started
Game ID: 786376185 0.25/0.50 (PRR) Gorgons (Hold'em)
Seat 5 is the button
Seat 1: SenNoSen (103.69).
Seat 2: GreinSeint (20).
Seat 3: in_ur_i (37.19).
Seat 4: caballeroXXX (114.11).
Seat 5: meandkids (51.50).
Seat 6: IlxxxlI (20).
Player IlxxxlI has small blind (0.25)
Player SenNoSen sitting out
Player GreinSeint has big blind (0.50)
Player IlxxxlI received card: [7s]
Player IlxxxlI received card: [9c]
Player in_ur_i folds
Player caballeroXXX folds
Player meandkids folds
Player IlxxxlI calls (0.25)
Player GreinSeint checks
*** FLOP ***: [3c 4h 8d]
Player IlxxxlI bets (0.50)
Player GreinSeint calls (0.50)
*** TURN ***: [3c 4h 8d] [8c]
Player IlxxxlI checks
Player GreinSeint bets (1.26)
Player IlxxxlI folds
Uncalled bet (1.26) returned to GreinSeint
Player GreinSeint mucks cards
------ Summary ------
Pot: 1.90. Rake 0.08. JP fee 0.02
Board: [3c 4h 8d 8c]
Player SenNoSen does not show cards.Bets: 0. Collects: 0. Wins: 0.
*Player GreinSeint mucks (does not show cards). Bets: 1. Collects: 1.90. Wins: 0.90.
Player in_ur_i does not show cards.Bets: 0. Collects: 0. Wins: 0.
Player caballeroXXX does not show cards.Bets: 0. Collects: 0. Wins: 0.
Player meandkids does not show cards.Bets: 0. Collects: 0. Wins: 0.
Player IlxxxlI does not show cards.Bets: 1. Collects: 0. Loses: 1.
Game ended at: 2016/11/28 20:39:20

Game started
Game ID: 786376109 0.25/0.50 (PRR) Gorgons (Hold'em)
Seat 4 is the button
Seat 1: SenNoSen (103.69).
Seat 2: GreinSeint (20).
Seat 3: in_ur_i (37.19).
Seat 4: caballeroXXX (114.11).
Seat 5: meandkids (51).
Seat 6: IlxxxlI (20).
Player meandkids has small blind (0.25)
Player IlxxxlI has big blind (0.50)
Player IlxxxlI received card: [4c]
Player IlxxxlI received card: [2s]
Player SenNoSen folds
Player GreinSeint folds
Player in_ur_i folds
Player caballeroXXX folds
Player meandkids raises (2.75)
Player IlxxxlI folds
Uncalled bet (2.50) returned to meandkids
Player meandkids mucks cards
------ Summary ------
Pot: 1. Rake 0
Player SenNoSen does not show cards.Bets: 0. Collects: 0. Wins: 0.
Player GreinSeint does not show cards.Bets: 0. Collects: 0. Wins: 0.
Player in_ur_i does not show cards.Bets: 0. Collects: 0. Wins: 0.
Player caballeroXXX does not show cards.Bets: 0. Collects: 0. Wins: 0.
*Player meandkids mucks (does not show cards). Bets: 0.50. Collects: 1. Wins: 0.50.
Player IlxxxlI does not show cards.Bets: 0.50. Collects: 0. Loses: 0.50.
Game ended at: 2016/11/28 20:38:36

Game started
Game ID: 786376030 0.25/0.50 (PRR) Gorgons (Hold'em)
Seat 3 is the button
Seat 1: SenNoSen (103.69).
Seat 2: GreinSeint (20).
Seat 3: in_ur_i (37.19).
Seat 4: caballeroXXX (114.36).
Seat 5: meandkids (50.75).
Seat 6: IlxxxlI (20).
Player caballeroXXX has small blind (0.25)
Player meandkids has big blind (0.50)
Player IlxxxlI received card: [Ac]
Player IlxxxlI received card: [3d]
Player IlxxxlI folds
Player SenNoSen folds
Player GreinSeint folds
Player in_ur_i folds
Player caballeroXXX folds
Uncalled bet (0.25) returned to meandkids
Player meandkids mucks cards
------ Summary ------
Pot: 0.50. Rake 0
Player SenNoSen does not show cards.Bets: 0. Collects: 0. Wins: 0.
Player GreinSeint does not show cards.Bets: 0. Collects: 0. Wins: 0.
Player in_ur_i does not show cards.Bets: 0. Collects: 0. Wins: 0.
Player caballeroXXX does not show cards.Bets: 0.25. Collects: 0. Loses: 0.25.
*Player meandkids mucks (does not show cards). Bets: 0.25. Collects: 0.50. Wins: 0.25.
Player IlxxxlI does not show cards.Bets: 0. Collects: 0. Wins: 0.
Game ended at: 2016/11/28 20:38:17

Game started
Game ID: 786375999 0.25/0.50 (PRR) Gorgons - 2 (Hold'em)
Seat 1 is the button
Seat 1: DonkReaper (60.42).
Seat 2: IlxxxlI (20).
Seat 3: SenNoSen (54.84).
Seat 5: in_ur_i (65.80).
Seat 6: caballeroXXX (65.61).
Player IlxxxlI has small blind (0.25)
Player SenNoSen has big blind (0.50)
Player IlxxxlI received card: [4c]
Player IlxxxlI received card: [4d]
Player in_ur_i raises (1.50)
Player caballeroXXX raises (5)
Player DonkReaper folds
Player IlxxxlI folds
Player SenNoSen folds
Player in_ur_i calls (3.50)
*** FLOP ***: [Qh 5d Kh]
Player in_ur_i checks
Player caballeroXXX checks
*** TURN ***: [Qh 5d Kh] [10c]
Player in_ur_i bets (5.11)
Player caballeroXXX calls (5.11)
*** RIVER ***: [Qh 5d Kh 10c] [5s]
Player in_ur_i checks
Player caballeroXXX checks
------ Summary ------
Pot: 19.93. Rake 0.80. JP fee 0.24
Board: [Qh 5d Kh 10c 5s]
Player DonkReaper does not show cards.Bets: 0. Collects: 0. Wins: 0.
Player IlxxxlI does not show cards.Bets: 0.25. Collects: 0. Loses: 0.25.
Player SenNoSen does not show cards.Bets: 0.50. Collects: 0. Loses: 0.50.
Player in_ur_i shows: Two pairs. Js and 5s [Jh Jc]. Bets: 10.11. Collects: 0. Loses: 10.11.
*Player caballeroXXX shows: Two pairs. Qs and 5s [As Qc]. Bets: 10.11. Collects: 19.93. Wins: 9.82.
Game ended at: 2016/11/28 20:39:8

Game started
Game ID: 786375903 1/2 (PRR) Lakhey (Short) (Hold'em)
Seat 6 is the button
Seat 1: IlxxxlI (44.53).
Seat 2: gfclbv (86).
Seat 3: BBDub27 (150.40).
Seat 4: Wollverin (131.70).
Seat 5: meandkids (89.44).
Seat 6: Are you with me (83.90).
Player IlxxxlI has small blind (1)
Player gfclbv has big blind (2)
Player IlxxxlI received card: [5d]
Player IlxxxlI received card: [6h]
Player BBDub27 folds
Player Wollverin raises (5)
Player meandkids folds
Player Are you with me folds
Player IlxxxlI folds
Player gfclbv calls (3)
*** FLOP ***: [Ks 4c Kd]
Player gfclbv checks
Player Wollverin bets (4)
Player gfclbv raises (10)
Player Wollverin calls (6)
*** TURN ***: [Ks 4c Kd] [2s]
Player gfclbv bets (16)
Player Wollverin calls (16)
*** RIVER ***: [Ks 4c Kd 2s] [6s]
Player gfclbv checks
Player Wollverin bets (30)
Player gfclbv folds
Uncalled bet (30) returned to Wollverin
Player Wollverin mucks cards
------ Summary ------
Pot: 60. Rake 2.76. JP fee 0.24
Board: [Ks 4c Kd 2s 6s]
Player IlxxxlI does not show cards.Bets: 1. Collects: 0. Loses: 1.
Player gfclbv does not show cards.Bets: 31. Collects: 0. Loses: 31.
Player BBDub27 does not show cards.Bets: 0. Collects: 0. Wins: 0.
*Player Wollverin mucks (does not show cards). Bets: 31. Collects: 60. Wins: 29.
Player meandkids does not show cards.Bets: 0. Collects: 0. Wins: 0.
Player Are you with me does not show cards.Bets: 0. Collects: 0. Wins: 0.
Game ended at: 2016/11/28 20:39:18

Game started
Game ID: 786375837 0.25/0.50 (PRR) Gorgons (Hold'em)
Seat 2 is the button
Seat 1: SenNoSen (103.69).
Seat 2: GreinSeint (20).
Seat 3: in_ur_i (40.11).
Seat 4: caballeroXXX (111.73).
Seat 5: meandkids (50.75).
Seat 6: IlxxxlI (20).
Player in_ur_i has small blind (0.25)
Player caballeroXXX has big blind (0.50)
Player IlxxxlI received card: [9s]
Player IlxxxlI received card: [Jd]
Player meandkids folds
Player IlxxxlI folds
Player SenNoSen folds
Player GreinSeint folds
Player in_ur_i raises (1.25)
Player caballeroXXX calls (1)
*** FLOP ***: [Js 9c Kd]
Player in_ur_i bets (1.42)
Player caballeroXXX calls (1.42)
*** TURN ***: [Js 9c Kd] [2c]
Player in_ur_i checks
Player caballeroXXX bets (2.77)
Player in_ur_i folds
Uncalled bet (2.77) returned to caballeroXXX
Player caballeroXXX mucks cards
------ Summary ------
Pot: 5.55. Rake 0.21. JP fee 0.08
Board: [Js 9c Kd 2c]
Player SenNoSen does not show cards.Bets: 0. Collects: 0. Wins: 0.
Player GreinSeint does not show cards.Bets: 0. Collects: 0. Wins: 0.
Player in_ur_i does not show cards.Bets: 2.92. Collects: 0. Loses: 2.92.
*Player caballeroXXX mucks (does not show cards). Bets: 2.92. Collects: 5.55. Wins: 2.63.
Player meandkids does not show cards.Bets: 0. Collects: 0. Wins: 0.
Player IlxxxlI does not show cards.Bets: 0. Collects: 0. Wins: 0.
Game ended at: 2016/11/28 20:37:58

Game started
Game ID: 786375788 0.25/0.50 (PRR) Gorgons - 2 (Hold'em)
Seat 6 is the button
Seat 1: DonkReaper (60.67).
Seat 2: IlxxxlI (20).
Seat 3: SenNoSen (50.75).
Seat 5: in_ur_i (65.80).
Seat 6: caballeroXXX (69.36).
Player DonkReaper has small blind (0.25)
Player IlxxxlI has big blind (0.50)
Player IlxxxlI received card: [3d]
Player IlxxxlI received card: [Ad]
Player SenNoSen raises (1.50)
Player in_ur_i folds
Player caballeroXXX calls (1.50)
Player DonkReaper folds
Player IlxxxlI folds
*** FLOP ***: [8c Jh 9c]
Player SenNoSen checks
Player caballeroXXX bets (2.25)
Player SenNoSen calls (2.25)
*** TURN ***: [8c Jh 9c] [3h]
Player SenNoSen checks
Player caballeroXXX checks
*** RIVER ***: [8c Jh 9c 3h] [4h]
Player SenNoSen bets (5.22)
Player caballeroXXX folds
Uncalled bet (5.22) returned to SenNoSen
Player SenNoSen mucks cards
------ Summary ------
Pot: 7.84. Rake 0.29. JP fee 0.12
Board: [8c Jh 9c 3h 4h]
Player DonkReaper does not show cards.Bets: 0.25. Collects: 0. Loses: 0.25.
Player IlxxxlI does not show cards.Bets: 0.50. Collects: 0. Loses: 0.50.
*Player SenNoSen mucks (does not show cards). Bets: 3.75. Collects: 7.84. Wins: 4.09.
Player in_ur_i does not show cards.Bets: 0. Collects: 0. Wins: 0.
Player caballeroXXX does not show cards.Bets: 3.75. Collects: 0. Loses: 3.75.
Game ended at: 2016/11/28 20:37:46

Game started
Game ID: 786375716 1/2 (PRR) Lakhey (Short) (Hold'em)
Seat 5 is the button
Seat 1: IlxxxlI (46.53).
Seat 2: gfclbv (86).
Seat 3: BBDub27 (150.40).
Seat 4: Wollverin (131.70).
Seat 5: meandkids (89.44).
Seat 6: Are you with me (81.90).
Player Are you with me has small blind (1)
Player IlxxxlI has big blind (2)
Player IlxxxlI received card: [4c]
Player IlxxxlI received card: [5h]
Player gfclbv folds
Player BBDub27 is timed out.
Player BBDub27 folds
Player Wollverin folds
Player meandkids folds
Player Are you with me raises (3.40)
Player IlxxxlI folds
Uncalled bet (2.40) returned to Are you with me
Player Are you with me mucks cards
------ Summary ------
Pot: 4. Rake 0
Player IlxxxlI does not show cards.Bets: 2. Collects: 0. Loses: 2.
Player gfclbv does not show cards.Bets: 0. Collects: 0. Wins: 0.
Player BBDub27 does not show cards.Bets: 0. Collects: 0. Wins: 0.
Player Wollverin does not show cards.Bets: 0. Collects: 0. Wins: 0.
Player meandkids does not show cards.Bets: 0. Collects: 0. Wins: 0.
*Player Are you with me mucks (does not show cards). Bets: 2. Collects: 4. Wins: 2.
Game ended at: 2016/11/28 20:37:21

Game started
Game ID: 786375700 0.25/0.50 (PRR) Gorgons (Hold'em)
Seat 1 is the button
Seat 1: SenNoSen (103.69).
Seat 2: GreinSeint (20.25).
Seat 3: in_ur_i (40.61).
Seat 4: caballeroXXX (111.73).
Seat 5: meandkids (50).
Seat 6: IlxxxlI (20).
Player GreinSeint has small blind (0.25)
Player in_ur_i has big blind (0.50)
Player IlxxxlI received card: [10d]
Player IlxxxlI received card: [3c]
Player caballeroXXX folds
Player meandkids raises (3)
Player IlxxxlI folds
Player SenNoSen folds
Player GreinSeint folds
Player in_ur_i folds
Uncalled bet (2.50) returned to meandkids
Player meandkids mucks cards
------ Summary ------
Pot: 1.25. Rake 0
Player SenNoSen does not show cards.Bets: 0. Collects: 0. Wins: 0.
Player GreinSeint does not show cards.Bets: 0.25. Collects: 0. Loses: 0.25.
Player in_ur_i does not show cards.Bets: 0.50. Collects: 0. Loses: 0.50.
Player caballeroXXX does not show cards.Bets: 0. Collects: 0. Wins: 0.
*Player meandkids mucks (does not show cards). Bets: 0.50. Collects: 1.25. Wins: 0.75.
Player IlxxxlI does not show cards.Bets: 0. Collects: 0. Wins: 0.
Game ended at: 2016/11/28 20:37:3

Game started
Game ID: 786375698 0.25/0.50 (PRR) Gorgons - 5 (Hold'em)
Seat 2 is the button
Seat 1: caballeroXXX (73.85).
Seat 2: GreinSeint (19.25).
Seat 3: DonkReaper (63.79).
Seat 4: in_ur_i (42.96).
Seat 6: IlxxxlI (33.75).
Player DonkReaper has small blind (0.25)
Player in_ur_i has big blind (0.50)
Player IlxxxlI received card: [10h]
Player IlxxxlI received card: [7h]
Player IlxxxlI folds
Player caballeroXXX raises (1.25)
Player GreinSeint folds
Player DonkReaper folds
Player in_ur_i calls (0.75)
*** FLOP ***: [Qs 4h Kd]
Player in_ur_i bets (1.31)
Player caballeroXXX folds
Uncalled bet (1.31) returned to in_ur_i
Player in_ur_i mucks cards
------ Summary ------
Pot: 2.62. Rake 0.09. JP fee 0.04
Board: [Qs 4h Kd]
Player caballeroXXX does not show cards.Bets: 1.25. Collects: 0. Loses: 1.25.
Player GreinSeint does not show cards.Bets: 0. Collects: 0. Wins: 0.
Player DonkReaper does not show cards.Bets: 0.25. Collects: 0. Loses: 0.25.
*Player in_ur_i mucks (does not show cards). Bets: 1.25. Collects: 2.62. Wins: 1.37.
Player IlxxxlI does not show cards.Bets: 0. Collects: 0. Wins: 0.
Game ended at: 2016/11/28 20:37:2

Game started
Game ID: 786375620 0.25/0.50 (PRR) Gorgons (Hold'em)
Seat 6 is the button
Seat 1: SenNoSen (103.94).
Seat 2: GreinSeint (20).
Seat 3: in_ur_i (40.61).
Seat 4: caballeroXXX (111.73).
Seat 5: meandkids (50).
Seat 6: IlxxxlI (20).
Player SenNoSen has small blind (0.25)
Player GreinSeint has big blind (0.50)
Player IlxxxlI received card: [9c]
Player IlxxxlI received card: [6c]
Player in_ur_i folds
Player caballeroXXX folds
Player meandkids folds
Player IlxxxlI folds
Player SenNoSen folds
Uncalled bet (0.25) returned to GreinSeint
Player GreinSeint mucks cards
------ Summary ------
Pot: 0.50. Rake 0
Player SenNoSen does not show cards.Bets: 0.25. Collects: 0. Loses: 0.25.
*Player GreinSeint mucks (does not show cards). Bets: 0.25. Collects: 0.50. Wins: 0.25.
Player in_ur_i does not show cards.Bets: 0. Collects: 0. Wins: 0.
Player caballeroXXX does not show cards.Bets: 0. Collects: 0. Wins: 0.
Player meandkids does not show cards.Bets: 0. Collects: 0. Wins: 0.
Player IlxxxlI does not show cards.Bets: 0. Collects: 0. Wins: 0.
Game ended at: 2016/11/28 20:36:28

Game started
Game ID: 786375577 0.25/0.50 (PRR) Gorgons - 5 (Hold'em)
Seat 1 is the button
Seat 1: caballeroXXX (73.85).
Seat 2: GreinSeint (19.50).
Seat 3: DonkReaper (64.29).
Seat 4: in_ur_i (42.21).
Seat 5: Cinch23 (16.66).
Seat 6: IlxxxlI (33.75).
Player GreinSeint has small blind (0.25)
Player DonkReaper has big blind (0.50)
Player IlxxxlI received card: [5h]
Player IlxxxlI received card: [Ks]
Player in_ur_i raises (1.50)
Player Cinch23 folds
Player IlxxxlI folds
Player caballeroXXX folds
Player GreinSeint folds
Player DonkReaper folds
Uncalled bet (1) returned to in_ur_i
Player in_ur_i mucks cards
------ Summary ------
Pot: 1.25. Rake 0
Player caballeroXXX does not show cards.Bets: 0. Collects: 0. Wins: 0.
Player GreinSeint does not show cards.Bets: 0.25. Collects: 0. Loses: 0.25.
Player DonkReaper does not show cards.Bets: 0.50. Collects: 0. Loses: 0.50.
*Player in_ur_i mucks (does not show cards). Bets: 0.50. Collects: 1.25. Wins: 0.75.
Player Cinch23 does not show cards.Bets: 0. Collects: 0. Wins: 0.
Player IlxxxlI does not show cards.Bets: 0. Collects: 0. Wins: 0.
Game ended at: 2016/11/28 20:36:27

Game started
Game ID: 786375554 1/2 (PRR) Lakhey (Short) (Hold'em)
Seat 4 is the button
Seat 1: IlxxxlI (46.53).
Seat 2: gfclbv (86).
Seat 3: BBDub27 (150.40).
Seat 4: Wollverin (128.70).
Seat 5: meandkids (90.44).
Seat 6: Are you with me (83.90).
Player meandkids has small blind (1)
Player Are you with me has big blind (2)
Player IlxxxlI received card: [5h]
Player IlxxxlI received card: [3c]
Player IlxxxlI folds
Player gfclbv folds
Player BBDub27 is timed out.
Player BBDub27 folds
Player Wollverin raises (4)
Player meandkids folds
Player Are you with me folds
Uncalled bet (2) returned to Wollverin
Player Wollverin mucks cards
------ Summary ------
Pot: 5. Rake 0
Player IlxxxlI does not show cards.Bets: 0. Collects: 0. Wins: 0.
Player gfclbv does not show cards.Bets: 0. Collects: 0. Wins: 0.
Player BBDub27 does not show cards.Bets: 0. Collects: 0. Wins: 0.
*Player Wollverin mucks (does not show cards). Bets: 2. Collects: 5. Wins: 3.
Player meandkids does not show cards.Bets: 1. Collects: 0. Loses: 1.
Player Are you with me does not show cards.Bets: 2. Collects: 0. Loses: 2.
Game ended at: 2016/11/28 20:36:31

Game started
Game ID: 786375533 0.25/0.50 (PRR) Gorgons (Hold'em)
Seat 5 is the button
Seat 1: SenNoSen (104.44).
Seat 2: GreinSeint (20).
Seat 3: in_ur_i (40.61).
Seat 4: caballeroXXX (111.73).
Seat 5: meandkids (49.25).
Seat 6: IlxxxlI (20).
Player IlxxxlI has small blind (0.25)
Player SenNoSen has big blind (0.50)
Player IlxxxlI received card: [Jc]
Player IlxxxlI received card: [Kh]
Player GreinSeint folds
Player in_ur_i folds
Player caballeroXXX folds
Player meandkids raises (3)
Player IlxxxlI folds
Player SenNoSen folds
Uncalled bet (2.50) returned to meandkids
Player meandkids mucks cards
------ Summary ------
Pot: 1.25. Rake 0
Player SenNoSen does not show cards.Bets: 0.50. Collects: 0. Loses: 0.50.
Player GreinSeint does not show cards.Bets: 0. Collects: 0. Wins: 0.
Player in_ur_i does not show cards.Bets: 0. Collects: 0. Wins: 0.
Player caballeroXXX does not show cards.Bets: 0. Collects: 0. Wins: 0.
*Player meandkids mucks (does not show cards). Bets: 0.50. Collects: 1.25. Wins: 0.75.
Player IlxxxlI does not show cards.Bets: 0.25. Collects: 0. Loses: 0.25.
Game ended at: 2016/11/28 20:36:8

Game started
Game ID: 786375526 0.25/0.50 (PRR) Gorgons - 2 (Hold'em)
Seat 5 is the button
Seat 1: DonkReaper (59.08).
Seat 2: IlxxxlI (20).
Seat 3: SenNoSen (50.75).
Seat 5: in_ur_i (67.30).
Seat 6: caballeroXXX (69.61).
Player caballeroXXX has small blind (0.25)
Player DonkReaper has big blind (0.50)
Player IlxxxlI received card: [2h]
Player IlxxxlI received card: [3d]
Player IlxxxlI folds
Player SenNoSen folds
Player in_ur_i raises (1.50)
Player caballeroXXX folds
Player DonkReaper calls (1)
*** FLOP ***: [Qc Kh 9c]
Player DonkReaper checks
Player in_ur_i is timed out.
Player in_ur_i checks
*** TURN ***: [Qc Kh 9c] [10s]
Player DonkReaper bets (2.06)
Player in_ur_i folds
Uncalled bet (2.06) returned to DonkReaper
Player DonkReaper mucks cards
------ Summary ------
Pot: 3.09. Rake 0.12. JP fee 0.04
Board: [Qc Kh 9c 10s]
*Player DonkReaper mucks (does not show cards). Bets: 1.50. Collects: 3.09. Wins: 1.59.
Player IlxxxlI does not show cards.Bets: 0. Collects: 0. Wins: 0.
Player SenNoSen does not show cards.Bets: 0. Collects: 0. Wins: 0.
Player in_ur_i does not show cards.Bets: 1.50. Collects: 0. Loses: 1.50.
Player caballeroXXX does not show cards.Bets: 0.25. Collects: 0. Loses: 0.25.
Game ended at: 2016/11/28 20:36:50

Game started
Game ID: 786375493 0.25/0.50 (PRR) Gorgons - 5 (Hold'em)
Seat 6 is the button
Seat 1: caballeroXXX (74.10).
Seat 2: GreinSeint (20).
Seat 3: DonkReaper (64.29).
Seat 4: in_ur_i (43.71).
Seat 5: Cinch23 (14.41).
Seat 6: IlxxxlI (33.75).
Player caballeroXXX has small blind (0.25)
Player GreinSeint has big blind (0.50)
Player IlxxxlI received card: [9c]
Player IlxxxlI received card: [6s]
Player DonkReaper folds
Player in_ur_i raises (1.50)
Player Cinch23 allin (14.41)
Player IlxxxlI folds
Player caballeroXXX folds
Player GreinSeint folds
Player in_ur_i folds
Uncalled bet (12.91) returned to Cinch23
Player Cinch23 mucks cards
------ Summary ------
Pot: 3.75. Rake 0
Player caballeroXXX does not show cards.Bets: 0.25. Collects: 0. Loses: 0.25.
Player GreinSeint does not show cards.Bets: 0.50. Collects: 0. Loses: 0.50.
Player DonkReaper does not show cards.Bets: 0. Collects: 0. Wins: 0.
Player in_ur_i does not show cards.Bets: 1.50. Collects: 0. Loses: 1.50.
*Player Cinch23 mucks (does not show cards). Bets: 1.50. Collects: 3.75. Wins: 2.25.
Player IlxxxlI does not show cards.Bets: 0. Collects: 0. Wins: 0.
Game ended at: 2016/11/28 20:35:50

Game started
Game ID: 786375446 0.25/0.50 (PRR) Gorgons (Hold'em)
Seat 4 is the button
Seat 1: SenNoSen (104.44).
Seat 2: GreinSeint (20).
Seat 3: in_ur_i (40.61).
Seat 4: caballeroXXX (110.98).
Seat 5: meandkids (49.50).
Seat 6: IlxxxlI (20).
Player meandkids has small blind (0.25)
Player IlxxxlI has big blind (0.50)
Player IlxxxlI received card: [10h]
Player IlxxxlI received card: [2d]
Player SenNoSen folds
Player GreinSeint folds
Player in_ur_i folds
Player caballeroXXX raises (1)
Player meandkids folds
Player IlxxxlI folds
Uncalled bet (0.50) returned to caballeroXXX
Player caballeroXXX mucks cards
------ Summary ------
Pot: 1.25. Rake 0
Player SenNoSen does not show cards.Bets: 0. Collects: 0. Wins: 0.
Player GreinSeint does not show cards.Bets: 0. Collects: 0. Wins: 0.
Player in_ur_i does not show cards.Bets: 0. Collects: 0. Wins: 0.
*Player caballeroXXX mucks (does not show cards). Bets: 0.50. Collects: 1.25. Wins: 0.75.
Player meandkids does not show cards.Bets: 0.25. Collects: 0. Loses: 0.25.
Player IlxxxlI does not show cards.Bets: 0.50. Collects: 0. Loses: 0.50.
Game ended at: 2016/11/28 20:35:37

Game started
Game ID: 786375445 0.25/0.50 (PRR) Gorgons - 5 (Hold'em)
Seat 5 is the button
Seat 1: caballeroXXX (73.85).
Seat 2: GreinSeint (20).
Seat 3: DonkReaper (64.29).
Seat 4: in_ur_i (43.71).
Seat 5: Cinch23 (14.41).
Seat 6: IlxxxlI (34).
Player IlxxxlI has small blind (0.25)
Player caballeroXXX has big blind (0.50)
Player IlxxxlI received card: [4d]
Player IlxxxlI received card: [5c]
Player GreinSeint folds
Player DonkReaper folds
Player in_ur_i folds
Player Cinch23 folds
Player IlxxxlI folds
Uncalled bet (0.25) returned to caballeroXXX
Player caballeroXXX mucks cards
------ Summary ------
Pot: 0.50. Rake 0
*Player caballeroXXX mucks (does not show cards). Bets: 0.25. Collects: 0.50. Wins: 0.25.
Player GreinSeint does not show cards.Bets: 0. Collects: 0. Wins: 0.
Player DonkReaper does not show cards.Bets: 0. Collects: 0. Wins: 0.
Player in_ur_i does not show cards.Bets: 0. Collects: 0. Wins: 0.
Player Cinch23 does not show cards.Bets: 0. Collects: 0. Wins: 0.
Player IlxxxlI does not show cards.Bets: 0.25. Collects: 0. Loses: 0.25.
Game ended at: 2016/11/28 20:35:26

Game started
Game ID: 786375365 0.25/0.50 (PRR) Gorgons (Hold'em)
Seat 3 is the button
Seat 1: SenNoSen (104.44).
Seat 2: GreinSeint (19.25).
Seat 3: in_ur_i (40.61).
Seat 4: caballeroXXX (111.23).
Seat 5: meandkids (50).
Seat 6: IlxxxlI (20).
Player caballeroXXX has small blind (0.25)
Player meandkids has big blind (0.50)
Player IlxxxlI received card: [Ad]
Player IlxxxlI received card: [4c]
Player IlxxxlI folds
Player SenNoSen folds
Player GreinSeint raises (1.50)
Player in_ur_i folds
Player caballeroXXX folds
Player meandkids folds
Uncalled bet (1) returned to GreinSeint
Player GreinSeint mucks cards
------ Summary ------
Pot: 1.25. Rake 0
Player SenNoSen does not show cards.Bets: 0. Collects: 0. Wins: 0.
*Player GreinSeint mucks (does not show cards). Bets: 0.50. Collects: 1.25. Wins: 0.75.
Player in_ur_i does not show cards.Bets: 0. Collects: 0. Wins: 0.
Player caballeroXXX does not show cards.Bets: 0.25. Collects: 0. Loses: 0.25.
Player meandkids does not show cards.Bets: 0.50. Collects: 0. Loses: 0.50.
Player IlxxxlI does not show cards.Bets: 0. Collects: 0. Wins: 0.
Game ended at: 2016/11/28 20:35:11

Game started
Game ID: 786375335 0.25/0.50 (PRR) Gorgons - 2 (Hold'em)
Seat 3 is the button
Seat 1: DonkReaper (59.08).
Seat 2: IlxxxlI (20).
Seat 3: SenNoSen (50.75).
Seat 4: Cinch23 (85.85).
Seat 5: in_ur_i (69.30).
Seat 6: caballeroXXX (69.61).
Player Cinch23 has small blind (0.25)
Player in_ur_i has big blind (0.50)
Player IlxxxlI received card: [2h]
Player IlxxxlI received card: [Qh]
Player caballeroXXX folds
Player DonkReaper folds
Player IlxxxlI folds
Player SenNoSen folds
Player Cinch23 raises (0.75)
Player in_ur_i calls (0.50)
*** FLOP ***: [2s 8c Jd]
Player Cinch23 bets (1)
Player in_ur_i calls (1)
*** TURN ***: [2s 8c Jd] [7c]
Player Cinch23 bets (2)
Player in_ur_i folds
Uncalled bet (2) returned to Cinch23
Player Cinch23 mucks cards
------ Summary ------
Pot: 3.80. Rake 0.14. JP fee 0.06
Board: [2s 8c Jd 7c]
Player DonkReaper does not show cards.Bets: 0. Collects: 0. Wins: 0.
Player IlxxxlI does not show cards.Bets: 0. Collects: 0. Wins: 0.
Player SenNoSen does not show cards.Bets: 0. Collects: 0. Wins: 0.
*Player Cinch23 mucks (does not show cards). Bets: 2. Collects: 3.80. Wins: 1.80.
Player in_ur_i does not show cards.Bets: 2. Collects: 0. Loses: 2.
Player caballeroXXX does not show cards.Bets: 0. Collects: 0. Wins: 0.
Game ended at: 2016/11/28 20:35:35

Game started
Game ID: 786375299 0.25/0.50 (PRR) Gorgons - 5 (Hold'em)
Seat 4 is the button
Seat 1: caballeroXXX (73.85).
Seat 2: GreinSeint (20).
Seat 3: DonkReaper (71.62).
Seat 4: in_ur_i (43.71).
Seat 5: Cinch23 (7.33).
Seat 6: IlxxxlI (34.50).
Player Cinch23 has small blind (0.25)
Player IlxxxlI has big blind (0.50)
Player IlxxxlI received card: [7s]
Player IlxxxlI received card: [8s]
Player caballeroXXX folds
Player GreinSeint folds
Player DonkReaper raises (1.50)
Player in_ur_i folds
Player Cinch23 allin (7.08)
Player IlxxxlI folds
Player DonkReaper calls (5.83)
*** FLOP ***: [Ac 6s 8c]
*** TURN ***: [Ac 6s 8c] [9h]
*** RIVER ***: [Ac 6s 8c 9h] [4s]
------ Summary ------
Pot: 14.41. Rake 0.51. JP fee 0.24
Board: [Ac 6s 8c 9h 4s]
Player caballeroXXX does not show cards.Bets: 0. Collects: 0. Wins: 0.
Player GreinSeint does not show cards.Bets: 0. Collects: 0. Wins: 0.
Player DonkReaper shows: High card A [10d Ks]. Bets: 7.33. Collects: 0. Loses: 7.33.
Player in_ur_i does not show cards.Bets: 0. Collects: 0. Wins: 0.
*Player Cinch23 shows: One pair of As [3s Ad]. Bets: 7.33. Collects: 14.41. Wins: 7.08.
Player IlxxxlI does not show cards.Bets: 0.50. Collects: 0. Loses: 0.50.
Game ended at: 2016/11/28 20:35:9

Game started
Game ID: 786375284 0.25/0.50 (PRR) Gorgons (Hold'em)
Seat 2 is the button
Seat 1: SenNoSen (104.44).
Seat 2: GreinSeint (19.25).
Seat 3: in_ur_i (40.11).
Seat 4: caballeroXXX (111.73).
Seat 5: meandkids (50).
Seat 6: IlxxxlI (20).
Player in_ur_i has small blind (0.25)
Player caballeroXXX has big blind (0.50)
Player IlxxxlI received card: [Kc]
Player IlxxxlI received card: [Js]
Player meandkids folds
Player IlxxxlI folds
Player SenNoSen folds
Player GreinSeint folds
Player in_ur_i raises (1.25)
Player caballeroXXX folds
Uncalled bet (1) returned to in_ur_i
Player in_ur_i mucks cards
------ Summary ------
Pot: 1. Rake 0
Player SenNoSen does not show cards.Bets: 0. Collects: 0. Wins: 0.
Player GreinSeint does not show cards.Bets: 0. Collects: 0. Wins: 0.
*Player in_ur_i mucks (does not show cards). Bets: 0.50. Collects: 1. Wins: 0.50.
Player caballeroXXX does not show cards.Bets: 0.50. Collects: 0. Loses: 0.50.
Player meandkids does not show cards.Bets: 0. Collects: 0. Wins: 0.
Player IlxxxlI does not show cards.Bets: 0. Collects: 0. Wins: 0.
Game ended at: 2016/11/28 20:34:46

Game started
Game ID: 786375285 1/2 (PRR) Lakhey (Short) (Hold'em)
Seat 3 is the button
Seat 1: IlxxxlI (46.53).
Seat 2: gfclbv (86).
Seat 3: BBDub27 (150.40).
Seat 4: Wollverin (129.70).
Seat 5: meandkids (95.44).
Seat 6: Are you with me (78.45).
Player Wollverin has small blind (1)
Player meandkids has big blind (2)
Player IlxxxlI received card: [Ad]
Player IlxxxlI received card: [3h]
Player Are you with me raises (5)
Player IlxxxlI folds
Player gfclbv folds
Player BBDub27 folds
Player Wollverin folds
Player meandkids calls (3)
*** FLOP ***: [3s 3d 6d]
Player meandkids checks
Player Are you with me bets (3.66)
Player meandkids folds
Uncalled bet (3.66) returned to Are you with me
Player Are you with me mucks cards
------ Summary ------
Pot: 10.45. Rake 0.37. JP fee 0.18
Board: [3s 3d 6d]
Player IlxxxlI does not show cards.Bets: 0. Collects: 0. Wins: 0.
Player gfclbv does not show cards.Bets: 0. Collects: 0. Wins: 0.
Player BBDub27 does not show cards.Bets: 0. Collects: 0. Wins: 0.
Player Wollverin does not show cards.Bets: 1. Collects: 0. Loses: 1.
Player meandkids does not show cards.Bets: 5. Collects: 0. Loses: 5.
*Player Are you with me mucks (does not show cards). Bets: 5. Collects: 10.45. Wins: 5.45.
Game ended at: 2016/11/28 20:35:43

Game started
Game ID: 786375241 0.25/0.50 (PRR) Gorgons - 2 (Hold'em)
Seat 2 is the button
Seat 1: DonkReaper (59.08).
Seat 2: IlxxxlI (20).
Seat 3: SenNoSen (50.25).
Seat 4: Cinch23 (86.35).
Seat 5: in_ur_i (69.30).
Seat 6: caballeroXXX (69.61).
Player SenNoSen has small blind (0.25)
Player Cinch23 has big blind (0.50)
Player IlxxxlI received card: [9c]
Player IlxxxlI received card: [6s]
Player in_ur_i folds
Player caballeroXXX folds
Player DonkReaper folds
Player IlxxxlI folds
Player SenNoSen raises (1.25)
Player Cinch23 folds
Uncalled bet (1) returned to SenNoSen
Player SenNoSen mucks cards
------ Summary ------
Pot: 1. Rake 0
Player DonkReaper does not show cards.Bets: 0. Collects: 0. Wins: 0.
Player IlxxxlI does not show cards.Bets: 0. Collects: 0. Wins: 0.
*Player SenNoSen mucks (does not show cards). Bets: 0.50. Collects: 1. Wins: 0.50.
Player Cinch23 does not show cards.Bets: 0.50. Collects: 0. Loses: 0.50.
Player in_ur_i does not show cards.Bets: 0. Collects: 0. Wins: 0.
Player caballeroXXX does not show cards.Bets: 0. Collects: 0. Wins: 0.
Game ended at: 2016/11/28 20:34:37

Game started
Game ID: 786375192 0.25/0.50 (PRR) Gorgons (Hold'em)
Seat 1 is the button
Seat 1: SenNoSen (104.44).
Seat 2: GreinSeint (19.50).
Seat 3: in_ur_i (40.61).
Seat 4: caballeroXXX (110.98).
Seat 6: IlxxxlI (20).
Player GreinSeint has small blind (0.25)
Player in_ur_i has big blind (0.50)
Player IlxxxlI received card: [9c]
Player IlxxxlI received card: [5c]
Player caballeroXXX raises (1.50)
Player IlxxxlI folds
Player SenNoSen folds
Player GreinSeint folds
Player in_ur_i folds
Uncalled bet (1) returned to caballeroXXX
Player caballeroXXX mucks cards
------ Summary ------
Pot: 1.25. Rake 0
Player SenNoSen does not show cards.Bets: 0. Collects: 0. Wins: 0.
Player GreinSeint does not show cards.Bets: 0.25. Collects: 0. Loses: 0.25.
Player in_ur_i does not show cards.Bets: 0.50. Collects: 0. Loses: 0.50.
*Player caballeroXXX mucks (does not show cards). Bets: 0.50. Collects: 1.25. Wins: 0.75.
Player IlxxxlI does not show cards.Bets: 0. Collects: 0. Wins: 0.
Game ended at: 2016/11/28 20:34:22

Game started
Game ID: 786375038 0.25/0.50 (PRR) Gorgons - 2 (Hold'em)
Seat 1 is the button
Seat 1: DonkReaper (59.08).
Seat 2: IlxxxlI (20).
Seat 3: SenNoSen (50.75).
Seat 4: Cinch23 (86.35).
Seat 5: in_ur_i (68.55).
Seat 6: caballeroXXX (69.61).
Player IlxxxlI has small blind (0.25)
Player SenNoSen has big blind (0.50)
Player IlxxxlI received card: [5d]
Player IlxxxlI received card: [4h]
Player Cinch23 folds
Player in_ur_i raises (1.50)
Player caballeroXXX folds
Player DonkReaper folds
Player IlxxxlI folds
Player SenNoSen folds
Uncalled bet (1) returned to in_ur_i
Player in_ur_i mucks cards
------ Summary ------
Pot: 1.25. Rake 0
Player DonkReaper does not show cards.Bets: 0. Collects: 0. Wins: 0.
Player IlxxxlI does not show cards.Bets: 0.25. Collects: 0. Loses: 0.25.
Player SenNoSen does not show cards.Bets: 0.50. Collects: 0. Loses: 0.50.
Player Cinch23 does not show cards.Bets: 0. Collects: 0. Wins: 0.
*Player in_ur_i mucks (does not show cards). Bets: 0.50. Collects: 1.25. Wins: 0.75.
Player caballeroXXX does not show cards.Bets: 0. Collects: 0. Wins: 0.
Game ended at: 2016/11/28 20:34:11

Game started
Game ID: 786375031 1/2 (PRR) Lakhey (Short) (Hold'em)
Seat 2 is the button
Seat 1: IlxxxlI (46.53).
Seat 2: gfclbv (86).
Seat 3: BBDub27 (139.50).
Seat 4: Wollverin (131.70).
Seat 5: meandkids (105.44).
Seat 6: Are you with me (78.45).
Player BBDub27 has small blind (1)
Player Wollverin has big blind (2)
Player IlxxxlI received card: [5h]
Player IlxxxlI received card: [Qc]
Player meandkids raises (10)
Player Are you with me folds
Player IlxxxlI folds
Player gfclbv folds
Player BBDub27 calls (9)
Player Wollverin folds
*** FLOP ***: [6s 7d Jh]
Player BBDub27 checks
Player meandkids checks
*** TURN ***: [6s 7d Jh] [8c]
Player BBDub27 bets (12)
Player meandkids folds
Uncalled bet (12) returned to BBDub27
Player BBDub27 mucks cards
------ Summary ------
Pot: 20.90. Rake 0.86. JP fee 0.24
Board: [6s 7d Jh 8c]
Player IlxxxlI does not show cards.Bets: 0. Collects: 0. Wins: 0.
Player gfclbv does not show cards.Bets: 0. Collects: 0. Wins: 0.
*Player BBDub27 mucks (does not show cards). Bets: 10. Collects: 20.90. Wins: 10.90.
Player Wollverin does not show cards.Bets: 2. Collects: 0. Loses: 2.
Player meandkids does not show cards.Bets: 10. Collects: 0. Loses: 10.
Player Are you with me does not show cards.Bets: 0. Collects: 0. Wins: 0.
Game ended at: 2016/11/28 20:34:23

Game started
Game ID: 786375004 0.25/0.50 (PRR) Gorgons (Hold'em)
Seat 6 is the button
Seat 1: SenNoSen (50.75).
Seat 2: GreinSeint (20).
Seat 3: in_ur_i (42.11).
Seat 4: caballeroXXX (110.98).
Seat 5: meandkids (34.69).
Seat 6: IlxxxlI (20).
Player SenNoSen has small blind (0.25)
Player GreinSeint has big blind (0.50)
Player IlxxxlI received card: [Kd]
Player IlxxxlI received card: [Ac]
Player in_ur_i raises (1.50)
Player caballeroXXX folds
Player meandkids calls (1.50)
Player IlxxxlI raises (4.50)
Player SenNoSen raises (10.25)
Player GreinSeint folds
Player in_ur_i folds
Player meandkids calls (9)
Player IlxxxlI allin (15.50)
Player SenNoSen allin (40.25)
Player meandkids allin (24.19)
Uncalled bet (16.06) returned to SenNoSen
*** FLOP ***: [4h Jc 3s]
*** TURN ***: [4h Jc 3s] [10h]
*** RIVER ***: [4h Jc 3s 10h] [10c]
------ Summary ------
Pot: 88.38. Rake 2.76. JP fee 0.24
Board: [4h Jc 3s 10h 10c]
*Player SenNoSen shows: Two pairs. Qs and 10s [Qs Qh]. Bets: 34.69. Collects: 88.38. Wins: 53.69.
Player GreinSeint does not show cards.Bets: 0.50. Collects: 0. Loses: 0.50.
Player in_ur_i does not show cards.Bets: 1.50. Collects: 0. Loses: 1.50.
Player caballeroXXX does not show cards.Bets: 0. Collects: 0. Wins: 0.
Player meandkids shows: One pair of 10s [9d Ad]. Bets: 34.69. Collects: 0. Loses: 34.69.
Player IlxxxlI shows: One pair of 10s [Kd Ac]. Bets: 20. Collects: 0. Loses: 20.
Game ended at: 2016/11/28 20:33:54

Game started
Game ID: 786374986 0.25/0.50 (PRR) Gorgons - 5 (Hold'em)
Seat 2 is the button
Seat 1: caballeroXXX (71.56).
Seat 2: GreinSeint (19.25).
Seat 3: DonkReaper (71.87).
Seat 4: in_ur_i (44.46).
Seat 5: Cinch23 (7.83).
Seat 6: IlxxxlI (36.25).
Player DonkReaper has small blind (0.25)
Player in_ur_i has big blind (0.50)
Player IlxxxlI received card: [10s]
Player IlxxxlI received card: [10h]
Player Cinch23 folds
Player IlxxxlI raises (1.75)
Player caballeroXXX calls (1.75)
Player GreinSeint folds
Player DonkReaper folds
Player in_ur_i folds
*** FLOP ***: [9s Jc Kh]
Player IlxxxlI checks
Player caballeroXXX bets (2.50)
Player IlxxxlI is timed out.
Player IlxxxlI folds
Uncalled bet (2.50) returned to caballeroXXX
Player caballeroXXX mucks cards
------ Summary ------
Pot: 4.04. Rake 0.15. JP fee 0.06
Board: [9s Jc Kh]
*Player caballeroXXX mucks (does not show cards). Bets: 1.75. Collects: 4.04. Wins: 2.29.
Player GreinSeint does not show cards.Bets: 0. Collects: 0. Wins: 0.
Player DonkReaper does not show cards.Bets: 0.25. Collects: 0. Loses: 0.25.
Player in_ur_i does not show cards.Bets: 0.50. Collects: 0. Loses: 0.50.
Player Cinch23 does not show cards.Bets: 0. Collects: 0. Wins: 0.
Player IlxxxlI does not show cards.Bets: 1.75. Collects: 0. Loses: 1.75.
Game ended at: 2016/11/28 20:34:7

Game started
Game ID: 786374901 0.25/0.50 (PRR) Gorgons - 2 (Hold'em)
Seat 6 is the button
Seat 1: DonkReaper (59.33).
Seat 2: IlxxxlI (20).
Seat 3: SenNoSen (50.75).
Seat 4: Cinch23 (85.60).
Seat 5: in_ur_i (68.55).
Seat 6: caballeroXXX (69.61).
Player DonkReaper has small blind (0.25)
Player IlxxxlI has big blind (0.50)
Player IlxxxlI received card: [9h]
Player IlxxxlI received card: [10c]
Player SenNoSen folds
Player Cinch23 raises (1)
Player in_ur_i folds
Player caballeroXXX folds
Player DonkReaper folds
Player IlxxxlI folds
Uncalled bet (0.50) returned to Cinch23
Player Cinch23 mucks cards
------ Summary ------
Pot: 1.25. Rake 0
Player DonkReaper does not show cards.Bets: 0.25. Collects: 0. Loses: 0.25.
Player IlxxxlI does not show cards.Bets: 0.50. Collects: 0. Loses: 0.50.
Player SenNoSen does not show cards.Bets: 0. Collects: 0. Wins: 0.
*Player Cinch23 mucks (does not show cards). Bets: 0.50. Collects: 1.25. Wins: 0.75.
Player in_ur_i does not show cards.Bets: 0. Collects: 0. Wins: 0.
Player caballeroXXX does not show cards.Bets: 0. Collects: 0. Wins: 0.
Game ended at: 2016/11/28 20:33:11

Game started
Game ID: 786374836 0.25/0.50 (PRR) Gorgons - 5 (Hold'em)
Seat 1 is the button
Seat 1: caballeroXXX (71.56).
Seat 2: GreinSeint (19.50).
Seat 3: DonkReaper (71.62).
Seat 4: in_ur_i (44.46).
Seat 5: Cinch23 (7.83).
Seat 6: IlxxxlI (36.25).
Player GreinSeint has small blind (0.25)
Player DonkReaper has big blind (0.50)
Player IlxxxlI received card: [4h]
Player IlxxxlI received card: [6h]
Player in_ur_i folds
Player Cinch23 folds
Player IlxxxlI folds
Player caballeroXXX folds
Player GreinSeint folds
Uncalled bet (0.25) returned to DonkReaper
Player DonkReaper mucks cards
------ Summary ------
Pot: 0.50. Rake 0
Player caballeroXXX does not show cards.Bets: 0. Collects: 0. Wins: 0.
Player GreinSeint does not show cards.Bets: 0.25. Collects: 0. Loses: 0.25.
*Player DonkReaper mucks (does not show cards). Bets: 0.25. Collects: 0.50. Wins: 0.25.
Player in_ur_i does not show cards.Bets: 0. Collects: 0. Wins: 0.
Player Cinch23 does not show cards.Bets: 0. Collects: 0. Wins: 0.
Player IlxxxlI does not show cards.Bets: 0. Collects: 0. Wins: 0.
Game ended at: 2016/11/28 20:32:56

Game started
Game ID: 786374758 1/2 (PRR) Lakhey (Short) (Hold'em)
Seat 1 is the button
Seat 1: IlxxxlI (50.53).
Seat 2: gfclbv (80).
Seat 3: BBDub27 (141.50).
Seat 5: meandkids (105.44).
Seat 6: Are you with me (78.45).
Player gfclbv has small blind (1)
Player BBDub27 has big blind (2)
Player IlxxxlI received card: [Qd]
Player IlxxxlI received card: [10c]
Player meandkids folds
Player Are you with me folds
Player IlxxxlI raises (4)
Player gfclbv raises (9)
Player BBDub27 folds
Player IlxxxlI folds
Uncalled bet (6) returned to gfclbv
Player gfclbv mucks cards
------ Summary ------
Pot: 10. Rake 0
Player IlxxxlI does not show cards.Bets: 4. Collects: 0. Loses: 4.
*Player gfclbv mucks (does not show cards). Bets: 4. Collects: 10. Wins: 6.
Player BBDub27 does not show cards.Bets: 2. Collects: 0. Loses: 2.
Player meandkids does not show cards.Bets: 0. Collects: 0. Wins: 0.
Player Are you with me does not show cards.Bets: 0. Collects: 0. Wins: 0.
Game ended at: 2016/11/28 20:33:9

Game started
Game ID: 786374711 0.25/0.50 (PRR) Gorgons - 5 (Hold'em)
Seat 6 is the button
Seat 1: caballeroXXX (68.06).
Seat 2: GreinSeint (20).
Seat 3: DonkReaper (71.62).
Seat 4: in_ur_i (45.96).
Seat 5: Cinch23 (7.83).
Seat 6: IlxxxlI (37.75).
Player caballeroXXX has small blind (0.25)
Player GreinSeint has big blind (0.50)
Player IlxxxlI received card: [7h]
Player IlxxxlI received card: [7d]
Player DonkReaper folds
Player in_ur_i raises (1.50)
Player Cinch23 folds
Player IlxxxlI calls (1.50)
Player caballeroXXX raises (6.25)
Player GreinSeint folds
Player in_ur_i folds
Player IlxxxlI folds
Uncalled bet (5) returned to caballeroXXX
Player caballeroXXX mucks cards
------ Summary ------
Pot: 5. Rake 0
*Player caballeroXXX mucks (does not show cards). Bets: 1.50. Collects: 5. Wins: 3.50.
Player GreinSeint does not show cards.Bets: 0.50. Collects: 0. Loses: 0.50.
Player DonkReaper does not show cards.Bets: 0. Collects: 0. Wins: 0.
Player in_ur_i does not show cards.Bets: 1.50. Collects: 0. Loses: 1.50.
Player Cinch23 does not show cards.Bets: 0. Collects: 0. Wins: 0.
Player IlxxxlI does not show cards.Bets: 1.50. Collects: 0. Loses: 1.50.
Game ended at: 2016/11/28 20:32:5

Game started
Game ID: 786374685 0.25/0.50 (PRR) Gorgons (Hold'em)
Seat 5 is the button
Seat 1: SenNoSen (51.25).
Seat 3: in_ur_i (42.11).
Seat 4: caballeroXXX (104.93).
Seat 5: meandkids (34.69).
Seat 6: IlxxxlI (20.25).
Player IlxxxlI has small blind (0.25)
Player SenNoSen has big blind (0.50)
Player IlxxxlI received card: [Jc]
Player IlxxxlI received card: [10c]
Player in_ur_i folds
Player caballeroXXX raises (1.25)
Player meandkids folds
Player IlxxxlI raises (2.94)
Player SenNoSen folds
Player caballeroXXX calls (1.94)
*** FLOP ***: [5d 4s Ah]
Player IlxxxlI bets (3)
Player caballeroXXX calls (3)
*** TURN ***: [5d 4s Ah] [8d]
Player IlxxxlI checks
Player caballeroXXX checks
*** RIVER ***: [5d 4s Ah 8d] [Ac]
Player IlxxxlI checks
Player caballeroXXX checks
Player IlxxxlI mucks cards
------ Summary ------
Pot: 12.24. Rake 0.44. JP fee 0.20
Board: [5d 4s Ah 8d Ac]
Player SenNoSen does not show cards.Bets: 0.50. Collects: 0. Loses: 0.50.
Player in_ur_i does not show cards.Bets: 0. Collects: 0. Wins: 0.
*Player caballeroXXX shows: Two pairs. As and Qs [Qc Qd]. Bets: 6.19. Collects: 12.24. Wins: 6.05.
Player meandkids does not show cards.Bets: 0. Collects: 0. Wins: 0.
Player IlxxxlI mucks (does not show: [Jc 10c]). Bets: 6.19. Collects: 0. Loses: 6.19.
Game ended at: 2016/11/28 20:32:58

Game started
Game ID: 786374681 1/2 (PRR) Lakhey (Short) (Hold'em)
Seat 6 is the button
Seat 1: IlxxxlI (51.53).
Seat 2: gfclbv (80).
Seat 3: BBDub27 (138.50).
Seat 5: meandkids (105.44).
Seat 6: Are you with me (78.45).
Player IlxxxlI has small blind (1)
Player gfclbv has big blind (2)
Player IlxxxlI received card: [7s]
Player IlxxxlI received card: [Kd]
Player BBDub27 raises (7)
Player meandkids folds
Player Are you with me folds
Player IlxxxlI folds
Player gfclbv folds
Uncalled bet (5) returned to BBDub27
Player BBDub27 mucks cards
------ Summary ------
Pot: 5. Rake 0
Player IlxxxlI does not show cards.Bets: 1. Collects: 0. Loses: 1.
Player gfclbv does not show cards.Bets: 2. Collects: 0. Loses: 2.
*Player BBDub27 mucks (does not show cards). Bets: 2. Collects: 5. Wins: 3.
Player meandkids does not show cards.Bets: 0. Collects: 0. Wins: 0.
Player Are you with me does not show cards.Bets: 0. Collects: 0. Wins: 0.
Game ended at: 2016/11/28 20:31:42

Game started
Game ID: 786374648 0.25/0.50 (PRR) Gorgons (Hold'em)
Seat 4 is the button
Seat 1: SenNoSen (51.25).
Seat 3: in_ur_i (42.11).
Seat 4: caballeroXXX (104.93).
Seat 5: meandkids (34.94).
Seat 6: IlxxxlI (20).
Player meandkids has small blind (0.25)
Player IlxxxlI has big blind (0.50)
Player IlxxxlI received card: [Ah]
Player IlxxxlI received card: [Ad]
Player SenNoSen folds
Player in_ur_i folds
Player caballeroXXX folds
Player meandkids folds
Uncalled bet (0.25) returned to IlxxxlI
Player IlxxxlI mucks cards
------ Summary ------
Pot: 0.50. Rake 0
Player SenNoSen does not show cards.Bets: 0. Collects: 0. Wins: 0.
Player in_ur_i does not show cards.Bets: 0. Collects: 0. Wins: 0.
Player caballeroXXX does not show cards.Bets: 0. Collects: 0. Wins: 0.
Player meandkids does not show cards.Bets: 0.25. Collects: 0. Loses: 0.25.
*Player IlxxxlI mucks (does not show cards). Bets: 0.25. Collects: 0.50. Wins: 0.25.
Game ended at: 2016/11/28 20:31:13

Game started
Game ID: 786374637 1/2 (PRR) Lakhey (Short) (Hold'em)
Seat 5 is the button
Seat 1: IlxxxlI (50.53).
Seat 5: meandkids (105.44).
Seat 6: Are you with me (79.45).
Player Are you with me has small blind (1)
Player IlxxxlI has big blind (2)
Player IlxxxlI received card: [Ks]
Player IlxxxlI received card: [Kh]
Player meandkids folds
Player Are you with me folds
Uncalled bet (1) returned to IlxxxlI
Player IlxxxlI mucks cards
------ Summary ------
Pot: 2. Rake 0
*Player IlxxxlI mucks (does not show cards). Bets: 1. Collects: 2. Wins: 1.
Player meandkids does not show cards.Bets: 0. Collects: 0. Wins: 0.
Player Are you with me does not show cards.Bets: 1. Collects: 0. Loses: 1.
Game ended at: 2016/11/28 20:31:12

Game started
Game ID: 786374626 0.25/0.50 (PRR) Gorgons - 5 (Hold'em)
Seat 5 is the button
Seat 1: caballeroXXX (67.81).
Seat 3: DonkReaper (71.62).
Seat 4: in_ur_i (45.96).
Seat 5: Cinch23 (7.83).
Seat 6: IlxxxlI (38).
Player IlxxxlI has small blind (0.25)
Player caballeroXXX has big blind (0.50)
Player IlxxxlI received card: [4d]
Player IlxxxlI received card: [Kh]
Player DonkReaper folds
Player in_ur_i folds
Player Cinch23 folds
Player IlxxxlI folds
Uncalled bet (0.25) returned to caballeroXXX
Player caballeroXXX mucks cards
------ Summary ------
Pot: 0.50. Rake 0
*Player caballeroXXX mucks (does not show cards). Bets: 0.25. Collects: 0.50. Wins: 0.25.
Player DonkReaper does not show cards.Bets: 0. Collects: 0. Wins: 0.
Player in_ur_i does not show cards.Bets: 0. Collects: 0. Wins: 0.
Player Cinch23 does not show cards.Bets: 0. Collects: 0. Wins: 0.
Player IlxxxlI does not show cards.Bets: 0.25. Collects: 0. Loses: 0.25.
Game ended at: 2016/11/28 20:31:24

Game started
Game ID: 786374590 0.25/0.50 (PRR) Gorgons (Hold'em)
Seat 3 is the button
Seat 1: SenNoSen (50.50).
Seat 3: in_ur_i (42.11).
Seat 4: caballeroXXX (105.18).
Seat 5: meandkids (35.44).
Seat 6: IlxxxlI (20).
Player caballeroXXX has small blind (0.25)
Player meandkids has big blind (0.50)
Player IlxxxlI received card: [5s]
Player IlxxxlI received card: [3d]
Player IlxxxlI folds
Player SenNoSen raises (1)
Player in_ur_i folds
Player caballeroXXX folds
Player meandkids folds
Uncalled bet (0.50) returned to SenNoSen
Player SenNoSen mucks cards
------ Summary ------
Pot: 1.25. Rake 0
*Player SenNoSen mucks (does not show cards). Bets: 0.50. Collects: 1.25. Wins: 0.75.
Player in_ur_i does not show cards.Bets: 0. Collects: 0. Wins: 0.
Player caballeroXXX does not show cards.Bets: 0.25. Collects: 0. Loses: 0.25.
Player meandkids does not show cards.Bets: 0.50. Collects: 0. Loses: 0.50.
Player IlxxxlI does not show cards.Bets: 0. Collects: 0. Wins: 0.
Game ended at: 2016/11/28 20:31:2

Game started
Game ID: 786374529 1/2 (PRR) Lakhey (Short) (Hold'em)
Seat 3 is the button
Seat 1: IlxxxlI (50.53).
Seat 3: BBDub27 (138.50).
Seat 5: meandkids (106.44).
Seat 6: Are you with me (78.45).
Player meandkids has small blind (1)
Player Are you with me has big blind (2)
Player IlxxxlI received card: [Ks]
Player IlxxxlI received card: [5h]
Player IlxxxlI folds
Player BBDub27 is timed out.
Player BBDub27 folds
Player meandkids folds
Uncalled bet (1) returned to Are you with me
Player Are you with me mucks cards
------ Summary ------
Pot: 2. Rake 0
Player IlxxxlI does not show cards.Bets: 0. Collects: 0. Wins: 0.
Player BBDub27 does not show cards.Bets: 0. Collects: 0. Wins: 0.
Player meandkids does not show cards.Bets: 1. Collects: 0. Loses: 1.
*Player Are you with me mucks (does not show cards). Bets: 1. Collects: 2. Wins: 1.
Game ended at: 2016/11/28 20:30:58

Game started
Game ID: 786374418 0.25/0.50 (PRR) Gorgons - 5 (Hold'em)
Seat 4 is the button
Seat 1: caballeroXXX (67.81).
Seat 3: DonkReaper (71.62).
Seat 4: in_ur_i (45.96).
Seat 5: Cinch23 (27.83).
Seat 6: IlxxxlI (20).
Player Cinch23 has small blind (0.25)
Player IlxxxlI has big blind (0.50)
Player IlxxxlI received card: [8c]
Player IlxxxlI received card: [Qs]
Player caballeroXXX folds
Player DonkReaper folds
Player in_ur_i folds
Player Cinch23 raises (0.75)
Player IlxxxlI calls (0.50)
*** FLOP ***: [Qc 9d Qd]
Player Cinch23 bets (1)
Player IlxxxlI calls (1)
*** TURN ***: [Qc 9d Qd] [4d]
Player Cinch23 checks
Player IlxxxlI checks
*** RIVER ***: [Qc 9d Qd 4d] [Qh]
Player Cinch23 bets (2)
Player IlxxxlI allin (18)
Player Cinch23 calls (16)
------ Summary ------
Pot: 38. Rake 1.76. JP fee 0.24
Board: [Qc 9d Qd 4d Qh]
Player caballeroXXX does not show cards.Bets: 0. Collects: 0. Wins: 0.
Player DonkReaper does not show cards.Bets: 0. Collects: 0. Wins: 0.
Player in_ur_i does not show cards.Bets: 0. Collects: 0. Wins: 0.
Player Cinch23 shows: Full House (Q/9) [9c As]. Bets: 20. Collects: 0. Loses: 20.
*Player IlxxxlI shows: Four of kind of Qs [8c Qs]. Bets: 20. Collects: 38. Wins: 18.
Game ended at: 2016/11/28 20:30:53

Game started
Game ID: 786374408 1/2 (PRR) Lakhey (Short) (Hold'em)
Seat 1 is the button
Seat 1: IlxxxlI (50.53).
Seat 3: BBDub27 (139.50).
Seat 4: Wollverin (131.70).
Seat 5: meandkids (111.44).
Seat 6: Are you with me (73).
Player BBDub27 has small blind (1)
Player Wollverin sitting out
Player meandkids has big blind (2)
Player IlxxxlI received card: [7d]
Player IlxxxlI received card: [4h]
Player Are you with me raises (5)
Player IlxxxlI folds
Player BBDub27 folds
Player meandkids calls (3)
*** FLOP ***: [5h 9c As]
Player meandkids checks
Player Are you with me checks
*** TURN ***: [5h 9c As] [2d]
Player meandkids checks
Player Are you with me bets (3)
Player meandkids folds
Uncalled bet (3) returned to Are you with me
Player Are you with me mucks cards
------ Summary ------
Pot: 10.45. Rake 0.37. JP fee 0.18
Board: [5h 9c As 2d]
Player IlxxxlI does not show cards.Bets: 0. Collects: 0. Wins: 0.
Player BBDub27 does not show cards.Bets: 1. Collects: 0. Loses: 1.
Player Wollverin does not show cards.Bets: 0. Collects: 0. Wins: 0.
Player meandkids does not show cards.Bets: 5. Collects: 0. Loses: 5.
*Player Are you with me mucks (does not show cards). Bets: 5. Collects: 10.45. Wins: 5.45.
Game ended at: 2016/11/28 20:30:23

Game started
Game ID: 786374386 0.25/0.50 (PRR) Gorgons (Hold'em)
Seat 1 is the button
Seat 1: SenNoSen (50.50).
Seat 3: in_ur_i (45.56).
Seat 4: caballeroXXX (102.07).
Seat 5: meandkids (35.44).
Seat 6: IlxxxlI (20).
Player in_ur_i has small blind (0.25)
Player caballeroXXX has big blind (0.50)
Player IlxxxlI received card: [3d]
Player IlxxxlI received card: [7c]
Player meandkids folds
Player IlxxxlI folds
Player SenNoSen folds
Player in_ur_i calls (0.25)
Player caballeroXXX checks
*** FLOP ***: [Ac 6s 7d]
Player in_ur_i bets (0.50)
Player caballeroXXX calls (0.50)
*** TURN ***: [Ac 6s 7d] [6d]
Player in_ur_i checks
Player caballeroXXX bets (0.95)
Player in_ur_i calls (0.95)
*** RIVER ***: [Ac 6s 7d 6d] [2c]
Player in_ur_i checks
Player caballeroXXX bets (1.50)
Player in_ur_i calls (1.50)
Player in_ur_i mucks cards
------ Summary ------
Pot: 6.56. Rake 0.24. JP fee 0.10
Board: [Ac 6s 7d 6d 2c]
Player SenNoSen does not show cards.Bets: 0. Collects: 0. Wins: 0.
Player in_ur_i mucks (does not show cards). Bets: 3.45. Collects: 0. Loses: 3.45.
*Player caballeroXXX shows: Three Of Kind of 6s [Qd 6c]. Bets: 3.45. Collects: 6.56. Wins: 3.11.
Player meandkids does not show cards.Bets: 0. Collects: 0. Wins: 0.
Player IlxxxlI does not show cards.Bets: 0. Collects: 0. Wins: 0.
Game ended at: 2016/11/28 20:30:42

Game started
Game ID: 786374373 0.25/0.50 (PRR) Gorgons - 5 (Hold'em)
Seat 3 is the button
Seat 1: caballeroXXX (67.81).
Seat 3: DonkReaper (71.62).
Seat 4: in_ur_i (46.21).
Seat 5: Cinch23 (27.58).
Seat 6: IlxxxlI (20).
Player in_ur_i has small blind (0.25)
Player Cinch23 has big blind (0.50)
Player IlxxxlI received card: [Qh]
Player IlxxxlI received card: [5d]
Player IlxxxlI folds
Player caballeroXXX folds
Player DonkReaper folds
Player in_ur_i folds
Uncalled bet (0.25) returned to Cinch23
Player Cinch23 mucks cards
------ Summary ------
Pot: 0.50. Rake 0
Player caballeroXXX does not show cards.Bets: 0. Collects: 0. Wins: 0.
Player DonkReaper does not show cards.Bets: 0. Collects: 0. Wins: 0.
Player in_ur_i does not show cards.Bets: 0.25. Collects: 0. Loses: 0.25.
*Player Cinch23 mucks (does not show cards). Bets: 0.25. Collects: 0.50. Wins: 0.25.
Player IlxxxlI does not show cards.Bets: 0. Collects: 0. Wins: 0.
Game ended at: 2016/11/28 20:29:43

Game started
Game ID: 786374302 0.25/0.50 (PRR) Gorgons (Hold'em)
Seat 6 is the button
Seat 1: SenNoSen (50).
Seat 3: in_ur_i (46.06).
Seat 4: caballeroXXX (102.07).
Seat 5: meandkids (35.44).
Seat 6: IlxxxlI (20).
Player SenNoSen has small blind (0.25)
Player in_ur_i has big blind (0.50)
Player IlxxxlI received card: [5s]
Player IlxxxlI received card: [9s]
Player caballeroXXX folds
Player meandkids folds
Player IlxxxlI folds
Player SenNoSen raises (1.25)
Player in_ur_i folds
Uncalled bet (1) returned to SenNoSen
Player SenNoSen mucks cards
------ Summary ------
Pot: 1. Rake 0
*Player SenNoSen mucks (does not show cards). Bets: 0.50. Collects: 1. Wins: 0.50.
Player in_ur_i does not show cards.Bets: 0.50. Collects: 0. Loses: 0.50.
Player caballeroXXX does not show cards.Bets: 0. Collects: 0. Wins: 0.
Player meandkids does not show cards.Bets: 0. Collects: 0. Wins: 0.
Player IlxxxlI does not show cards.Bets: 0. Collects: 0. Wins: 0.
Game ended at: 2016/11/28 20:29:30

Game started
Game ID: 786374277 1/2 (PRR) Lakhey (Short) (Hold'em)
Seat 6 is the button
Seat 1: IlxxxlI (51.53).
Seat 3: BBDub27 (141.50).
Seat 4: Wollverin (131.70).
Seat 5: meandkids (111.44).
Seat 6: Are you with me (70).
Player IlxxxlI has small blind (1)
Player BBDub27 has big blind (2)
Player IlxxxlI received card: [4c]
Player IlxxxlI received card: [4h]
Player Wollverin folds
Player meandkids folds
Player Are you with me raises (6)
Player IlxxxlI folds
Player BBDub27 folds
Uncalled bet (4) returned to Are you with me
Player Are you with me mucks cards
------ Summary ------
Pot: 5. Rake 0
Player IlxxxlI does not show cards.Bets: 1. Collects: 0. Loses: 1.
Player BBDub27 does not show cards.Bets: 2. Collects: 0. Loses: 2.
Player Wollverin does not show cards.Bets: 0. Collects: 0. Wins: 0.
Player meandkids does not show cards.Bets: 0. Collects: 0. Wins: 0.
*Player Are you with me mucks (does not show cards). Bets: 2. Collects: 5. Wins: 3.
Game ended at: 2016/11/28 20:29:39

Game started
Game ID: 786374262 0.25/0.50 (PRR) Gorgons - 5 (Hold'em)
Seat 1 is the button
Seat 1: caballeroXXX (66.67).
Seat 3: DonkReaper (71.87).
Seat 4: in_ur_i (47.21).
Seat 5: Cinch23 (27.58).
Seat 6: IlxxxlI (20).
Player DonkReaper has small blind (0.25)
Player in_ur_i has big blind (0.50)
Player IlxxxlI received card: [3h]
Player IlxxxlI received card: [5s]
Player Cinch23 folds
Player IlxxxlI folds
Player caballeroXXX raises (1)
Player DonkReaper folds
Player in_ur_i calls (0.50)
*** FLOP ***: [7c 3d Js]
Player in_ur_i checks
Player caballeroXXX bets (1.50)
Player in_ur_i folds
Uncalled bet (1.50) returned to caballeroXXX
Player caballeroXXX mucks cards
------ Summary ------
Pot: 2.14. Rake 0.09. JP fee 0.02
Board: [7c 3d Js]
*Player caballeroXXX mucks (does not show cards). Bets: 1. Collects: 2.14. Wins: 1.14.
Player DonkReaper does not show cards.Bets: 0.25. Collects: 0. Loses: 0.25.
Player in_ur_i does not show cards.Bets: 1. Collects: 0. Loses: 1.
Player Cinch23 does not show cards.Bets: 0. Collects: 0. Wins: 0.
Player IlxxxlI does not show cards.Bets: 0. Collects: 0. Wins: 0.
Game ended at: 2016/11/28 20:29:29

Game started
Game ID: 786374145 1/2 (PRR) Lakhey (Short) (Hold'em)
Seat 5 is the button
Seat 1: IlxxxlI (53.53).
Seat 3: BBDub27 (141.50).
Seat 4: Wollverin (128.70).
Seat 5: meandkids (111.44).
Seat 6: Are you with me (70).
Player Are you with me has small blind (1)
Player IlxxxlI has big blind (2)
Player IlxxxlI received card: [7c]
Player IlxxxlI received card: [2s]
Player BBDub27 is timed out.
Player BBDub27 folds
Player Wollverin raises (4)
Player meandkids folds
Player Are you with me folds
Player IlxxxlI folds
Uncalled bet (2) returned to Wollverin
Player Wollverin mucks cards
------ Summary ------
Pot: 5. Rake 0
Player IlxxxlI does not show cards.Bets: 2. Collects: 0. Loses: 2.
Player BBDub27 does not show cards.Bets: 0. Collects: 0. Wins: 0.
*Player Wollverin mucks (does not show cards). Bets: 2. Collects: 5. Wins: 3.
Player meandkids does not show cards.Bets: 0. Collects: 0. Wins: 0.
Player Are you with me does not show cards.Bets: 1. Collects: 0. Loses: 1.
Game ended at: 2016/11/28 20:29:1

Game started
Game ID: 786374138 0.25/0.50 (PRR) Gorgons (Hold'em)
Seat 5 is the button
Seat 1: SenNoSen (50).
Seat 3: in_ur_i (46.06).
Seat 4: caballeroXXX (90.10).
Seat 5: meandkids (47.94).
Seat 6: IlxxxlI (20.25).
Player IlxxxlI has small blind (0.25)
Player SenNoSen has big blind (0.50)
Player IlxxxlI received card: [7s]
Player IlxxxlI received card: [7h]
Player in_ur_i folds
Player caballeroXXX raises (1.25)
Player meandkids raises (5)
Player IlxxxlI folds
Player SenNoSen folds
Player caballeroXXX raises (11.25)
Player meandkids calls (7.50)
*** FLOP ***: [8s Qc 5d]
Player caballeroXXX bets (16)
Player meandkids folds
Uncalled bet (16) returned to caballeroXXX
Player caballeroXXX mucks cards
------ Summary ------
Pot: 24.47. Rake 1.04. JP fee 0.24
Board: [8s Qc 5d]
Player SenNoSen does not show cards.Bets: 0.50. Collects: 0. Loses: 0.50.
Player in_ur_i does not show cards.Bets: 0. Collects: 0. Wins: 0.
*Player caballeroXXX mucks (does not show cards). Bets: 12.50. Collects: 24.47. Wins: 11.97.
Player meandkids does not show cards.Bets: 12.50. Collects: 0. Loses: 12.50.
Player IlxxxlI does not show cards.Bets: 0.25. Collects: 0. Loses: 0.25.
Game ended at: 2016/11/28 20:29:7

Game started
Game ID: 786374081 0.25/0.50 (PRR) Gorgons (Hold'em)
Seat 4 is the button
Seat 1: SenNoSen (50).
Seat 3: in_ur_i (46.06).
Seat 4: caballeroXXX (90.10).
Seat 5: meandkids (48.19).
Seat 6: IlxxxlI (20).
Player meandkids has small blind (0.25)
Player IlxxxlI has big blind (0.50)
Player IlxxxlI received card: [3h]
Player IlxxxlI received card: [4c]
Player SenNoSen folds
Player in_ur_i folds
Player caballeroXXX folds
Player meandkids folds
Uncalled bet (0.25) returned to IlxxxlI
Player IlxxxlI mucks cards
------ Summary ------
Pot: 0.50. Rake 0
Player SenNoSen does not show cards.Bets: 0. Collects: 0. Wins: 0.
Player in_ur_i does not show cards.Bets: 0. Collects: 0. Wins: 0.
Player caballeroXXX does not show cards.Bets: 0. Collects: 0. Wins: 0.
Player meandkids does not show cards.Bets: 0.25. Collects: 0. Loses: 0.25.
*Player IlxxxlI mucks (does not show cards). Bets: 0.25. Collects: 0.50. Wins: 0.25.
Game ended at: 2016/11/28 20:28:19

Game started
Game ID: 786373985 0.25/0.50 (PRR) Gorgons (Hold'em)
Seat 3 is the button
Seat 1: SenNoSen (50).
Seat 3: in_ur_i (45.31).
Seat 4: caballeroXXX (90.35).
Seat 5: meandkids (48.69).
Seat 6: IlxxxlI (20).
Player caballeroXXX has small blind (0.25)
Player meandkids has big blind (0.50)
Player IlxxxlI received card: [7s]
Player IlxxxlI received card: [4h]
Player IlxxxlI folds
Player SenNoSen folds
Player in_ur_i raises (1.50)
Player caballeroXXX folds
Player meandkids folds
Uncalled bet (1) returned to in_ur_i
Player in_ur_i mucks cards
------ Summary ------
Pot: 1.25. Rake 0
Player SenNoSen does not show cards.Bets: 0. Collects: 0. Wins: 0.
*Player in_ur_i mucks (does not show cards). Bets: 0.50. Collects: 1.25. Wins: 0.75.
Player caballeroXXX does not show cards.Bets: 0.25. Collects: 0. Loses: 0.25.
Player meandkids does not show cards.Bets: 0.50. Collects: 0. Loses: 0.50.
Player IlxxxlI does not show cards.Bets: 0. Collects: 0. Wins: 0.
Game ended at: 2016/11/28 20:28:0

Game started
Game ID: 786373930 0.25/0.50 (PRR) Gorgons - 5 (Hold'em)
Seat 6 is the button
Seat 1: caballeroXXX (66.92).
Seat 3: DonkReaper (72.87).
Seat 4: in_ur_i (47.21).
Seat 5: Cinch23 (20.96).
Seat 6: IlxxxlI (20).
Player caballeroXXX has small blind (0.25)
Player DonkReaper has big blind (0.50)
Player IlxxxlI received card: [Kd]
Player IlxxxlI received card: [10d]
Player in_ur_i folds
Player Cinch23 raises (1)
Player IlxxxlI calls (1)
Player caballeroXXX folds
Player DonkReaper calls (0.50)
*** FLOP ***: [Ac 4s Ah]
Player DonkReaper checks
Player Cinch23 checks
Player IlxxxlI bets (1.03)
Player DonkReaper folds
Player Cinch23 calls (1.03)
*** TURN ***: [Ac 4s Ah] [3s]
Player Cinch23 checks
Player IlxxxlI checks
*** RIVER ***: [Ac 4s Ah 3s] [Kc]
Player Cinch23 bets (4)
Player IlxxxlI calls (4)
Player IlxxxlI mucks cards
------ Summary ------
Pot: 12.65. Rake 0.44. JP fee 0.22
Board: [Ac 4s Ah 3s Kc]
Player caballeroXXX does not show cards.Bets: 0.25. Collects: 0. Loses: 0.25.
Player DonkReaper does not show cards.Bets: 1. Collects: 0. Loses: 1.
Player in_ur_i does not show cards.Bets: 0. Collects: 0. Wins: 0.
*Player Cinch23 shows: Three Of Kind of As [Ad 10h]. Bets: 6.03. Collects: 12.65. Wins: 6.62.
Player IlxxxlI mucks (does not show: [Kd 10d]). Bets: 6.03. Collects: 0. Loses: 6.03.
Game ended at: 2016/11/28 20:28:55

Game started
Game ID: 786373915 0.25/0.50 (PRR) Gorgons (Hold'em)
Seat 1 is the button
Seat 1: SenNoSen (50).
Seat 3: in_ur_i (45.56).
Seat 4: caballeroXXX (90.10).
Seat 5: meandkids (48.69).
Seat 6: IlxxxlI (20).
Player in_ur_i has small blind (0.25)
Player caballeroXXX has big blind (0.50)
Player IlxxxlI received card: [3c]
Player IlxxxlI received card: [Ad]
Player meandkids folds
Player IlxxxlI folds
Player SenNoSen folds
Player in_ur_i folds
Uncalled bet (0.25) returned to caballeroXXX
Player caballeroXXX mucks cards
------ Summary ------
Pot: 0.50. Rake 0
Player SenNoSen does not show cards.Bets: 0. Collects: 0. Wins: 0.
Player in_ur_i does not show cards.Bets: 0.25. Collects: 0. Loses: 0.25.
*Player caballeroXXX mucks (does not show cards). Bets: 0.25. Collects: 0.50. Wins: 0.25.
Player meandkids does not show cards.Bets: 0. Collects: 0. Wins: 0.
Player IlxxxlI does not show cards.Bets: 0. Collects: 0. Wins: 0.
Game ended at: 2016/11/28 20:27:33

Game started
Game ID: 786373841 0.25/0.50 (PRR) Gorgons - 5 (Hold'em)
Seat 5 is the button
Seat 1: caballeroXXX (67.42).
Seat 3: DonkReaper (72.87).
Seat 4: in_ur_i (46.46).
Seat 5: Cinch23 (20.96).
Seat 6: IlxxxlI (20).
Player IlxxxlI has small blind (0.25)
Player caballeroXXX has big blind (0.50)
Player IlxxxlI received card: [3d]
Player IlxxxlI received card: [10s]
Player DonkReaper folds
Player in_ur_i raises (1.50)
Player Cinch23 folds
Player IlxxxlI folds
Player caballeroXXX folds
Uncalled bet (1) returned to in_ur_i
Player in_ur_i mucks cards
------ Summary ------
Pot: 1.25. Rake 0
Player caballeroXXX does not show cards.Bets: 0.50. Collects: 0. Loses: 0.50.
Player DonkReaper does not show cards.Bets: 0. Collects: 0. Wins: 0.
*Player in_ur_i mucks (does not show cards). Bets: 0.50. Collects: 1.25. Wins: 0.75.
Player Cinch23 does not show cards.Bets: 0. Collects: 0. Wins: 0.
Player IlxxxlI does not show cards.Bets: 0.25. Collects: 0. Loses: 0.25.
Game ended at: 2016/11/28 20:27:13

Game started
Game ID: 786373822 0.25/0.50 (PRR) Gorgons (Hold'em)
Seat 6 is the button
Seat 1: SenNoSen (50).
Seat 3: in_ur_i (45.31).
Seat 4: caballeroXXX (90.10).
Seat 5: meandkids (48.69).
Seat 6: IlxxxlI (20).
Player SenNoSen has small blind (0.25)
Player in_ur_i has big blind (0.50)
Player IlxxxlI received card: [7s]
Player IlxxxlI received card: [9h]
Player caballeroXXX folds
Player meandkids folds
Player IlxxxlI folds
Player SenNoSen folds
Uncalled bet (0.25) returned to in_ur_i
Player in_ur_i mucks cards
------ Summary ------
Pot: 0.50. Rake 0
Player SenNoSen does not show cards.Bets: 0.25. Collects: 0. Loses: 0.25.
*Player in_ur_i mucks (does not show cards). Bets: 0.25. Collects: 0.50. Wins: 0.25.
Player caballeroXXX does not show cards.Bets: 0. Collects: 0. Wins: 0.
Player meandkids does not show cards.Bets: 0. Collects: 0. Wins: 0.
Player IlxxxlI does not show cards.Bets: 0. Collects: 0. Wins: 0.
Game ended at: 2016/11/28 20:27:8

Game started
Game ID: 786373762 1/2 (PRR) Lakhey (Short) (Hold'em)
Seat 4 is the button
Seat 1: IlxxxlI (53.53).
Seat 3: BBDub27 (138.75).
Seat 4: Wollverin (128.70).
Seat 5: meandkids (112.44).
Seat 6: Are you with me (70).
Player meandkids has small blind (1)
Player Are you with me has big blind (2)
Player IlxxxlI received card: [8d]
Player IlxxxlI received card: [6d]
Player IlxxxlI folds
Player BBDub27 calls (2)
Player Wollverin folds
Player meandkids folds
Player Are you with me checks
*** FLOP ***: [5d Qc 9c]
Player Are you with me checks
Player BBDub27 is timed out.
Player BBDub27 checks
*** TURN ***: [5d Qc 9c] [7c]
Player Are you with me checks
Player BBDub27 allin (136.75)
Player Are you with me folds
Uncalled bet (136.75) returned to BBDub27
Player BBDub27 mucks cards
------ Summary ------
Pot: 4.75. Rake 0.17. JP fee 0.08
Board: [5d Qc 9c 7c]
Player IlxxxlI does not show cards.Bets: 0. Collects: 0. Wins: 0.
*Player BBDub27 mucks (does not show cards). Bets: 2. Collects: 4.75. Wins: 2.75.
Player Wollverin does not show cards.Bets: 0. Collects: 0. Wins: 0.
Player meandkids does not show cards.Bets: 1. Collects: 0. Loses: 1.
Player Are you with me does not show cards.Bets: 2. Collects: 0. Loses: 2.
Game ended at: 2016/11/28 20:28:21

Game started
Game ID: 786373721 0.25/0.50 (PRR) Gorgons (Hold'em)
Seat 5 is the button
Seat 1: SenNoSen (50).
Seat 3: in_ur_i (45.31).
Seat 4: caballeroXXX (90.10).
Seat 5: meandkids (47.94).
Seat 6: IlxxxlI (20).
Player IlxxxlI has small blind (0.25)
Player SenNoSen has big blind (0.50)
Player IlxxxlI received card: [9d]
Player IlxxxlI received card: [Jc]
Player in_ur_i folds
Player caballeroXXX folds
Player meandkids raises (3)
Player IlxxxlI folds
Player SenNoSen folds
Uncalled bet (2.50) returned to meandkids
Player meandkids mucks cards
------ Summary ------
Pot: 1.25. Rake 0
Player SenNoSen does not show cards.Bets: 0.50. Collects: 0. Loses: 0.50.
Player in_ur_i does not show cards.Bets: 0. Collects: 0. Wins: 0.
Player caballeroXXX does not show cards.Bets: 0. Collects: 0. Wins: 0.
*Player meandkids mucks (does not show cards). Bets: 0.50. Collects: 1.25. Wins: 0.75.
Player IlxxxlI does not show cards.Bets: 0.25. Collects: 0. Loses: 0.25.
Game ended at: 2016/11/28 20:26:41

Game started
Game ID: 786373673 1/2 (PRR) Lakhey (Short) (Hold'em)
Seat 3 is the button
Seat 1: IlxxxlI (53.53).
Seat 3: BBDub27 (130.75).
Seat 4: Wollverin (129.70).
Seat 5: meandkids (114.44).
Seat 6: Are you with me (70).
Player Wollverin has small blind (1)
Player meandkids has big blind (2)
Player IlxxxlI received card: [Qd]
Player IlxxxlI received card: [10s]
Player Are you with me raises (5)
Player IlxxxlI folds
Player BBDub27 allin (130.75)
Player Wollverin folds
Player meandkids folds
Player Are you with me folds
Uncalled bet (125.75) returned to BBDub27
Player BBDub27 mucks cards
------ Summary ------
Pot: 13. Rake 0
Player IlxxxlI does not show cards.Bets: 0. Collects: 0. Wins: 0.
*Player BBDub27 mucks (does not show cards). Bets: 5. Collects: 13. Wins: 8.
Player Wollverin does not show cards.Bets: 1. Collects: 0. Loses: 1.
Player meandkids does not show cards.Bets: 2. Collects: 0. Loses: 2.
Player Are you with me does not show cards.Bets: 5. Collects: 0. Loses: 5.
Game ended at: 2016/11/28 20:26:26

Game started
Game ID: 786373655 0.25/0.50 (PRR) Gorgons - 5 (Hold'em)
Seat 4 is the button
Seat 1: caballeroXXX (67.42).
Seat 3: DonkReaper (72.87).
Seat 4: in_ur_i (46.46).
Seat 5: Cinch23 (20.06).
Seat 6: IlxxxlI (20).
Player Cinch23 has small blind (0.25)
Player IlxxxlI has big blind (0.50)
Player IlxxxlI received card: [2s]
Player IlxxxlI received card: [2d]
Player caballeroXXX folds
Player DonkReaper folds
Player in_ur_i folds
Player Cinch23 raises (0.75)
Player IlxxxlI calls (0.50)
*** FLOP ***: [8s 7d Qc]
Player Cinch23 bets (1)
Player IlxxxlI folds
Uncalled bet (1) returned to Cinch23
Player Cinch23 mucks cards
------ Summary ------
Pot: 1.90. Rake 0.08. JP fee 0.02
Board: [8s 7d Qc]
Player caballeroXXX does not show cards.Bets: 0. Collects: 0. Wins: 0.
Player DonkReaper does not show cards.Bets: 0. Collects: 0. Wins: 0.
Player in_ur_i does not show cards.Bets: 0. Collects: 0. Wins: 0.
*Player Cinch23 mucks (does not show cards). Bets: 1. Collects: 1.90. Wins: 0.90.
Player IlxxxlI does not show cards.Bets: 1. Collects: 0. Loses: 1.
Game ended at: 2016/11/28 20:26:48

Game started
Game ID: 786373649 0.25/0.50 (PRR) Gorgons (Hold'em)
Seat 4 is the button
Seat 1: SenNoSen (50).
Seat 3: in_ur_i (44.56).
Seat 4: caballeroXXX (90.10).
Seat 5: meandkids (48.19).
Seat 6: IlxxxlI (20).
Player meandkids has small blind (0.25)
Player IlxxxlI has big blind (0.50)
Player IlxxxlI received card: [10s]
Player IlxxxlI received card: [8d]
Player SenNoSen folds
Player in_ur_i raises (1.50)
Player caballeroXXX folds
Player meandkids folds
Player IlxxxlI folds
Uncalled bet (1) returned to in_ur_i
Player in_ur_i mucks cards
------ Summary ------
Pot: 1.25. Rake 0
Player SenNoSen does not show cards.Bets: 0. Collects: 0. Wins: 0.
*Player in_ur_i mucks (does not show cards). Bets: 0.50. Collects: 1.25. Wins: 0.75.
Player caballeroXXX does not show cards.Bets: 0. Collects: 0. Wins: 0.
Player meandkids does not show cards.Bets: 0.25. Collects: 0. Loses: 0.25.
Player IlxxxlI does not show cards.Bets: 0.50. Collects: 0. Loses: 0.50.
Game ended at: 2016/11/28 20:26:14

Game started
Game ID: 786373593 1/2 (PRR) Lakhey (Short) (Hold'em)
Seat 1 is the button
Seat 1: IlxxxlI (53.53).
Seat 3: BBDub27 (128.75).
Seat 4: Wollverin (131.70).
Seat 5: meandkids (114.44).
Seat 6: Are you with me (70).
Player BBDub27 has small blind (1)
Player Wollverin has big blind (2)
Player IlxxxlI received card: [7h]
Player IlxxxlI received card: [9s]
Player meandkids folds
Player Are you with me folds
Player IlxxxlI folds
Player BBDub27 allin (127.75)
Player Wollverin folds
Uncalled bet (126.75) returned to BBDub27
Player BBDub27 mucks cards
------ Summary ------
Pot: 4. Rake 0
Player IlxxxlI does not show cards.Bets: 0. Collects: 0. Wins: 0.
*Player BBDub27 mucks (does not show cards). Bets: 2. Collects: 4. Wins: 2.
Player Wollverin does not show cards.Bets: 2. Collects: 0. Loses: 2.
Player meandkids does not show cards.Bets: 0. Collects: 0. Wins: 0.
Player Are you with me does not show cards.Bets: 0. Collects: 0. Wins: 0.
Game ended at: 2016/11/28 20:25:59

Game started
Game ID: 786373582 0.25/0.50 (PRR) Gorgons - 5 (Hold'em)
Seat 3 is the button
Seat 1: caballeroXXX (67.42).
Seat 3: DonkReaper (72.87).
Seat 4: in_ur_i (46.71).
Seat 5: Cinch23 (19.81).
Seat 6: IlxxxlI (20).
Player in_ur_i has small blind (0.25)
Player Cinch23 has big blind (0.50)
Player IlxxxlI received card: [6c]
Player IlxxxlI received card: [8s]
Player IlxxxlI folds
Player caballeroXXX folds
Player DonkReaper folds
Player in_ur_i folds
Uncalled bet (0.25) returned to Cinch23
Player Cinch23 mucks cards
------ Summary ------
Pot: 0.50. Rake 0
Player caballeroXXX does not show cards.Bets: 0. Collects: 0. Wins: 0.
Player DonkReaper does not show cards.Bets: 0. Collects: 0. Wins: 0.
Player in_ur_i does not show cards.Bets: 0.25. Collects: 0. Loses: 0.25.
*Player Cinch23 mucks (does not show cards). Bets: 0.25. Collects: 0.50. Wins: 0.25.
Player IlxxxlI does not show cards.Bets: 0. Collects: 0. Wins: 0.
Game ended at: 2016/11/28 20:25:51

Game started
Game ID: 786373525 0.25/0.50 (PRR) Gorgons - 5 (Hold'em)
Seat 1 is the button
Seat 1: caballeroXXX (67.42).
Seat 3: DonkReaper (73.12).
Seat 4: in_ur_i (46.46).
Seat 6: IlxxxlI (20).
Player DonkReaper has small blind (0.25)
Player in_ur_i has big blind (0.50)
Player IlxxxlI received card: [3s]
Player IlxxxlI received card: [Kh]
Player IlxxxlI folds
Player caballeroXXX folds
Player DonkReaper folds
Uncalled bet (0.25) returned to in_ur_i
Player in_ur_i mucks cards
------ Summary ------
Pot: 0.50. Rake 0
Player caballeroXXX does not show cards.Bets: 0. Collects: 0. Wins: 0.
Player DonkReaper does not show cards.Bets: 0.25. Collects: 0. Loses: 0.25.
*Player in_ur_i mucks (does not show cards). Bets: 0.25. Collects: 0.50. Wins: 0.25.
Player IlxxxlI does not show cards.Bets: 0. Collects: 0. Wins: 0.
Game ended at: 2016/11/28 20:25:31

Game started
Game ID: 786373459 1/2 (PRR) Lakhey (Short) (Hold'em)
Seat 6 is the button
Seat 1: IlxxxlI (54.53).
Seat 3: BBDub27 (118.80).
Seat 4: Wollverin (131.70).
Seat 5: meandkids (124.44).
Seat 6: Are you with me (70).
Player IlxxxlI has small blind (1)
Player BBDub27 has big blind (2)
Player IlxxxlI received card: [4d]
Player IlxxxlI received card: [Qs]
Player Wollverin folds
Player meandkids raises (10)
Player Are you with me folds
Player IlxxxlI folds
Player BBDub27 calls (8)
*** FLOP ***: [7c 4s Jc]
Player BBDub27 allin (108.80)
Player meandkids folds
Uncalled bet (108.80) returned to BBDub27
Player BBDub27 mucks cards
------ Summary ------
Pot: 19.95. Rake 0.81. JP fee 0.24
Board: [7c 4s Jc]
Player IlxxxlI does not show cards.Bets: 1. Collects: 0. Loses: 1.
*Player BBDub27 mucks (does not show cards). Bets: 10. Collects: 19.95. Wins: 9.95.
Player Wollverin does not show cards.Bets: 0. Collects: 0. Wins: 0.
Player meandkids does not show cards.Bets: 10. Collects: 0. Loses: 10.
Player Are you with me does not show cards.Bets: 0. Collects: 0. Wins: 0.
Game ended at: 2016/11/28 20:25:34

Game started
Game ID: 786373410 0.25/0.50 (PRR) Gorgons - 5 (Hold'em)
Seat 6 is the button
Seat 1: caballeroXXX (67.67).
Seat 3: DonkReaper (73.62).
Seat 4: in_ur_i (45.71).
Seat 5: Cinch23 (19.81).
Seat 6: IlxxxlI (20).
Player caballeroXXX has small blind (0.25)
Player DonkReaper has big blind (0.50)
Player IlxxxlI received card: [6d]
Player IlxxxlI received card: [9d]
Player in_ur_i raises (1.50)
Player Cinch23 is timed out.
Player Cinch23 folds
Player IlxxxlI folds
Player caballeroXXX folds
Player DonkReaper folds
Uncalled bet (1) returned to in_ur_i
Player in_ur_i mucks cards
------ Summary ------
Pot: 1.25. Rake 0
Player caballeroXXX does not show cards.Bets: 0.25. Collects: 0. Loses: 0.25.
Player DonkReaper does not show cards.Bets: 0.50. Collects: 0. Loses: 0.50.
*Player in_ur_i mucks (does not show cards). Bets: 0.50. Collects: 1.25. Wins: 0.75.
Player Cinch23 does not show cards.Bets: 0. Collects: 0. Wins: 0.
Player IlxxxlI does not show cards.Bets: 0. Collects: 0. Wins: 0.
Game ended at: 2016/11/28 20:25:13

Game started
Game ID: 786373227 1/2 (PRR) Lakhey (Short) (Hold'em)
Seat 5 is the button
Seat 1: IlxxxlI (45).
Seat 4: Wollverin (131.70).
Seat 5: meandkids (124.44).
Seat 6: Are you with me (70).
Player Are you with me has small blind (1)
Player IlxxxlI has big blind (2)
Player IlxxxlI received card: [Kh]
Player IlxxxlI received card: [8c]
Player Wollverin folds
Player meandkids folds
Player Are you with me raises (3.40)
Player IlxxxlI calls (2.40)
*** FLOP ***: [8h 3c Ah]
Player Are you with me bets (4.18)
Player IlxxxlI calls (4.18)
*** TURN ***: [8h 3c Ah] [9d]
Player Are you with me bets (2)
Player IlxxxlI calls (2)
*** RIVER ***: [8h 3c Ah 9d] [Kd]
Player Are you with me checks
Player IlxxxlI bets (22)
Player Are you with me folds
Uncalled bet (22) returned to IlxxxlI
Player IlxxxlI mucks cards
------ Summary ------
Pot: 20.11. Rake 0.81. JP fee 0.24
Board: [8h 3c Ah 9d Kd]
*Player IlxxxlI mucks (does not show cards). Bets: 10.58. Collects: 20.11. Wins: 9.53.
Player Wollverin does not show cards.Bets: 0. Collects: 0. Wins: 0.
Player meandkids does not show cards.Bets: 0. Collects: 0. Wins: 0.
Player Are you with me does not show cards.Bets: 10.58. Collects: 0. Loses: 10.58.
Game ended at: 2016/11/28 20:24:55

Game started
Game ID: 786373225 0.25/0.50 (PRR) Gorgons - 5 (Hold'em)
Seat 5 is the button
Seat 1: caballeroXXX (64.69).
Seat 3: DonkReaper (73.62).
Seat 4: in_ur_i (48.75).
Seat 5: Cinch23 (19.81).
Seat 6: IlxxxlI (20).
Player IlxxxlI has small blind (0.25)
Player caballeroXXX has big blind (0.50)
Player IlxxxlI received card: [10d]
Player IlxxxlI received card: [Ks]
Player DonkReaper folds
Player in_ur_i raises (1.50)
Player Cinch23 folds
Player IlxxxlI folds
Player caballeroXXX calls (1)
*** FLOP ***: [Qh 4d 9h]
Player caballeroXXX checks
Player in_ur_i bets (1.54)
Player caballeroXXX raises (6.16)
Player in_ur_i folds
Uncalled bet (4.62) returned to caballeroXXX
Player caballeroXXX mucks cards
------ Summary ------
Pot: 6.02. Rake 0.21. JP fee 0.10
Board: [Qh 4d 9h]
*Player caballeroXXX mucks (does not show cards). Bets: 3.04. Collects: 6.02. Wins: 2.98.
Player DonkReaper does not show cards.Bets: 0. Collects: 0. Wins: 0.
Player in_ur_i does not show cards.Bets: 3.04. Collects: 0. Loses: 3.04.
Player Cinch23 does not show cards.Bets: 0. Collects: 0. Wins: 0.
Player IlxxxlI does not show cards.Bets: 0.25. Collects: 0. Loses: 0.25.
Game ended at: 2016/11/28 20:24:35

Game started
Game ID: 786373141 1/2 (PRR) Lakhey (Short) (Hold'em)
Seat 4 is the button
Seat 1: IlxxxlI (45).
Seat 3: BBDub27 (118.80).
Seat 4: Wollverin (128.70).
Seat 5: meandkids (125.44).
Seat 6: Are you with me (70).
Player meandkids has small blind (1)
Player Are you with me has big blind (2)
Player BBDub27 is timed out.
Player BBDub27 wait BB
Player IlxxxlI received card: [2s]
Player IlxxxlI received card: [8c]
Player IlxxxlI folds
Player Wollverin raises (4)
Player meandkids folds
Player Are you with me folds
Uncalled bet (2) returned to Wollverin
Player Wollverin mucks cards
------ Summary ------
Pot: 5. Rake 0
Player IlxxxlI does not show cards.Bets: 0. Collects: 0. Wins: 0.
Player BBDub27 does not show cards.Bets: 0. Collects: 0. Wins: 0.
*Player Wollverin mucks (does not show cards). Bets: 2. Collects: 5. Wins: 3.
Player meandkids does not show cards.Bets: 1. Collects: 0. Loses: 1.
Player Are you with me does not show cards.Bets: 2. Collects: 0. Loses: 2.
Game ended at: 2016/11/28 20:23:37

Game started
Game ID: 786373062 0.25/0.50 (PRR) Gorgons - 5 (Hold'em)
Seat 4 is the button
Seat 1: caballeroXXX (59.26).
Seat 2: 38979 (57.09).
Seat 3: DonkReaper (73.62).
Seat 4: in_ur_i (48.75).
Seat 5: Cinch23 (25.31).
Seat 6: IlxxxlI (20).
Player Cinch23 has small blind (0.25)
Player IlxxxlI has big blind (0.50)
Player IlxxxlI received card: [7c]
Player IlxxxlI received card: [Ks]
Player caballeroXXX raises (1.50)
Player 38979 folds
Player DonkReaper folds
Player in_ur_i folds
Player Cinch23 raises (2.25)
Player IlxxxlI folds
Player caballeroXXX calls (1)
*** FLOP ***: [2h 3c 10d]
Player Cinch23 bets (3)
Player caballeroXXX calls (3)
*** TURN ***: [2h 3c 10d] [8s]
Player Cinch23 checks
Player caballeroXXX checks
*** RIVER ***: [2h 3c 10d 8s] [4s]
Player Cinch23 checks
Player caballeroXXX checks
Player Cinch23 mucks cards
------ Summary ------
Pot: 10.93. Rake 0.39. JP fee 0.18
Board: [2h 3c 10d 8s 4s]
*Player caballeroXXX shows: High card A [Ad Qd]. Bets: 5.50. Collects: 10.93. Wins: 5.43.
Player 38979 does not show cards.Bets: 0. Collects: 0. Wins: 0.
Player DonkReaper does not show cards.Bets: 0. Collects: 0. Wins: 0.
Player in_ur_i does not show cards.Bets: 0. Collects: 0. Wins: 0.
Player Cinch23 mucks (does not show cards). Bets: 5.50. Collects: 0. Loses: 5.50.
Player IlxxxlI does not show cards.Bets: 0.50. Collects: 0. Loses: 0.50.
Game ended at: 2016/11/28 20:23:34

Game started
Game ID: 786372883 1/2 (PRR) Lakhey (Short) (Hold'em)
Seat 1 is the button
Seat 1: IlxxxlI (45).
Seat 4: Wollverin (145.70).
Seat 5: meandkids (110.14).
Seat 6: Are you with me (70).
Player Wollverin has small blind (1)
Player meandkids has big blind (2)
Player IlxxxlI received card: [7h]
Player IlxxxlI received card: [6d]
Player Are you with me folds
Player IlxxxlI folds
Player Wollverin raises (3.50)
Player meandkids raises (15)
Player Wollverin calls (12.50)
*** FLOP ***: [7d 2c 10d]
Player Wollverin checks
Player meandkids bets (21.53)
Player Wollverin folds
Uncalled bet (21.53) returned to meandkids
Player meandkids mucks cards
------ Summary ------
Pot: 32.30. Rake 1.46. JP fee 0.24
Board: [7d 2c 10d]
Player IlxxxlI does not show cards.Bets: 0. Collects: 0. Wins: 0.
Player Wollverin does not show cards.Bets: 17. Collects: 0. Loses: 17.
*Player meandkids mucks (does not show cards). Bets: 17. Collects: 32.30. Wins: 15.30.
Player Are you with me does not show cards.Bets: 0. Collects: 0. Wins: 0.
Game ended at: 2016/11/28 20:23:10

Game started
Game ID: 786372837 0.25/0.50 (PRR) Gorgons - 5 (Hold'em)
Seat 3 is the button
Seat 1: caballeroXXX (59.26).
Seat 2: 38979 (57.09).
Seat 3: DonkReaper (70.84).
Seat 4: in_ur_i (50.25).
Seat 5: Cinch23 (26.81).
Seat 6: IlxxxlI (20).
Player in_ur_i has small blind (0.25)
Player Cinch23 has big blind (0.50)
Player IlxxxlI received card: [Qs]
Player IlxxxlI received card: [Jd]
Player IlxxxlI folds
Player caballeroXXX folds
Player 38979 folds
Player DonkReaper raises (1.50)
Player in_ur_i calls (1.25)
Player Cinch23 calls (1)
*** FLOP ***: [Kh 10c 8c]
Player in_ur_i checks
Player Cinch23 checks
Player DonkReaper bets (2.85)
Player in_ur_i folds
Player Cinch23 folds
Uncalled bet (2.85) returned to DonkReaper
Player DonkReaper mucks cards
------ Summary ------
Pot: 4.28. Rake 0.16. JP fee 0.06
Board: [Kh 10c 8c]
Player caballeroXXX does not show cards.Bets: 0. Collects: 0. Wins: 0.
Player 38979 does not show cards.Bets: 0. Collects: 0. Wins: 0.
*Player DonkReaper mucks (does not show cards). Bets: 1.50. Collects: 4.28. Wins: 2.78.
Player in_ur_i does not show cards.Bets: 1.50. Collects: 0. Loses: 1.50.
Player Cinch23 does not show cards.Bets: 1.50. Collects: 0. Loses: 1.50.
Player IlxxxlI does not show cards.Bets: 0. Collects: 0. Wins: 0.
Game ended at: 2016/11/28 20:22:43

Game started
Game ID: 786372776 0.25/0.50 (PRR) Gorgons - 5 (Hold'em)
Seat 2 is the button
Seat 1: caballeroXXX (59.26).
Seat 2: 38979 (57.09).
Seat 3: DonkReaper (71.09).
Seat 4: in_ur_i (50).
Seat 5: Cinch23 (26.81).
Seat 6: IlxxxlI (20).
Player DonkReaper has small blind (0.25)
Player in_ur_i has big blind (0.50)
Player IlxxxlI received card: [Qs]
Player IlxxxlI received card: [Js]
Player Cinch23 folds
Player IlxxxlI folds
Player caballeroXXX folds
Player 38979 folds
Player DonkReaper folds
Uncalled bet (0.25) returned to in_ur_i
Player in_ur_i mucks cards
------ Summary ------
Pot: 0.50. Rake 0
Player caballeroXXX does not show cards.Bets: 0. Collects: 0. Wins: 0.
Player 38979 does not show cards.Bets: 0. Collects: 0. Wins: 0.
Player DonkReaper does not show cards.Bets: 0.25. Collects: 0. Loses: 0.25.
*Player in_ur_i mucks (does not show cards). Bets: 0.25. Collects: 0.50. Wins: 0.25.
Player Cinch23 does not show cards.Bets: 0. Collects: 0. Wins: 0.
Player IlxxxlI does not show cards.Bets: 0. Collects: 0. Wins: 0.
Game ended at: 2016/11/28 20:21:37

Game started
Game ID: 786372752 1/2 (PRR) Lakhey (Short) (Hold'em)
Seat 6 is the button
Seat 1: IlxxxlI (46).
Seat 3: BBDub27 (120.80).
Seat 4: Wollverin (142.70).
Seat 5: meandkids (110.14).
Seat 6: Are you with me (70).
Player IlxxxlI has small blind (1)
Player BBDub27 has big blind (2)
Player IlxxxlI received card: [Ac]
Player IlxxxlI received card: [2c]
Player Wollverin raises (5)
Player meandkids folds
Player Are you with me folds
Player IlxxxlI folds
Player BBDub27 is timed out.
Player BBDub27 folds
Uncalled bet (3) returned to Wollverin
Player Wollverin mucks cards
------ Summary ------
Pot: 5. Rake 0
Player IlxxxlI does not show cards.Bets: 1. Collects: 0. Loses: 1.
Player BBDub27 does not show cards.Bets: 2. Collects: 0. Loses: 2.
*Player Wollverin mucks (does not show cards). Bets: 2. Collects: 5. Wins: 3.
Player meandkids does not show cards.Bets: 0. Collects: 0. Wins: 0.
Player Are you with me does not show cards.Bets: 0. Collects: 0. Wins: 0.
Game ended at: 2016/11/28 20:21:52

Game started
Game ID: 786372687 1/2 (PRR) Lakhey (Short) (Hold'em)
Seat 5 is the button
Seat 1: IlxxxlI (45).
Seat 2: 38979 (218.52).
Seat 3: BBDub27 (120.80).
Seat 4: Wollverin (142.70).
Seat 5: meandkids (110.14).
Seat 6: Are you with me (70).
Player Are you with me has small blind (1)
Player IlxxxlI has big blind (2)
Player IlxxxlI received card: [Qd]
Player IlxxxlI received card: [Ac]
Player 38979 folds
Player BBDub27 folds
Player Wollverin folds
Player meandkids folds
Player Are you with me folds
Uncalled bet (1) returned to IlxxxlI
Player IlxxxlI mucks cards
------ Summary ------
Pot: 2. Rake 0
*Player IlxxxlI mucks (does not show cards). Bets: 1. Collects: 2. Wins: 1.
Player 38979 does not show cards.Bets: 0. Collects: 0. Wins: 0.
Player BBDub27 does not show cards.Bets: 0. Collects: 0. Wins: 0.
Player Wollverin does not show cards.Bets: 0. Collects: 0. Wins: 0.
Player meandkids does not show cards.Bets: 0. Collects: 0. Wins: 0.
Player Are you with me does not show cards.Bets: 1. Collects: 0. Loses: 1.
Game ended at: 2016/11/28 20:21:12

Game started
Game ID: 786372588 1/2 (PRR) Lakhey (Short) - 2 (Hold'em)
Seat 1 is the button
Seat 1: IlxxxlI (55.30).
Seat 3: sheenius81 (184.70).
Seat 5: Wollverin (100).
Seat 6: meandkids (100).
Player sheenius81 has small blind (1)
Player Wollverin has big blind (2)
Player IlxxxlI received card: [10c]
Player IlxxxlI received card: [10s]
Player meandkids calls (2)
Player IlxxxlI raises (6)
Player sheenius81 folds
Player Wollverin folds
Player meandkids calls (4)
*** FLOP ***: [Jh 3c 6h]
Player meandkids checks
Player IlxxxlI bets (3.42)
Player meandkids calls (3.42)
*** TURN ***: [Jh 3c 6h] [Jd]
Player meandkids checks
Player IlxxxlI bets (6.91)
Player meandkids calls (6.91)
*** RIVER ***: [Jh 3c 6h Jd] [7s]
Player meandkids checks
Player IlxxxlI bets (11.29)
Player meandkids folds
Uncalled bet (11.29) returned to IlxxxlI
Player IlxxxlI mucks cards
------ Summary ------
Pot: 33.88. Rake 1.54. JP fee 0.24
Board: [Jh 3c 6h Jd 7s]
*Player IlxxxlI mucks (does not show cards). Bets: 16.33. Collects: 33.88. Wins: 17.55.
Player sheenius81 does not show cards.Bets: 1. Collects: 0. Loses: 1.
Player Wollverin does not show cards.Bets: 2. Collects: 0. Loses: 2.
Player meandkids does not show cards.Bets: 16.33. Collects: 0. Loses: 16.33.
Game ended at: 2016/11/28 20:21:29

Game started
Game ID: 786372521 1/2 (PRR) Lakhey (Short) - 2 (Hold'em)
Seat 6 is the button
Seat 1: IlxxxlI (50.80).
Seat 3: sheenius81 (189.70).
Seat 5: Wollverin (100).
Seat 6: meandkids (100).
Player IlxxxlI has small blind (1)
Player sheenius81 has big blind (2)
Player IlxxxlI received card: [Ac]
Player IlxxxlI received card: [Kd]
Player Wollverin folds
Player meandkids folds
Player IlxxxlI raises (4)
Player sheenius81 calls (3)
*** FLOP ***: [5d 10s Ad]
Player IlxxxlI bets (4.94)
Player sheenius81 folds
Uncalled bet (4.94) returned to IlxxxlI
Player IlxxxlI mucks cards
------ Summary ------
Pot: 9.50. Rake 0.34. JP fee 0.16
Board: [5d 10s Ad]
*Player IlxxxlI mucks (does not show cards). Bets: 5. Collects: 9.50. Wins: 4.50.
Player sheenius81 does not show cards.Bets: 5. Collects: 0. Loses: 5.
Player Wollverin does not show cards.Bets: 0. Collects: 0. Wins: 0.
Player meandkids does not show cards.Bets: 0. Collects: 0. Wins: 0.
Game ended at: 2016/11/28 20:20:22

Game started
Game ID: 786372459 1/2 (PRR) Lakhey (Short) - 2 (Hold'em)
Seat 5 is the button
Seat 1: IlxxxlI (49.80).
Seat 2: 38979 (248.69).
Seat 3: sheenius81 (189.70).
Seat 5: Wollverin (100).
Seat 6: meandkids (101).
Player meandkids has small blind (1)
Player IlxxxlI has big blind (2)
Player IlxxxlI received card: [8d]
Player IlxxxlI received card: [2s]
Player 38979 folds
Player sheenius81 folds
Player Wollverin folds
Player meandkids folds
Uncalled bet (1) returned to IlxxxlI
Player IlxxxlI mucks cards
------ Summary ------
Pot: 2. Rake 0
*Player IlxxxlI mucks (does not show cards). Bets: 1. Collects: 2. Wins: 1.
Player 38979 does not show cards.Bets: 0. Collects: 0. Wins: 0.
Player sheenius81 does not show cards.Bets: 0. Collects: 0. Wins: 0.
Player Wollverin does not show cards.Bets: 0. Collects: 0. Wins: 0.
Player meandkids does not show cards.Bets: 1. Collects: 0. Loses: 1.
Game ended at: 2016/11/28 20:20:1

Game started
Game ID: 786372412 1/2 (PRR) Lakhey (Short) - 2 (Hold'em)
Seat 3 is the button
Seat 1: IlxxxlI (49.80).
Seat 2: 38979 (248.69).
Seat 3: sheenius81 (189.70).
Seat 5: Wollverin (101).
Seat 6: meandkids (100).
Player Wollverin has small blind (1)
Player meandkids has big blind (2)
Player IlxxxlI received card: [Qs]
Player IlxxxlI received card: [4s]
Player IlxxxlI folds
Player 38979 folds
Player sheenius81 folds
Player Wollverin folds
Uncalled bet (1) returned to meandkids
Player meandkids mucks cards
------ Summary ------
Pot: 2. Rake 0
Player IlxxxlI does not show cards.Bets: 0. Collects: 0. Wins: 0.
Player 38979 does not show cards.Bets: 0. Collects: 0. Wins: 0.
Player sheenius81 does not show cards.Bets: 0. Collects: 0. Wins: 0.
Player Wollverin does not show cards.Bets: 1. Collects: 0. Loses: 1.
*Player meandkids mucks (does not show cards). Bets: 1. Collects: 2. Wins: 1.
Game ended at: 2016/11/28 20:19:44

Game started
Game ID: 786372391 1/2 (PRR) Lakhey (Short) (Hold'em)
Seat 4 is the button
Seat 1: IlxxxlI (45).
Seat 2: 38979 (218.52).
Seat 3: BBDub27 (120.80).
Seat 4: Wollverin (129.70).
Seat 5: meandkids (111.14).
Seat 6: Are you with me (72.73).
Player meandkids has small blind (1)
Player Are you with me has big blind (2)
Player IlxxxlI received card: [3c]
Player IlxxxlI received card: [Jd]
Player IlxxxlI folds
Player 38979 folds
Player BBDub27 is timed out.
Player BBDub27 folds
Player Wollverin raises (4)
Player meandkids folds
Player Are you with me raises (10)
Player Wollverin allin (125.70)
Player Are you with me folds
Uncalled bet (117.70) returned to Wollverin
Player Wollverin mucks cards
------ Summary ------
Pot: 25. Rake 0
Player IlxxxlI does not show cards.Bets: 0. Collects: 0. Wins: 0.
Player 38979 does not show cards.Bets: 0. Collects: 0. Wins: 0.
Player BBDub27 does not show cards.Bets: 0. Collects: 0. Wins: 0.
*Player Wollverin mucks (does not show cards). Bets: 12. Collects: 25. Wins: 13.
Player meandkids does not show cards.Bets: 1. Collects: 0. Loses: 1.
Player Are you with me does not show cards.Bets: 12. Collects: 0. Loses: 12.
Game ended at: 2016/11/28 20:20:52

Game started
Game ID: 786372378 0.25/0.50 (PRR) Gorgons - 5 (Hold'em)
Seat 1 is the button
Seat 1: caballeroXXX (58.51).
Seat 2: 38979 (57.34).
Seat 3: DonkReaper (71.59).
Seat 4: in_ur_i (50).
Seat 5: Cinch23 (26.81).
Seat 6: IlxxxlI (20).
Player 38979 has small blind (0.25)
Player DonkReaper has big blind (0.50)
Player IlxxxlI received card: [4c]
Player IlxxxlI received card: [4h]
Player in_ur_i folds
Player Cinch23 folds
Player IlxxxlI folds
Player caballeroXXX raises (1)
Player 38979 folds
Player DonkReaper folds
Uncalled bet (0.50) returned to caballeroXXX
Player caballeroXXX mucks cards
------ Summary ------
Pot: 1.25. Rake 0
*Player caballeroXXX mucks (does not show cards). Bets: 0.50. Collects: 1.25. Wins: 0.75.
Player 38979 does not show cards.Bets: 0.25. Collects: 0. Loses: 0.25.
Player DonkReaper does not show cards.Bets: 0.50. Collects: 0. Loses: 0.50.
Player in_ur_i does not show cards.Bets: 0. Collects: 0. Wins: 0.
Player Cinch23 does not show cards.Bets: 0. Collects: 0. Wins: 0.
Player IlxxxlI does not show cards.Bets: 0. Collects: 0. Wins: 0.
Game ended at: 2016/11/28 20:21:18

Game started
Game ID: 786372354 1/2 (PRR) Lakhey (Short) - 2 (Hold'em)
Seat 2 is the button
Seat 1: IlxxxlI (49.80).
Seat 2: 38979 (248.69).
Seat 3: sheenius81 (190.70).
Seat 4: Are you with me (71.35).
Seat 5: Wollverin (100).
Player sheenius81 has small blind (1)
Player Are you with me sitting out
Player Wollverin has big blind (2)
Player IlxxxlI received card: [10d]
Player IlxxxlI received card: [Jc]
Player IlxxxlI folds
Player 38979 folds
Player sheenius81 folds
Uncalled bet (1) returned to Wollverin
Player Wollverin mucks cards
------ Summary ------
Pot: 2. Rake 0
Player IlxxxlI does not show cards.Bets: 0. Collects: 0. Wins: 0.
Player 38979 does not show cards.Bets: 0. Collects: 0. Wins: 0.
Player sheenius81 does not show cards.Bets: 1. Collects: 0. Loses: 1.
Player Are you with me does not show cards.Bets: 0. Collects: 0. Wins: 0.
*Player Wollverin mucks (does not show cards). Bets: 1. Collects: 2. Wins: 1.
Game ended at: 2016/11/28 20:19:33

Game started
Game ID: 786372295 0.25/0.50 (PRR) Gorgons - 5 (Hold'em)
Seat 6 is the button
Seat 1: caballeroXXX (58.01).
Seat 2: 38979 (57.84).
Seat 3: DonkReaper (71.59).
Seat 4: in_ur_i (50).
Seat 5: Cinch23 (26.81).
Seat 6: IlxxxlI (20).
Player caballeroXXX has small blind (0.25)
Player 38979 has big blind (0.50)
Player IlxxxlI received card: [Qc]
Player IlxxxlI received card: [4c]
Player DonkReaper folds
Player in_ur_i folds
Player Cinch23 folds
Player IlxxxlI folds
Player caballeroXXX raises (1.25)
Player 38979 folds
Uncalled bet (1) returned to caballeroXXX
Player caballeroXXX mucks cards
------ Summary ------
Pot: 1. Rake 0
*Player caballeroXXX mucks (does not show cards). Bets: 0.50. Collects: 1. Wins: 0.50.
Player 38979 does not show cards.Bets: 0.50. Collects: 0. Loses: 0.50.
Player DonkReaper does not show cards.Bets: 0. Collects: 0. Wins: 0.
Player in_ur_i does not show cards.Bets: 0. Collects: 0. Wins: 0.
Player Cinch23 does not show cards.Bets: 0. Collects: 0. Wins: 0.
Player IlxxxlI does not show cards.Bets: 0. Collects: 0. Wins: 0.
Game ended at: 2016/11/28 20:19:24

Game started
Game ID: 786372170 1/2 (PRR) Lakhey (Short) (Hold'em)
Seat 3 is the button
Seat 1: IlxxxlI (45).
Seat 2: 38979 (218.52).
Seat 3: BBDub27 (120.80).
Seat 4: Wollverin (127.70).
Seat 5: meandkids (113.14).
Seat 6: Are you with me (72.73).
Player Wollverin has small blind (1)
Player meandkids has big blind (2)
Player IlxxxlI received card: [3s]
Player IlxxxlI received card: [8c]
Player Are you with me folds
Player IlxxxlI folds
Player 38979 folds
Player BBDub27 is timed out.
Player BBDub27 folds
Player Wollverin raises (3.50)
Player meandkids folds
Uncalled bet (2.50) returned to Wollverin
Player Wollverin mucks cards
------ Summary ------
Pot: 4. Rake 0
Player IlxxxlI does not show cards.Bets: 0. Collects: 0. Wins: 0.
Player 38979 does not show cards.Bets: 0. Collects: 0. Wins: 0.
Player BBDub27 does not show cards.Bets: 0. Collects: 0. Wins: 0.
*Player Wollverin mucks (does not show cards). Bets: 2. Collects: 4. Wins: 2.
Player meandkids does not show cards.Bets: 2. Collects: 0. Loses: 2.
Player Are you with me does not show cards.Bets: 0. Collects: 0. Wins: 0.
Game ended at: 2016/11/28 20:19:28

Game started
Game ID: 786372123 0.25/0.50 (PRR) Gorgons - 5 (Hold'em)
Seat 5 is the button
Seat 1: caballeroXXX (57.51).
Seat 2: 38979 (57.84).
Seat 3: DonkReaper (71.59).
Seat 4: in_ur_i (50).
Seat 5: Cinch23 (26.81).
Seat 6: IlxxxlI (20.49).
Player IlxxxlI has small blind (0.25)
Player caballeroXXX has big blind (0.50)
Player IlxxxlI received card: [7c]
Player IlxxxlI received card: [8s]
Player 38979 folds
Player DonkReaper folds
Player in_ur_i folds
Player Cinch23 folds
Player IlxxxlI calls (0.25)
Player caballeroXXX raises (1)
Player IlxxxlI folds
Uncalled bet (1) returned to caballeroXXX
Player caballeroXXX mucks cards
------ Summary ------
Pot: 1. Rake 0
*Player caballeroXXX mucks (does not show cards). Bets: 0.50. Collects: 1. Wins: 0.50.
Player 38979 does not show cards.Bets: 0. Collects: 0. Wins: 0.
Player DonkReaper does not show cards.Bets: 0. Collects: 0. Wins: 0.
Player in_ur_i does not show cards.Bets: 0. Collects: 0. Wins: 0.
Player Cinch23 does not show cards.Bets: 0. Collects: 0. Wins: 0.
Player IlxxxlI does not show cards.Bets: 0.50. Collects: 0. Loses: 0.50.
Game ended at: 2016/11/28 20:19:0

Game started
Game ID: 786371995 1/2 (PRR) Lakhey (Short) (Hold'em)
Seat 2 is the button
Seat 1: IlxxxlI (45).
Seat 2: 38979 (218.52).
Seat 3: BBDub27 (121.80).
Seat 4: Wollverin (121.70).
Seat 5: meandkids (113.14).
Seat 6: Are you with me (77.73).
Player BBDub27 has small blind (1)
Player Wollverin has big blind (2)
Player IlxxxlI received card: [10h]
Player IlxxxlI received card: [8s]
Player meandkids folds
Player Are you with me raises (5)
Player IlxxxlI folds
Player 38979 folds
Player BBDub27 folds
Player Wollverin raises (16)
Player Are you with me folds
Uncalled bet (13) returned to Wollverin
Player Wollverin mucks cards
------ Summary ------
Pot: 11. Rake 0
Player IlxxxlI does not show cards.Bets: 0. Collects: 0. Wins: 0.
Player 38979 does not show cards.Bets: 0. Collects: 0. Wins: 0.
Player BBDub27 does not show cards.Bets: 1. Collects: 0. Loses: 1.
*Player Wollverin mucks (does not show cards). Bets: 5. Collects: 11. Wins: 6.
Player meandkids does not show cards.Bets: 0. Collects: 0. Wins: 0.
Player Are you with me does not show cards.Bets: 5. Collects: 0. Loses: 5.
Game ended at: 2016/11/28 20:18:27

Game started
Game ID: 786371930 1/2 (PRR) Lakhey (Short) (Hold'em)
Seat 1 is the button
Seat 1: IlxxxlI (45).
Seat 2: 38979 (219.52).
Seat 3: BBDub27 (120.80).
Seat 4: Wollverin (121.70).
Seat 5: meandkids (113.14).
Seat 6: Are you with me (77.73).
Player 38979 has small blind (1)
Player BBDub27 has big blind (2)
Player IlxxxlI received card: [Qc]
Player IlxxxlI received card: [6c]
Player Wollverin folds
Player meandkids folds
Player Are you with me folds
Player IlxxxlI folds
Player 38979 folds
Uncalled bet (1) returned to BBDub27
Player BBDub27 mucks cards
------ Summary ------
Pot: 2. Rake 0
Player IlxxxlI does not show cards.Bets: 0. Collects: 0. Wins: 0.
Player 38979 does not show cards.Bets: 1. Collects: 0. Loses: 1.
*Player BBDub27 mucks (does not show cards). Bets: 1. Collects: 2. Wins: 1.
Player Wollverin does not show cards.Bets: 0. Collects: 0. Wins: 0.
Player meandkids does not show cards.Bets: 0. Collects: 0. Wins: 0.
Player Are you with me does not show cards.Bets: 0. Collects: 0. Wins: 0.
Game ended at: 2016/11/28 20:17:41

Game started
Game ID: 786371870 1/2 (PRR) Lakhey (Short) (Hold'em)
Seat 6 is the button
Seat 1: IlxxxlI (43).
Seat 2: 38979 (221.52).
Seat 4: Wollverin (121.70).
Seat 5: meandkids (113.14).
Seat 6: Are you with me (77.73).
Player IlxxxlI has small blind (1)
Player 38979 has big blind (2)
Player IlxxxlI received card: [Qh]
Player IlxxxlI received card: [10h]
Player Wollverin folds
Player meandkids folds
Player Are you with me folds
Player IlxxxlI raises (4)
Player 38979 folds
Uncalled bet (3) returned to IlxxxlI
Player IlxxxlI mucks cards
------ Summary ------
Pot: 4. Rake 0
*Player IlxxxlI mucks (does not show cards). Bets: 2. Collects: 4. Wins: 2.
Player 38979 does not show cards.Bets: 2. Collects: 0. Loses: 2.
Player Wollverin does not show cards.Bets: 0. Collects: 0. Wins: 0.
Player meandkids does not show cards.Bets: 0. Collects: 0. Wins: 0.
Player Are you with me does not show cards.Bets: 0. Collects: 0. Wins: 0.
Game ended at: 2016/11/28 20:17:25

Game started
Game ID: 786371770 1/2 (PRR) Lakhey (Short) (Hold'em)
Seat 5 is the button
Seat 1: IlxxxlI (45).
Seat 2: 38979 (221.52).
Seat 4: Wollverin (121.70).
Seat 5: meandkids (110.14).
Seat 6: Are you with me (78.73).
Player Are you with me has small blind (1)
Player IlxxxlI has big blind (2)
Player IlxxxlI received card: [Kh]
Player IlxxxlI received card: [3d]
Player 38979 folds
Player Wollverin folds
Player meandkids raises (10)
Player Are you with me folds
Player IlxxxlI folds
Uncalled bet (8) returned to meandkids
Player meandkids mucks cards
------ Summary ------
Pot: 5. Rake 0
Player IlxxxlI does not show cards.Bets: 2. Collects: 0. Loses: 2.
Player 38979 does not show cards.Bets: 0. Collects: 0. Wins: 0.
Player Wollverin does not show cards.Bets: 0. Collects: 0. Wins: 0.
*Player meandkids mucks (does not show cards). Bets: 2. Collects: 5. Wins: 3.
Player Are you with me does not show cards.Bets: 1. Collects: 0. Loses: 1.
Game ended at: 2016/11/28 20:17:8

Game started
Game ID: 786371742 0.25/0.50 (PRR) Gorgons - 5 (Hold'em)
Seat 4 is the button
Seat 1: caballeroXXX (57.51).
Seat 2: 38979 (57.84).
Seat 3: DonkReaper (51.59).
Seat 4: in_ur_i (50).
Seat 5: Cinch23 (48.50).
Seat 6: IlxxxlI (20.99).
Player Cinch23 has small blind (0.25)
Player IlxxxlI has big blind (0.50)
Player IlxxxlI received card: [2d]
Player IlxxxlI received card: [8s]
Player caballeroXXX folds
Player 38979 folds
Player DonkReaper raises (1.50)
Player in_ur_i folds
Player Cinch23 raises (5.25)
Player IlxxxlI folds
Player DonkReaper calls (4)
*** FLOP ***: [Jh 5c Jc]
Player Cinch23 bets (5.50)
Player DonkReaper calls (5.50)
*** TURN ***: [Jh 5c Jc] [Qc]
Player Cinch23 checks
Player DonkReaper bets (10.69)
Player Cinch23 calls (10.69)
*** RIVER ***: [Jh 5c Jc Qc] [Qs]
Player Cinch23 checks
Player DonkReaper bets (13.89)
Player Cinch23 folds
Uncalled bet (13.89) returned to DonkReaper
Player DonkReaper mucks cards
------ Summary ------
Pot: 41.69. Rake 1.95. JP fee 0.24
Board: [Jh 5c Jc Qc Qs]
Player caballeroXXX does not show cards.Bets: 0. Collects: 0. Wins: 0.
Player 38979 does not show cards.Bets: 0. Collects: 0. Wins: 0.
*Player DonkReaper mucks (does not show cards). Bets: 21.69. Collects: 41.69. Wins: 20.
Player in_ur_i does not show cards.Bets: 0. Collects: 0. Wins: 0.
Player Cinch23 does not show cards.Bets: 21.69. Collects: 0. Loses: 21.69.
Player IlxxxlI does not show cards.Bets: 0.50. Collects: 0. Loses: 0.50.
Game ended at: 2016/11/28 20:18:13

Game started
Game ID: 786371737 1/2 (PRR) Lakhey (Short) - 2 (Hold'em)
Seat 1 is the button
Seat 1: IlxxxlI (49.80).
Seat 2: 38979 (249.69).
Seat 3: sheenius81 (146.79).
Seat 4: Are you with me (71.35).
Seat 5: Wollverin (100.24).
Player 38979 has small blind (1)
Player sheenius81 has big blind (2)
Player IlxxxlI received card: [4h]
Player IlxxxlI received card: [9s]
Player Are you with me folds
Player Wollverin raises (4)
Player IlxxxlI folds
Player 38979 folds
Player sheenius81 raises (8)
Player Wollverin calls (6)
*** FLOP ***: [10h 4c Js]
Player sheenius81 bets (13.30)
Player Wollverin calls (13.30)
*** TURN ***: [10h 4c Js] [Jh]
Player sheenius81 bets (22.61)
Player Wollverin calls (22.61)
*** RIVER ***: [10h 4c Js Jh] [5s]
Player sheenius81 bets (59.88)
Player Wollverin folds
Uncalled bet (59.88) returned to sheenius81
Player sheenius81 mucks cards
------ Summary ------
Pot: 89.82. Rake 2.76. JP fee 0.24
Board: [10h 4c Js Jh 5s]
Player IlxxxlI does not show cards.Bets: 0. Collects: 0. Wins: 0.
Player 38979 does not show cards.Bets: 1. Collects: 0. Loses: 1.
*Player sheenius81 mucks (does not show cards). Bets: 45.91. Collects: 89.82. Wins: 43.91.
Player Are you with me does not show cards.Bets: 0. Collects: 0. Wins: 0.
Player Wollverin does not show cards.Bets: 45.91. Collects: 0. Loses: 45.91.
Game ended at: 2016/11/28 20:19:17

Game started
Game ID: 786371678 1/2 (PRR) Lakhey (Short) (Hold'em)
Seat 4 is the button
Seat 1: IlxxxlI (45).
Seat 2: 38979 (221.52).
Seat 3: BBDub27 (120.80).
Seat 4: Wollverin (121.70).
Seat 5: meandkids (111.14).
Seat 6: Are you with me (77.73).
Player meandkids has small blind (1)
Player Are you with me has big blind (2)
Player BBDub27 is timed out.
Player BBDub27 wait BB
Player IlxxxlI received card: [Jc]
Player IlxxxlI received card: [5c]
Player IlxxxlI folds
Player 38979 folds
Player Wollverin folds
Player meandkids folds
Uncalled bet (1) returned to Are you with me
Player Are you with me mucks cards
------ Summary ------
Pot: 2. Rake 0
Player IlxxxlI does not show cards.Bets: 0. Collects: 0. Wins: 0.
Player 38979 does not show cards.Bets: 0. Collects: 0. Wins: 0.
Player BBDub27 does not show cards.Bets: 0. Collects: 0. Wins: 0.
Player Wollverin does not show cards.Bets: 0. Collects: 0. Wins: 0.
Player meandkids does not show cards.Bets: 1. Collects: 0. Loses: 1.
*Player Are you with me mucks (does not show cards). Bets: 1. Collects: 2. Wins: 1.
Game ended at: 2016/11/28 20:16:40

Game started
Game ID: 786371570 0.25/0.50 (PRR) Gorgons - 5 (Hold'em)
Seat 3 is the button
Seat 1: caballeroXXX (57.51).
Seat 2: 38979 (57.84).
Seat 3: DonkReaper (50).
Seat 4: in_ur_i (50.25).
Seat 5: Cinch23 (50).
Seat 6: IlxxxlI (20.99).
Player in_ur_i has small blind (0.25)
Player Cinch23 has big blind (0.50)
Player IlxxxlI received card: [Ac]
Player IlxxxlI received card: [6c]
Player IlxxxlI folds
Player caballeroXXX folds
Player 38979 folds
Player DonkReaper raises (1.50)
Player in_ur_i folds
Player Cinch23 calls (1)
*** FLOP ***: [6h 8s Kd]
Player Cinch23 checks
Player DonkReaper bets (2.06)
Player Cinch23 folds
Uncalled bet (2.06) returned to DonkReaper
Player DonkReaper mucks cards
------ Summary ------
Pot: 3.09. Rake 0.12. JP fee 0.04
Board: [6h 8s Kd]
Player caballeroXXX does not show cards.Bets: 0. Collects: 0. Wins: 0.
Player 38979 does not show cards.Bets: 0. Collects: 0. Wins: 0.
*Player DonkReaper mucks (does not show cards). Bets: 1.50. Collects: 3.09. Wins: 1.59.
Player in_ur_i does not show cards.Bets: 0.25. Collects: 0. Loses: 0.25.
Player Cinch23 does not show cards.Bets: 1.50. Collects: 0. Loses: 1.50.
Player IlxxxlI does not show cards.Bets: 0. Collects: 0. Wins: 0.
Game ended at: 2016/11/28 20:16:34

Game started
Game ID: 786371547 1/2 (PRR) Lakhey (Short) - 2 (Hold'em)
Seat 5 is the button
Seat 1: IlxxxlI (50.80).
Seat 2: 38979 (248.69).
Seat 3: sheenius81 (146.79).
Seat 4: Are you with me (71.35).
Seat 5: Wollverin (100.24).
Player IlxxxlI has small blind (1)
Player 38979 has big blind (2)
Player IlxxxlI received card: [8h]
Player IlxxxlI received card: [5c]
Player sheenius81 is timed out.
Player sheenius81 folds
Player Are you with me folds
Player Wollverin folds
Player IlxxxlI folds
Uncalled bet (1) returned to 38979
Player 38979 mucks cards
------ Summary ------
Pot: 2. Rake 0
Player IlxxxlI does not show cards.Bets: 1. Collects: 0. Loses: 1.
*Player 38979 mucks (does not show cards). Bets: 1. Collects: 2. Wins: 1.
Player sheenius81 does not show cards.Bets: 0. Collects: 0. Wins: 0.
Player Are you with me does not show cards.Bets: 0. Collects: 0. Wins: 0.
Player Wollverin does not show cards.Bets: 0. Collects: 0. Wins: 0.
Game ended at: 2016/11/28 20:16:33

Game started
Game ID: 786371487 0.25/0.50 (PRR) Gorgons - 5 (Hold'em)
Seat 2 is the button
Seat 1: caballeroXXX (57.51).
Seat 2: 38979 (57.84).
Seat 3: DonkReaper (50.25).
Seat 4: in_ur_i (50).
Seat 6: IlxxxlI (20.99).
Player DonkReaper has small blind (0.25)
Player in_ur_i has big blind (0.50)
Player IlxxxlI received card: [7c]
Player IlxxxlI received card: [6c]
Player IlxxxlI folds
Player caballeroXXX folds
Player 38979 folds
Player DonkReaper folds
Uncalled bet (0.25) returned to in_ur_i
Player in_ur_i mucks cards
------ Summary ------
Pot: 0.50. Rake 0
Player caballeroXXX does not show cards.Bets: 0. Collects: 0. Wins: 0.
Player 38979 does not show cards.Bets: 0. Collects: 0. Wins: 0.
Player DonkReaper does not show cards.Bets: 0.25. Collects: 0. Loses: 0.25.
*Player in_ur_i mucks (does not show cards). Bets: 0.25. Collects: 0.50. Wins: 0.25.
Player IlxxxlI does not show cards.Bets: 0. Collects: 0. Wins: 0.
Game ended at: 2016/11/28 20:15:50

Game started
Game ID: 786371441 0.25/0.50 (PRR) Gorgons - 5 (Hold'em)
Seat 1 is the button
Seat 1: caballeroXXX (57.51).
Seat 2: 38979 (58.09).
Seat 3: DonkReaper (50).
Seat 4: in_ur_i (50).
Seat 6: IlxxxlI (20.99).
Player 38979 has small blind (0.25)
Player DonkReaper has big blind (0.50)
Player IlxxxlI received card: [2c]
Player IlxxxlI received card: [Ad]
Player in_ur_i folds
Player IlxxxlI folds
Player caballeroXXX folds
Player 38979 folds
Uncalled bet (0.25) returned to DonkReaper
Player DonkReaper mucks cards
------ Summary ------
Pot: 0.50. Rake 0
Player caballeroXXX does not show cards.Bets: 0. Collects: 0. Wins: 0.
Player 38979 does not show cards.Bets: 0.25. Collects: 0. Loses: 0.25.
*Player DonkReaper mucks (does not show cards). Bets: 0.25. Collects: 0.50. Wins: 0.25.
Player in_ur_i does not show cards.Bets: 0. Collects: 0. Wins: 0.
Player IlxxxlI does not show cards.Bets: 0. Collects: 0. Wins: 0.
Game ended at: 2016/11/28 20:15:31

Game started
Game ID: 786371352 0.25/0.50 (PRR) Gorgons - 5 (Hold'em)
Seat 6 is the button
Seat 1: caballeroXXX (56.51).
Seat 2: 38979 (58.59).
Seat 4: in_ur_i (50).
Seat 6: IlxxxlI (21.49).
Player caballeroXXX has small blind (0.25)
Player 38979 has big blind (0.50)
Player IlxxxlI received card: [6h]
Player IlxxxlI received card: [7h]
Player in_ur_i folds
Player IlxxxlI calls (0.50)
Player caballeroXXX raises (1.75)
Player 38979 folds
Player IlxxxlI folds
Uncalled bet (1.50) returned to caballeroXXX
Player caballeroXXX mucks cards
------ Summary ------
Pot: 1.50. Rake 0
*Player caballeroXXX mucks (does not show cards). Bets: 0.50. Collects: 1.50. Wins: 1.
Player 38979 does not show cards.Bets: 0.50. Collects: 0. Loses: 0.50.
Player in_ur_i does not show cards.Bets: 0. Collects: 0. Wins: 0.
Player IlxxxlI does not show cards.Bets: 0.50. Collects: 0. Loses: 0.50.
Game ended at: 2016/11/28 20:15:21

Game started
Game ID: 786371282 1/2 (PRR) Lakhey (Short) (Hold'em)
Seat 2 is the button
Seat 1: IlxxxlI (45).
Seat 2: 38979 (221.52).
Seat 4: Wollverin (113.15).
Seat 5: meandkids (120.64).
Seat 6: Are you with me (77.73).
Player Wollverin has small blind (1)
Player meandkids has big blind (2)
Player IlxxxlI received card: [5s]
Player IlxxxlI received card: [7h]
Player Are you with me folds
Player IlxxxlI folds
Player 38979 folds
Player Wollverin raises (4)
Player meandkids calls (3)
*** FLOP ***: [Jh Kh 5c]
Player Wollverin bets (4.50)
Player meandkids calls (4.50)
*** TURN ***: [Jh Kh 5c] [9d]
Player Wollverin checks
Player meandkids checks
*** RIVER ***: [Jh Kh 5c 9d] [Ah]
Player Wollverin bets (12)
Player meandkids folds
Uncalled bet (12) returned to Wollverin
Player Wollverin mucks cards
------ Summary ------
Pot: 18.05. Rake 0.71. JP fee 0.24
Board: [Jh Kh 5c 9d Ah]
Player IlxxxlI does not show cards.Bets: 0. Collects: 0. Wins: 0.
Player 38979 does not show cards.Bets: 0. Collects: 0. Wins: 0.
*Player Wollverin mucks (does not show cards). Bets: 9.50. Collects: 18.05. Wins: 8.55.
Player meandkids does not show cards.Bets: 9.50. Collects: 0. Loses: 9.50.
Player Are you with me does not show cards.Bets: 0. Collects: 0. Wins: 0.
Game ended at: 2016/11/28 20:16:18

Game started
Game ID: 786371106 0.25/0.50 (PRR) Gorgons - 5 (Hold'em)
Seat 4 is the button
Seat 1: caballeroXXX (55.61).
Seat 3: sucazappa (54.25).
Seat 4: in_ur_i (50).
Seat 6: IlxxxlI (22.49).
Player IlxxxlI has small blind (0.25)
Player caballeroXXX has big blind (0.50)
Player IlxxxlI received card: [5s]
Player IlxxxlI received card: [Js]
Player sucazappa folds
Player in_ur_i folds
Player IlxxxlI calls (0.25)
Player caballeroXXX checks
*** FLOP ***: [9c 6c 5c]
Player IlxxxlI checks
Player caballeroXXX bets (0.50)
Player IlxxxlI calls (0.50)
*** TURN ***: [9c 6c 5c] [Ks]
Player IlxxxlI checks
Player caballeroXXX bets (1.50)
Player IlxxxlI folds
Uncalled bet (1.50) returned to caballeroXXX
Player caballeroXXX mucks cards
------ Summary ------
Pot: 1.90. Rake 0.08. JP fee 0.02
Board: [9c 6c 5c Ks]
*Player caballeroXXX mucks (does not show cards). Bets: 1. Collects: 1.90. Wins: 0.90.
Player sucazappa does not show cards.Bets: 0. Collects: 0. Wins: 0.
Player in_ur_i does not show cards.Bets: 0. Collects: 0. Wins: 0.
Player IlxxxlI does not show cards.Bets: 1. Collects: 0. Loses: 1.
Game ended at: 2016/11/28 20:14:56

Game started
Game ID: 786371096 1/2 (PRR) Lakhey (Short) (Hold'em)
Seat 1 is the button
Seat 1: IlxxxlI (45).
Seat 2: 38979 (222.52).
Seat 3: BBDub27 (122.80).
Seat 4: Wollverin (113.15).
Seat 5: meandkids (120.64).
Seat 6: Are you with me (74.73).
Player 38979 has small blind (1)
Player BBDub27 has big blind (2)
Player IlxxxlI received card: [8s]
Player IlxxxlI received card: [Jh]
Player Wollverin folds
Player meandkids folds
Player Are you with me raises (5)
Player IlxxxlI folds
Player 38979 folds
Player BBDub27 is timed out.
Player BBDub27 folds
Uncalled bet (3) returned to Are you with me
Player Are you with me mucks cards
------ Summary ------
Pot: 5. Rake 0
Player IlxxxlI does not show cards.Bets: 0. Collects: 0. Wins: 0.
Player 38979 does not show cards.Bets: 1. Collects: 0. Loses: 1.
Player BBDub27 does not show cards.Bets: 2. Collects: 0. Loses: 2.
Player Wollverin does not show cards.Bets: 0. Collects: 0. Wins: 0.
Player meandkids does not show cards.Bets: 0. Collects: 0. Wins: 0.
*Player Are you with me mucks (does not show cards). Bets: 2. Collects: 5. Wins: 3.
Game ended at: 2016/11/28 20:14:40

Game started
Game ID: 786371034 1/2 (PRR) Lakhey (Short) - 2 (Hold'em)
Seat 4 is the button
Seat 1: IlxxxlI (40).
Seat 2: 38979 (248.69).
Seat 3: sheenius81 (146.79).
Seat 4: Are you with me (71.35).
Seat 5: Wollverin (112.24).
Player Wollverin has small blind (1)
Player IlxxxlI has big blind (2)
Player IlxxxlI received card: [2c]
Player IlxxxlI received card: [4d]
Player 38979 folds
Player sheenius81 is timed out.
Player sheenius81 folds
Player Are you with me folds
Player Wollverin calls (1)
Player IlxxxlI checks
*** FLOP ***: [8h 10d 4c]
Player Wollverin bets (2)
Player IlxxxlI calls (2)
*** TURN ***: [8h 10d 4c] [2h]
Player Wollverin bets (3.80)
Player IlxxxlI raises (8)
Player Wollverin calls (4.20)
*** RIVER ***: [8h 10d 4c 2h] [8c]
Player Wollverin checks
Player IlxxxlI checks
Player Wollverin mucks cards
------ Summary ------
Pot: 22.80. Rake 0.96. JP fee 0.24
Board: [8h 10d 4c 2h 8c]
*Player IlxxxlI shows: Two pairs. 8s and 4s [2c 4d]. Bets: 12. Collects: 22.80. Wins: 10.80.
Player 38979 does not show cards.Bets: 0. Collects: 0. Wins: 0.
Player sheenius81 does not show cards.Bets: 0. Collects: 0. Wins: 0.
Player Are you with me does not show cards.Bets: 0. Collects: 0. Wins: 0.
Player Wollverin mucks (does not show cards). Bets: 12. Collects: 0. Loses: 12.
Game ended at: 2016/11/28 20:15:43

Game started
Game ID: 786370839 0.25/0.50 (PRR) Gorgons - 5 (Hold'em)
Seat 3 is the button
Seat 1: caballeroXXX (51.35).
Seat 3: sucazappa (57.40).
Seat 4: in_ur_i (42.61).
Seat 6: IlxxxlI (23.74).
Player in_ur_i has small blind (0.25)
Player IlxxxlI has big blind (0.50)
Player IlxxxlI received card: [Jd]
Player IlxxxlI received card: [10s]
Player caballeroXXX raises (1.25)
Player sucazappa calls (1.25)
Player in_ur_i folds
Player IlxxxlI calls (0.75)
*** FLOP ***: [6d Qh Qs]
Player IlxxxlI checks
Player caballeroXXX bets (1.90)
Player sucazappa calls (1.90)
Player IlxxxlI folds
*** TURN ***: [6d Qh Qs] [Ad]
Player caballeroXXX checks
Player sucazappa checks
*** RIVER ***: [6d Qh Qs Ad] [10d]
Player caballeroXXX bets (3.70)
Player sucazappa folds
Uncalled bet (3.70) returned to caballeroXXX
Player caballeroXXX mucks cards
------ Summary ------
Pot: 7.41. Rake 0.27. JP fee 0.12
Board: [6d Qh Qs Ad 10d]
*Player caballeroXXX mucks (does not show cards). Bets: 3.15. Collects: 7.41. Wins: 4.26.
Player sucazappa does not show cards.Bets: 3.15. Collects: 0. Loses: 3.15.
Player in_ur_i does not show cards.Bets: 0.25. Collects: 0. Loses: 0.25.
Player IlxxxlI does not show cards.Bets: 1.25. Collects: 0. Loses: 1.25.
Game ended at: 2016/11/28 20:13:55

Game started
Game ID: 786370797 1/2 (PRR) Lakhey (Short) - 2 (Hold'em)
Seat 3 is the button
Seat 1: IlxxxlI (40).
Seat 2: 38979 (248.69).
Seat 3: sheenius81 (146.79).
Seat 4: Are you with me (72.35).
Seat 5: Wollverin (107.24).
Player Are you with me has small blind (1)
Player Wollverin has big blind (2)
Player IlxxxlI received card: [8s]
Player IlxxxlI received card: [Js]
Player IlxxxlI raises (4)
Player 38979 folds
Player sheenius81 folds
Player Are you with me folds
Player Wollverin raises (38)
Player IlxxxlI folds
Uncalled bet (36) returned to Wollverin
Player Wollverin mucks cards
------ Summary ------
Pot: 9. Rake 0
Player IlxxxlI does not show cards.Bets: 4. Collects: 0. Loses: 4.
Player 38979 does not show cards.Bets: 0. Collects: 0. Wins: 0.
Player sheenius81 does not show cards.Bets: 0. Collects: 0. Wins: 0.
Player Are you with me does not show cards.Bets: 1. Collects: 0. Loses: 1.
*Player Wollverin mucks (does not show cards). Bets: 4. Collects: 9. Wins: 5.
Game ended at: 2016/11/28 20:13:36

Game started
Game ID: 786370756 0.25/0.50 (PRR) Gorgons - 5 (Hold'em)
Seat 1 is the button
Seat 1: caballeroXXX (50.60).
Seat 3: sucazappa (57.65).
Seat 4: in_ur_i (43.11).
Seat 6: IlxxxlI (23.74).
Player sucazappa has small blind (0.25)
Player in_ur_i has big blind (0.50)
Player IlxxxlI received card: [7h]
Player IlxxxlI received card: [3d]
Player IlxxxlI folds
Player caballeroXXX raises (1)
Player sucazappa folds
Player in_ur_i folds
Uncalled bet (0.50) returned to caballeroXXX
Player caballeroXXX mucks cards
------ Summary ------
Pot: 1.25. Rake 0
*Player caballeroXXX mucks (does not show cards). Bets: 0.50. Collects: 1.25. Wins: 0.75.
Player sucazappa does not show cards.Bets: 0.25. Collects: 0. Loses: 0.25.
Player in_ur_i does not show cards.Bets: 0.50. Collects: 0. Loses: 0.50.
Player IlxxxlI does not show cards.Bets: 0. Collects: 0. Wins: 0.
Game ended at: 2016/11/28 20:12:47

Game started
Game ID: 786370747 1/2 (PRR) Lakhey (Short) (Hold'em)
Seat 6 is the button
Seat 1: IlxxxlI (46).
Seat 2: 38979 (226.72).
Seat 3: BBDub27 (122.80).
Seat 4: Wollverin (113.15).
Seat 5: meandkids (120.64).
Seat 6: Are you with me (70).
Player IlxxxlI has small blind (1)
Player 38979 has big blind (2)
Player IlxxxlI received card: [Qd]
Player IlxxxlI received card: [8h]
Player BBDub27 folds
Player Wollverin folds
Player meandkids folds
Player Are you with me raises (4.20)
Player IlxxxlI folds
Player 38979 calls (2.20)
*** FLOP ***: [10d Kd 9d]
Player 38979 checks
Player Are you with me checks
*** TURN ***: [10d Kd 9d] [4h]
Player 38979 checks
Player Are you with me bets (6)
Player 38979 folds
Uncalled bet (6) returned to Are you with me
Player Are you with me mucks cards
------ Summary ------
Pot: 8.93. Rake 0.33. JP fee 0.14
Board: [10d Kd 9d 4h]
Player IlxxxlI does not show cards.Bets: 1. Collects: 0. Loses: 1.
Player 38979 does not show cards.Bets: 4.20. Collects: 0. Loses: 4.20.
Player BBDub27 does not show cards.Bets: 0. Collects: 0. Wins: 0.
Player Wollverin does not show cards.Bets: 0. Collects: 0. Wins: 0.
Player meandkids does not show cards.Bets: 0. Collects: 0. Wins: 0.
*Player Are you with me mucks (does not show cards). Bets: 4.20. Collects: 8.93. Wins: 4.73.
Game ended at: 2016/11/28 20:13:52

Game started
Game ID: 786370533 1/2 (PRR) Lakhey (Short) (Hold'em)
Seat 5 is the button
Seat 1: IlxxxlI (48).
Seat 2: 38979 (242.22).
Seat 3: BBDub27 (106).
Seat 4: Wollverin (113.15).
Seat 5: meandkids (120.64).
Seat 6: Are you with me (70.31).
Player Are you with me has small blind (1)
Player IlxxxlI has big blind (2)
Player IlxxxlI received card: [4c]
Player IlxxxlI received card: [6c]
Player 38979 raises (6)
Player BBDub27 calls (6)
Player Wollverin folds
Player meandkids folds
Player Are you with me folds
Player IlxxxlI folds
*** FLOP ***: [3d Qc Kd]
Player 38979 bets (9.50)
Player BBDub27 allin (100)
Player 38979 folds
Uncalled bet (90.50) returned to BBDub27
Player BBDub27 mucks cards
------ Summary ------
Pot: 32.30. Rake 1.46. JP fee 0.24
Board: [3d Qc Kd]
Player IlxxxlI does not show cards.Bets: 2. Collects: 0. Loses: 2.
Player 38979 does not show cards.Bets: 15.50. Collects: 0. Loses: 15.50.
*Player BBDub27 mucks (does not show cards). Bets: 15.50. Collects: 32.30. Wins: 16.80.
Player Wollverin does not show cards.Bets: 0. Collects: 0. Wins: 0.
Player meandkids does not show cards.Bets: 0. Collects: 0. Wins: 0.
Player Are you with me does not show cards.Bets: 1. Collects: 0. Loses: 1.
Game ended at: 2016/11/28 20:12:25

Game started
Game ID: 786370506 0.25/0.50 (PRR) Gorgons - 5 (Hold'em)
Seat 6 is the button
Seat 1: caballeroXXX (50.85).
Seat 3: sucazappa (50).
Seat 4: in_ur_i (51.34).
Seat 6: IlxxxlI (23.74).
Player caballeroXXX has small blind (0.25)
Player sucazappa has big blind (0.50)
Player IlxxxlI received card: [2c]
Player IlxxxlI received card: [6h]
Player in_ur_i raises (1.50)
Player IlxxxlI folds
Player caballeroXXX folds
Player sucazappa calls (1)
*** FLOP ***: [As 9c 8s]
Player sucazappa checks
Player in_ur_i bets (2.06)
Player sucazappa calls (2.06)
*** TURN ***: [As 9c 8s] [7s]
Player sucazappa checks
Player in_ur_i checks
*** RIVER ***: [As 9c 8s 7s] [Kh]
Player sucazappa bets (4.67)
Player in_ur_i calls (4.67)
Player in_ur_i mucks cards
------ Summary ------
Pot: 15.88. Rake 0.59. JP fee 0.24
Board: [As 9c 8s 7s Kh]
Player caballeroXXX does not show cards.Bets: 0.25. Collects: 0. Loses: 0.25.
*Player sucazappa shows: Straight to J [Jd 10h]. Bets: 8.23. Collects: 15.88. Wins: 7.65.
Player in_ur_i mucks (does not show cards). Bets: 8.23. Collects: 0. Loses: 8.23.
Player IlxxxlI does not show cards.Bets: 0. Collects: 0. Wins: 0.
Game ended at: 2016/11/28 20:12:24

Game started
Game ID: 786370481 1/2 (PRR) Lakhey (Short) - 2 (Hold'em)
Seat 2 is the button
Seat 1: IlxxxlI (40).
Seat 2: 38979 (136.39).
Seat 3: sheenius81 (147.79).
Seat 4: Are you with me (74.35).
Seat 5: Wollverin (107.24).
Seat 6: dscshift (112.30).
Player sheenius81 has small blind (1)
Player Are you with me has big blind (2)
Player IlxxxlI received card: [9c]
Player IlxxxlI received card: [Qh]
Player Wollverin folds
Player dscshift calls (2)
Player IlxxxlI folds
Player 38979 raises (12)
Player sheenius81 folds
Player Are you with me folds
Player dscshift calls (10)
*** FLOP ***: [7d Kc 9h]
Player dscshift checks
Player 38979 bets (18)
Player dscshift raises (50)
Player 38979 allin (106.39)
Player dscshift allin (50.30)
Uncalled bet (24.09) returned to 38979
*** TURN ***: [7d Kc 9h] [Js]
*** RIVER ***: [7d Kc 9h Js] [3s]
------ Summary ------
Pot: 224.60. Rake 2.76. JP fee 0.24
Board: [7d Kc 9h Js 3s]
Player IlxxxlI does not show cards.Bets: 0. Collects: 0. Wins: 0.
*Player 38979 shows: One pair of As [Ac Ad]. Bets: 112.30. Collects: 224.60. Wins: 112.30.
Player sheenius81 does not show cards.Bets: 1. Collects: 0. Loses: 1.
Player Are you with me does not show cards.Bets: 2. Collects: 0. Loses: 2.
Player Wollverin does not show cards.Bets: 0. Collects: 0. Wins: 0.
Player dscshift shows: One pair of Ks [Kd Ah]. Bets: 112.30. Collects: 0. Loses: 112.30.
Game ended at: 2016/11/28 20:12:33

Game started
Game ID: 786370396 1/2 (PRR) Lakhey (Short) (Hold'em)
Seat 4 is the button
Seat 1: IlxxxlI (48).
Seat 2: 38979 (242.22).
Seat 3: BBDub27 (103).
Seat 4: Wollverin (113.15).
Seat 5: meandkids (121.64).
Seat 6: Are you with me (72.31).
Player meandkids has small blind (1)
Player Are you with me has big blind (2)
Player IlxxxlI received card: [8s]
Player IlxxxlI received card: [Qd]
Player IlxxxlI folds
Player 38979 folds
Player BBDub27 raises (19)
Player Wollverin folds
Player meandkids folds
Player Are you with me folds
Uncalled bet (17) returned to BBDub27
Player BBDub27 mucks cards
------ Summary ------
Pot: 5. Rake 0
Player IlxxxlI does not show cards.Bets: 0. Collects: 0. Wins: 0.
Player 38979 does not show cards.Bets: 0. Collects: 0. Wins: 0.
*Player BBDub27 mucks (does not show cards). Bets: 2. Collects: 5. Wins: 3.
Player Wollverin does not show cards.Bets: 0. Collects: 0. Wins: 0.
Player meandkids does not show cards.Bets: 1. Collects: 0. Loses: 1.
Player Are you with me does not show cards.Bets: 2. Collects: 0. Loses: 2.
Game ended at: 2016/11/28 20:11:33

Game started
Game ID: 786370370 0.25/0.50 (PRR) Gorgons - 5 (Hold'em)
Seat 4 is the button
Seat 1: caballeroXXX (52.35).
Seat 4: in_ur_i (49.75).
Seat 6: IlxxxlI (23.99).
Player IlxxxlI has small blind (0.25)
Player caballeroXXX has big blind (0.50)
Player IlxxxlI received card: [Kc]
Player IlxxxlI received card: [4d]
Player in_ur_i raises (1.50)
Player IlxxxlI folds
Player caballeroXXX calls (1)
*** FLOP ***: [4h Js 6h]
Player caballeroXXX checks
Player in_ur_i bets (1.54)
Player caballeroXXX folds
Uncalled bet (1.54) returned to in_ur_i
Player in_ur_i mucks cards
------ Summary ------
Pot: 3.09. Rake 0.12. JP fee 0.04
Board: [4h Js 6h]
Player caballeroXXX does not show cards.Bets: 1.50. Collects: 0. Loses: 1.50.
*Player in_ur_i mucks (does not show cards). Bets: 1.50. Collects: 3.09. Wins: 1.59.
Player IlxxxlI does not show cards.Bets: 0.25. Collects: 0. Loses: 0.25.
Game ended at: 2016/11/28 20:11:26

Game started
Game ID: 786370266 0.25/0.50 (PRR) Gorgons - 5 (Hold'em)
Seat 1 is the button
Seat 1: caballeroXXX (52.35).
Seat 4: in_ur_i (50.25).
Seat 6: IlxxxlI (23.54).
Player in_ur_i has small blind (0.25)
Player IlxxxlI has big blind (0.50)
Player IlxxxlI received card: [Ks]
Player IlxxxlI received card: [9h]
Player caballeroXXX folds
Player in_ur_i calls (0.25)
Player IlxxxlI checks
*** FLOP ***: [5c 4s 4h]
Player in_ur_i checks
Player IlxxxlI bets (0.63)
Player in_ur_i folds
Uncalled bet (0.63) returned to IlxxxlI
Player IlxxxlI mucks cards
------ Summary ------
Pot: 0.95. Rake 0.05
Board: [5c 4s 4h]
Player caballeroXXX does not show cards.Bets: 0. Collects: 0. Wins: 0.
Player in_ur_i does not show cards.Bets: 0.50. Collects: 0. Loses: 0.50.
*Player IlxxxlI mucks (does not show cards). Bets: 0.50. Collects: 0.95. Wins: 0.45.
Game ended at: 2016/11/28 20:10:52

Game started
Game ID: 786370253 1/2 (PRR) Lakhey (Short) (Hold'em)
Seat 3 is the button
Seat 1: IlxxxlI (48).
Seat 2: 38979 (242.22).
Seat 3: BBDub27 (100).
Seat 4: Wollverin (114.15).
Seat 5: meandkids (123.64).
Seat 6: Are you with me (72.31).
Player Wollverin has small blind (1)
Player meandkids has big blind (2)
Player IlxxxlI received card: [8s]
Player IlxxxlI received card: [6s]
Player Are you with me folds
Player IlxxxlI folds
Player 38979 folds
Player BBDub27 raises (7)
Player Wollverin folds
Player meandkids folds
Uncalled bet (5) returned to BBDub27
Player BBDub27 mucks cards
------ Summary ------
Pot: 5. Rake 0
Player IlxxxlI does not show cards.Bets: 0. Collects: 0. Wins: 0.
Player 38979 does not show cards.Bets: 0. Collects: 0. Wins: 0.
*Player BBDub27 mucks (does not show cards). Bets: 2. Collects: 5. Wins: 3.
Player Wollverin does not show cards.Bets: 1. Collects: 0. Loses: 1.
Player meandkids does not show cards.Bets: 2. Collects: 0. Loses: 2.
Player Are you with me does not show cards.Bets: 0. Collects: 0. Wins: 0.
Game ended at: 2016/11/28 20:10:59

Game started
Game ID: 786370208 0.25/0.50 (PRR) Gorgons - 5 (Hold'em)
Seat 6 is the button
Seat 1: caballeroXXX (52.60).
Seat 4: in_ur_i (50).
Seat 6: IlxxxlI (23.54).
Player caballeroXXX has small blind (0.25)
Player in_ur_i has big blind (0.50)
Player IlxxxlI received card: [6c]
Player IlxxxlI received card: [Kd]
Player IlxxxlI folds
Player caballeroXXX folds
Uncalled bet (0.25) returned to in_ur_i
Player in_ur_i mucks cards
------ Summary ------
Pot: 0.50. Rake 0
Player caballeroXXX does not show cards.Bets: 0.25. Collects: 0. Loses: 0.25.
*Player in_ur_i mucks (does not show cards). Bets: 0.25. Collects: 0.50. Wins: 0.25.
Player IlxxxlI does not show cards.Bets: 0. Collects: 0. Wins: 0.
Game ended at: 2016/11/28 20:10:27

Game started
Game ID: 786370130 0.25/0.50 (PRR) Gorgons - 5 (Hold'em)
Seat 2 is the button
Seat 1: caballeroXXX (52.10).
Seat 2: 38979 (58.59).
Seat 6: IlxxxlI (24.04).
Player IlxxxlI has small blind (0.25)
Player caballeroXXX has big blind (0.50)
Player IlxxxlI received card: [8c]
Player IlxxxlI received card: [9d]
Player 38979 folds
Player IlxxxlI calls (0.25)
Player caballeroXXX raises (1)
Player IlxxxlI folds
Uncalled bet (1) returned to caballeroXXX
Player caballeroXXX mucks cards
------ Summary ------
Pot: 1. Rake 0
*Player caballeroXXX mucks (does not show cards). Bets: 0.50. Collects: 1. Wins: 0.50.
Player 38979 does not show cards.Bets: 0. Collects: 0. Wins: 0.
Player IlxxxlI does not show cards.Bets: 0.50. Collects: 0. Loses: 0.50.
Game ended at: 2016/11/28 20:10:14

Game started
Game ID: 786370081 0.50/1 (PRR) Kraken (short) (Hold'em)
Seat 5 is the button
Seat 1: Cinch23 (69.83).
Seat 5: IlxxxlI (31.83).
Player IlxxxlI has small blind (0.50)
Player Cinch23 has big blind (1)
Player IlxxxlI received card: [As]
Player IlxxxlI received card: [6h]
Player IlxxxlI raises (2)
Player Cinch23 calls (1.50)
*** FLOP ***: [9d 2c 7s]
Player Cinch23 checks
Player IlxxxlI bets (1.58)
Player Cinch23 calls (1.58)
*** TURN ***: [9d 2c 7s] [Js]
Player Cinch23 checks
Player IlxxxlI checks
*** RIVER ***: [9d 2c 7s Js] [Jc]
Player Cinch23 bets (3)
Player IlxxxlI folds
Uncalled bet (3) returned to Cinch23
Player Cinch23 mucks cards
------ Summary ------
Pot: 7.76. Rake 0.36. JP fee 0.04
Board: [9d 2c 7s Js Jc]
*Player Cinch23 mucks (does not show cards). Bets: 4.08. Collects: 7.76. Wins: 3.68.
Player IlxxxlI does not show cards.Bets: 4.08. Collects: 0. Loses: 4.08.
Game ended at: 2016/11/28 20:10:24

Game started
Game ID: 786370059 1/2 (PRR) Lakhey (Short) (Hold'em)
Seat 2 is the button
Seat 1: IlxxxlI (48).
Seat 2: 38979 (234.22).
Seat 3: BBDub27 (100).
Seat 4: Wollverin (116.15).
Seat 5: meandkids (123.64).
Seat 6: Are you with me (77.31).
Player BBDub27 has small blind (1)
Player Wollverin has big blind (2)
Player IlxxxlI received card: [3h]
Player IlxxxlI received card: [5s]
Player meandkids folds
Player Are you with me raises (5)
Player IlxxxlI folds
Player 38979 raises (17)
Player BBDub27 folds
Player Wollverin folds
Player Are you with me folds
Uncalled bet (12) returned to 38979
Player 38979 mucks cards
------ Summary ------
Pot: 13. Rake 0
Player IlxxxlI does not show cards.Bets: 0. Collects: 0. Wins: 0.
*Player 38979 mucks (does not show cards). Bets: 5. Collects: 13. Wins: 8.
Player BBDub27 does not show cards.Bets: 1. Collects: 0. Loses: 1.
Player Wollverin does not show cards.Bets: 2. Collects: 0. Loses: 2.
Player meandkids does not show cards.Bets: 0. Collects: 0. Wins: 0.
Player Are you with me does not show cards.Bets: 5. Collects: 0. Loses: 5.
Game ended at: 2016/11/28 20:10:26

Game started
Game ID: 786370039 0.50/1 (PRR) Kraken (short) (Hold'em)
Seat 1 is the button
Seat 1: Cinch23 (68.83).
Seat 5: IlxxxlI (32.83).
Player Cinch23 has small blind (0.50)
Player IlxxxlI has big blind (1)
Player IlxxxlI received card: [3s]
Player IlxxxlI received card: [Qd]
Player Cinch23 raises (1.50)
Player IlxxxlI folds
Uncalled bet (1) returned to Cinch23
Player Cinch23 mucks cards
------ Summary ------
Pot: 2. Rake 0
*Player Cinch23 mucks (does not show cards). Bets: 1. Collects: 2. Wins: 1.
Player IlxxxlI does not show cards.Bets: 1. Collects: 0. Loses: 1.
Game ended at: 2016/11/28 20:9:39

Game started
Game ID: 786370001 0.25/0.50 (PRR) Gorgons - 5 (Hold'em)
Seat 1 is the button
Seat 1: caballeroXXX (60.35).
Seat 2: 38979 (50.69).
Seat 6: IlxxxlI (24.54).
Player 38979 has small blind (0.25)
Player IlxxxlI has big blind (0.50)
Player IlxxxlI received card: [Ah]
Player IlxxxlI received card: [5s]
Player caballeroXXX raises (1)
Player 38979 raises (3.25)
Player IlxxxlI folds
Player caballeroXXX calls (2.50)
*** FLOP ***: [Qd 7c 6d]
Player 38979 bets (4.75)
Player caballeroXXX calls (4.75)
*** TURN ***: [Qd 7c 6d] [7h]
Player 38979 bets (8.50)
Player caballeroXXX folds
Uncalled bet (8.50) returned to 38979
Player 38979 mucks cards
------ Summary ------
Pot: 16.15. Rake 0.77. JP fee 0.08
Board: [Qd 7c 6d 7h]
Player caballeroXXX does not show cards.Bets: 8.25. Collects: 0. Loses: 8.25.
*Player 38979 mucks (does not show cards). Bets: 8.25. Collects: 16.15. Wins: 7.90.
Player IlxxxlI does not show cards.Bets: 0.50. Collects: 0. Loses: 0.50.
Game ended at: 2016/11/28 20:9:55

Game started
Game ID: 786369988 1/2 (PRR) Lakhey (Short) - 2 (Hold'em)
Seat 1 is the button
Seat 1: IlxxxlI (40).
Seat 2: 38979 (181.39).
Seat 3: sheenius81 (100.79).
Seat 4: Are you with me (79.35).
Seat 5: Wollverin (107.24).
Seat 6: dscshift (112.30).
Player 38979 has small blind (1)
Player sheenius81 has big blind (2)
Player IlxxxlI received card: [Jd]
Player IlxxxlI received card: [8h]
Player Are you with me raises (5)
Player Wollverin folds
Player dscshift folds
Player IlxxxlI folds
Player 38979 raises (16)
Player sheenius81 calls (15)
Player Are you with me folds
*** FLOP ***: [5c 9s Kc]
Player 38979 checks
Player sheenius81 checks
*** TURN ***: [5c 9s Kc] [4s]
Player 38979 checks
Player sheenius81 checks
*** RIVER ***: [5c 9s Kc 4s] [6s]
Player 38979 bets (28)
Player sheenius81 allin (83.79)
Player 38979 folds
Uncalled bet (55.79) returned to sheenius81
Player sheenius81 mucks cards
------ Summary ------
Pot: 92. Rake 2.76. JP fee 0.24
Board: [5c 9s Kc 4s 6s]
Player IlxxxlI does not show cards.Bets: 0. Collects: 0. Wins: 0.
Player 38979 does not show cards.Bets: 45. Collects: 0. Loses: 45.
*Player sheenius81 mucks (does not show cards). Bets: 45. Collects: 92. Wins: 47.
Player Are you with me does not show cards.Bets: 5. Collects: 0. Loses: 5.
Player Wollverin does not show cards.Bets: 0. Collects: 0. Wins: 0.
Player dscshift does not show cards.Bets: 0. Collects: 0. Wins: 0.
Game ended at: 2016/11/28 20:11:22

Game started
Game ID: 786369966 0.25/0.50 (PRR) Gorgons - 5 (Hold'em)
Seat 6 is the button
Seat 1: caballeroXXX (60.60).
Seat 2: 38979 (50.44).
Seat 6: IlxxxlI (24.54).
Player caballeroXXX has small blind (0.25)
Player 38979 has big blind (0.50)
Player IlxxxlI received card: [6s]
Player IlxxxlI received card: [Kd]
Player IlxxxlI folds
Player caballeroXXX folds
Uncalled bet (0.25) returned to 38979
Player 38979 mucks cards
------ Summary ------
Pot: 0.50. Rake 0
Player caballeroXXX does not show cards.Bets: 0.25. Collects: 0. Loses: 0.25.
*Player 38979 mucks (does not show cards). Bets: 0.25. Collects: 0.50. Wins: 0.25.
Player IlxxxlI does not show cards.Bets: 0. Collects: 0. Wins: 0.
Game ended at: 2016/11/28 20:9:17

Game started
Game ID: 786369878 0.25/0.50 (PRR) Gorgons - 5 (Hold'em)
Seat 2 is the button
Seat 1: caballeroXXX (60.35).
Seat 2: 38979 (50.44).
Seat 6: IlxxxlI (24.79).
Player IlxxxlI has small blind (0.25)
Player caballeroXXX has big blind (0.50)
Player IlxxxlI received card: [8h]
Player IlxxxlI received card: [4h]
Player 38979 folds
Player IlxxxlI folds
Uncalled bet (0.25) returned to caballeroXXX
Player caballeroXXX mucks cards
------ Summary ------
Pot: 0.50. Rake 0
*Player caballeroXXX mucks (does not show cards). Bets: 0.25. Collects: 0.50. Wins: 0.25.
Player 38979 does not show cards.Bets: 0. Collects: 0. Wins: 0.
Player IlxxxlI does not show cards.Bets: 0.25. Collects: 0. Loses: 0.25.
Game ended at: 2016/11/28 20:9:8

Game started
Game ID: 786369869 0.50/1 (PRR) Kraken (short) (Hold'em)
Seat 5 is the button
Seat 1: Cinch23 (66.83).
Seat 2: 38979 (86.20).
Seat 5: IlxxxlI (32.83).
Player Cinch23 has small blind (0.50)
Player 38979 has big blind (1)
Player IlxxxlI received card: [Qs]
Player IlxxxlI received card: [4c]
Player IlxxxlI folds
Player Cinch23 raises (1.50)
Player 38979 folds
Uncalled bet (1) returned to Cinch23
Player Cinch23 mucks cards
------ Summary ------
Pot: 2. Rake 0
*Player Cinch23 mucks (does not show cards). Bets: 1. Collects: 2. Wins: 1.
Player 38979 does not show cards.Bets: 1. Collects: 0. Loses: 1.
Player IlxxxlI does not show cards.Bets: 0. Collects: 0. Wins: 0.
Game ended at: 2016/11/28 20:9:5

Game started
Game ID: 786369810 1/2 (PRR) Lakhey (Short) (Hold'em)
Seat 1 is the button
Seat 1: IlxxxlI (40).
Seat 2: 38979 (235.22).
Seat 3: BBDub27 (100).
Seat 4: Wollverin (116.15).
Seat 5: meandkids (123.64).
Seat 6: Are you with me (82.31).
Player 38979 has small blind (1)
Player BBDub27 has big blind (2)
Player IlxxxlI received card: [6h]
Player IlxxxlI received card: [6s]
Player Wollverin folds
Player meandkids folds
Player Are you with me raises (5)
Player IlxxxlI allin (40)
Player 38979 folds
Player BBDub27 is timed out.
Player BBDub27 folds
Player Are you with me folds
Uncalled bet (35) returned to IlxxxlI
Player IlxxxlI mucks cards
------ Summary ------
Pot: 13. Rake 0
*Player IlxxxlI mucks (does not show cards). Bets: 5. Collects: 13. Wins: 8.
Player 38979 does not show cards.Bets: 1. Collects: 0. Loses: 1.
Player BBDub27 does not show cards.Bets: 2. Collects: 0. Loses: 2.
Player Wollverin does not show cards.Bets: 0. Collects: 0. Wins: 0.
Player meandkids does not show cards.Bets: 0. Collects: 0. Wins: 0.
Player Are you with me does not show cards.Bets: 5. Collects: 0. Loses: 5.
Game ended at: 2016/11/28 20:9:33

Game started
Game ID: 786369808 0.25/0.50 (PRR) Gorgons - 8 (Hold'em)
Seat 5 is the button
Seat 2: Cinch23 (30.60).
Seat 5: IlxxxlI (41).
Seat 6: caballeroXXX (149.87).
Player caballeroXXX has small blind (0.25)
Player Cinch23 has big blind (0.50)
Player IlxxxlI received card: [5d]
Player IlxxxlI received card: [5s]
Player IlxxxlI raises (1.50)
Player caballeroXXX folds
Player Cinch23 calls (1)
*** FLOP ***: [4c 10s Jh]
Player Cinch23 checks
Player IlxxxlI checks
*** TURN ***: [4c 10s Jh] [As]
Player Cinch23 checks
Player IlxxxlI checks
*** RIVER ***: [4c 10s Jh As] [Jd]
Player Cinch23 checks
Player IlxxxlI checks
Player Cinch23 mucks cards
------ Summary ------
Pot: 3.09. Rake 0.12. JP fee 0.04
Board: [4c 10s Jh As Jd]
Player Cinch23 mucks (does not show cards). Bets: 1.50. Collects: 0. Loses: 1.50.
*Player IlxxxlI shows: Two pairs. Js and 5s [5d 5s]. Bets: 1.50. Collects: 3.09. Wins: 1.59.
Player caballeroXXX does not show cards.Bets: 0.25. Collects: 0. Loses: 0.25.
Game ended at: 2016/11/28 20:9:23

Game started
Game ID: 786369806 1/2 (PRR) Lakhey (Short) - 2 (Hold'em)
Seat 6 is the button
Seat 1: IlxxxlI (40).
Seat 2: 38979 (183.39).
Seat 3: sheenius81 (100.79).
Seat 4: Are you with me (76.35).
Seat 5: Wollverin (107.24).
Seat 6: dscshift (112.30).
Player IlxxxlI has small blind (1)
Player 38979 has big blind (2)
Player IlxxxlI received card: [9d]
Player IlxxxlI received card: [6d]
Player sheenius81 folds
Player Are you with me raises (5)
Player Wollverin folds
Player dscshift folds
Player IlxxxlI folds
Player 38979 folds
Uncalled bet (3) returned to Are you with me
Player Are you with me mucks cards
------ Summary ------
Pot: 5. Rake 0
Player IlxxxlI does not show cards.Bets: 1. Collects: 0. Loses: 1.
Player 38979 does not show cards.Bets: 2. Collects: 0. Loses: 2.
Player sheenius81 does not show cards.Bets: 0. Collects: 0. Wins: 0.
*Player Are you with me mucks (does not show cards). Bets: 2. Collects: 5. Wins: 3.
Player Wollverin does not show cards.Bets: 0. Collects: 0. Wins: 0.
Player dscshift does not show cards.Bets: 0. Collects: 0. Wins: 0.
Game ended at: 2016/11/28 20:9:14

Game started
Game ID: 786369791 0.25/0.50 (PRR) Gorgons - 5 (Hold'em)
Seat 1 is the button
Seat 1: caballeroXXX (59.60).
Seat 2: 38979 (50.69).
Seat 6: IlxxxlI (25.29).
Player 38979 has small blind (0.25)
Player IlxxxlI has big blind (0.50)
Player IlxxxlI received card: [4h]
Player IlxxxlI received card: [8c]
Player caballeroXXX raises (1)
Player 38979 folds
Player IlxxxlI folds
Uncalled bet (0.50) returned to caballeroXXX
Player caballeroXXX mucks cards
------ Summary ------
Pot: 1.25. Rake 0
*Player caballeroXXX mucks (does not show cards). Bets: 0.50. Collects: 1.25. Wins: 0.75.
Player 38979 does not show cards.Bets: 0.25. Collects: 0. Loses: 0.25.
Player IlxxxlI does not show cards.Bets: 0.50. Collects: 0. Loses: 0.50.
Game ended at: 2016/11/28 20:8:46

Game started
Game ID: 786369771 0.50/1 (PRR) Kraken (short) (Hold'em)
Seat 2 is the button
Seat 1: Cinch23 (67.83).
Seat 2: 38979 (84.70).
Seat 5: IlxxxlI (33.33).
Player IlxxxlI has small blind (0.50)
Player Cinch23 has big blind (1)
Player IlxxxlI received card: [9c]
Player IlxxxlI received card: [2h]
Player 38979 raises (2)
Player IlxxxlI folds
Player Cinch23 folds
Uncalled bet (1) returned to 38979
Player 38979 mucks cards
------ Summary ------
Pot: 2.50. Rake 0
Player Cinch23 does not show cards.Bets: 1. Collects: 0. Loses: 1.
*Player 38979 mucks (does not show cards). Bets: 1. Collects: 2.50. Wins: 1.50.
Player IlxxxlI does not show cards.Bets: 0.50. Collects: 0. Loses: 0.50.
Game ended at: 2016/11/28 20:8:45

Game started
Game ID: 786369721 0.25/0.50 (PRR) Gorgons - 5 (Hold'em)
Seat 6 is the button
Seat 1: caballeroXXX (59.85).
Seat 2: 38979 (51.19).
Seat 3: meandkids (112.19).
Seat 6: IlxxxlI (24.54).
Player caballeroXXX has small blind (0.25)
Player 38979 has big blind (0.50)
Player IlxxxlI received card: [10h]
Player IlxxxlI received card: [Qh]
Player meandkids folds
Player IlxxxlI raises (1.50)
Player caballeroXXX folds
Player 38979 folds
Uncalled bet (1) returned to IlxxxlI
Player IlxxxlI mucks cards
------ Summary ------
Pot: 1.25. Rake 0
Player caballeroXXX does not show cards.Bets: 0.25. Collects: 0. Loses: 0.25.
Player 38979 does not show cards.Bets: 0.50. Collects: 0. Loses: 0.50.
Player meandkids does not show cards.Bets: 0. Collects: 0. Wins: 0.
*Player IlxxxlI mucks (does not show cards). Bets: 0.50. Collects: 1.25. Wins: 0.75.
Game ended at: 2016/11/28 20:8:27

Game started
Game ID: 786369693 0.50/1 (PRR) Kraken (short) (Hold'em)
Seat 1 is the button
Seat 1: Cinch23 (67.83).
Seat 2: 38979 (83.70).
Seat 5: IlxxxlI (34.33).
Player 38979 has small blind (0.50)
Player IlxxxlI has big blind (1)
Player IlxxxlI received card: [3c]
Player IlxxxlI received card: [9c]
Player Cinch23 folds
Player 38979 raises (2.50)
Player IlxxxlI folds
Uncalled bet (2) returned to 38979
Player 38979 mucks cards
------ Summary ------
Pot: 2. Rake 0
Player Cinch23 does not show cards.Bets: 0. Collects: 0. Wins: 0.
*Player 38979 mucks (does not show cards). Bets: 1. Collects: 2. Wins: 1.
Player IlxxxlI does not show cards.Bets: 1. Collects: 0. Loses: 1.
Game ended at: 2016/11/28 20:8:22

Game started
Game ID: 786369591 0.25/0.50 (PRR) Gorgons - 5 (Hold'em)
Seat 3 is the button
Seat 1: caballeroXXX (60.35).
Seat 2: 38979 (51.19).
Seat 3: meandkids (112.19).
Seat 6: IlxxxlI (24.09).
Player IlxxxlI has small blind (0.25)
Player caballeroXXX has big blind (0.50)
Player IlxxxlI received card: [4d]
Player IlxxxlI received card: [5d]
Player 38979 folds
Player meandkids folds
Player IlxxxlI calls (0.25)
Player caballeroXXX checks
*** FLOP ***: [Js Ad Kd]
Player IlxxxlI bets (0.63)
Player caballeroXXX folds
Uncalled bet (0.63) returned to IlxxxlI
Player IlxxxlI mucks cards
------ Summary ------
Pot: 0.95. Rake 0.05
Board: [Js Ad Kd]
Player caballeroXXX does not show cards.Bets: 0.50. Collects: 0. Loses: 0.50.
Player 38979 does not show cards.Bets: 0. Collects: 0. Wins: 0.
Player meandkids does not show cards.Bets: 0. Collects: 0. Wins: 0.
*Player IlxxxlI mucks (does not show cards). Bets: 0.50. Collects: 0.95. Wins: 0.45.
Game ended at: 2016/11/28 20:8:9

Game started
Game ID: 786369582 1/2 (PRR) Lakhey (Short) - 2 (Hold'em)
Seat 5 is the button
Seat 1: IlxxxlI (40).
Seat 2: 38979 (183.39).
Seat 3: sheenius81 (100.79).
Seat 4: Are you with me (76.35).
Seat 5: Wollverin (111.24).
Seat 6: dscshift (106.80).
Player dscshift has small blind (1)
Player IlxxxlI has big blind (2)
Player IlxxxlI received card: [Jd]
Player IlxxxlI received card: [4s]
Player 38979 folds
Player sheenius81 folds
Player Are you with me folds
Player Wollverin raises (4)
Player dscshift calls (3)
Player IlxxxlI folds
*** FLOP ***: [Qc 7c Kd]
Player dscshift checks
Player Wollverin checks
*** TURN ***: [Qc 7c Kd] [4h]
Player dscshift bets (10)
Player Wollverin folds
Uncalled bet (10) returned to dscshift
Player dscshift mucks cards
------ Summary ------
Pot: 9.50. Rake 0.34. JP fee 0.16
Board: [Qc 7c Kd 4h]
Player IlxxxlI does not show cards.Bets: 2. Collects: 0. Loses: 2.
Player 38979 does not show cards.Bets: 0. Collects: 0. Wins: 0.
Player sheenius81 does not show cards.Bets: 0. Collects: 0. Wins: 0.
Player Are you with me does not show cards.Bets: 0. Collects: 0. Wins: 0.
Player Wollverin does not show cards.Bets: 4. Collects: 0. Loses: 4.
*Player dscshift mucks (does not show cards). Bets: 4. Collects: 9.50. Wins: 5.50.
Game ended at: 2016/11/28 20:8:30

Game started
Game ID: 786369581 0.25/0.50 (PRR) Gorgons - 8 (Hold'em)
Seat 2 is the button
Seat 2: Cinch23 (51.35).
Seat 5: IlxxxlI (20.75).
Seat 6: caballeroXXX (150.37).
Player IlxxxlI has small blind (0.25)
Player caballeroXXX has big blind (0.50)
Player IlxxxlI received card: [Jc]
Player IlxxxlI received card: [Ac]
Player Cinch23 raises (1)
Player IlxxxlI raises (2.33)
Player caballeroXXX folds
Player Cinch23 raises (7)
Player IlxxxlI calls (5.42)
*** FLOP ***: [3d Jh Jd]
Player IlxxxlI checks
Player Cinch23 allin (43.35)
Player IlxxxlI allin (12.75)
Uncalled bet (30.60) returned to Cinch23
*** TURN ***: [3d Jh Jd] [8c]
*** RIVER ***: [3d Jh Jd 8c] [Qs]
------ Summary ------
Pot: 41. Rake 0.92. JP fee 0.08
Board: [3d Jh Jd 8c Qs]
Player Cinch23 shows: One pair of Js [As Ks]. Bets: 20.75. Collects: 0. Loses: 20.75.
*Player IlxxxlI shows: Three Of Kind of Js [Jc Ac]. Bets: 20.75. Collects: 41. Wins: 20.25.
Player caballeroXXX does not show cards.Bets: 0.50. Collects: 0. Loses: 0.50.
Game ended at: 2016/11/28 20:8:29

Game started
Game ID: 786369563 0.50/1 (PRR) Kraken (short) (Hold'em)
Seat 5 is the button
Seat 1: Cinch23 (68.33).
Seat 2: 38979 (73.20).
Seat 5: IlxxxlI (45.33).
Player Cinch23 has small blind (0.50)
Player 38979 has big blind (1)
Player IlxxxlI received card: [6h]
Player IlxxxlI received card: [6s]
Player IlxxxlI raises (3)
Player Cinch23 folds
Player 38979 raises (10)
Player IlxxxlI calls (8)
*** FLOP ***: [4d 2c 8s]
Player 38979 bets (14)
Player IlxxxlI folds
Uncalled bet (14) returned to 38979
Player 38979 mucks cards
------ Summary ------
Pot: 21.50. Rake 0.92. JP fee 0.08
Board: [4d 2c 8s]
Player Cinch23 does not show cards.Bets: 0.50. Collects: 0. Loses: 0.50.
*Player 38979 mucks (does not show cards). Bets: 11. Collects: 21.50. Wins: 10.50.
Player IlxxxlI does not show cards.Bets: 11. Collects: 0. Loses: 11.
Game ended at: 2016/11/28 20:8:1

Game started
Game ID: 786369527 1/2 (PRR) Lakhey (Short) (Hold'em)
Seat 6 is the button
Seat 1: IlxxxlI (40).
Seat 2: 38979 (227.67).
Seat 3: BBDub27 (100).
Seat 4: Wollverin (116.15).
Seat 5: meandkids (123.64).
Seat 6: Are you with me (89.64).
Player IlxxxlI has small blind (1)
Player 38979 has big blind (2)
Player IlxxxlI received card: [3c]
Player IlxxxlI received card: [4d]
Player BBDub27 is timed out.
Player BBDub27 folds
Player Wollverin folds
Player meandkids folds
Player Are you with me raises (4.20)
Player IlxxxlI folds
Player 38979 calls (2.20)
*** FLOP ***: [2s Ks 7c]
Player 38979 checks
Player Are you with me bets (3.13)
Player 38979 calls (3.13)
*** TURN ***: [2s Ks 7c] [2c]
Player 38979 checks
Player Are you with me checks
*** RIVER ***: [2s Ks 7c 2c] [10s]
Player 38979 bets (12)
Player Are you with me folds
Uncalled bet (12) returned to 38979
Player 38979 mucks cards
------ Summary ------
Pot: 14.88. Rake 0.54. JP fee 0.24
Board: [2s Ks 7c 2c 10s]
Player IlxxxlI does not show cards.Bets: 1. Collects: 0. Loses: 1.
*Player 38979 mucks (does not show cards). Bets: 7.33. Collects: 14.88. Wins: 7.55.
Player BBDub27 does not show cards.Bets: 0. Collects: 0. Wins: 0.
Player Wollverin does not show cards.Bets: 0. Collects: 0. Wins: 0.
Player meandkids does not show cards.Bets: 0. Collects: 0. Wins: 0.
Player Are you with me does not show cards.Bets: 7.33. Collects: 0. Loses: 7.33.
Game ended at: 2016/11/28 20:8:31

Game started
Game ID: 786369518 0.25/0.50 (PRR) Gorgons - 5 (Hold'em)
Seat 2 is the button
Seat 1: caballeroXXX (60.35).
Seat 2: 38979 (51.19).
Seat 3: meandkids (112.44).
Seat 5: SenNoSen (50).
Seat 6: IlxxxlI (23.84).
Player meandkids has small blind (0.25)
Player SenNoSen sitting out
Player IlxxxlI has big blind (0.50)
Player IlxxxlI received card: [Qd]
Player IlxxxlI received card: [10c]
Player caballeroXXX folds
Player 38979 folds
Player meandkids folds
Uncalled bet (0.25) returned to IlxxxlI
Player IlxxxlI mucks cards
------ Summary ------
Pot: 0.50. Rake 0
Player caballeroXXX does not show cards.Bets: 0. Collects: 0. Wins: 0.
Player 38979 does not show cards.Bets: 0. Collects: 0. Wins: 0.
Player meandkids does not show cards.Bets: 0.25. Collects: 0. Loses: 0.25.
Player SenNoSen does not show cards.Bets: 0. Collects: 0. Wins: 0.
*Player IlxxxlI mucks (does not show cards). Bets: 0.25. Collects: 0.50. Wins: 0.25.
Game ended at: 2016/11/28 20:7:35

Game started
Game ID: 786369488 0.25/0.50 (PRR) Gorgons - 8 (Hold'em)
Seat 6 is the button
Seat 2: Cinch23 (51.60).
Seat 5: IlxxxlI (20.50).
Seat 6: caballeroXXX (150.37).
Player Cinch23 has small blind (0.25)
Player IlxxxlI has big blind (0.50)
Player IlxxxlI received card: [9h]
Player IlxxxlI received card: [Qd]
Player caballeroXXX folds
Player Cinch23 folds
Uncalled bet (0.25) returned to IlxxxlI
Player IlxxxlI mucks cards
------ Summary ------
Pot: 0.50. Rake 0
Player Cinch23 does not show cards.Bets: 0.25. Collects: 0. Loses: 0.25.
*Player IlxxxlI mucks (does not show cards). Bets: 0.25. Collects: 0.50. Wins: 0.25.
Player caballeroXXX does not show cards.Bets: 0. Collects: 0. Wins: 0.
Game ended at: 2016/11/28 20:7:32

Game started
Game ID: 786369469 0.50/1 (PRR) Kraken (short) (Hold'em)
Seat 2 is the button
Seat 1: Cinch23 (68.33).
Seat 2: 38979 (76.20).
Seat 5: IlxxxlI (41.33).
Seat 6: meandkids (50).
Player IlxxxlI has small blind (0.50)
Player meandkids has big blind (1)
Player IlxxxlI received card: [8s]
Player IlxxxlI received card: [9s]
Player Cinch23 folds
Player 38979 raises (3)
Player IlxxxlI raises (7.09)
Player meandkids folds
Player 38979 folds
Uncalled bet (4.59) returned to IlxxxlI
Player IlxxxlI mucks cards
------ Summary ------
Pot: 7. Rake 0
Player Cinch23 does not show cards.Bets: 0. Collects: 0. Wins: 0.
Player 38979 does not show cards.Bets: 3. Collects: 0. Loses: 3.
*Player IlxxxlI mucks (does not show cards). Bets: 3. Collects: 7. Wins: 4.
Player meandkids does not show cards.Bets: 1. Collects: 0. Loses: 1.
Game ended at: 2016/11/28 20:7:28

Game started
Game ID: 786369395 0.25/0.50 (PRR) Gorgons - 5 (Hold'em)
Seat 1 is the button
Seat 1: caballeroXXX (60.35).
Seat 2: 38979 (51.44).
Seat 3: meandkids (112.94).
Seat 5: SenNoSen (50).
Seat 6: IlxxxlI (23.09).
Player 38979 has small blind (0.25)
Player meandkids has big blind (0.50)
Player IlxxxlI received card: [Js]
Player IlxxxlI received card: [As]
Player SenNoSen folds
Player IlxxxlI raises (1.20)
Player caballeroXXX folds
Player 38979 folds
Player meandkids folds
Uncalled bet (0.70) returned to IlxxxlI
Player IlxxxlI mucks cards
------ Summary ------
Pot: 1.25. Rake 0
Player caballeroXXX does not show cards.Bets: 0. Collects: 0. Wins: 0.
Player 38979 does not show cards.Bets: 0.25. Collects: 0. Loses: 0.25.
Player meandkids does not show cards.Bets: 0.50. Collects: 0. Loses: 0.50.
Player SenNoSen does not show cards.Bets: 0. Collects: 0. Wins: 0.
*Player IlxxxlI mucks (does not show cards). Bets: 0.50. Collects: 1.25. Wins: 0.75.
Game ended at: 2016/11/28 20:7:19

Game started
Game ID: 786369348 0.25/0.50 (PRR) Gorgons - 8 (Hold'em)
Seat 5 is the button
Seat 2: Cinch23 (53.10).
Seat 5: IlxxxlI (20.50).
Seat 6: caballeroXXX (149.02).
Player caballeroXXX has small blind (0.25)
Player Cinch23 has big blind (0.50)
Player IlxxxlI received card: [8h]
Player IlxxxlI received card: [2d]
Player IlxxxlI folds
Player caballeroXXX raises (1.25)
Player Cinch23 calls (1)
*** FLOP ***: [9h Qd Ac]
Player caballeroXXX checks
Player Cinch23 checks
*** TURN ***: [9h Qd Ac] [9s]
Player caballeroXXX bets (1.75)
Player Cinch23 folds
Uncalled bet (1.75) returned to caballeroXXX
Player caballeroXXX mucks cards
------ Summary ------
Pot: 2.85. Rake 0.11. JP fee 0.04
Board: [9h Qd Ac 9s]
Player Cinch23 does not show cards.Bets: 1.50. Collects: 0. Loses: 1.50.
Player IlxxxlI does not show cards.Bets: 0. Collects: 0. Wins: 0.
*Player caballeroXXX mucks (does not show cards). Bets: 1.50. Collects: 2.85. Wins: 1.35.
Game ended at: 2016/11/28 20:7:11

Game started
Game ID: 786369338 1/2 (PRR) Lakhey (Short) - 2 (Hold'em)
Seat 4 is the button
Seat 1: IlxxxlI (40).
Seat 2: 38979 (183.39).
Seat 3: sheenius81 (100.79).
Seat 4: Are you with me (70).
Seat 5: Wollverin (112.24).
Seat 6: dscshift (112.80).
Player Wollverin has small blind (1)
Player dscshift has big blind (2)
Player IlxxxlI received card: [3s]
Player IlxxxlI received card: [Jd]
Player IlxxxlI folds
Player 38979 folds
Player sheenius81 folds
Player Are you with me raises (6)
Player Wollverin folds
Player dscshift calls (4)
*** FLOP ***: [As Ah 8s]
Player dscshift checks
Player Are you with me bets (6.17)
Player dscshift folds
Uncalled bet (6.17) returned to Are you with me
Player Are you with me mucks cards
------ Summary ------
Pot: 12.35. Rake 0.45. JP fee 0.20
Board: [As Ah 8s]
Player IlxxxlI does not show cards.Bets: 0. Collects: 0. Wins: 0.
Player 38979 does not show cards.Bets: 0. Collects: 0. Wins: 0.
Player sheenius81 does not show cards.Bets: 0. Collects: 0. Wins: 0.
*Player Are you with me mucks (does not show cards). Bets: 6. Collects: 12.35. Wins: 6.35.
Player Wollverin does not show cards.Bets: 1. Collects: 0. Loses: 1.
Player dscshift does not show cards.Bets: 6. Collects: 0. Loses: 6.
Game ended at: 2016/11/28 20:7:33

Game started
Game ID: 786369291 0.25/0.50 (PRR) Gorgons - 8 (Hold'em)
Seat 2 is the button
Seat 2: Cinch23 (53.10).
Seat 5: IlxxxlI (20).
Seat 6: caballeroXXX (149.52).
Player IlxxxlI has small blind (0.25)
Player caballeroXXX has big blind (0.50)
Player IlxxxlI received card: [10d]
Player IlxxxlI received card: [Qs]
Player Cinch23 folds
Player IlxxxlI raises (1)
Player caballeroXXX folds
Uncalled bet (0.75) returned to IlxxxlI
Player IlxxxlI mucks cards
------ Summary ------
Pot: 1. Rake 0
Player Cinch23 does not show cards.Bets: 0. Collects: 0. Wins: 0.
*Player IlxxxlI mucks (does not show cards). Bets: 0.50. Collects: 1. Wins: 0.50.
Player caballeroXXX does not show cards.Bets: 0.50. Collects: 0. Loses: 0.50.
Game ended at: 2016/11/28 20:6:35

Game started
Game ID: 786369229 0.50/1 (PRR) Kraken (short) (Hold'em)
Seat 1 is the button
Seat 1: Cinch23 (89.83).
Seat 2: 38979 (76.70).
Seat 4: TranscendencE (62.69).
Seat 5: IlxxxlI (21.50).
Seat 6: meandkids (50).
Player 38979 has small blind (0.50)
Player TranscendencE sitting out
Player IlxxxlI has big blind (1)
Player IlxxxlI received card: [3d]
Player IlxxxlI received card: [Ad]
Player meandkids folds
Player Cinch23 raises (2)
Player 38979 folds
Player IlxxxlI calls (1)
*** FLOP ***: [9d 4d 8d]
Player IlxxxlI checks
Player Cinch23 bets (2.50)
Player IlxxxlI raises (5.55)
Player Cinch23 allin (85.33)
Player IlxxxlI allin (13.95)
Uncalled bet (68.33) returned to Cinch23
*** TURN ***: [9d 4d 8d] [8s]
*** RIVER ***: [9d 4d 8d 8s] [3c]
------ Summary ------
Pot: 41.33. Rake 1.93. JP fee 0.24
Board: [9d 4d 8d 8s 3c]
Player Cinch23 shows: One pair of 8s [Jd 10s]. Bets: 21.50. Collects: 0. Loses: 21.50.
Player 38979 does not show cards.Bets: 0.50. Collects: 0. Loses: 0.50.
Player TranscendencE does not show cards.Bets: 0. Collects: 0. Wins: 0.
*Player IlxxxlI shows: Flush, A high [3d Ad]. Bets: 21.50. Collects: 41.33. Wins: 19.83.
Player meandkids does not show cards.Bets: 0. Collects: 0. Wins: 0.
Game ended at: 2016/11/28 20:7:6

Game started
Game ID: 786369207 0.25/0.50 (PRR) Gorgons - 5 (Hold'em)
Seat 6 is the button
Seat 1: caballeroXXX (60.60).
Seat 2: 38979 (52.94).
Seat 3: meandkids (112.94).
Seat 5: SenNoSen (50).
Seat 6: IlxxxlI (21.50).
Player caballeroXXX has small blind (0.25)
Player 38979 has big blind (0.50)
Player IlxxxlI received card: [8h]
Player IlxxxlI received card: [Ac]
Player meandkids folds
Player SenNoSen folds
Player IlxxxlI raises (1.50)
Player caballeroXXX folds
Player 38979 calls (1)
*** FLOP ***: [8s 7h 5h]
Player 38979 checks
Player IlxxxlI bets (2.50)
Player 38979 folds
Uncalled bet (2.50) returned to IlxxxlI
Player IlxxxlI mucks cards
------ Summary ------
Pot: 3.09. Rake 0.12. JP fee 0.04
Board: [8s 7h 5h]
Player caballeroXXX does not show cards.Bets: 0.25. Collects: 0. Loses: 0.25.
Player 38979 does not show cards.Bets: 1.50. Collects: 0. Loses: 1.50.
Player meandkids does not show cards.Bets: 0. Collects: 0. Wins: 0.
Player SenNoSen does not show cards.Bets: 0. Collects: 0. Wins: 0.
*Player IlxxxlI mucks (does not show cards). Bets: 1.50. Collects: 3.09. Wins: 1.59.
Game ended at: 2016/11/28 20:6:48

Game started
Game ID: 786369179 1/2 (PRR) Lakhey (Short) - 2 (Hold'em)
Seat 3 is the button
Seat 1: IlxxxlI (40).
Seat 2: 38979 (175.14).
Seat 3: sheenius81 (106.79).
Seat 4: Are you with me (70).
Seat 5: Wollverin (114.24).
Seat 6: dscshift (112.80).
Player Are you with me has small blind (1)
Player Wollverin has big blind (2)
Player IlxxxlI received card: [3h]
Player IlxxxlI received card: [4c]
Player dscshift folds
Player IlxxxlI folds
Player 38979 raises (6)
Player sheenius81 calls (6)
Player Are you with me folds
Player Wollverin folds
*** FLOP ***: [7d Kc 7s]
Player 38979 checks
Player sheenius81 checks
*** TURN ***: [7d Kc 7s] [9d]
Player 38979 bets (10)
Player sheenius81 folds
Uncalled bet (10) returned to 38979
Player 38979 mucks cards
------ Summary ------
Pot: 14.25. Rake 0.51. JP fee 0.24
Board: [7d Kc 7s 9d]
Player IlxxxlI does not show cards.Bets: 0. Collects: 0. Wins: 0.
*Player 38979 mucks (does not show cards). Bets: 6. Collects: 14.25. Wins: 8.25.
Player sheenius81 does not show cards.Bets: 6. Collects: 0. Loses: 6.
Player Are you with me does not show cards.Bets: 1. Collects: 0. Loses: 1.
Player Wollverin does not show cards.Bets: 2. Collects: 0. Loses: 2.
Player dscshift does not show cards.Bets: 0. Collects: 0. Wins: 0.
Game ended at: 2016/11/28 20:6:34

Game started
Game ID: 786369153 0.50/1 (PRR) Kraken (short) (Hold'em)
Seat 6 is the button
Seat 1: Cinch23 (90.33).
Seat 2: 38979 (77.70).
Seat 4: TranscendencE (62.69).
Seat 5: IlxxxlI (20).
Seat 6: meandkids (50).
Player Cinch23 has small blind (0.50)
Player 38979 has big blind (1)
Player IlxxxlI received card: [10h]
Player IlxxxlI received card: [Qh]
Player TranscendencE folds
Player IlxxxlI raises (2.40)
Player meandkids folds
Player Cinch23 folds
Player 38979 folds
Uncalled bet (1.40) returned to IlxxxlI
Player IlxxxlI mucks cards
------ Summary ------
Pot: 2.50. Rake 0
Player Cinch23 does not show cards.Bets: 0.50. Collects: 0. Loses: 0.50.
Player 38979 does not show cards.Bets: 1. Collects: 0. Loses: 1.
Player TranscendencE does not show cards.Bets: 0. Collects: 0. Wins: 0.
*Player IlxxxlI mucks (does not show cards). Bets: 1. Collects: 2.50. Wins: 1.50.
Player meandkids does not show cards.Bets: 0. Collects: 0. Wins: 0.
Game ended at: 2016/11/28 20:6:4

Game started
Game ID: 786369095 1/2 (PRR) Lakhey (Short) (Hold'em)
Seat 5 is the button
Seat 1: IlxxxlI (40).
Seat 2: 38979 (227.67).
Seat 3: BBDub27 (100).
Seat 4: Wollverin (107.10).
Seat 5: meandkids (123.64).
Seat 6: Are you with me (90.64).
Player Are you with me has small blind (1)
Player IlxxxlI has big blind (2)
Player IlxxxlI received card: [Ah]
Player IlxxxlI received card: [3h]
Player 38979 folds
Player BBDub27 is timed out.
Player BBDub27 folds
Player Wollverin raises (4)
Player meandkids folds
Player Are you with me folds
Player IlxxxlI calls (2)
*** FLOP ***: [Ks 5d 2s]
Player IlxxxlI checks
Player Wollverin bets (5)
Player IlxxxlI calls (5)
*** TURN ***: [Ks 5d 2s] [9h]
Player IlxxxlI checks
Player Wollverin bets (12)
Player IlxxxlI folds
Uncalled bet (12) returned to Wollverin
Player Wollverin mucks cards
------ Summary ------
Pot: 18.05. Rake 0.71. JP fee 0.24
Board: [Ks 5d 2s 9h]
Player IlxxxlI does not show cards.Bets: 9. Collects: 0. Loses: 9.
Player 38979 does not show cards.Bets: 0. Collects: 0. Wins: 0.
Player BBDub27 does not show cards.Bets: 0. Collects: 0. Wins: 0.
*Player Wollverin mucks (does not show cards). Bets: 9. Collects: 18.05. Wins: 9.05.
Player meandkids does not show cards.Bets: 0. Collects: 0. Wins: 0.
Player Are you with me does not show cards.Bets: 1. Collects: 0. Loses: 1.
Game ended at: 2016/11/28 20:7:21

Game started
Game ID: 786369094 0.25/0.50 (PRR) Gorgons - 5 (Hold'em)
Seat 5 is the button
Seat 1: caballeroXXX (61.10).
Seat 2: 38979 (52.94).
Seat 3: meandkids (112.19).
Seat 5: SenNoSen (50).
Seat 6: IlxxxlI (21.75).
Player IlxxxlI has small blind (0.25)
Player caballeroXXX has big blind (0.50)
Player IlxxxlI received card: [Kd]
Player IlxxxlI received card: [3d]
Player 38979 folds
Player meandkids raises (3)
Player SenNoSen folds
Player IlxxxlI folds
Player caballeroXXX folds
Uncalled bet (2.50) returned to meandkids
Player meandkids mucks cards
------ Summary ------
Pot: 1.25. Rake 0
Player caballeroXXX does not show cards.Bets: 0.50. Collects: 0. Loses: 0.50.
Player 38979 does not show cards.Bets: 0. Collects: 0. Wins: 0.
*Player meandkids mucks (does not show cards). Bets: 0.50. Collects: 1.25. Wins: 0.75.
Player SenNoSen does not show cards.Bets: 0. Collects: 0. Wins: 0.
Player IlxxxlI does not show cards.Bets: 0.25. Collects: 0. Loses: 0.25.
Game ended at: 2016/11/28 20:5:57

Game started
Game ID: 786369025 0.25/0.50 (PRR) Gorgons - 8 (Hold'em)
Seat 6 is the button
Seat 2: Cinch23 (49.50).
Seat 3: Goomashroom (66.05).
Seat 4: lovecola (59.48).
Seat 5: IlxxxlI (20).
Seat 6: caballeroXXX (149.52).
Player Cinch23 has small blind (0.25)
Player Goomashroom sitting out
Player lovecola sitting out
Player IlxxxlI has big blind (0.50)
Player IlxxxlI received card: [Ad]
Player IlxxxlI received card: [10h]
Player caballeroXXX folds
Player Cinch23 raises (0.75)
Player IlxxxlI calls (0.50)
*** FLOP ***: [10c Ks 2d]
Player Cinch23 bets (1)
Player IlxxxlI calls (1)
*** TURN ***: [10c Ks 2d] [4h]
Player Cinch23 checks
Player IlxxxlI checks
*** RIVER ***: [10c Ks 2d 4h] [3s]
Player Cinch23 bets (2)
Player IlxxxlI calls (2)
Player IlxxxlI mucks cards
------ Summary ------
Pot: 7.60. Rake 0.32. JP fee 0.08
Board: [10c Ks 2d 4h 3s]
*Player Cinch23 shows: One pair of Ks [Kc 8c]. Bets: 4. Collects: 7.60. Wins: 3.60.
Player Goomashroom does not show cards.Bets: 0. Collects: 0. Wins: 0.
Player lovecola does not show cards.Bets: 0. Collects: 0. Wins: 0.
Player IlxxxlI mucks (does not show: [Ad 10h]). Bets: 4. Collects: 0. Loses: 4.
Player caballeroXXX does not show cards.Bets: 0. Collects: 0. Wins: 0.
Game ended at: 2016/11/28 20:6:19

Game started
Game ID: 786369011 0.25/0.50 (PRR) Gorgons - 5 (Hold'em)
Seat 3 is the button
Seat 1: caballeroXXX (61.10).
Seat 2: 38979 (54.44).
Seat 3: meandkids (112.19).
Seat 5: SenNoSen (50.25).
Seat 6: IlxxxlI (20).
Player SenNoSen has small blind (0.25)
Player IlxxxlI has big blind (0.50)
Player IlxxxlI received card: [As]
Player IlxxxlI received card: [Kh]
Player caballeroXXX folds
Player 38979 raises (1.50)
Player meandkids folds
Player SenNoSen folds
Player IlxxxlI allin (19.50)
Player 38979 folds
Uncalled bet (18.50) returned to IlxxxlI
Player IlxxxlI mucks cards
------ Summary ------
Pot: 3.25. Rake 0
Player caballeroXXX does not show cards.Bets: 0. Collects: 0. Wins: 0.
Player 38979 does not show cards.Bets: 1.50. Collects: 0. Loses: 1.50.
Player meandkids does not show cards.Bets: 0. Collects: 0. Wins: 0.
Player SenNoSen does not show cards.Bets: 0.25. Collects: 0. Loses: 0.25.
*Player IlxxxlI mucks (does not show cards). Bets: 1.50. Collects: 3.25. Wins: 1.75.
Game ended at: 2016/11/28 20:5:28

Game started
Game ID: 786368918 0.50/1 (PRR) Kraken (short) (Hold'em)
Seat 5 is the button
Seat 1: Cinch23 (73.88).
Seat 2: 38979 (77.70).
Seat 4: TranscendencE (62.69).
Seat 5: IlxxxlI (31.79).
Seat 6: meandkids (50.50).
Player meandkids has small blind (0.50)
Player Cinch23 has big blind (1)
Player IlxxxlI received card: [8d]
Player IlxxxlI received card: [8s]
Player 38979 folds
Player TranscendencE folds
Player IlxxxlI raises (3)
Player meandkids folds
Player Cinch23 raises (8)
Player IlxxxlI calls (6)
*** FLOP ***: [6s As 5s]
Player Cinch23 bets (8.75)
Player IlxxxlI calls (8.75)
*** TURN ***: [6s As 5s] [9c]
Player Cinch23 checks
Player IlxxxlI checks
*** RIVER ***: [6s As 5s 9c] [4c]
Player Cinch23 bets (15)
Player IlxxxlI folds
Uncalled bet (15) returned to Cinch23
Player Cinch23 mucks cards
------ Summary ------
Pot: 34.20. Rake 1.56. JP fee 0.24
Board: [6s As 5s 9c 4c]
*Player Cinch23 mucks (does not show cards). Bets: 17.75. Collects: 34.20. Wins: 16.45.
Player 38979 does not show cards.Bets: 0. Collects: 0. Wins: 0.
Player TranscendencE does not show cards.Bets: 0. Collects: 0. Wins: 0.
Player IlxxxlI does not show cards.Bets: 17.75. Collects: 0. Loses: 17.75.
Player meandkids does not show cards.Bets: 0.50. Collects: 0. Loses: 0.50.
Game ended at: 2016/11/28 20:5:42

Game started
Game ID: 786368868 0.25/0.50 (PRR) Gorgons - 5 (Hold'em)
Seat 1 is the button
Seat 1: caballeroXXX (61.10).
Seat 2: 38979 (53.94).
Seat 3: meandkids (112.94).
Seat 4: Goomashroom (128.48).
Seat 6: IlxxxlI (20).
Player 38979 has small blind (0.25)
Player meandkids has big blind (0.50)
Player IlxxxlI received card: [6c]
Player IlxxxlI received card: [5s]
Player Goomashroom folds
Player IlxxxlI folds
Player caballeroXXX folds
Player 38979 raises (0.75)
Player meandkids folds
Uncalled bet (0.50) returned to 38979
Player 38979 mucks cards
------ Summary ------
Pot: 1. Rake 0
Player caballeroXXX does not show cards.Bets: 0. Collects: 0. Wins: 0.
*Player 38979 mucks (does not show cards). Bets: 0.50. Collects: 1. Wins: 0.50.
Player meandkids does not show cards.Bets: 0.50. Collects: 0. Loses: 0.50.
Player Goomashroom does not show cards.Bets: 0. Collects: 0. Wins: 0.
Player IlxxxlI does not show cards.Bets: 0. Collects: 0. Wins: 0.
Game ended at: 2016/11/28 20:4:51

Game started
Game ID: 786368847 1/2 (PRR) Lakhey (Short) (Hold'em)
Seat 4 is the button
Seat 1: IlxxxlI (40).
Seat 2: 38979 (227.67).
Seat 4: Wollverin (111.10).
Seat 5: meandkids (116.24).
Seat 6: Are you with me (94.64).
Player meandkids has small blind (1)
Player Are you with me has big blind (2)
Player IlxxxlI received card: [Qh]
Player IlxxxlI received card: [4c]
Player IlxxxlI folds
Player 38979 folds
Player Wollverin raises (4)
Player meandkids calls (3)
Player Are you with me calls (2)
*** FLOP ***: [Ad 8s Kd]
Player meandkids checks
Player Are you with me checks
Player Wollverin checks
*** TURN ***: [Ad 8s Kd] [Ac]
Player meandkids bets (7.60)
Player Are you with me folds
Player Wollverin folds
Uncalled bet (7.60) returned to meandkids
Player meandkids mucks cards
------ Summary ------
Pot: 11.40. Rake 0.40. JP fee 0.20
Board: [Ad 8s Kd Ac]
Player IlxxxlI does not show cards.Bets: 0. Collects: 0. Wins: 0.
Player 38979 does not show cards.Bets: 0. Collects: 0. Wins: 0.
Player Wollverin does not show cards.Bets: 4. Collects: 0. Loses: 4.
*Player meandkids mucks (does not show cards). Bets: 4. Collects: 11.40. Wins: 7.40.
Player Are you with me does not show cards.Bets: 4. Collects: 0. Loses: 4.
Game ended at: 2016/11/28 20:5:29

Game started
Game ID: 786368833 0.50/1 (PRR) Kraken (short) (Hold'em)
Seat 4 is the button
Seat 1: Cinch23 (73.88).
Seat 2: 38979 (77.70).
Seat 4: TranscendencE (62.69).
Seat 5: IlxxxlI (32.29).
Seat 6: meandkids (50).
Player IlxxxlI has small blind (0.50)
Player meandkids has big blind (1)
Player IlxxxlI received card: [2d]
Player IlxxxlI received card: [3c]
Player Cinch23 folds
Player 38979 folds
Player TranscendencE folds
Player IlxxxlI folds
Uncalled bet (0.50) returned to meandkids
Player meandkids mucks cards
------ Summary ------
Pot: 1. Rake 0
Player Cinch23 does not show cards.Bets: 0. Collects: 0. Wins: 0.
Player 38979 does not show cards.Bets: 0. Collects: 0. Wins: 0.
Player TranscendencE does not show cards.Bets: 0. Collects: 0. Wins: 0.
Player IlxxxlI does not show cards.Bets: 0.50. Collects: 0. Loses: 0.50.
*Player meandkids mucks (does not show cards). Bets: 0.50. Collects: 1. Wins: 0.50.
Game ended at: 2016/11/28 20:4:43

Game started
Game ID: 786368687 1/2 (PRR) Lakhey (Short) (Hold'em)
Seat 2 is the button
Seat 1: IlxxxlI (40).
Seat 2: 38979 (227.67).
Seat 3: BBDub27 (101).
Seat 4: Wollverin (110.10).
Seat 5: meandkids (116.24).
Seat 6: Are you with me (94.64).
Player BBDub27 has small blind (1)
Player Wollverin has big blind (2)
Player IlxxxlI received card: [Jh]
Player IlxxxlI received card: [4h]
Player meandkids folds
Player Are you with me folds
Player IlxxxlI folds
Player 38979 folds
Player BBDub27 is timed out.
Player BBDub27 folds
Uncalled bet (1) returned to Wollverin
Player Wollverin mucks cards
------ Summary ------
Pot: 2. Rake 0
Player IlxxxlI does not show cards.Bets: 0. Collects: 0. Wins: 0.
Player 38979 does not show cards.Bets: 0. Collects: 0. Wins: 0.
Player BBDub27 does not show cards.Bets: 1. Collects: 0. Loses: 1.
*Player Wollverin mucks (does not show cards). Bets: 1. Collects: 2. Wins: 1.
Player meandkids does not show cards.Bets: 0. Collects: 0. Wins: 0.
Player Are you with me does not show cards.Bets: 0. Collects: 0. Wins: 0.
Game ended at: 2016/11/28 20:4:25

Game started
Game ID: 786368649 1/2 (PRR) Lakhey (Short) - 2 (Hold'em)
Seat 2 is the button
Seat 1: IlxxxlI (40).
Seat 2: 38979 (175.14).
Seat 3: sheenius81 (118.39).
Seat 4: Are you with me (70).
Seat 5: Wollverin (100).
Seat 6: dscshift (112.80).
Player sheenius81 has small blind (1)
Player Are you with me has big blind (2)
Player IlxxxlI received card: [6c]
Player IlxxxlI received card: [10d]
Player Wollverin raises (4)
Player dscshift folds
Player IlxxxlI folds
Player 38979 folds
Player sheenius81 calls (3)
Player Are you with me calls (2)
*** FLOP ***: [3c 6d 8d]
Player sheenius81 checks
Player Are you with me checks
Player Wollverin checks
*** TURN ***: [3c 6d 8d] [8h]
Player sheenius81 bets (7.60)
Player Are you with me folds
Player Wollverin calls (7.60)
*** RIVER ***: [3c 6d 8d 8h] [Jc]
Player sheenius81 checks
Player Wollverin checks
------ Summary ------
Pot: 25.84. Rake 1.12. JP fee 0.24
Board: [3c 6d 8d 8h Jc]
Player IlxxxlI does not show cards.Bets: 0. Collects: 0. Wins: 0.
Player 38979 does not show cards.Bets: 0. Collects: 0. Wins: 0.
Player sheenius81 shows: One pair of 8s [7d 9s]. Bets: 11.60. Collects: 0. Loses: 11.60.
Player Are you with me does not show cards.Bets: 4. Collects: 0. Loses: 4.
*Player Wollverin shows: One pair of 8s (kicker A) [As Kc]. Bets: 11.60. Collects: 25.84. Wins: 14.24.
Player dscshift does not show cards.Bets: 0. Collects: 0. Wins: 0.
Game ended at: 2016/11/28 20:5:45

Game started
Game ID: 786368638 0.25/0.50 (PRR) Gorgons - 5 (Hold'em)
Seat 6 is the button
Seat 1: caballeroXXX (61.35).
Seat 2: 38979 (54.44).
Seat 3: meandkids (109.07).
Seat 4: Goomashroom (128.48).
Seat 6: IlxxxlI (20).
Player caballeroXXX has small blind (0.25)
Player 38979 has big blind (0.50)
Player IlxxxlI received card: [Jc]
Player IlxxxlI received card: [Ad]
Player meandkids calls (0.50)
Player Goomashroom folds
Player IlxxxlI raises (2)
Player caballeroXXX folds
Player 38979 folds
Player meandkids calls (1.50)
*** FLOP ***: [9s Kh 7s]
Player meandkids checks
Player IlxxxlI bets (1.50)
Player meandkids calls (1.50)
*** TURN ***: [9s Kh 7s] [3d]
Player meandkids checks
Player IlxxxlI checks
*** RIVER ***: [9s Kh 7s 3d] [Kc]
Player meandkids checks
Player IlxxxlI checks
Player IlxxxlI mucks cards
------ Summary ------
Pot: 7.37. Rake 0.26. JP fee 0.12
Board: [9s Kh 7s 3d Kc]
Player caballeroXXX does not show cards.Bets: 0.25. Collects: 0. Loses: 0.25.
Player 38979 does not show cards.Bets: 0.50. Collects: 0. Loses: 0.50.
*Player meandkids shows: Two pairs. Ks and 9s [9c 10c]. Bets: 3.50. Collects: 7.37. Wins: 3.87.
Player Goomashroom does not show cards.Bets: 0. Collects: 0. Wins: 0.
Player IlxxxlI mucks (does not show: [Jc Ad]). Bets: 3.50. Collects: 0. Loses: 3.50.
Game ended at: 2016/11/28 20:4:28

Game started
Game ID: 786368612 1/2 (PRR) Lakhey (Short) (Hold'em)
Seat 1 is the button
Seat 1: IlxxxlI (40).
Seat 2: 38979 (228.67).
Seat 3: BBDub27 (100).
Seat 4: Wollverin (110.10).
Seat 5: meandkids (116.24).
Seat 6: Are you with me (94.64).
Player 38979 has small blind (1)
Player BBDub27 has big blind (2)
Player IlxxxlI received card: [9d]
Player IlxxxlI received card: [Jc]
Player Wollverin folds
Player meandkids folds
Player Are you with me folds
Player IlxxxlI folds
Player 38979 folds
Uncalled bet (1) returned to BBDub27
Player BBDub27 mucks cards
------ Summary ------
Pot: 2. Rake 0
Player IlxxxlI does not show cards.Bets: 0. Collects: 0. Wins: 0.
Player 38979 does not show cards.Bets: 1. Collects: 0. Loses: 1.
*Player BBDub27 mucks (does not show cards). Bets: 1. Collects: 2. Wins: 1.
Player Wollverin does not show cards.Bets: 0. Collects: 0. Wins: 0.
Player meandkids does not show cards.Bets: 0. Collects: 0. Wins: 0.
Player Are you with me does not show cards.Bets: 0. Collects: 0. Wins: 0.
Game ended at: 2016/11/28 20:3:44

Game started
Game ID: 786368552 0.25/0.50 (PRR) Gorgons - 8 (Hold'em)
Seat 4 is the button
Seat 1: legenda99 (74.49).
Seat 3: Goomashroom (66.05).
Seat 4: lovecola (50).
Seat 5: IlxxxlI (20.65).
Seat 6: caballeroXXX (160.02).
Player IlxxxlI has small blind (0.25)
Player caballeroXXX has big blind (0.50)
Player IlxxxlI received card: [Ad]
Player IlxxxlI received card: [Qd]
Player legenda99 raises (1.50)
Player Goomashroom folds
Player lovecola folds
Player IlxxxlI calls (1.25)
Player caballeroXXX folds
*** FLOP ***: [4d 10h 8d]
Player IlxxxlI checks
Player legenda99 bets (2.22)
Player IlxxxlI raises (5.50)
Player legenda99 allin (70.77)
Player IlxxxlI allin (13.65)
Uncalled bet (53.84) returned to legenda99
*** TURN ***: [4d 10h 8d] [8h]
*** RIVER ***: [4d 10h 8d 8h] [2h]
------ Summary ------
Pot: 39.71. Rake 1.85. JP fee 0.24
Board: [4d 10h 8d 8h 2h]
*Player legenda99 shows: Two pairs. 10s and 8s [10d As]. Bets: 20.65. Collects: 39.71. Wins: 19.06.
Player Goomashroom does not show cards.Bets: 0. Collects: 0. Wins: 0.
Player lovecola does not show cards.Bets: 0. Collects: 0. Wins: 0.
Player IlxxxlI shows: One pair of 8s [Ad Qd]. Bets: 20.65. Collects: 0. Loses: 20.65.
Player caballeroXXX does not show cards.Bets: 0.50. Collects: 0. Loses: 0.50.
Game ended at: 2016/11/28 20:4:16

Game started
Game ID: 786368543 0.25/0.50 (PRR) Gorgons - 3 (Hold'em)
Seat 6 is the button
Seat 2: Cinch23 (52.88).
Seat 6: IlxxxlI (25.53).
Player IlxxxlI has small blind (0.25)
Player Cinch23 has big blind (0.50)
Player IlxxxlI received card: [8d]
Player IlxxxlI received card: [Qd]
Player IlxxxlI raises (1)
Player Cinch23 folds
Uncalled bet (0.75) returned to IlxxxlI
Player IlxxxlI mucks cards
------ Summary ------
Pot: 1. Rake 0
Player Cinch23 does not show cards.Bets: 0.50. Collects: 0. Loses: 0.50.
*Player IlxxxlI mucks (does not show cards). Bets: 0.50. Collects: 1. Wins: 0.50.
Game ended at: 2016/11/28 20:3:30

Game started
Game ID: 786368534 0.50/1 (PRR) Kraken (short) (Hold'em)
Seat 2 is the button
Seat 1: Cinch23 (73.88).
Seat 2: 38979 (55.39).
Seat 3: Bhodisattva (23.18).
Seat 4: TranscendencE (65.69).
Seat 5: IlxxxlI (32.29).
Seat 6: meandkids (50).
Player Bhodisattva has small blind (0.50)
Player TranscendencE has big blind (1)
Player IlxxxlI received card: [9s]
Player IlxxxlI received card: [Jc]
Player IlxxxlI folds
Player meandkids folds
Player Cinch23 folds
Player 38979 raises (3)
Player Bhodisattva calls (2.50)
Player TranscendencE calls (2)
*** FLOP ***: [10d 7c Qh]
Player Bhodisattva checks
Player TranscendencE checks
Player 38979 checks
*** TURN ***: [10d 7c Qh] [Jd]
Player Bhodisattva checks
Player TranscendencE checks
Player 38979 bets (5.70)
Player Bhodisattva calls (5.70)
Player TranscendencE folds
*** RIVER ***: [10d 7c Qh Jd] [4c]
Player Bhodisattva checks
Player 38979 bets (12.92)
Player Bhodisattva calls (12.92)
Player Bhodisattva mucks cards
------ Summary ------
Pot: 43.93. Rake 2.07. JP fee 0.24
Board: [10d 7c Qh Jd 4c]
Player Cinch23 does not show cards.Bets: 0. Collects: 0. Wins: 0.
*Player 38979 shows: Straight to A [Ad Kd]. Bets: 21.62. Collects: 43.93. Wins: 22.31.
Player Bhodisattva mucks (does not show cards). Bets: 21.62. Collects: 0. Loses: 21.62.
Player TranscendencE does not show cards.Bets: 3. Collects: 0. Loses: 3.
Player IlxxxlI does not show cards.Bets: 0. Collects: 0. Wins: 0.
Player meandkids does not show cards.Bets: 0. Collects: 0. Wins: 0.
Game ended at: 2016/11/28 20:4:19

Game started
Game ID: 786368527 1/2 (PRR) Lakhey (Short) (Hold'em)
Seat 6 is the button
Seat 1: IlxxxlI (40).
Seat 2: 38979 (230.67).
Seat 3: BBDub27 (100).
Seat 4: Wollverin (107.10).
Seat 5: meandkids (116.24).
Seat 6: Are you with me (94.64).
Player IlxxxlI has small blind (1)
Player 38979 has big blind (2)
Player IlxxxlI received card: [Js]
Player IlxxxlI received card: [3h]
Player BBDub27 folds
Player Wollverin raises (4)
Player meandkids folds
Player Are you with me folds
Player IlxxxlI folds
Player 38979 folds
Uncalled bet (2) returned to Wollverin
Player Wollverin mucks cards
------ Summary ------
Pot: 5. Rake 0
Player IlxxxlI does not show cards.Bets: 1. Collects: 0. Loses: 1.
Player 38979 does not show cards.Bets: 2. Collects: 0. Loses: 2.
Player BBDub27 does not show cards.Bets: 0. Collects: 0. Wins: 0.
*Player Wollverin mucks (does not show cards). Bets: 2. Collects: 5. Wins: 3.
Player meandkids does not show cards.Bets: 0. Collects: 0. Wins: 0.
Player Are you with me does not show cards.Bets: 0. Collects: 0. Wins: 0.
Game ended at: 2016/11/28 20:3:27

Game started
Game ID: 786368423 0.25/0.50 (PRR) Gorgons - 3 (Hold'em)
Seat 2 is the button
Seat 2: Cinch23 (52.38).
Seat 6: IlxxxlI (26.03).
Player Cinch23 has small blind (0.25)
Player IlxxxlI has big blind (0.50)
Player IlxxxlI received card: [10c]
Player IlxxxlI received card: [Js]
Player Cinch23 raises (0.75)
Player IlxxxlI folds
Uncalled bet (0.50) returned to Cinch23
Player Cinch23 mucks cards
------ Summary ------
Pot: 1. Rake 0
*Player Cinch23 mucks (does not show cards). Bets: 0.50. Collects: 1. Wins: 0.50.
Player IlxxxlI does not show cards.Bets: 0.50. Collects: 0. Loses: 0.50.
Game ended at: 2016/11/28 20:3:9

Game started
Game ID: 786368413 0.25/0.50 (PRR) Gorgons - 5 (Hold'em)
Seat 4 is the button
Seat 1: caballeroXXX (62.85).
Seat 2: 38979 (50).
Seat 3: meandkids (110.57).
Seat 4: Goomashroom (129.98).
Seat 6: IlxxxlI (20).
Player IlxxxlI has small blind (0.25)
Player caballeroXXX has big blind (0.50)
Player IlxxxlI received card: [4d]
Player IlxxxlI received card: [Jd]
Player 38979 raises (1.50)
Player meandkids calls (1.50)
Player Goomashroom calls (1.50)
Player IlxxxlI folds
Player caballeroXXX calls (1)
*** FLOP ***: [8d Ks Ad]
Player caballeroXXX checks
Player 38979 bets (3.96)
Player meandkids folds
Player Goomashroom folds
Player caballeroXXX folds
Uncalled bet (3.96) returned to 38979
Player 38979 mucks cards
------ Summary ------
Pot: 5.94. Rake 0.21. JP fee 0.10
Board: [8d Ks Ad]
Player caballeroXXX does not show cards.Bets: 1.50. Collects: 0. Loses: 1.50.
*Player 38979 mucks (does not show cards). Bets: 1.50. Collects: 5.94. Wins: 4.44.
Player meandkids does not show cards.Bets: 1.50. Collects: 0. Loses: 1.50.
Player Goomashroom does not show cards.Bets: 1.50. Collects: 0. Loses: 1.50.
Player IlxxxlI does not show cards.Bets: 0.25. Collects: 0. Loses: 0.25.
Game ended at: 2016/11/28 20:3:32

Game started
Game ID: 786368391 0.50/1 (PRR) Kraken (short) (Hold'em)
Seat 1 is the button
Seat 1: Cinch23 (73.88).
Seat 2: 38979 (50.89).
Seat 3: Bhodisattva (24.18).
Seat 4: TranscendencE (65.69).
Seat 5: IlxxxlI (35.79).
Seat 6: meandkids (50).
Player 38979 has small blind (0.50)
Player Bhodisattva has big blind (1)
Player IlxxxlI received card: [Ah]
Player IlxxxlI received card: [Qs]
Player TranscendencE folds
Player IlxxxlI raises (3.50)
Player meandkids folds
Player Cinch23 folds
Player 38979 raises (15.50)
Player Bhodisattva folds
Player IlxxxlI folds
Uncalled bet (12.50) returned to 38979
Player 38979 mucks cards
------ Summary ------
Pot: 8. Rake 0
Player Cinch23 does not show cards.Bets: 0. Collects: 0. Wins: 0.
*Player 38979 mucks (does not show cards). Bets: 3.50. Collects: 8. Wins: 4.50.
Player Bhodisattva does not show cards.Bets: 1. Collects: 0. Loses: 1.
Player TranscendencE does not show cards.Bets: 0. Collects: 0. Wins: 0.
Player IlxxxlI does not show cards.Bets: 3.50. Collects: 0. Loses: 3.50.
Player meandkids does not show cards.Bets: 0. Collects: 0. Wins: 0.
Game ended at: 2016/11/28 20:3:7

Game started
Game ID: 786368380 1/2 (PRR) Lakhey (Short) - 2 (Hold'em)
Seat 1 is the button
Seat 1: IlxxxlI (40).
Seat 2: 38979 (181.14).
Seat 3: sheenius81 (120.39).
Seat 5: Wollverin (100).
Seat 6: dscshift (105.50).
Player 38979 has small blind (1)
Player sheenius81 has big blind (2)
Player IlxxxlI received card: [7h]
Player IlxxxlI received card: [5d]
Player Wollverin folds
Player dscshift calls (2)
Player IlxxxlI folds
Player 38979 calls (1)
Player sheenius81 checks
*** FLOP ***: [2s Js Qc]
Player 38979 checks
Player sheenius81 checks
Player dscshift checks
*** TURN ***: [2s Js Qc] [10d]
Player 38979 bets (4)
Player sheenius81 folds
Player dscshift calls (4)
*** RIVER ***: [2s Js Qc 10d] [9h]
Player 38979 checks
Player dscshift bets (6)
Player 38979 folds
Uncalled bet (6) returned to dscshift
Player dscshift mucks cards
------ Summary ------
Pot: 13.30. Rake 0.48. JP fee 0.22
Board: [2s Js Qc 10d 9h]
Player IlxxxlI does not show cards.Bets: 0. Collects: 0. Wins: 0.
Player 38979 does not show cards.Bets: 6. Collects: 0. Loses: 6.
Player sheenius81 does not show cards.Bets: 2. Collects: 0. Loses: 2.
Player Wollverin does not show cards.Bets: 0. Collects: 0. Wins: 0.
*Player dscshift mucks (does not show cards). Bets: 6. Collects: 13.30. Wins: 7.30.
Game ended at: 2016/11/28 20:3:36

Game started
Game ID: 786368370 1/2 (PRR) Lakhey (Short) (Hold'em)
Seat 5 is the button
Seat 1: IlxxxlI (40).
Seat 2: 38979 (230.67).
Seat 3: BBDub27 (100).
Seat 4: Wollverin (104.10).
Seat 5: meandkids (116.24).
Seat 6: Are you with me (95.64).
Player Are you with me has small blind (1)
Player IlxxxlI has big blind (2)
Player IlxxxlI received card: [10d]
Player IlxxxlI received card: [2h]
Player 38979 folds
Player BBDub27 is timed out.
Player BBDub27 folds
Player Wollverin raises (4)
Player meandkids folds
Player Are you with me folds
Player IlxxxlI folds
Uncalled bet (2) returned to Wollverin
Player Wollverin mucks cards
------ Summary ------
Pot: 5. Rake 0
Player IlxxxlI does not show cards.Bets: 2. Collects: 0. Loses: 2.
Player 38979 does not show cards.Bets: 0. Collects: 0. Wins: 0.
Player BBDub27 does not show cards.Bets: 0. Collects: 0. Wins: 0.
*Player Wollverin mucks (does not show cards). Bets: 2. Collects: 5. Wins: 3.
Player meandkids does not show cards.Bets: 0. Collects: 0. Wins: 0.
Player Are you with me does not show cards.Bets: 1. Collects: 0. Loses: 1.
Game ended at: 2016/11/28 20:3:7

Game started
Game ID: 786368334 1/2 (PRR) Lakhey (Short) (Hold'em)
Seat 4 is the button
Seat 1: IlxxxlI (40).
Seat 2: 38979 (230.67).
Seat 4: Wollverin (104.10).
Seat 5: meandkids (117.24).
Seat 6: Are you with me (94.64).
Player meandkids has small blind (1)
Player Are you with me has big blind (2)
Player IlxxxlI received card: [9s]
Player IlxxxlI received card: [2h]
Player IlxxxlI folds
Player 38979 folds
Player Wollverin folds
Player meandkids folds
Uncalled bet (1) returned to Are you with me
Player Are you with me mucks cards
------ Summary ------
Pot: 2. Rake 0
Player IlxxxlI does not show cards.Bets: 0. Collects: 0. Wins: 0.
Player 38979 does not show cards.Bets: 0. Collects: 0. Wins: 0.
Player Wollverin does not show cards.Bets: 0. Collects: 0. Wins: 0.
Player meandkids does not show cards.Bets: 1. Collects: 0. Loses: 1.
*Player Are you with me mucks (does not show cards). Bets: 1. Collects: 2. Wins: 1.
Game ended at: 2016/11/28 20:2:29

Game started
Game ID: 786368323 0.25/0.50 (PRR) Gorgons - 3 (Hold'em)
Seat 6 is the button
Seat 1: Goomashroom (72.12).
Seat 2: Cinch23 (52.13).
Seat 6: IlxxxlI (26.03).
Player Goomashroom has small blind (0.25)
Player Cinch23 has big blind (0.50)
Player IlxxxlI received card: [7s]
Player IlxxxlI received card: [10d]
Player IlxxxlI folds
Player Goomashroom folds
Uncalled bet (0.25) returned to Cinch23
Player Cinch23 mucks cards
------ Summary ------
Pot: 0.50. Rake 0
Player Goomashroom does not show cards.Bets: 0.25. Collects: 0. Loses: 0.25.
*Player Cinch23 mucks (does not show cards). Bets: 0.25. Collects: 0.50. Wins: 0.25.
Player IlxxxlI does not show cards.Bets: 0. Collects: 0. Wins: 0.
Game ended at: 2016/11/28 20:2:39

Game started
Game ID: 786368280 0.25/0.50 (PRR) Gorgons - 5 (Hold'em)
Seat 3 is the button
Seat 1: caballeroXXX (62.85).
Seat 2: 38979 (50).
Seat 3: meandkids (110.57).
Seat 4: Goomashroom (129.48).
Seat 5: legenda99 (70.24).
Seat 6: IlxxxlI (20).
Player Goomashroom has small blind (0.25)
Player legenda99 sitting out
Player IlxxxlI has big blind (0.50)
Player IlxxxlI received card: [4c]
Player IlxxxlI received card: [Jd]
Player caballeroXXX folds
Player 38979 folds
Player meandkids folds
Player Goomashroom raises (1.25)
Player IlxxxlI folds
Uncalled bet (1) returned to Goomashroom
Player Goomashroom mucks cards
------ Summary ------
Pot: 1. Rake 0
Player caballeroXXX does not show cards.Bets: 0. Collects: 0. Wins: 0.
Player 38979 does not show cards.Bets: 0. Collects: 0. Wins: 0.
Player meandkids does not show cards.Bets: 0. Collects: 0. Wins: 0.
*Player Goomashroom mucks (does not show cards). Bets: 0.50. Collects: 1. Wins: 0.50.
Player legenda99 does not show cards.Bets: 0. Collects: 0. Wins: 0.
Player IlxxxlI does not show cards.Bets: 0.50. Collects: 0. Loses: 0.50.
Game ended at: 2016/11/28 20:2:39

Game started
Game ID: 786368226 0.50/1 (PRR) Kraken (short) (Hold'em)
Seat 6 is the button
Seat 1: Cinch23 (74.38).
Seat 2: 38979 (51.89).
Seat 3: Bhodisattva (24.18).
Seat 4: TranscendencE (65.69).
Seat 5: IlxxxlI (35.79).
Seat 6: meandkids (48.50).
Player Cinch23 has small blind (0.50)
Player 38979 has big blind (1)
Player IlxxxlI received card: [4s]
Player IlxxxlI received card: [8c]
Player Bhodisattva folds
Player TranscendencE folds
Player IlxxxlI folds
Player meandkids raises (6)
Player Cinch23 folds
Player 38979 folds
Uncalled bet (5) returned to meandkids
Player meandkids mucks cards
------ Summary ------
Pot: 2.50. Rake 0
Player Cinch23 does not show cards.Bets: 0.50. Collects: 0. Loses: 0.50.
Player 38979 does not show cards.Bets: 1. Collects: 0. Loses: 1.
Player Bhodisattva does not show cards.Bets: 0. Collects: 0. Wins: 0.
Player TranscendencE does not show cards.Bets: 0. Collects: 0. Wins: 0.
Player IlxxxlI does not show cards.Bets: 0. Collects: 0. Wins: 0.
*Player meandkids mucks (does not show cards). Bets: 1. Collects: 2.50. Wins: 1.50.
Game ended at: 2016/11/28 20:2:34

Game started
Game ID: 786368207 0.25/0.50 (PRR) Gorgons - 8 (Hold'em)
Seat 3 is the button
Seat 1: legenda99 (74.49).
Seat 3: Goomashroom (51.62).
Seat 4: lovecola (52.23).
Seat 5: IlxxxlI (21.15).
Seat 6: caballeroXXX (160.02).
Player lovecola has small blind (0.25)
Player IlxxxlI has big blind (0.50)
Player IlxxxlI received card: [Kd]
Player IlxxxlI received card: [3s]
Player caballeroXXX folds
Player legenda99 folds
Player Goomashroom raises (1.13)
Player lovecola raises (3.25)
Player IlxxxlI folds
Player Goomashroom calls (2.37)
*** FLOP ***: [6c 4s 8c]
Player lovecola bets (4)
Player Goomashroom calls (4)
*** TURN ***: [6c 4s 8c] [Jh]
Player lovecola bets (8)
Player Goomashroom calls (8)
*** RIVER ***: [6c 4s 8c Jh] [9h]
Player lovecola checks
Player Goomashroom allin (36.12)
Player lovecola folds
Uncalled bet (36.12) returned to Goomashroom
Player Goomashroom mucks cards
------ Summary ------
Pot: 29.93. Rake 1.33. JP fee 0.24
Board: [6c 4s 8c Jh 9h]
Player legenda99 does not show cards.Bets: 0. Collects: 0. Wins: 0.
*Player Goomashroom mucks (does not show cards). Bets: 15.50. Collects: 29.93. Wins: 14.43.
Player lovecola does not show cards.Bets: 15.50. Collects: 0. Loses: 15.50.
Player IlxxxlI does not show cards.Bets: 0.50. Collects: 0. Loses: 0.50.
Player caballeroXXX does not show cards.Bets: 0. Collects: 0. Wins: 0.
Game ended at: 2016/11/28 20:3:11

Game started
Game ID: 786368181 0.50/1 (PRR) Kraken (short) (Hold'em)
Seat 5 is the button
Seat 1: Cinch23 (73.88).
Seat 2: 38979 (51.89).
Seat 3: Bhodisattva (24.18).
Seat 4: TranscendencE (65.69).
Seat 5: IlxxxlI (35.79).
Seat 6: meandkids (49).
Player meandkids has small blind (0.50)
Player Cinch23 has big blind (1)
Player IlxxxlI received card: [Qc]
Player IlxxxlI received card: [2c]
Player 38979 folds
Player Bhodisattva folds
Player TranscendencE folds
Player IlxxxlI folds
Player meandkids folds
Uncalled bet (0.50) returned to Cinch23
Player Cinch23 mucks cards
------ Summary ------
Pot: 1. Rake 0
*Player Cinch23 mucks (does not show cards). Bets: 0.50. Collects: 1. Wins: 0.50.
Player 38979 does not show cards.Bets: 0. Collects: 0. Wins: 0.
Player Bhodisattva does not show cards.Bets: 0. Collects: 0. Wins: 0.
Player TranscendencE does not show cards.Bets: 0. Collects: 0. Wins: 0.
Player IlxxxlI does not show cards.Bets: 0. Collects: 0. Wins: 0.
Player meandkids does not show cards.Bets: 0.50. Collects: 0. Loses: 0.50.
Game ended at: 2016/11/28 20:1:53

Game started
Game ID: 786368172 1/2 (PRR) Lakhey (Short) (Hold'em)
Seat 3 is the button
Seat 1: IlxxxlI (40).
Seat 2: 38979 (230.67).
Seat 3: BBDub27 (100).
Seat 4: Wollverin (105.10).
Seat 5: meandkids (119.24).
Seat 6: Are you with me (91.64).
Player Wollverin has small blind (1)
Player meandkids has big blind (2)
Player IlxxxlI received card: [Qs]
Player IlxxxlI received card: [Jh]
Player Are you with me raises (5)
Player IlxxxlI folds
Player 38979 folds
Player BBDub27 is timed out.
Player BBDub27 folds
Player Wollverin folds
Player meandkids folds
Uncalled bet (3) returned to Are you with me
Player Are you with me mucks cards
------ Summary ------
Pot: 5. Rake 0
Player IlxxxlI does not show cards.Bets: 0. Collects: 0. Wins: 0.
Player 38979 does not show cards.Bets: 0. Collects: 0. Wins: 0.
Player BBDub27 does not show cards.Bets: 0. Collects: 0. Wins: 0.
Player Wollverin does not show cards.Bets: 1. Collects: 0. Loses: 1.
Player meandkids does not show cards.Bets: 2. Collects: 0. Loses: 2.
*Player Are you with me mucks (does not show cards). Bets: 2. Collects: 5. Wins: 3.
Game ended at: 2016/11/28 20:2:21

Game started
Game ID: 786368140 0.25/0.50 (PRR) Gorgons - 3 (Hold'em)
Seat 2 is the button
Seat 1: Goomashroom (70.99).
Seat 2: Cinch23 (52.13).
Seat 6: IlxxxlI (27.28).
Player IlxxxlI has small blind (0.25)
Player Goomashroom has big blind (0.50)
Player IlxxxlI received card: [Jd]
Player IlxxxlI received card: [Kh]
Player Cinch23 folds
Player IlxxxlI raises (1)
Player Goomashroom calls (0.75)
*** FLOP ***: [9h 5h 2s]
Player IlxxxlI checks
Player Goomashroom bets (1.75)
Player IlxxxlI folds
Uncalled bet (1.75) returned to Goomashroom
Player Goomashroom mucks cards
------ Summary ------
Pot: 2.38. Rake 0.08. JP fee 0.04
Board: [9h 5h 2s]
*Player Goomashroom mucks (does not show cards). Bets: 1.25. Collects: 2.38. Wins: 1.13.
Player Cinch23 does not show cards.Bets: 0. Collects: 0. Wins: 0.
Player IlxxxlI does not show cards.Bets: 1.25. Collects: 0. Loses: 1.25.
Game ended at: 2016/11/28 20:2:17

Game started
Game ID: 786368095 0.25/0.50 (PRR) Gorgons - 8 (Hold'em)
Seat 1 is the button
Seat 1: legenda99 (74.49).
Seat 3: Goomashroom (51.87).
Seat 4: lovecola (52.73).
Seat 5: IlxxxlI (21.15).
Seat 6: caballeroXXX (159.27).
Player Goomashroom has small blind (0.25)
Player lovecola has big blind (0.50)
Player IlxxxlI received card: [7s]
Player IlxxxlI received card: [4s]
Player IlxxxlI folds
Player caballeroXXX raises (1.25)
Player legenda99 folds
Player Goomashroom folds
Player lovecola folds
Uncalled bet (0.75) returned to caballeroXXX
Player caballeroXXX mucks cards
------ Summary ------
Pot: 1.25. Rake 0
Player legenda99 does not show cards.Bets: 0. Collects: 0. Wins: 0.
Player Goomashroom does not show cards.Bets: 0.25. Collects: 0. Loses: 0.25.
Player lovecola does not show cards.Bets: 0.50. Collects: 0. Loses: 0.50.
Player IlxxxlI does not show cards.Bets: 0. Collects: 0. Wins: 0.
*Player caballeroXXX mucks (does not show cards). Bets: 0.50. Collects: 1.25. Wins: 0.75.
Game ended at: 2016/11/28 20:1:47

Game started
Game ID: 786368076 0.50/1 (PRR) Kraken (short) (Hold'em)
Seat 4 is the button
Seat 1: Cinch23 (73.88).
Seat 2: 38979 (51.89).
Seat 3: Bhodisattva (22.68).
Seat 4: TranscendencE (65.69).
Seat 5: IlxxxlI (36.29).
Seat 6: meandkids (50).
Player IlxxxlI has small blind (0.50)
Player meandkids has big blind (1)
Player IlxxxlI received card: [Ad]
Player IlxxxlI received card: [9s]
Player Cinch23 folds
Player 38979 folds
Player Bhodisattva raises (2)
Player TranscendencE folds
Player IlxxxlI folds
Player meandkids folds
Uncalled bet (1) returned to Bhodisattva
Player Bhodisattva mucks cards
------ Summary ------
Pot: 2.50. Rake 0
Player Cinch23 does not show cards.Bets: 0. Collects: 0. Wins: 0.
Player 38979 does not show cards.Bets: 0. Collects: 0. Wins: 0.
*Player Bhodisattva mucks (does not show cards). Bets: 1. Collects: 2.50. Wins: 1.50.
Player TranscendencE does not show cards.Bets: 0. Collects: 0. Wins: 0.
Player IlxxxlI does not show cards.Bets: 0.50. Collects: 0. Loses: 0.50.
Player meandkids does not show cards.Bets: 1. Collects: 0. Loses: 1.
Game ended at: 2016/11/28 20:1:40

Game started
Game ID: 786368072 0.25/0.50 (PRR) Gorgons - 5 (Hold'em)
Seat 2 is the button
Seat 1: caballeroXXX (62.85).
Seat 2: 38979 (50).
Seat 3: meandkids (98.47).
Seat 4: Goomashroom (129.98).
Seat 5: legenda99 (70.24).
Seat 6: IlxxxlI (20).
Player meandkids has small blind (0.25)
Player Goomashroom has big blind (0.50)
Player IlxxxlI received card: [10c]
Player IlxxxlI received card: [3d]
Player legenda99 folds
Player IlxxxlI folds
Player caballeroXXX folds
Player 38979 raises (1.50)
Player meandkids raises (6.25)
Player Goomashroom folds
Player 38979 calls (5)
*** FLOP ***: [8d Qh Qs]
Player meandkids checks
Player 38979 bets (6.41)
Player meandkids calls (6.41)
*** TURN ***: [8d Qh Qs] [Ks]
Player meandkids checks
Player 38979 checks
*** RIVER ***: [8d Qh Qs Ks] [Jh]
Player meandkids checks
Player 38979 checks
Player 38979 mucks cards
------ Summary ------
Pot: 25.01. Rake 1.07. JP fee 0.24
Board: [8d Qh Qs Ks Jh]
Player caballeroXXX does not show cards.Bets: 0. Collects: 0. Wins: 0.
Player 38979 mucks (does not show cards). Bets: 12.91. Collects: 0. Loses: 12.91.
*Player meandkids shows: Two pairs. Qs and 7s [7c 7h]. Bets: 12.91. Collects: 25.01. Wins: 12.10.
Player Goomashroom does not show cards.Bets: 0.50. Collects: 0. Loses: 0.50.
Player legenda99 does not show cards.Bets: 0. Collects: 0. Wins: 0.
Player IlxxxlI does not show cards.Bets: 0. Collects: 0. Wins: 0.
Game ended at: 2016/11/28 20:2:3

Game started
Game ID: 786368029 1/2 (PRR) Lakhey (Short) - 2 (Hold'em)
Seat 6 is the button
Seat 1: IlxxxlI (40).
Seat 2: 38979 (201.43).
Seat 3: sheenius81 (101.17).
Seat 5: Wollverin (100).
Seat 6: dscshift (105.50).
Player IlxxxlI has small blind (1)
Player 38979 has big blind (2)
Player IlxxxlI received card: [8h]
Player IlxxxlI received card: [9c]
Player sheenius81 calls (2)
Player Wollverin folds
Player dscshift folds
Player IlxxxlI folds
Player 38979 raises (6.67)
Player sheenius81 calls (6.67)
*** FLOP ***: [9h 5s 2s]
Player 38979 checks
Player sheenius81 checks
*** TURN ***: [9h 5s 2s] [Ac]
Player 38979 bets (11.62)
Player sheenius81 calls (11.62)
*** RIVER ***: [9h 5s 2s Ac] [2d]
Player 38979 checks
Player sheenius81 bets (19.75)
Player 38979 folds
Uncalled bet (19.75) returned to sheenius81
Player sheenius81 mucks cards
------ Summary ------
Pot: 39.51. Rake 1.83. JP fee 0.24
Board: [9h 5s 2s Ac 2d]
Player IlxxxlI does not show cards.Bets: 1. Collects: 0. Loses: 1.
Player 38979 does not show cards.Bets: 20.29. Collects: 0. Loses: 20.29.
*Player sheenius81 mucks (does not show cards). Bets: 20.29. Collects: 39.51. Wins: 19.22.
Player Wollverin does not show cards.Bets: 0. Collects: 0. Wins: 0.
Player dscshift does not show cards.Bets: 0. Collects: 0. Wins: 0.
Game ended at: 2016/11/28 20:2:33

Game started
Game ID: 786368024 0.25/0.50 (PRR) Gorgons - 3 (Hold'em)
Seat 1 is the button
Seat 1: Goomashroom (72.12).
Seat 2: Cinch23 (50.50).
Seat 6: IlxxxlI (27.78).
Player Cinch23 has small blind (0.25)
Player IlxxxlI has big blind (0.50)
Player IlxxxlI received card: [10h]
Player IlxxxlI received card: [5s]
Player Goomashroom raises (1.13)
Player Cinch23 raises (4.25)
Player IlxxxlI folds
Player Goomashroom folds
Uncalled bet (3.37) returned to Cinch23
Player Cinch23 mucks cards
------ Summary ------
Pot: 2.76. Rake 0
Player Goomashroom does not show cards.Bets: 1.13. Collects: 0. Loses: 1.13.
*Player Cinch23 mucks (does not show cards). Bets: 1.13. Collects: 2.76. Wins: 1.63.
Player IlxxxlI does not show cards.Bets: 0.50. Collects: 0. Loses: 0.50.
Game ended at: 2016/11/28 20:1:33

Game started
Game ID: 786367959 0.25/0.50 (PRR) Gorgons - 5 (Hold'em)
Seat 1 is the button
Seat 1: caballeroXXX (62.85).
Seat 2: 38979 (50).
Seat 3: meandkids (95.41).
Seat 4: Goomashroom (129.98).
Seat 5: legenda99 (70.24).
Seat 6: IlxxxlI (20).
Player 38979 has small blind (0.25)
Player meandkids has big blind (0.50)
Player IlxxxlI received card: [As]
Player IlxxxlI received card: [7h]
Player Goomashroom folds
Player legenda99 folds
Player IlxxxlI folds
Player caballeroXXX folds
Player 38979 raises (1.25)
Player meandkids calls (1)
*** FLOP ***: [10s 3c Qd]
Player 38979 bets (1.90)
Player meandkids raises (7.60)
Player 38979 folds
Uncalled bet (5.70) returned to meandkids
Player meandkids mucks cards
------ Summary ------
Pot: 6.46. Rake 0.24. JP fee 0.10
Board: [10s 3c Qd]
Player caballeroXXX does not show cards.Bets: 0. Collects: 0. Wins: 0.
Player 38979 does not show cards.Bets: 3.40. Collects: 0. Loses: 3.40.
*Player meandkids mucks (does not show cards). Bets: 3.40. Collects: 6.46. Wins: 3.06.
Player Goomashroom does not show cards.Bets: 0. Collects: 0. Wins: 0.
Player legenda99 does not show cards.Bets: 0. Collects: 0. Wins: 0.
Player IlxxxlI does not show cards.Bets: 0. Collects: 0. Wins: 0.
Game ended at: 2016/11/28 20:1:13

Game started
Game ID: 786367918 1/2 (PRR) Lakhey (Short) - 2 (Hold'em)
Seat 5 is the button
Seat 1: IlxxxlI (40).
Seat 2: 38979 (201.43).
Seat 3: sheenius81 (105.17).
Seat 5: Wollverin (100).
Seat 6: dscshift (100).
Player dscshift has small blind (1)
Player IlxxxlI has big blind (2)
Player IlxxxlI received card: [3s]
Player IlxxxlI received card: [7h]
Player 38979 folds
Player sheenius81 raises (4)
Player Wollverin folds
Player dscshift calls (3)
Player IlxxxlI folds
*** FLOP ***: [6d 7d 5h]
Player dscshift bets (10)
Player sheenius81 folds
Uncalled bet (10) returned to dscshift
Player dscshift mucks cards
------ Summary ------
Pot: 9.50. Rake 0.34. JP fee 0.16
Board: [6d 7d 5h]
Player IlxxxlI does not show cards.Bets: 2. Collects: 0. Loses: 2.
Player 38979 does not show cards.Bets: 0. Collects: 0. Wins: 0.
Player sheenius81 does not show cards.Bets: 4. Collects: 0. Loses: 4.
Player Wollverin does not show cards.Bets: 0. Collects: 0. Wins: 0.
*Player dscshift mucks (does not show cards). Bets: 4. Collects: 9.50. Wins: 5.50.
Game ended at: 2016/11/28 20:1:8

Game started
Game ID: 786367890 0.50/1 (PRR) Kraken (short) (Hold'em)
Seat 3 is the button
Seat 1: Cinch23 (73.88).
Seat 2: 38979 (51.89).
Seat 3: Bhodisattva (22.68).
Seat 4: TranscendencE (77.10).
Seat 5: IlxxxlI (26.02).
Seat 6: meandkids (50).
Player TranscendencE has small blind (0.50)
Player IlxxxlI has big blind (1)
Player IlxxxlI received card: [Jc]
Player IlxxxlI received card: [Qc]
Player meandkids folds
Player Cinch23 folds
Player 38979 folds
Player Bhodisattva folds
Player TranscendencE raises (2.50)
Player IlxxxlI calls (2)
*** FLOP ***: [6c Jd Qh]
Player TranscendencE bets (2.85)
Player IlxxxlI calls (2.85)
*** TURN ***: [6c Jd Qh] [4h]
Player TranscendencE bets (5.56)
Player IlxxxlI calls (5.56)
*** RIVER ***: [6c Jd Qh 4h] [9s]
Player TranscendencE checks
Player IlxxxlI allin (14.61)
Player TranscendencE folds
Uncalled bet (14.61) returned to IlxxxlI
Player IlxxxlI mucks cards
------ Summary ------
Pot: 21.68. Rake 0.90. JP fee 0.24
Board: [6c Jd Qh 4h 9s]
Player Cinch23 does not show cards.Bets: 0. Collects: 0. Wins: 0.
Player 38979 does not show cards.Bets: 0. Collects: 0. Wins: 0.
Player Bhodisattva does not show cards.Bets: 0. Collects: 0. Wins: 0.
Player TranscendencE does not show cards.Bets: 11.41. Collects: 0. Loses: 11.41.
*Player IlxxxlI mucks (does not show cards). Bets: 11.41. Collects: 21.68. Wins: 10.27.
Player meandkids does not show cards.Bets: 0. Collects: 0. Wins: 0.
Game ended at: 2016/11/28 20:1:14

Game started
Game ID: 786367877 0.25/0.50 (PRR) Gorgons - 5 (Hold'em)
Seat 6 is the button
Seat 1: caballeroXXX (62.35).
Seat 2: 38979 (50).
Seat 3: meandkids (95.41).
Seat 4: Goomashroom (129.98).
Seat 5: legenda99 (70.24).
Seat 6: IlxxxlI (20).
Player caballeroXXX has small blind (0.25)
Player 38979 has big blind (0.50)
Player IlxxxlI received card: [Ac]
Player IlxxxlI received card: [8d]
Player meandkids folds
Player Goomashroom folds
Player legenda99 folds
Player IlxxxlI folds
Player caballeroXXX raises (1.25)
Player 38979 folds
Uncalled bet (1) returned to caballeroXXX
Player caballeroXXX mucks cards
------ Summary ------
Pot: 1. Rake 0
*Player caballeroXXX mucks (does not show cards). Bets: 0.50. Collects: 1. Wins: 0.50.
Player 38979 does not show cards.Bets: 0.50. Collects: 0. Loses: 0.50.
Player meandkids does not show cards.Bets: 0. Collects: 0. Wins: 0.
Player Goomashroom does not show cards.Bets: 0. Collects: 0. Wins: 0.
Player legenda99 does not show cards.Bets: 0. Collects: 0. Wins: 0.
Player IlxxxlI does not show cards.Bets: 0. Collects: 0. Wins: 0.
Game ended at: 2016/11/28 20:0:45

Game started
Game ID: 786367863 1/2 (PRR) Lakhey (Short) (Hold'em)
Seat 2 is the button
Seat 1: IlxxxlI (40).
Seat 2: 38979 (230.67).
Seat 3: BBDub27 (100).
Seat 4: Wollverin (107.10).
Seat 5: meandkids (125.67).
Seat 6: Are you with me (83).
Player BBDub27 has small blind (1)
Player Wollverin has big blind (2)
Player IlxxxlI received card: [10c]
Player IlxxxlI received card: [9s]
Player meandkids calls (2)
Player Are you with me calls (2)
Player IlxxxlI folds
Player 38979 folds
Player BBDub27 is timed out.
Player BBDub27 folds
Player Wollverin checks
*** FLOP ***: [2s Qc 5s]
Player Wollverin checks
Player meandkids bets (4.43)
Player Are you with me raises (14)
Player Wollverin folds
Player meandkids folds
Uncalled bet (9.57) returned to Are you with me
Player Are you with me mucks cards
------ Summary ------
Pot: 15.07. Rake 0.55. JP fee 0.24
Board: [2s Qc 5s]
Player IlxxxlI does not show cards.Bets: 0. Collects: 0. Wins: 0.
Player 38979 does not show cards.Bets: 0. Collects: 0. Wins: 0.
Player BBDub27 does not show cards.Bets: 1. Collects: 0. Loses: 1.
Player Wollverin does not show cards.Bets: 2. Collects: 0. Loses: 2.
Player meandkids does not show cards.Bets: 6.43. Collects: 0. Loses: 6.43.
*Player Are you with me mucks (does not show cards). Bets: 6.43. Collects: 15.07. Wins: 8.64.
Game ended at: 2016/11/28 20:1:39

Game started
Game ID: 786367847 0.50/1 (PRR) Kraken (short) (Hold'em)
Seat 2 is the button
Seat 1: Cinch23 (72.38).
Seat 2: 38979 (51.89).
Seat 3: Bhodisattva (23.18).
Seat 4: TranscendencE (78.10).
Seat 5: IlxxxlI (26.02).
Seat 6: meandkids (50).
Player Bhodisattva has small blind (0.50)
Player TranscendencE has big blind (1)
Player IlxxxlI received card: [Ac]
Player IlxxxlI received card: [5s]
Player IlxxxlI folds
Player meandkids folds
Player Cinch23 raises (2)
Player 38979 folds
Player Bhodisattva folds
Player TranscendencE folds
Uncalled bet (1) returned to Cinch23
Player Cinch23 mucks cards
------ Summary ------
Pot: 2.50. Rake 0
*Player Cinch23 mucks (does not show cards). Bets: 1. Collects: 2.50. Wins: 1.50.
Player 38979 does not show cards.Bets: 0. Collects: 0. Wins: 0.
Player Bhodisattva does not show cards.Bets: 0.50. Collects: 0. Loses: 0.50.
Player TranscendencE does not show cards.Bets: 1. Collects: 0. Loses: 1.
Player IlxxxlI does not show cards.Bets: 0. Collects: 0. Wins: 0.
Player meandkids does not show cards.Bets: 0. Collects: 0. Wins: 0.
Game ended at: 2016/11/28 20:0:23

Game started
Game ID: 786367735 1/2 (PRR) Lakhey (Short) - 2 (Hold'em)
Seat 3 is the button
Seat 1: IlxxxlI (40).
Seat 2: 38979 (193.18).
Seat 3: sheenius81 (111.17).
Seat 5: Wollverin (100).
Seat 6: dscshift (40).
Player Wollverin has small blind (1)
Player dscshift has big blind (2)
Player IlxxxlI received card: [4d]
Player IlxxxlI received card: [9d]
Player IlxxxlI folds
Player 38979 raises (6)
Player sheenius81 calls (6)
Player Wollverin folds
Player dscshift folds
*** FLOP ***: [10s 8c 6s]
Player 38979 checks
Player sheenius81 checks
*** TURN ***: [10s 8c 6s] [5h]
Player 38979 bets (10)
Player sheenius81 folds
Uncalled bet (10) returned to 38979
Player 38979 mucks cards
------ Summary ------
Pot: 14.25. Rake 0.51. JP fee 0.24
Board: [10s 8c 6s 5h]
Player IlxxxlI does not show cards.Bets: 0. Collects: 0. Wins: 0.
*Player 38979 mucks (does not show cards). Bets: 6. Collects: 14.25. Wins: 8.25.
Player sheenius81 does not show cards.Bets: 6. Collects: 0. Loses: 6.
Player Wollverin does not show cards.Bets: 1. Collects: 0. Loses: 1.
Player dscshift does not show cards.Bets: 2. Collects: 0. Loses: 2.
Game ended at: 2016/11/28 20:0:34

Game started
Game ID: 786367721 0.50/1 (PRR) Kraken (short) (Hold'em)
Seat 1 is the button
Seat 1: Cinch23 (72.38).
Seat 2: 38979 (54.89).
Seat 3: Bhodisattva (20.18).
Seat 4: TranscendencE (78.10).
Seat 5: IlxxxlI (26.02).
Seat 6: meandkids (50).
Player 38979 has small blind (0.50)
Player Bhodisattva has big blind (1)
Player IlxxxlI received card: [4c]
Player IlxxxlI received card: [9d]
Player TranscendencE folds
Player IlxxxlI folds
Player meandkids folds
Player Cinch23 folds
Player 38979 raises (2.50)
Player Bhodisattva allin (19.18)
Player 38979 folds
Uncalled bet (17.18) returned to Bhodisattva
Player Bhodisattva mucks cards
------ Summary ------
Pot: 6. Rake 0
Player Cinch23 does not show cards.Bets: 0. Collects: 0. Wins: 0.
Player 38979 does not show cards.Bets: 3. Collects: 0. Loses: 3.
*Player Bhodisattva mucks (does not show cards). Bets: 3. Collects: 6. Wins: 3.
Player TranscendencE does not show cards.Bets: 0. Collects: 0. Wins: 0.
Player IlxxxlI does not show cards.Bets: 0. Collects: 0. Wins: 0.
Player meandkids does not show cards.Bets: 0. Collects: 0. Wins: 0.
Game ended at: 2016/11/28 20:0:8

Game started
Game ID: 786367710 1/2 (PRR) Lakhey (Hold'em)
Seat 5 is the button
Seat 2: IlxxxlI (86.02).
Seat 3: gfclbv (80).
Seat 5: Orondi (444.13).
Player IlxxxlI has small blind (1)
Player gfclbv has big blind (2)
Player IlxxxlI received card: [Jc]
Player IlxxxlI received card: [6h]
Player Orondi folds
Player IlxxxlI folds
Uncalled bet (1) returned to gfclbv
Player gfclbv mucks cards
------ Summary ------
Pot: 2. Rake 0
Player IlxxxlI does not show cards.Bets: 1. Collects: 0. Loses: 1.
*Player gfclbv mucks (does not show cards). Bets: 1. Collects: 2. Wins: 1.
Player Orondi does not show cards.Bets: 0. Collects: 0. Wins: 0.
Game ended at: 2016/11/28 19:59:54

Game started
Game ID: 786367697 1/2 (PRR) Lakhey (Hold'em)
Seat 2 is the button
Seat 2: IlxxxlI (87.02).
Seat 5: Orondi (443.13).
Player IlxxxlI has small blind (1)
Player Orondi has big blind (2)
Player IlxxxlI received card: [5d]
Player IlxxxlI received card: [Ks]
Player IlxxxlI folds
Uncalled bet (1) returned to Orondi
Player Orondi mucks cards
------ Summary ------
Pot: 2. Rake 0
Player IlxxxlI does not show cards.Bets: 1. Collects: 0. Loses: 1.
*Player Orondi mucks (does not show cards). Bets: 1. Collects: 2. Wins: 1.
Game ended at: 2016/11/28 19:59:33

Game started
Game ID: 786367693 1/2 (PRR) Lakhey (Short) (Hold'em)
Seat 1 is the button
Seat 1: IlxxxlI (40).
Seat 2: 38979 (231.67).
Seat 3: BBDub27 (100).
Seat 4: Wollverin (107.10).
Seat 5: meandkids (117.52).
Seat 6: Are you with me (83).
Player 38979 has small blind (1)
Player BBDub27 has big blind (2)
Player IlxxxlI received card: [3d]
Player IlxxxlI received card: [6s]
Player Wollverin folds
Player meandkids raises (8)
Player Are you with me folds
Player IlxxxlI folds
Player 38979 folds
Player BBDub27 calls (6)
*** FLOP ***: [Kh Ad 5h]
Player BBDub27 checks
Player meandkids bets (10.76)
Player BBDub27 folds
Uncalled bet (10.76) returned to meandkids
Player meandkids mucks cards
------ Summary ------
Pot: 16.15. Rake 0.61. JP fee 0.24
Board: [Kh Ad 5h]
Player IlxxxlI does not show cards.Bets: 0. Collects: 0. Wins: 0.
Player 38979 does not show cards.Bets: 1. Collects: 0. Loses: 1.
Player BBDub27 does not show cards.Bets: 8. Collects: 0. Loses: 8.
Player Wollverin does not show cards.Bets: 0. Collects: 0. Wins: 0.
*Player meandkids mucks (does not show cards). Bets: 8. Collects: 16.15. Wins: 8.15.
Player Are you with me does not show cards.Bets: 0. Collects: 0. Wins: 0.
Game ended at: 2016/11/28 20:0:15

Game started
Game ID: 786367681 0.50/1 (PRR) Kraken (short) (Hold'em)
Seat 6 is the button
Seat 1: Cinch23 (72.88).
Seat 2: 38979 (55.89).
Seat 3: Bhodisattva (20.18).
Seat 4: TranscendencE (78.10).
Seat 5: IlxxxlI (26.02).
Seat 6: meandkids (48.50).
Player Cinch23 has small blind (0.50)
Player 38979 has big blind (1)
Player IlxxxlI received card: [5d]
Player IlxxxlI received card: [Ah]
Player Bhodisattva folds
Player TranscendencE folds
Player IlxxxlI folds
Player meandkids raises (6)
Player Cinch23 folds
Player 38979 folds
Uncalled bet (5) returned to meandkids
Player meandkids mucks cards
------ Summary ------
Pot: 2.50. Rake 0
Player Cinch23 does not show cards.Bets: 0.50. Collects: 0. Loses: 0.50.
Player 38979 does not show cards.Bets: 1. Collects: 0. Loses: 1.
Player Bhodisattva does not show cards.Bets: 0. Collects: 0. Wins: 0.
Player TranscendencE does not show cards.Bets: 0. Collects: 0. Wins: 0.
Player IlxxxlI does not show cards.Bets: 0. Collects: 0. Wins: 0.
*Player meandkids mucks (does not show cards). Bets: 1. Collects: 2.50. Wins: 1.50.
Game ended at: 2016/11/28 19:59:37

Game started
Game ID: 786367656 1/2 (PRR) Lakhey (Short) - 2 (Hold'em)
Seat 2 is the button
Seat 1: IlxxxlI (40).
Seat 2: 38979 (193.18).
Seat 3: sheenius81 (107.57).
Seat 5: Wollverin (100).
Player sheenius81 has small blind (1)
Player Wollverin has big blind (2)
Player IlxxxlI received card: [8s]
Player IlxxxlI received card: [5s]
Player IlxxxlI folds
Player 38979 folds
Player sheenius81 raises (3)
Player Wollverin calls (2)
*** FLOP ***: [Jd 6d Ad]
Player sheenius81 bets (5.06)
Player Wollverin folds
Uncalled bet (5.06) returned to sheenius81
Player sheenius81 mucks cards
------ Summary ------
Pot: 7.60. Rake 0.28. JP fee 0.12
Board: [Jd 6d Ad]
Player IlxxxlI does not show cards.Bets: 0. Collects: 0. Wins: 0.
Player 38979 does not show cards.Bets: 0. Collects: 0. Wins: 0.
*Player sheenius81 mucks (does not show cards). Bets: 4. Collects: 7.60. Wins: 3.60.
Player Wollverin does not show cards.Bets: 4. Collects: 0. Loses: 4.
Game ended at: 2016/11/28 19:59:43

Game started
Game ID: 786367651 0.25/0.50 (PRR) Gorgons - 5 (Hold'em)
Seat 5 is the button
Seat 1: caballeroXXX (62.85).
Seat 2: 38979 (50).
Seat 3: meandkids (81.60).
Seat 4: Goomashroom (129.98).
Seat 5: legenda99 (84.79).
Seat 6: IlxxxlI (20).
Player IlxxxlI has small blind (0.25)
Player caballeroXXX has big blind (0.50)
Player IlxxxlI received card: [2c]
Player IlxxxlI received card: [6d]
Player 38979 folds
Player meandkids raises (3)
Player Goomashroom folds
Player legenda99 calls (3)
Player IlxxxlI folds
Player caballeroXXX folds
*** FLOP ***: [10d 7c 9c]
Player meandkids bets (4.28)
Player legenda99 calls (4.28)
*** TURN ***: [10d 7c 9c] [7d]
Player meandkids checks
Player legenda99 bets (7.27)
Player meandkids calls (7.27)
*** RIVER ***: [10d 7c 9c 7d] [5c]
Player meandkids checks
Player legenda99 checks
------ Summary ------
Pot: 28.36. Rake 1.25. JP fee 0.24
Board: [10d 7c 9c 7d 5c]
Player caballeroXXX does not show cards.Bets: 0.50. Collects: 0. Loses: 0.50.
Player 38979 does not show cards.Bets: 0. Collects: 0. Wins: 0.
*Player meandkids shows: Flush, A high [Ac 3c]. Bets: 14.55. Collects: 28.36. Wins: 13.81.
Player Goomashroom does not show cards.Bets: 0. Collects: 0. Wins: 0.
Player legenda99 shows: Two pairs. 9s and 7s [Js 9s]. Bets: 14.55. Collects: 0. Loses: 14.55.
Player IlxxxlI does not show cards.Bets: 0.25. Collects: 0. Loses: 0.25.
Game ended at: 2016/11/28 20:0:16

Game started
Game ID: 786367636 0.25/0.50 (PRR) Gorgons - 8 (Hold'em)
Seat 6 is the button
Seat 1: legenda99 (111.55).
Seat 3: Goomashroom (52.37).
Seat 4: lovecola (52.73).
Seat 5: IlxxxlI (21.15).
Seat 6: caballeroXXX (124.71).
Player legenda99 has small blind (0.25)
Player Goomashroom has big blind (0.50)
Player IlxxxlI received card: [6c]
Player IlxxxlI received card: [Ad]
Player lovecola folds
Player IlxxxlI folds
Player caballeroXXX raises (1)
Player legenda99 raises (3.25)
Player Goomashroom folds
Player caballeroXXX calls (2.50)
*** FLOP ***: [Ac 2s 9h]
Player legenda99 checks
Player caballeroXXX checks
*** TURN ***: [Ac 2s 9h] [3c]
Player legenda99 bets (3.56)
Player caballeroXXX calls (3.56)
*** RIVER ***: [Ac 2s 9h 3c] [7h]
Player legenda99 bets (8.50)
Player caballeroXXX raises (30)
Player legenda99 calls (21.50)
Player legenda99 mucks cards
------ Summary ------
Pot: 71.62. Rake 2.76. JP fee 0.24
Board: [Ac 2s 9h 3c 7h]
Player legenda99 mucks (does not show cards). Bets: 37.06. Collects: 0. Loses: 37.06.
Player Goomashroom does not show cards.Bets: 0.50. Collects: 0. Loses: 0.50.
Player lovecola does not show cards.Bets: 0. Collects: 0. Wins: 0.
Player IlxxxlI does not show cards.Bets: 0. Collects: 0. Wins: 0.
*Player caballeroXXX shows: Three Of Kind of 7s [7c 7d]. Bets: 37.06. Collects: 71.62. Wins: 34.56.
Game ended at: 2016/11/28 20:1:18

Game started
Game ID: 786367629 0.25/0.50 (PRR) Gorgons - 3 (Hold'em)
Seat 6 is the button
Seat 1: Goomashroom (51).
Seat 2: Cinch23 (48.25).
Seat 6: IlxxxlI (27.78).
Player Goomashroom has small blind (0.25)
Player Cinch23 has big blind (0.50)
Player IlxxxlI received card: [Kh]
Player IlxxxlI received card: [6s]
Player IlxxxlI folds
Player Goomashroom raises (1.25)
Player Cinch23 calls (1)
*** FLOP ***: [6d Qd 10d]
Player Goomashroom bets (2.12)
Player Cinch23 calls (2.12)
*** TURN ***: [6d Qd 10d] [4d]
Player Goomashroom bets (2.54)
Player Cinch23 raises (7.75)
Player Goomashroom calls (5.21)
*** RIVER ***: [6d Qd 10d 4d] [7c]
Player Goomashroom checks
Player Cinch23 bets (11)
Player Goomashroom raises (22)
Player Cinch23 folds
Uncalled bet (11) returned to Goomashroom
Player Goomashroom mucks cards
------ Summary ------
Pot: 43.74. Rake 0.92. JP fee 0.08
Board: [6d Qd 10d 4d 7c]
*Player Goomashroom mucks (does not show cards). Bets: 22.37. Collects: 43.74. Wins: 21.37.
Player Cinch23 does not show cards.Bets: 22.37. Collects: 0. Loses: 22.37.
Player IlxxxlI does not show cards.Bets: 0. Collects: 0. Wins: 0.
Game ended at: 2016/11/28 20:0:35

Game started
Game ID: 786367626 1/2 (PRR) Lakhey (Short) - 2 (Hold'em)
Seat 1 is the button
Seat 1: IlxxxlI (40).
Seat 2: 38979 (194.18).
Seat 3: sheenius81 (106.57).
Seat 5: Wollverin (100).
Player 38979 has small blind (1)
Player sheenius81 has big blind (2)
Player IlxxxlI received card: [3s]
Player IlxxxlI received card: [Ac]
Player Wollverin folds
Player IlxxxlI folds
Player 38979 folds
Uncalled bet (1) returned to sheenius81
Player sheenius81 mucks cards
------ Summary ------
Pot: 2. Rake 0
Player IlxxxlI does not show cards.Bets: 0. Collects: 0. Wins: 0.
Player 38979 does not show cards.Bets: 1. Collects: 0. Loses: 1.
*Player sheenius81 mucks (does not show cards). Bets: 1. Collects: 2. Wins: 1.
Player Wollverin does not show cards.Bets: 0. Collects: 0. Wins: 0.
Game ended at: 2016/11/28 19:59:11

Game started
Game ID: 786367586 1/2 (PRR) Lakhey (Short) (Hold'em)
Seat 6 is the button
Seat 1: IlxxxlI (40).
Seat 2: 38979 (233.67).
Seat 4: Wollverin (112.10).
Seat 5: meandkids (122.52).
Seat 6: Are you with me (70).
Player IlxxxlI has small blind (1)
Player 38979 has big blind (2)
Player IlxxxlI received card: [9h]
Player IlxxxlI received card: [5s]
Player Wollverin raises (5)
Player meandkids calls (5)
Player Are you with me allin (70)
Player IlxxxlI folds
Player 38979 folds
Player Wollverin folds
Player meandkids folds
Uncalled bet (65) returned to Are you with me
Player Are you with me mucks cards
------ Summary ------
Pot: 18. Rake 0
Player IlxxxlI does not show cards.Bets: 1. Collects: 0. Loses: 1.
Player 38979 does not show cards.Bets: 2. Collects: 0. Loses: 2.
Player Wollverin does not show cards.Bets: 5. Collects: 0. Loses: 5.
Player meandkids does not show cards.Bets: 5. Collects: 0. Loses: 5.
*Player Are you with me mucks (does not show cards). Bets: 5. Collects: 18. Wins: 13.
Game ended at: 2016/11/28 19:59:25

Game started
Game ID: 786367578 0.25/0.50 (PRR) Gorgons - 5 (Hold'em)
Seat 4 is the button
Seat 1: caballeroXXX (64.35).
Seat 2: 38979 (50).
Seat 3: meandkids (79.35).
Seat 4: Goomashroom (129.98).
Seat 5: legenda99 (85.04).
Seat 6: IlxxxlI (20).
Player legenda99 has small blind (0.25)
Player IlxxxlI has big blind (0.50)
Player IlxxxlI received card: [10h]
Player IlxxxlI received card: [2c]
Player caballeroXXX raises (1.50)
Player 38979 folds
Player meandkids raises (6.50)
Player Goomashroom folds
Player legenda99 folds
Player IlxxxlI folds
Player caballeroXXX folds
Uncalled bet (5) returned to meandkids
Player meandkids mucks cards
------ Summary ------
Pot: 3.75. Rake 0
Player caballeroXXX does not show cards.Bets: 1.50. Collects: 0. Loses: 1.50.
Player 38979 does not show cards.Bets: 0. Collects: 0. Wins: 0.
*Player meandkids mucks (does not show cards). Bets: 1.50. Collects: 3.75. Wins: 2.25.
Player Goomashroom does not show cards.Bets: 0. Collects: 0. Wins: 0.
Player legenda99 does not show cards.Bets: 0.25. Collects: 0. Loses: 0.25.
Player IlxxxlI does not show cards.Bets: 0.50. Collects: 0. Loses: 0.50.
Game ended at: 2016/11/28 19:59:7

Game started
Game ID: 786367575 0.25/0.50 (PRR) Gorgons - 3 (Hold'em)
Seat 2 is the button
Seat 1: Goomashroom (50.75).
Seat 2: Cinch23 (48.25).
Seat 6: IlxxxlI (28.03).
Player IlxxxlI has small blind (0.25)
Player Goomashroom has big blind (0.50)
Player IlxxxlI received card: [5d]
Player IlxxxlI received card: [4s]
Player Cinch23 folds
Player IlxxxlI folds
Uncalled bet (0.25) returned to Goomashroom
Player Goomashroom mucks cards
------ Summary ------
Pot: 0.50. Rake 0
*Player Goomashroom mucks (does not show cards). Bets: 0.25. Collects: 0.50. Wins: 0.25.
Player Cinch23 does not show cards.Bets: 0. Collects: 0. Wins: 0.
Player IlxxxlI does not show cards.Bets: 0.25. Collects: 0. Loses: 0.25.
Game ended at: 2016/11/28 19:59:0

Game started
Game ID: 786367550 1/2 (PRR) Lakhey (Short) - 2 (Hold'em)
Seat 5 is the button
Seat 1: IlxxxlI (40).
Seat 2: 38979 (198.18).
Seat 3: sheenius81 (102.02).
Seat 5: Wollverin (100).
Player IlxxxlI has small blind (1)
Player 38979 has big blind (2)
Player IlxxxlI received card: [5s]
Player IlxxxlI received card: [3c]
Player sheenius81 raises (4)
Player Wollverin folds
Player IlxxxlI folds
Player 38979 calls (2)
*** FLOP ***: [8h 6h 9h]
Player 38979 checks
Player sheenius81 bets (5.70)
Player 38979 folds
Uncalled bet (5.70) returned to sheenius81
Player sheenius81 mucks cards
------ Summary ------
Pot: 8.55. Rake 0.31. JP fee 0.14
Board: [8h 6h 9h]
Player IlxxxlI does not show cards.Bets: 1. Collects: 0. Loses: 1.
Player 38979 does not show cards.Bets: 4. Collects: 0. Loses: 4.
*Player sheenius81 mucks (does not show cards). Bets: 4. Collects: 8.55. Wins: 4.55.
Player Wollverin does not show cards.Bets: 0. Collects: 0. Wins: 0.
Game ended at: 2016/11/28 19:58:59

Game started
Game ID: 786367514 1/2 (PRR) Lakhey (Hold'em)
Seat 5 is the button
Seat 2: IlxxxlI (80).
Seat 4: Are you with me (98.22).
Seat 5: Orondi (450.93).
Player IlxxxlI has small blind (1)
Player Are you with me sitting out
Player Orondi has big blind (2)
Player IlxxxlI received card: [3c]
Player IlxxxlI received card: [3h]
Player IlxxxlI calls (1)
Player Orondi checks
*** FLOP ***: [4c 7d 6d]
Player IlxxxlI checks
Player Orondi bets (2)
Player IlxxxlI calls (2)
*** TURN ***: [4c 7d 6d] [3s]
Player IlxxxlI checks
Player Orondi bets (3.80)
Player IlxxxlI calls (3.80)
*** RIVER ***: [4c 7d 6d 3s] [10d]
Player IlxxxlI checks
Player Orondi checks
------ Summary ------
Pot: 14.82. Rake 0.74. JP fee 0.04
Board: [4c 7d 6d 3s 10d]
*Player IlxxxlI shows: Three Of Kind of 3s [3c 3h]. Bets: 7.80. Collects: 14.82. Wins: 7.02.
Player Are you with me does not show cards.Bets: 0. Collects: 0. Wins: 0.
Player Orondi shows: One pair of 7s [8h 7h]. Bets: 7.80. Collects: 0. Loses: 7.80.
Game ended at: 2016/11/28 19:59:23

Game started
Game ID: 786367466 0.25/0.50 (PRR) Gorgons - 3 (Hold'em)
Seat 1 is the button
Seat 1: Goomashroom (50).
Seat 2: Cinch23 (48.50).
Seat 6: IlxxxlI (28.53).
Player Cinch23 has small blind (0.25)
Player IlxxxlI has big blind (0.50)
Player IlxxxlI received card: [4d]
Player IlxxxlI received card: [7s]
Player Goomashroom raises (1.13)
Player Cinch23 folds
Player IlxxxlI folds
Uncalled bet (0.63) returned to Goomashroom
Player Goomashroom mucks cards
------ Summary ------
Pot: 1.25. Rake 0
*Player Goomashroom mucks (does not show cards). Bets: 0.50. Collects: 1.25. Wins: 0.75.
Player Cinch23 does not show cards.Bets: 0.25. Collects: 0. Loses: 0.25.
Player IlxxxlI does not show cards.Bets: 0.50. Collects: 0. Loses: 0.50.
Game ended at: 2016/11/28 19:58:43

Game started
Game ID: 786367424 1/2 (PRR) Lakhey (Short) - 2 (Hold'em)
Seat 4 is the button
Seat 1: IlxxxlI (40).
Seat 2: 38979 (100).
Seat 3: sheenius81 (102.02).
Seat 4: brokenlucks (98.18).
Seat 5: Wollverin (100).
Player Wollverin has small blind (1)
Player IlxxxlI has big blind (2)
Player IlxxxlI received card: [8d]
Player IlxxxlI received card: [Kc]
Player 38979 raises (6)
Player sheenius81 folds
Player brokenlucks calls (6)
Player Wollverin folds
Player IlxxxlI folds
*** FLOP ***: [3s Ad Jc]
Player 38979 bets (9.50)
Player brokenlucks calls (9.50)
*** TURN ***: [3s Ad Jc] [10s]
Player 38979 bets (24)
Player brokenlucks calls (24)
*** RIVER ***: [3s Ad Jc 10s] [10h]
Player 38979 allin (60.50)
Player brokenlucks allin (58.68)
Uncalled bet (1.82) returned to 38979
------ Summary ------
Pot: 196.36. Rake 2.76. JP fee 0.24
Board: [3s Ad Jc 10s 10h]
Player IlxxxlI does not show cards.Bets: 2. Collects: 0. Loses: 2.
*Player 38979 shows: Two pairs. As and Js [Jd Ac]. Bets: 98.18. Collects: 196.36. Wins: 98.18.
Player sheenius81 does not show cards.Bets: 0. Collects: 0. Wins: 0.
Player brokenlucks shows: Two pairs. As and 10s [Qc As]. Bets: 98.18. Collects: 0. Loses: 98.18.
Player Wollverin does not show cards.Bets: 1. Collects: 0. Loses: 1.
Game ended at: 2016/11/28 19:58:35

Game started
Game ID: 786367419 0.25/0.50 (PRR) Gorgons - 3 (Hold'em)
Seat 6 is the button
Seat 1: Goomashroom (50.10).
Seat 2: Cinch23 (49).
Seat 4: 38979 (95.70).
Seat 6: IlxxxlI (27.78).
Player Goomashroom has small blind (0.25)
Player Cinch23 has big blind (0.50)
Player IlxxxlI received card: [Ah]
Player IlxxxlI received card: [Jh]
Player 38979 folds
Player IlxxxlI raises (1.50)
Player Goomashroom folds
Player Cinch23 folds
Uncalled bet (1) returned to IlxxxlI
Player IlxxxlI mucks cards
------ Summary ------
Pot: 1.25. Rake 0
Player Goomashroom does not show cards.Bets: 0.25. Collects: 0. Loses: 0.25.
Player Cinch23 does not show cards.Bets: 0.50. Collects: 0. Loses: 0.50.
Player 38979 does not show cards.Bets: 0. Collects: 0. Wins: 0.
*Player IlxxxlI mucks (does not show cards). Bets: 0.50. Collects: 1.25. Wins: 0.75.
Game ended at: 2016/11/28 19:58:5

Game started
Game ID: 786367416 0.50/1 (PRR) Kraken (short) (Hold'em)
Seat 5 is the button
Seat 1: Cinch23 (64.30).
Seat 2: 38979 (55.89).
Seat 3: Bhodisattva (29.18).
Seat 4: TranscendencE (78.10).
Seat 5: IlxxxlI (26.02).
Seat 6: meandkids (49).
Player meandkids has small blind (0.50)
Player Cinch23 has big blind (1)
Player IlxxxlI received card: [3c]
Player IlxxxlI received card: [6h]
Player 38979 folds
Player Bhodisattva raises (2)
Player TranscendencE folds
Player IlxxxlI folds
Player meandkids folds
Player Cinch23 calls (1)
*** FLOP ***: [4s 9d 5h]
Player Cinch23 checks
Player Bhodisattva bets (2)
Player Cinch23 raises (7)
Player Bhodisattva calls (5)
*** TURN ***: [4s 9d 5h] [10c]
Player Cinch23 bets (9)
Player Bhodisattva folds
Uncalled bet (9) returned to Cinch23
Player Cinch23 mucks cards
------ Summary ------
Pot: 17.58. Rake 0.68. JP fee 0.24
Board: [4s 9d 5h 10c]
*Player Cinch23 mucks (does not show cards). Bets: 9. Collects: 17.58. Wins: 8.58.
Player 38979 does not show cards.Bets: 0. Collects: 0. Wins: 0.
Player Bhodisattva does not show cards.Bets: 9. Collects: 0. Loses: 9.
Player TranscendencE does not show cards.Bets: 0. Collects: 0. Wins: 0.
Player IlxxxlI does not show cards.Bets: 0. Collects: 0. Wins: 0.
Player meandkids does not show cards.Bets: 0.50. Collects: 0. Loses: 0.50.
Game ended at: 2016/11/28 19:59:18

Game started
Game ID: 786367389 0.25/0.50 (PRR) Gorgons - 8 (Hold'em)
Seat 5 is the button
Seat 1: legenda99 (110.18).
Seat 3: Goomashroom (52.37).
Seat 4: lovecola (53.98).
Seat 5: IlxxxlI (21.15).
Seat 6: caballeroXXX (124.96).
Player caballeroXXX has small blind (0.25)
Player legenda99 has big blind (0.50)
Player IlxxxlI received card: [2s]
Player IlxxxlI received card: [Ks]
Player Goomashroom folds
Player lovecola raises (1.25)
Player IlxxxlI folds
Player caballeroXXX folds
Player legenda99 calls (0.75)
*** FLOP ***: [5c 2c 9c]
Player legenda99 checks
Player lovecola checks
*** TURN ***: [5c 2c 9c] [Kd]
Player legenda99 bets (1.50)
Player lovecola folds
Uncalled bet (1.50) returned to legenda99
Player legenda99 mucks cards
------ Summary ------
Pot: 2.62. Rake 0.09. JP fee 0.04
Board: [5c 2c 9c Kd]
*Player legenda99 mucks (does not show cards). Bets: 1.25. Collects: 2.62. Wins: 1.37.
Player Goomashroom does not show cards.Bets: 0. Collects: 0. Wins: 0.
Player lovecola does not show cards.Bets: 1.25. Collects: 0. Loses: 1.25.
Player IlxxxlI does not show cards.Bets: 0. Collects: 0. Wins: 0.
Player caballeroXXX does not show cards.Bets: 0.25. Collects: 0. Loses: 0.25.
Game ended at: 2016/11/28 19:59:0

Game started
Game ID: 786367349 1/2 (PRR) Lakhey (Short) - 2 (Hold'em)
Seat 3 is the button
Seat 1: IlxxxlI (40).
Seat 2: 38979 (100).
Seat 3: sheenius81 (104.02).
Seat 4: brokenlucks (94.18).
Seat 5: Wollverin (100).
Player brokenlucks has small blind (1)
Player Wollverin has big blind (2)
Player IlxxxlI received card: [4c]
Player IlxxxlI received card: [5d]
Player IlxxxlI folds
Player 38979 folds
Player sheenius81 calls (2)
Player brokenlucks raises (11)
Player Wollverin folds
Player sheenius81 folds
Uncalled bet (10) returned to brokenlucks
Player brokenlucks mucks cards
------ Summary ------
Pot: 6. Rake 0
Player IlxxxlI does not show cards.Bets: 0. Collects: 0. Wins: 0.
Player 38979 does not show cards.Bets: 0. Collects: 0. Wins: 0.
Player sheenius81 does not show cards.Bets: 2. Collects: 0. Loses: 2.
*Player brokenlucks mucks (does not show cards). Bets: 2. Collects: 6. Wins: 4.
Player Wollverin does not show cards.Bets: 2. Collects: 0. Loses: 2.
Game ended at: 2016/11/28 19:57:48

Game started
Game ID: 786367347 0.50/1 (PRR) Kraken (short) (Hold'em)
Seat 4 is the button
Seat 1: Cinch23 (64.30).
Seat 2: 38979 (51.76).
Seat 3: Bhodisattva (29.18).
Seat 4: TranscendencE (81.10).
Seat 5: IlxxxlI (26.52).
Seat 6: meandkids (50).
Player IlxxxlI has small blind (0.50)
Player meandkids has big blind (1)
Player IlxxxlI received card: [3h]
Player IlxxxlI received card: [3d]
Player Cinch23 folds
Player 38979 raises (3)
Player Bhodisattva folds
Player TranscendencE calls (3)
Player IlxxxlI folds
Player meandkids folds
*** FLOP ***: [8d Ad 10d]
Player 38979 bets (4.75)
Player TranscendencE folds
Uncalled bet (4.75) returned to 38979
Player 38979 mucks cards
------ Summary ------
Pot: 7.13. Rake 0.25. JP fee 0.12
Board: [8d Ad 10d]
Player Cinch23 does not show cards.Bets: 0. Collects: 0. Wins: 0.
*Player 38979 mucks (does not show cards). Bets: 3. Collects: 7.13. Wins: 4.13.
Player Bhodisattva does not show cards.Bets: 0. Collects: 0. Wins: 0.
Player TranscendencE does not show cards.Bets: 3. Collects: 0. Loses: 3.
Player IlxxxlI does not show cards.Bets: 0.50. Collects: 0. Loses: 0.50.
Player meandkids does not show cards.Bets: 1. Collects: 0. Loses: 1.
Game ended at: 2016/11/28 19:57:47

Game started
Game ID: 786367306 1/2 (PRR) Lakhey (Short) (Hold'em)
Seat 5 is the button
Seat 1: IlxxxlI (40).
Seat 2: 38979 (233.67).
Seat 4: Wollverin (107.55).
Seat 5: meandkids (122.52).
Seat 6: Are you with me (70).
Player Are you with me has small blind (1)
Player IlxxxlI has big blind (2)
Player IlxxxlI received card: [7c]
Player IlxxxlI received card: [Ad]
Player 38979 folds
Player Wollverin raises (4)
Player meandkids folds
Player Are you with me folds
Player IlxxxlI calls (2)
*** FLOP ***: [8h Qs 10c]
Player IlxxxlI checks
Player Wollverin checks
*** TURN ***: [8h Qs 10c] [8s]
Player IlxxxlI checks
Player Wollverin checks
*** RIVER ***: [8h Qs 10c 8s] [4h]
Player IlxxxlI checks
Player Wollverin checks
Player IlxxxlI mucks cards
------ Summary ------
Pot: 8.55. Rake 0.31. JP fee 0.14
Board: [8h Qs 10c 8s 4h]
Player IlxxxlI mucks (does not show: [7c Ad]). Bets: 4. Collects: 0. Loses: 4.
Player 38979 does not show cards.Bets: 0. Collects: 0. Wins: 0.
*Player Wollverin shows: One pair of 8s [Js As]. Bets: 4. Collects: 8.55. Wins: 4.55.
Player meandkids does not show cards.Bets: 0. Collects: 0. Wins: 0.
Player Are you with me does not show cards.Bets: 1. Collects: 0. Loses: 1.
Game ended at: 2016/11/28 19:58:45

Game started
Game ID: 786367249 0.25/0.50 (PRR) Gorgons - 3 (Hold'em)
Seat 4 is the button
Seat 1: Goomashroom (51.35).
Seat 2: Cinch23 (49).
Seat 4: 38979 (95.70).
Seat 6: IlxxxlI (26.65).
Player IlxxxlI has small blind (0.25)
Player Goomashroom has big blind (0.50)
Player IlxxxlI received card: [Jh]
Player IlxxxlI received card: [Jc]
Player Cinch23 folds
Player 38979 folds
Player IlxxxlI raises (1)
Player Goomashroom calls (0.75)
*** FLOP ***: [Ad As 3h]
Player IlxxxlI checks
Player Goomashroom checks
*** TURN ***: [Ad As 3h] [4c]
Player IlxxxlI bets (0.79)
Player Goomashroom folds
Uncalled bet (0.79) returned to IlxxxlI
Player IlxxxlI mucks cards
------ Summary ------
Pot: 2.38. Rake 0.08. JP fee 0.04
Board: [Ad As 3h 4c]
Player Goomashroom does not show cards.Bets: 1.25. Collects: 0. Loses: 1.25.
Player Cinch23 does not show cards.Bets: 0. Collects: 0. Wins: 0.
Player 38979 does not show cards.Bets: 0. Collects: 0. Wins: 0.
*Player IlxxxlI mucks (does not show cards). Bets: 1.25. Collects: 2.38. Wins: 1.13.
Game ended at: 2016/11/28 19:57:46

Game started
Game ID: 786367241 1/2 (PRR) Lakhey (Short) - 2 (Hold'em)
Seat 2 is the button
Seat 1: IlxxxlI (40).
Seat 2: 38979 (100).
Seat 3: sheenius81 (106.02).
Seat 4: brokenlucks (92.18).
Player sheenius81 has small blind (1)
Player brokenlucks has big blind (2)
Player IlxxxlI received card: [7h]
Player IlxxxlI received card: [10c]
Player IlxxxlI folds
Player 38979 folds
Player sheenius81 calls (1)
Player brokenlucks raises (7.34)
Player sheenius81 folds
Uncalled bet (7.34) returned to brokenlucks
Player brokenlucks mucks cards
------ Summary ------
Pot: 4. Rake 0
Player IlxxxlI does not show cards.Bets: 0. Collects: 0. Wins: 0.
Player 38979 does not show cards.Bets: 0. Collects: 0. Wins: 0.
Player sheenius81 does not show cards.Bets: 2. Collects: 0. Loses: 2.
*Player brokenlucks mucks (does not show cards). Bets: 2. Collects: 4. Wins: 2.
Game ended at: 2016/11/28 19:57:22

Game started
Game ID: 786367237 0.25/0.50 (PRR) Gorgons - 8 (Hold'em)
Seat 4 is the button
Seat 3: Goomashroom (52.37).
Seat 4: lovecola (53.98).
Seat 5: IlxxxlI (20.25).
Seat 6: caballeroXXX (125.96).
Player IlxxxlI has small blind (0.25)
Player caballeroXXX has big blind (0.50)
Player IlxxxlI received card: [Qc]
Player IlxxxlI received card: [10s]
Player Goomashroom folds
Player lovecola folds
Player IlxxxlI calls (0.25)
Player caballeroXXX checks
*** FLOP ***: [9c 7d 8c]
Player IlxxxlI bets (0.50)
Player caballeroXXX calls (0.50)
*** TURN ***: [9c 7d 8c] [As]
Player IlxxxlI bets (1.04)
Player caballeroXXX folds
Uncalled bet (1.04) returned to IlxxxlI
Player IlxxxlI mucks cards
------ Summary ------
Pot: 1.90. Rake 0.08. JP fee 0.02
Board: [9c 7d 8c As]
Player Goomashroom does not show cards.Bets: 0. Collects: 0. Wins: 0.
Player lovecola does not show cards.Bets: 0. Collects: 0. Wins: 0.
*Player IlxxxlI mucks (does not show cards). Bets: 1. Collects: 1.90. Wins: 0.90.
Player caballeroXXX does not show cards.Bets: 1. Collects: 0. Loses: 1.
Game ended at: 2016/11/28 19:57:37

Game started
Game ID: 786367235 0.50/1 (PRR) Kraken (short) (Hold'em)
Seat 3 is the button
Seat 1: Cinch23 (64.30).
Seat 2: 38979 (51.76).
Seat 3: Bhodisattva (29.18).
Seat 4: TranscendencE (81.60).
Seat 5: IlxxxlI (27.52).
Seat 6: meandkids (48.50).
Player TranscendencE has small blind (0.50)
Player IlxxxlI has big blind (1)
Player IlxxxlI received card: [Jc]
Player IlxxxlI received card: [7s]
Player meandkids raises (6)
Player Cinch23 folds
Player 38979 folds
Player Bhodisattva folds
Player TranscendencE folds
Player IlxxxlI folds
Uncalled bet (5) returned to meandkids
Player meandkids mucks cards
------ Summary ------
Pot: 2.50. Rake 0
Player Cinch23 does not show cards.Bets: 0. Collects: 0. Wins: 0.
Player 38979 does not show cards.Bets: 0. Collects: 0. Wins: 0.
Player Bhodisattva does not show cards.Bets: 0. Collects: 0. Wins: 0.
Player TranscendencE does not show cards.Bets: 0.50. Collects: 0. Loses: 0.50.
Player IlxxxlI does not show cards.Bets: 1. Collects: 0. Loses: 1.
*Player meandkids mucks (does not show cards). Bets: 1. Collects: 2.50. Wins: 1.50.
Game ended at: 2016/11/28 19:57:21

Game started
Game ID: 786367211 0.25/0.50 (PRR) Gorgons - 5 (Hold'em)
Seat 3 is the button
Seat 1: caballeroXXX (64.35).
Seat 2: 38979 (50).
Seat 3: meandkids (79.35).
Seat 4: Goomashroom (110.12).
Seat 5: legenda99 (107.10).
Seat 6: IlxxxlI (20).
Player Goomashroom has small blind (0.25)
Player legenda99 has big blind (0.50)
Player IlxxxlI received card: [6c]
Player IlxxxlI received card: [3c]
Player IlxxxlI folds
Player caballeroXXX folds
Player 38979 folds
Player meandkids folds
Player Goomashroom raises (1.25)
Player legenda99 raises (4)
Player Goomashroom raises (10.12)
Player legenda99 calls (7.12)
*** FLOP ***: [5c 6d 6s]
Player Goomashroom bets (10.44)
Player legenda99 calls (10.44)
*** TURN ***: [5c 6d 6s] [As]
Player Goomashroom checks
Player legenda99 checks
*** RIVER ***: [5c 6d 6s As] [3h]
Player Goomashroom bets (20.96)
Player legenda99 folds
Uncalled bet (20.96) returned to Goomashroom
Player Goomashroom mucks cards
------ Summary ------
Pot: 41.92. Rake 1.96. JP fee 0.24
Board: [5c 6d 6s As 3h]
Player caballeroXXX does not show cards.Bets: 0. Collects: 0. Wins: 0.
Player 38979 does not show cards.Bets: 0. Collects: 0. Wins: 0.
Player meandkids does not show cards.Bets: 0. Collects: 0. Wins: 0.
*Player Goomashroom mucks (does not show cards). Bets: 22.06. Collects: 41.92. Wins: 19.86.
Player legenda99 does not show cards.Bets: 22.06. Collects: 0. Loses: 22.06.
Player IlxxxlI does not show cards.Bets: 0. Collects: 0. Wins: 0.
Game ended at: 2016/11/28 19:58:43

Game started
Game ID: 786367179 0.25/0.50 (PRR) Gorgons - 2 (Hold'em)
Seat 6 is the button
Seat 1: DonkReaper (67.64).
Seat 2: legenda99 (120.31).
Seat 3: Goomashroom (71.61).
Seat 4: IlxxxlI (25.91).
Seat 6: caballeroXXX (58.80).
Player DonkReaper has small blind (0.25)
Player legenda99 has big blind (0.50)
Player IlxxxlI received card: [10d]
Player IlxxxlI received card: [9d]
Player Goomashroom folds
Player IlxxxlI raises (1.20)
Player caballeroXXX folds
Player DonkReaper folds
Player legenda99 calls (0.70)
*** FLOP ***: [Ac 9c Ks]
Player legenda99 checks
Player IlxxxlI checks
*** TURN ***: [Ac 9c Ks] [Jd]
Player legenda99 checks
Player IlxxxlI checks
*** RIVER ***: [Ac 9c Ks Jd] [Ad]
Player legenda99 checks
Player IlxxxlI checks
------ Summary ------
Pot: 2.52. Rake 0.09. JP fee 0.04
Board: [Ac 9c Ks Jd Ad]
Player DonkReaper does not show cards.Bets: 0.25. Collects: 0. Loses: 0.25.
*Player legenda99 shows: Two pairs. As and 9s [10h 9s]. Bets: 1.20. Collects: 1.26. Wins: 0.06.
Player Goomashroom does not show cards.Bets: 0. Collects: 0. Wins: 0.
*Player IlxxxlI shows: Two pairs. As and 9s [10d 9d]. Bets: 1.20. Collects: 1.26. Wins: 0.06.
Player caballeroXXX does not show cards.Bets: 0. Collects: 0. Wins: 0.
Game ended at: 2016/11/28 19:57:36

Game started
Game ID: 786367174 1/2 (PRR) Lakhey (Short) - 2 (Hold'em)
Seat 1 is the button
Seat 1: IlxxxlI (40).
Seat 2: 38979 (105).
Seat 3: sheenius81 (100.02).
Seat 4: brokenlucks (92.18).
Player 38979 has small blind (1)
Player sheenius81 has big blind (2)
Player IlxxxlI received card: [Qc]
Player IlxxxlI received card: [6c]
Player brokenlucks folds
Player IlxxxlI folds
Player 38979 raises (5)
Player sheenius81 raises (16)
Player 38979 folds
Uncalled bet (12) returned to sheenius81
Player sheenius81 mucks cards
------ Summary ------
Pot: 12. Rake 0
Player IlxxxlI does not show cards.Bets: 0. Collects: 0. Wins: 0.
Player 38979 does not show cards.Bets: 6. Collects: 0. Loses: 6.
*Player sheenius81 mucks (does not show cards). Bets: 6. Collects: 12. Wins: 6.
Player brokenlucks does not show cards.Bets: 0. Collects: 0. Wins: 0.
Game ended at: 2016/11/28 19:56:43

Game started
Game ID: 786367165 0.25/0.50 (PRR) Gorgons - 8 (Hold'em)
Seat 3 is the button
Seat 3: Goomashroom (51.62).
Seat 4: lovecola (54.23).
Seat 5: IlxxxlI (20.75).
Seat 6: caballeroXXX (125.96).
Player lovecola has small blind (0.25)
Player IlxxxlI has big blind (0.50)
Player IlxxxlI received card: [2c]
Player IlxxxlI received card: [8h]
Player caballeroXXX folds
Player Goomashroom raises (1.13)
Player lovecola folds
Player IlxxxlI folds
Uncalled bet (0.63) returned to Goomashroom
Player Goomashroom mucks cards
------ Summary ------
Pot: 1.25. Rake 0
*Player Goomashroom mucks (does not show cards). Bets: 0.50. Collects: 1.25. Wins: 0.75.
Player lovecola does not show cards.Bets: 0.25. Collects: 0. Loses: 0.25.
Player IlxxxlI does not show cards.Bets: 0.50. Collects: 0. Loses: 0.50.
Player caballeroXXX does not show cards.Bets: 0. Collects: 0. Wins: 0.
Game ended at: 2016/11/28 19:56:42

Game started
Game ID: 786367119 0.25/0.50 (PRR) Gorgons - 2 (Hold'em)
Seat 4 is the button
Seat 1: DonkReaper (68.14).
Seat 3: Goomashroom (70.86).
Seat 4: IlxxxlI (25.91).
Seat 6: caballeroXXX (59.05).
Player caballeroXXX has small blind (0.25)
Player DonkReaper has big blind (0.50)
Player IlxxxlI received card: [3d]
Player IlxxxlI received card: [6s]
Player Goomashroom raises (1.25)
Player IlxxxlI folds
Player caballeroXXX folds
Player DonkReaper folds
Uncalled bet (0.75) returned to Goomashroom
Player Goomashroom mucks cards
------ Summary ------
Pot: 1.25. Rake 0
Player DonkReaper does not show cards.Bets: 0.50. Collects: 0. Loses: 0.50.
*Player Goomashroom mucks (does not show cards). Bets: 0.50. Collects: 1.25. Wins: 0.75.
Player IlxxxlI does not show cards.Bets: 0. Collects: 0. Wins: 0.
Player caballeroXXX does not show cards.Bets: 0.25. Collects: 0. Loses: 0.25.
Game ended at: 2016/11/28 19:56:22

Game started
Game ID: 786367112 1/2 (PRR) Lakhey (Short) - 2 (Hold'em)
Seat 4 is the button
Seat 1: IlxxxlI (40).
Seat 2: 38979 (100).
Seat 3: sheenius81 (104.02).
Seat 4: brokenlucks (92.18).
Player IlxxxlI has small blind (1)
Player 38979 has big blind (2)
Player IlxxxlI received card: [2h]
Player IlxxxlI received card: [3h]
Player sheenius81 raises (4)
Player brokenlucks folds
Player IlxxxlI folds
Player 38979 raises (12)
Player sheenius81 folds
Uncalled bet (10) returned to 38979
Player 38979 mucks cards
------ Summary ------
Pot: 9. Rake 0
Player IlxxxlI does not show cards.Bets: 1. Collects: 0. Loses: 1.
*Player 38979 mucks (does not show cards). Bets: 4. Collects: 9. Wins: 5.
Player sheenius81 does not show cards.Bets: 4. Collects: 0. Loses: 4.
Player brokenlucks does not show cards.Bets: 0. Collects: 0. Wins: 0.
Game ended at: 2016/11/28 19:56:21

Game started
Game ID: 786367089 0.25/0.50 (PRR) Gorgons - 8 (Hold'em)
Seat 6 is the button
Seat 3: Goomashroom (51.87).
Seat 4: lovecola (54.73).
Seat 5: IlxxxlI (20.75).
Seat 6: caballeroXXX (125.21).
Player Goomashroom has small blind (0.25)
Player lovecola has big blind (0.50)
Player IlxxxlI received card: [10h]
Player IlxxxlI received card: [Ks]
Player IlxxxlI folds
Player caballeroXXX raises (1)
Player Goomashroom folds
Player lovecola folds
Uncalled bet (0.50) returned to caballeroXXX
Player caballeroXXX mucks cards
------ Summary ------
Pot: 1.25. Rake 0
Player Goomashroom does not show cards.Bets: 0.25. Collects: 0. Loses: 0.25.
Player lovecola does not show cards.Bets: 0.50. Collects: 0. Loses: 0.50.
Player IlxxxlI does not show cards.Bets: 0. Collects: 0. Wins: 0.
*Player caballeroXXX mucks (does not show cards). Bets: 0.50. Collects: 1.25. Wins: 0.75.
Game ended at: 2016/11/28 19:56:20

Game started
Game ID: 786367088 0.25/0.50 (PRR) Gorgons - 3 (Hold'em)
Seat 2 is the button
Seat 1: Goomashroom (51.35).
Seat 2: Cinch23 (50).
Seat 4: 38979 (95.95).
Seat 6: IlxxxlI (25.51).
Player 38979 has small blind (0.25)
Player IlxxxlI has big blind (0.50)
Player IlxxxlI received card: [8h]
Player IlxxxlI received card: [Kh]
Player Goomashroom folds
Player Cinch23 raises (1)
Player 38979 folds
Player IlxxxlI calls (0.50)
*** FLOP ***: [As Ad 10c]
Player IlxxxlI checks
Player Cinch23 checks
*** TURN ***: [As Ad 10c] [6c]
Player IlxxxlI checks
Player Cinch23 checks
*** RIVER ***: [As Ad 10c 6c] [8s]
Player IlxxxlI checks
Player Cinch23 checks
Player Cinch23 mucks cards
------ Summary ------
Pot: 2.14. Rake 0.09. JP fee 0.02
Board: [As Ad 10c 6c 8s]
Player Goomashroom does not show cards.Bets: 0. Collects: 0. Wins: 0.
Player Cinch23 mucks (does not show cards). Bets: 1. Collects: 0. Loses: 1.
Player 38979 does not show cards.Bets: 0.25. Collects: 0. Loses: 0.25.
*Player IlxxxlI shows: Two pairs. As and 8s [8h Kh]. Bets: 1. Collects: 2.14. Wins: 1.14.
Game ended at: 2016/11/28 19:56:43

Game started
Game ID: 786367087 1/2 (PRR) Lakhey (Short) (Hold'em)
Seat 4 is the button
Seat 1: IlxxxlI (40).
Seat 2: 38979 (229.12).
Seat 4: Wollverin (107.55).
Seat 5: meandkids (123.52).
Seat 6: Are you with me (70.80).
Player meandkids has small blind (1)
Player Are you with me has big blind (2)
Player IlxxxlI received card: [9c]
Player IlxxxlI received card: [4h]
Player IlxxxlI folds
Player 38979 raises (4)
Player Wollverin folds
Player meandkids folds
Player Are you with me calls (2)
*** FLOP ***: [2d 4d 3d]
Player Are you with me checks
Player 38979 checks
*** TURN ***: [2d 4d 3d] [9h]
Player Are you with me checks
Player 38979 bets (6)
Player Are you with me folds
Uncalled bet (6) returned to 38979
Player 38979 mucks cards
------ Summary ------
Pot: 8.55. Rake 0.31. JP fee 0.14
Board: [2d 4d 3d 9h]
Player IlxxxlI does not show cards.Bets: 0. Collects: 0. Wins: 0.
*Player 38979 mucks (does not show cards). Bets: 4. Collects: 8.55. Wins: 4.55.
Player Wollverin does not show cards.Bets: 0. Collects: 0. Wins: 0.
Player meandkids does not show cards.Bets: 1. Collects: 0. Loses: 1.
Player Are you with me does not show cards.Bets: 4. Collects: 0. Loses: 4.
Game ended at: 2016/11/28 19:57:9

Game started
Game ID: 786367078 0.25/0.50 (PRR) Gorgons - 5 (Hold'em)
Seat 2 is the button
Seat 1: caballeroXXX (64.35).
Seat 2: 38979 (50).
Seat 3: meandkids (79.85).
Seat 4: Goomashroom (109.67).
Seat 6: IlxxxlI (20).
Player meandkids has small blind (0.25)
Player Goomashroom has big blind (0.50)
Player IlxxxlI received card: [Kd]
Player IlxxxlI received card: [7c]
Player IlxxxlI folds
Player caballeroXXX folds
Player 38979 folds
Player meandkids calls (0.25)
Player Goomashroom checks
*** FLOP ***: [8c 3h Kh]
Player meandkids checks
Player Goomashroom bets (0.75)
Player meandkids folds
Uncalled bet (0.75) returned to Goomashroom
Player Goomashroom mucks cards
------ Summary ------
Pot: 0.95. Rake 0.05
Board: [8c 3h Kh]
Player caballeroXXX does not show cards.Bets: 0. Collects: 0. Wins: 0.
Player 38979 does not show cards.Bets: 0. Collects: 0. Wins: 0.
Player meandkids does not show cards.Bets: 0.50. Collects: 0. Loses: 0.50.
*Player Goomashroom mucks (does not show cards). Bets: 0.50. Collects: 0.95. Wins: 0.45.
Player IlxxxlI does not show cards.Bets: 0. Collects: 0. Wins: 0.
Game ended at: 2016/11/28 19:56:35

Game started
Game ID: 786367072 0.50/1 (PRR) Kraken (short) (Hold'em)
Seat 2 is the button
Seat 1: Cinch23 (64.30).
Seat 2: 38979 (51.76).
Seat 3: Bhodisattva (36.48).
Seat 4: TranscendencE (82.60).
Seat 5: IlxxxlI (20).
Seat 6: meandkids (48.50).
Player Bhodisattva has small blind (0.50)
Player TranscendencE has big blind (1)
Player IlxxxlI received card: [Js]
Player IlxxxlI received card: [Jd]
Player IlxxxlI raises (3.50)
Player meandkids folds
Player Cinch23 folds
Player 38979 folds
Player Bhodisattva calls (3)
Player TranscendencE folds
*** FLOP ***: [6s Jc 8h]
Player Bhodisattva checks
Player IlxxxlI bets (3.80)
Player Bhodisattva calls (3.80)
*** TURN ***: [6s Jc 8h] [Kc]
Player Bhodisattva checks
Player IlxxxlI allin (12.70)
Player Bhodisattva folds
Uncalled bet (12.70) returned to IlxxxlI
Player IlxxxlI mucks cards
------ Summary ------
Pot: 14.82. Rake 0.54. JP fee 0.24
Board: [6s Jc 8h Kc]
Player Cinch23 does not show cards.Bets: 0. Collects: 0. Wins: 0.
Player 38979 does not show cards.Bets: 0. Collects: 0. Wins: 0.
Player Bhodisattva does not show cards.Bets: 7.30. Collects: 0. Loses: 7.30.
Player TranscendencE does not show cards.Bets: 1. Collects: 0. Loses: 1.
*Player IlxxxlI mucks (does not show cards). Bets: 7.30. Collects: 14.82. Wins: 7.52.
Player meandkids does not show cards.Bets: 0. Collects: 0. Wins: 0.
Game ended at: 2016/11/28 19:56:41

Game started
Game ID: 786367030 0.25/0.50 (PRR) Gorgons - 3 (Hold'em)
Seat 1 is the button
Seat 1: Goomashroom (51.35).
Seat 2: Cinch23 (49.50).
Seat 4: 38979 (96.45).
Seat 6: IlxxxlI (25.51).
Player Cinch23 has small blind (0.25)
Player 38979 has big blind (0.50)
Player IlxxxlI received card: [4d]
Player IlxxxlI received card: [2c]
Player IlxxxlI folds
Player Goomashroom folds
Player Cinch23 raises (0.75)
Player 38979 folds
Uncalled bet (0.50) returned to Cinch23
Player Cinch23 mucks cards
------ Summary ------
Pot: 1. Rake 0
Player Goomashroom does not show cards.Bets: 0. Collects: 0. Wins: 0.
*Player Cinch23 mucks (does not show cards). Bets: 0.50. Collects: 1. Wins: 0.50.
Player 38979 does not show cards.Bets: 0.50. Collects: 0. Loses: 0.50.
Player IlxxxlI does not show cards.Bets: 0. Collects: 0. Wins: 0.
Game ended at: 2016/11/28 19:55:52

Game started
Game ID: 786367025 0.25/0.50 (PRR) Gorgons - 8 (Hold'em)
Seat 5 is the button
Seat 3: Goomashroom (52.37).
Seat 4: lovecola (54.73).
Seat 5: IlxxxlI (20).
Seat 6: caballeroXXX (125.46).
Player caballeroXXX has small blind (0.25)
Player Goomashroom has big blind (0.50)
Player IlxxxlI received card: [Ad]
Player IlxxxlI received card: [Kh]
Player lovecola folds
Player IlxxxlI raises (1.50)
Player caballeroXXX folds
Player Goomashroom folds
Uncalled bet (1) returned to IlxxxlI
Player IlxxxlI mucks cards
------ Summary ------
Pot: 1.25. Rake 0
Player Goomashroom does not show cards.Bets: 0.50. Collects: 0. Loses: 0.50.
Player lovecola does not show cards.Bets: 0. Collects: 0. Wins: 0.
*Player IlxxxlI mucks (does not show cards). Bets: 0.50. Collects: 1.25. Wins: 0.75.
Player caballeroXXX does not show cards.Bets: 0.25. Collects: 0. Loses: 0.25.
Game ended at: 2016/11/28 19:55:52

Game started
Game ID: 786367018 0.25/0.50 (PRR) Gorgons - 5 (Hold'em)
Seat 1 is the button
Seat 1: caballeroXXX (63.60).
Seat 2: 38979 (50).
Seat 3: meandkids (80.35).
Seat 4: Goomashroom (109.67).
Seat 6: IlxxxlI (20).
Player 38979 has small blind (0.25)
Player meandkids has big blind (0.50)
Player IlxxxlI received card: [5d]
Player IlxxxlI received card: [10d]
Player Goomashroom folds
Player IlxxxlI folds
Player caballeroXXX raises (1)
Player 38979 folds
Player meandkids folds
Uncalled bet (0.50) returned to caballeroXXX
Player caballeroXXX mucks cards
------ Summary ------
Pot: 1.25. Rake 0
*Player caballeroXXX mucks (does not show cards). Bets: 0.50. Collects: 1.25. Wins: 0.75.
Player 38979 does not show cards.Bets: 0.25. Collects: 0. Loses: 0.25.
Player meandkids does not show cards.Bets: 0.50. Collects: 0. Loses: 0.50.
Player Goomashroom does not show cards.Bets: 0. Collects: 0. Wins: 0.
Player IlxxxlI does not show cards.Bets: 0. Collects: 0. Wins: 0.
Game ended at: 2016/11/28 19:55:47

Game started
Game ID: 786366981 1/2 (PRR) Lakhey (Short) - 2 (Hold'em)
Seat 3 is the button
Seat 1: IlxxxlI (40).
Seat 2: 38979 (100).
Seat 3: sheenius81 (99.47).
Seat 4: brokenlucks (93.18).
Seat 5: GamblerPaul (40).
Seat 6: gfclbv (236).
Player brokenlucks has small blind (1)
Player GamblerPaul sitting out
Player gfclbv sitting out
Player IlxxxlI has big blind (2)
Player IlxxxlI received card: [8d]
Player IlxxxlI received card: [Jc]
Player 38979 folds
Player sheenius81 raises (4)
Player brokenlucks folds
Player IlxxxlI calls (2)
*** FLOP ***: [10c 3c 5s]
Player IlxxxlI checks
Player sheenius81 checks
*** TURN ***: [10c 3c 5s] [2h]
Player IlxxxlI checks
Player sheenius81 checks
*** RIVER ***: [10c 3c 5s 2h] [10s]
Player IlxxxlI checks
Player sheenius81 checks
Player IlxxxlI mucks cards
------ Summary ------
Pot: 8.55. Rake 0.31. JP fee 0.14
Board: [10c 3c 5s 2h 10s]
Player IlxxxlI mucks (does not show: [8d Jc]). Bets: 4. Collects: 0. Loses: 4.
Player 38979 does not show cards.Bets: 0. Collects: 0. Wins: 0.
*Player sheenius81 shows: One pair of 10s [8c As]. Bets: 4. Collects: 8.55. Wins: 4.55.
Player brokenlucks does not show cards.Bets: 1. Collects: 0. Loses: 1.
Player GamblerPaul does not show cards.Bets: 0. Collects: 0. Wins: 0.
Player gfclbv does not show cards.Bets: 0. Collects: 0. Wins: 0.
Game ended at: 2016/11/28 19:55:57

Game started
Game ID: 786366974 0.25/0.50 (PRR) Gorgons - 3 (Hold'em)
Seat 6 is the button
Seat 1: Goomashroom (50.85).
Seat 2: Cinch23 (50).
Seat 4: 38979 (96.45).
Seat 6: IlxxxlI (25.51).
Player Goomashroom has small blind (0.25)
Player Cinch23 has big blind (0.50)
Player IlxxxlI received card: [Kh]
Player IlxxxlI received card: [3c]
Player 38979 folds
Player IlxxxlI folds
Player Goomashroom raises (1.25)
Player Cinch23 folds
Uncalled bet (1) returned to Goomashroom
Player Goomashroom mucks cards
------ Summary ------
Pot: 1. Rake 0
*Player Goomashroom mucks (does not show cards). Bets: 0.50. Collects: 1. Wins: 0.50.
Player Cinch23 does not show cards.Bets: 0.50. Collects: 0. Loses: 0.50.
Player 38979 does not show cards.Bets: 0. Collects: 0. Wins: 0.
Player IlxxxlI does not show cards.Bets: 0. Collects: 0. Wins: 0.
Game ended at: 2016/11/28 19:55:27

Game started
Game ID: 786366962 0.25/0.50 (PRR) Gorgons - 5 (Hold'em)
Seat 6 is the button
Seat 1: caballeroXXX (63.10).
Seat 2: 38979 (50).
Seat 3: meandkids (80.35).
Seat 4: Goomashroom (109.67).
Seat 6: IlxxxlI (20).
Player caballeroXXX has small blind (0.25)
Player 38979 has big blind (0.50)
Player IlxxxlI received card: [8d]
Player IlxxxlI received card: [3c]
Player meandkids folds
Player Goomashroom folds
Player IlxxxlI folds
Player caballeroXXX raises (1.25)
Player 38979 folds
Uncalled bet (1) returned to caballeroXXX
Player caballeroXXX mucks cards
------ Summary ------
Pot: 1. Rake 0
*Player caballeroXXX mucks (does not show cards). Bets: 0.50. Collects: 1. Wins: 0.50.
Player 38979 does not show cards.Bets: 0.50. Collects: 0. Loses: 0.50.
Player meandkids does not show cards.Bets: 0. Collects: 0. Wins: 0.
Player Goomashroom does not show cards.Bets: 0. Collects: 0. Wins: 0.
Player IlxxxlI does not show cards.Bets: 0. Collects: 0. Wins: 0.
Game ended at: 2016/11/28 19:55:23

Game started
Game ID: 786366937 0.25/0.50 (PRR) Gorgons - 8 (Hold'em)
Seat 4 is the button
Seat 3: Goomashroom (51).
Seat 4: lovecola (54.73).
Seat 5: IlxxxlI (20).
Seat 6: caballeroXXX (126.71).
Player IlxxxlI has small blind (0.25)
Player caballeroXXX has big blind (0.50)
Player IlxxxlI received card: [7h]
Player IlxxxlI received card: [3h]
Player Goomashroom raises (1.25)
Player lovecola folds
Player IlxxxlI folds
Player caballeroXXX calls (0.75)
*** FLOP ***: [Kc 4h 5c]
Player caballeroXXX checks
Player Goomashroom bets (1.75)
Player caballeroXXX folds
Uncalled bet (1.75) returned to Goomashroom
Player Goomashroom mucks cards
------ Summary ------
Pot: 2.62. Rake 0.09. JP fee 0.04
Board: [Kc 4h 5c]
*Player Goomashroom mucks (does not show cards). Bets: 1.25. Collects: 2.62. Wins: 1.37.
Player lovecola does not show cards.Bets: 0. Collects: 0. Wins: 0.
Player IlxxxlI does not show cards.Bets: 0.25. Collects: 0. Loses: 0.25.
Player caballeroXXX does not show cards.Bets: 1.25. Collects: 0. Loses: 1.25.
Game ended at: 2016/11/28 19:55:25

Game started
Game ID: 786366936 0.25/0.50 (PRR) Gorgons - 2 (Hold'em)
Seat 3 is the button
Seat 1: DonkReaper (68.14).
Seat 3: Goomashroom (73.73).
Seat 4: IlxxxlI (22.85).
Seat 6: caballeroXXX (59.55).
Player IlxxxlI has small blind (0.25)
Player caballeroXXX has big blind (0.50)
Player IlxxxlI received card: [Jh]
Player IlxxxlI received card: [Jd]
Player DonkReaper folds
Player Goomashroom raises (1.13)
Player IlxxxlI raises (2.62)
Player caballeroXXX folds
Player Goomashroom calls (1.74)
*** FLOP ***: [3h Ad As]
Player IlxxxlI checks
Player Goomashroom checks
*** TURN ***: [3h Ad As] [3c]
Player IlxxxlI checks
Player Goomashroom checks
*** RIVER ***: [3h Ad As 3c] [Jc]
Player IlxxxlI bets (12)
Player Goomashroom folds
Uncalled bet (12) returned to IlxxxlI
Player IlxxxlI mucks cards
------ Summary ------
Pot: 5.93. Rake 0.21. JP fee 0.10
Board: [3h Ad As 3c Jc]
Player DonkReaper does not show cards.Bets: 0. Collects: 0. Wins: 0.
Player Goomashroom does not show cards.Bets: 2.87. Collects: 0. Loses: 2.87.
*Player IlxxxlI mucks (does not show cards). Bets: 2.87. Collects: 5.93. Wins: 3.06.
Player caballeroXXX does not show cards.Bets: 0.50. Collects: 0. Loses: 0.50.
Game ended at: 2016/11/28 19:56:1

Game started
Game ID: 786366892 0.50/1 (PRR) Kraken (short) (Hold'em)
Seat 1 is the button
Seat 1: Cinch23 (48.50).
Seat 2: 38979 (68.26).
Seat 3: Bhodisattva (37.48).
Seat 4: TranscendencE (82.60).
Seat 5: IlxxxlI (20).
Seat 6: meandkids (48.50).
Player 38979 has small blind (0.50)
Player Bhodisattva has big blind (1)
Player IlxxxlI received card: [4h]
Player IlxxxlI received card: [7c]
Player TranscendencE folds
Player IlxxxlI folds
Player meandkids folds
Player Cinch23 raises (3)
Player 38979 calls (2.50)
Player Bhodisattva folds
*** FLOP ***: [9h 10s 7s]
Player 38979 checks
Player Cinch23 bets (4.50)
Player 38979 calls (4.50)
*** TURN ***: [9h 10s 7s] [10h]
Player 38979 checks
Player Cinch23 bets (9)
Player 38979 calls (9)
*** RIVER ***: [9h 10s 7s 10h] [5d]
Player 38979 checks
Player Cinch23 allin (32)
Player 38979 folds
Uncalled bet (32) returned to Cinch23
Player Cinch23 mucks cards
------ Summary ------
Pot: 32.30. Rake 1.46. JP fee 0.24
Board: [9h 10s 7s 10h 5d]
*Player Cinch23 mucks (does not show cards). Bets: 16.50. Collects: 32.30. Wins: 15.80.
Player 38979 does not show cards.Bets: 16.50. Collects: 0. Loses: 16.50.
Player Bhodisattva does not show cards.Bets: 1. Collects: 0. Loses: 1.
Player TranscendencE does not show cards.Bets: 0. Collects: 0. Wins: 0.
Player IlxxxlI does not show cards.Bets: 0. Collects: 0. Wins: 0.
Player meandkids does not show cards.Bets: 0. Collects: 0. Wins: 0.
Game ended at: 2016/11/28 19:55:46

Game started
Game ID: 786366885 0.25/0.50 (PRR) Gorgons - 5 (Hold'em)
Seat 4 is the button
Seat 1: caballeroXXX (62.85).
Seat 2: 38979 (50).
Seat 3: meandkids (80.35).
Seat 4: Goomashroom (109.67).
Seat 6: IlxxxlI (20).
Player IlxxxlI has small blind (0.25)
Player caballeroXXX has big blind (0.50)
Player IlxxxlI received card: [5c]
Player IlxxxlI received card: [8h]
Player 38979 folds
Player meandkids folds
Player Goomashroom folds
Player IlxxxlI folds
Uncalled bet (0.25) returned to caballeroXXX
Player caballeroXXX mucks cards
------ Summary ------
Pot: 0.50. Rake 0
*Player caballeroXXX mucks (does not show cards). Bets: 0.25. Collects: 0.50. Wins: 0.25.
Player 38979 does not show cards.Bets: 0. Collects: 0. Wins: 0.
Player meandkids does not show cards.Bets: 0. Collects: 0. Wins: 0.
Player Goomashroom does not show cards.Bets: 0. Collects: 0. Wins: 0.
Player IlxxxlI does not show cards.Bets: 0.25. Collects: 0. Loses: 0.25.
Game ended at: 2016/11/28 19:54:59

Game started
Game ID: 786366865 0.25/0.50 (PRR) Gorgons - 8 (Hold'em)
Seat 3 is the button
Seat 3: Goomashroom (51).
Seat 4: lovecola (54.98).
Seat 5: IlxxxlI (20).
Seat 6: caballeroXXX (125.96).
Player lovecola has small blind (0.25)
Player IlxxxlI has big blind (0.50)
Player IlxxxlI received card: [8d]
Player IlxxxlI received card: [Qh]
Player caballeroXXX raises (1.25)
Player Goomashroom folds
Player lovecola folds
Player IlxxxlI folds
Uncalled bet (0.75) returned to caballeroXXX
Player caballeroXXX mucks cards
------ Summary ------
Pot: 1.25. Rake 0
Player Goomashroom does not show cards.Bets: 0. Collects: 0. Wins: 0.
Player lovecola does not show cards.Bets: 0.25. Collects: 0. Loses: 0.25.
Player IlxxxlI does not show cards.Bets: 0.50. Collects: 0. Loses: 0.50.
*Player caballeroXXX mucks (does not show cards). Bets: 0.50. Collects: 1.25. Wins: 0.75.
Game ended at: 2016/11/28 19:54:49

Game started
Game ID: 786366862 0.25/0.50 (PRR) Gorgons - 3 (Hold'em)
Seat 4 is the button
Seat 1: Goomashroom (51.35).
Seat 4: 38979 (96.45).
Seat 6: IlxxxlI (25.06).
Player IlxxxlI has small blind (0.25)
Player Goomashroom has big blind (0.50)
Player IlxxxlI received card: [Kc]
Player IlxxxlI received card: [6c]
Player 38979 folds
Player IlxxxlI calls (0.25)
Player Goomashroom checks
*** FLOP ***: [7c 8h 3c]
Player IlxxxlI bets (0.63)
Player Goomashroom folds
Uncalled bet (0.63) returned to IlxxxlI
Player IlxxxlI mucks cards
------ Summary ------
Pot: 0.95. Rake 0.05
Board: [7c 8h 3c]
Player Goomashroom does not show cards.Bets: 0.50. Collects: 0. Loses: 0.50.
Player 38979 does not show cards.Bets: 0. Collects: 0. Wins: 0.
*Player IlxxxlI mucks (does not show cards). Bets: 0.50. Collects: 0.95. Wins: 0.45.
Game ended at: 2016/11/28 19:55:4

Game started
Game ID: 786366846 1/2 (PRR) Lakhey (Short) (Hold'em)
Seat 3 is the button
Seat 1: IlxxxlI (40).
Seat 2: 38979 (229.12).
Seat 3: BBDub27 (100).
Seat 4: Wollverin (115.55).
Seat 5: meandkids (116.32).
Player Wollverin has small blind (1)
Player meandkids has big blind (2)
Player IlxxxlI received card: [3c]
Player IlxxxlI received card: [Ks]
Player IlxxxlI folds
Player 38979 folds
Player BBDub27 is timed out.
Player BBDub27 folds
Player Wollverin raises (4)
Player meandkids calls (3)
*** FLOP ***: [Kh 5h Jh]
Player Wollverin bets (3)
Player meandkids calls (3)
*** TURN ***: [Kh 5h Jh] [9h]
Player Wollverin checks
Player meandkids bets (10.13)
Player Wollverin folds
Uncalled bet (10.13) returned to meandkids
Player meandkids mucks cards
------ Summary ------
Pot: 15.20. Rake 0.56. JP fee 0.24
Board: [Kh 5h Jh 9h]
Player IlxxxlI does not show cards.Bets: 0. Collects: 0. Wins: 0.
Player 38979 does not show cards.Bets: 0. Collects: 0. Wins: 0.
Player BBDub27 does not show cards.Bets: 0. Collects: 0. Wins: 0.
Player Wollverin does not show cards.Bets: 8. Collects: 0. Loses: 8.
*Player meandkids mucks (does not show cards). Bets: 8. Collects: 15.20. Wins: 7.20.
Game ended at: 2016/11/28 19:55:50

Game started
Game ID: 786366816 1/2 (PRR) Lakhey (Short) - 2 (Hold'em)
Seat 2 is the button
Seat 1: IlxxxlI (40).
Seat 2: 38979 (100).
Seat 3: sheenius81 (93.25).
Seat 4: brokenlucks (95.18).
Seat 5: GamblerPaul (40).
Seat 6: gfclbv (236).
Player sheenius81 has small blind (1)
Player brokenlucks has big blind (2)
Player IlxxxlI received card: [2d]
Player IlxxxlI received card: [2s]
Player GamblerPaul folds
Player gfclbv folds
Player IlxxxlI raises (4.80)
Player 38979 folds
Player sheenius81 calls (3.80)
Player brokenlucks folds
*** FLOP ***: [Qd 10s 5s]
Player sheenius81 checks
Player IlxxxlI checks
*** TURN ***: [Qd 10s 5s] [6h]
Player sheenius81 bets (7.34)
Player IlxxxlI folds
Uncalled bet (7.34) returned to sheenius81
Player sheenius81 mucks cards
------ Summary ------
Pot: 11.02. Rake 0.40. JP fee 0.18
Board: [Qd 10s 5s 6h]
Player IlxxxlI does not show cards.Bets: 4.80. Collects: 0. Loses: 4.80.
Player 38979 does not show cards.Bets: 0. Collects: 0. Wins: 0.
*Player sheenius81 mucks (does not show cards). Bets: 4.80. Collects: 11.02. Wins: 6.22.
Player brokenlucks does not show cards.Bets: 2. Collects: 0. Loses: 2.
Player GamblerPaul does not show cards.Bets: 0. Collects: 0. Wins: 0.
Player gfclbv does not show cards.Bets: 0. Collects: 0. Wins: 0.
Game ended at: 2016/11/28 19:55:7

Game started
Game ID: 786366813 0.25/0.50 (PRR) Gorgons - 2 (Hold'em)
Seat 1 is the button
Seat 1: DonkReaper (67.39).
Seat 2: legenda99 (120.56).
Seat 3: Goomashroom (74.23).
Seat 4: IlxxxlI (22.85).
Seat 6: caballeroXXX (59.55).
Player legenda99 has small blind (0.25)
Player Goomashroom has big blind (0.50)
Player IlxxxlI received card: [Qh]
Player IlxxxlI received card: [2s]
Player IlxxxlI folds
Player caballeroXXX folds
Player DonkReaper raises (1.50)
Player legenda99 folds
Player Goomashroom folds
Uncalled bet (1) returned to DonkReaper
Player DonkReaper mucks cards
------ Summary ------
Pot: 1.25. Rake 0
*Player DonkReaper mucks (does not show cards). Bets: 0.50. Collects: 1.25. Wins: 0.75.
Player legenda99 does not show cards.Bets: 0.25. Collects: 0. Loses: 0.25.
Player Goomashroom does not show cards.Bets: 0.50. Collects: 0. Loses: 0.50.
Player IlxxxlI does not show cards.Bets: 0. Collects: 0. Wins: 0.
Player caballeroXXX does not show cards.Bets: 0. Collects: 0. Wins: 0.
Game ended at: 2016/11/28 19:54:50

Game started
Game ID: 786366797 0.25/0.50 (PRR) Gorgons - 8 (Hold'em)
Seat 6 is the button
Seat 1: legenda99 (110.43).
Seat 3: Goomashroom (50.75).
Seat 4: lovecola (54.98).
Seat 5: IlxxxlI (20).
Seat 6: caballeroXXX (125.96).
Player legenda99 has small blind (0.25)
Player Goomashroom has big blind (0.50)
Player IlxxxlI received card: [10h]
Player IlxxxlI received card: [3d]
Player lovecola folds
Player IlxxxlI folds
Player caballeroXXX folds
Player legenda99 folds
Uncalled bet (0.25) returned to Goomashroom
Player Goomashroom mucks cards
------ Summary ------
Pot: 0.50. Rake 0
Player legenda99 does not show cards.Bets: 0.25. Collects: 0. Loses: 0.25.
*Player Goomashroom mucks (does not show cards). Bets: 0.25. Collects: 0.50. Wins: 0.25.
Player lovecola does not show cards.Bets: 0. Collects: 0. Wins: 0.
Player IlxxxlI does not show cards.Bets: 0. Collects: 0. Wins: 0.
Player caballeroXXX does not show cards.Bets: 0. Collects: 0. Wins: 0.
Game ended at: 2016/11/28 19:54:29

Game started
Game ID: 786366782 0.25/0.50 (PRR) Gorgons - 5 (Hold'em)
Seat 3 is the button
Seat 1: caballeroXXX (62.85).
Seat 2: 38979 (50).
Seat 3: meandkids (79.60).
Seat 4: Goomashroom (109.92).
Seat 5: legenda99 (107.60).
Seat 6: IlxxxlI (20).
Player Goomashroom has small blind (0.25)
Player legenda99 has big blind (0.50)
Player IlxxxlI received card: [5d]
Player IlxxxlI received card: [8h]
Player IlxxxlI folds
Player caballeroXXX folds
Player 38979 folds
Player meandkids raises (3)
Player Goomashroom folds
Player legenda99 folds
Uncalled bet (2.50) returned to meandkids
Player meandkids mucks cards
------ Summary ------
Pot: 1.25. Rake 0
Player caballeroXXX does not show cards.Bets: 0. Collects: 0. Wins: 0.
Player 38979 does not show cards.Bets: 0. Collects: 0. Wins: 0.
*Player meandkids mucks (does not show cards). Bets: 0.50. Collects: 1.25. Wins: 0.75.
Player Goomashroom does not show cards.Bets: 0.25. Collects: 0. Loses: 0.25.
Player legenda99 does not show cards.Bets: 0.50. Collects: 0. Loses: 0.50.
Player IlxxxlI does not show cards.Bets: 0. Collects: 0. Wins: 0.
Game ended at: 2016/11/28 19:54:34

Game started
Game ID: 786366777 0.50/1 (PRR) Kraken (short) (Hold'em)
Seat 6 is the button
Seat 1: Cinch23 (49).
Seat 2: 38979 (69.26).
Seat 3: Bhodisattva (37.48).
Seat 4: TranscendencE (81.10).
Seat 5: IlxxxlI (20).
Seat 6: meandkids (48.50).
Player Cinch23 has small blind (0.50)
Player 38979 has big blind (1)
Player IlxxxlI received card: [8d]
Player IlxxxlI received card: [2s]
Player Bhodisattva folds
Player TranscendencE raises (3)
Player IlxxxlI folds
Player meandkids folds
Player Cinch23 folds
Player 38979 folds
Uncalled bet (2) returned to TranscendencE
Player TranscendencE mucks cards
------ Summary ------
Pot: 2.50. Rake 0
Player Cinch23 does not show cards.Bets: 0.50. Collects: 0. Loses: 0.50.
Player 38979 does not show cards.Bets: 1. Collects: 0. Loses: 1.
Player Bhodisattva does not show cards.Bets: 0. Collects: 0. Wins: 0.
*Player TranscendencE mucks (does not show cards). Bets: 1. Collects: 2.50. Wins: 1.50.
Player IlxxxlI does not show cards.Bets: 0. Collects: 0. Wins: 0.
Player meandkids does not show cards.Bets: 0. Collects: 0. Wins: 0.
Game ended at: 2016/11/28 19:54:37

Game started
Game ID: 786366769 0.25/0.50 (PRR) Gorgons - 3 (Hold'em)
Seat 1 is the button
Seat 1: Goomashroom (51.35).
Seat 4: 38979 (96.70).
Seat 6: IlxxxlI (24.81).
Player 38979 has small blind (0.25)
Player IlxxxlI has big blind (0.50)
Player IlxxxlI received card: [2c]
Player IlxxxlI received card: [As]
Player Goomashroom folds
Player 38979 folds
Uncalled bet (0.25) returned to IlxxxlI
Player IlxxxlI mucks cards
------ Summary ------
Pot: 0.50. Rake 0
Player Goomashroom does not show cards.Bets: 0. Collects: 0. Wins: 0.
Player 38979 does not show cards.Bets: 0.25. Collects: 0. Loses: 0.25.
*Player IlxxxlI mucks (does not show cards). Bets: 0.25. Collects: 0.50. Wins: 0.25.
Game ended at: 2016/11/28 19:54:28

Game started
Game ID: 786366751 0.25/0.50 (PRR) Gorgons - 2 (Hold'em)
Seat 6 is the button
Seat 1: DonkReaper (67.64).
Seat 2: legenda99 (120.31).
Seat 3: Goomashroom (74.23).
Seat 4: IlxxxlI (22.85).
Seat 6: caballeroXXX (59.55).
Player DonkReaper has small blind (0.25)
Player legenda99 has big blind (0.50)
Player IlxxxlI received card: [9c]
Player IlxxxlI received card: [2d]
Player Goomashroom folds
Player IlxxxlI folds
Player caballeroXXX folds
Player DonkReaper folds
Uncalled bet (0.25) returned to legenda99
Player legenda99 mucks cards
------ Summary ------
Pot: 0.50. Rake 0
Player DonkReaper does not show cards.Bets: 0.25. Collects: 0. Loses: 0.25.
*Player legenda99 mucks (does not show cards). Bets: 0.25. Collects: 0.50. Wins: 0.25.
Player Goomashroom does not show cards.Bets: 0. Collects: 0. Wins: 0.
Player IlxxxlI does not show cards.Bets: 0. Collects: 0. Wins: 0.
Player caballeroXXX does not show cards.Bets: 0. Collects: 0. Wins: 0.
Game ended at: 2016/11/28 19:54:12

Game started
Game ID: 786366726 0.25/0.50 (PRR) Gorgons - 5 (Hold'em)
Seat 2 is the button
Seat 1: caballeroXXX (62.85).
Seat 2: 38979 (50).
Seat 3: meandkids (79.85).
Seat 4: Goomashroom (109.67).
Seat 5: legenda99 (107.60).
Seat 6: IlxxxlI (20).
Player meandkids has small blind (0.25)
Player Goomashroom has big blind (0.50)
Player IlxxxlI received card: [10s]
Player IlxxxlI received card: [2h]
Player legenda99 folds
Player IlxxxlI folds
Player caballeroXXX folds
Player 38979 folds
Player meandkids folds
Uncalled bet (0.25) returned to Goomashroom
Player Goomashroom mucks cards
------ Summary ------
Pot: 0.50. Rake 0
Player caballeroXXX does not show cards.Bets: 0. Collects: 0. Wins: 0.
Player 38979 does not show cards.Bets: 0. Collects: 0. Wins: 0.
Player meandkids does not show cards.Bets: 0.25. Collects: 0. Loses: 0.25.
*Player Goomashroom mucks (does not show cards). Bets: 0.25. Collects: 0.50. Wins: 0.25.
Player legenda99 does not show cards.Bets: 0. Collects: 0. Wins: 0.
Player IlxxxlI does not show cards.Bets: 0. Collects: 0. Wins: 0.
Game ended at: 2016/11/28 19:54:4

Game started
Game ID: 786366714 0.25/0.50 (PRR) Gorgons - 8 (Hold'em)
Seat 5 is the button
Seat 1: legenda99 (110.93).
Seat 3: Goomashroom (50).
Seat 4: lovecola (54.98).
Seat 5: IlxxxlI (20).
Seat 6: caballeroXXX (126.21).
Player caballeroXXX has small blind (0.25)
Player legenda99 has big blind (0.50)
Player IlxxxlI received card: [3c]
Player IlxxxlI received card: [8c]
Player Goomashroom raises (1.50)
Player lovecola folds
Player IlxxxlI folds
Player caballeroXXX folds
Player legenda99 folds
Uncalled bet (1) returned to Goomashroom
Player Goomashroom mucks cards
------ Summary ------
Pot: 1.25. Rake 0
Player legenda99 does not show cards.Bets: 0.50. Collects: 0. Loses: 0.50.
*Player Goomashroom mucks (does not show cards). Bets: 0.50. Collects: 1.25. Wins: 0.75.
Player lovecola does not show cards.Bets: 0. Collects: 0. Wins: 0.
Player IlxxxlI does not show cards.Bets: 0. Collects: 0. Wins: 0.
Player caballeroXXX does not show cards.Bets: 0.25. Collects: 0. Loses: 0.25.
Game ended at: 2016/11/28 19:54:6

Game started
Game ID: 786366712 0.50/1 (PRR) Kraken (short) (Hold'em)
Seat 5 is the button
Seat 1: Cinch23 (50).
Seat 2: 38979 (69.26).
Seat 3: Bhodisattva (35.98).
Seat 4: TranscendencE (81.10).
Seat 5: IlxxxlI (20).
Seat 6: meandkids (49).
Player meandkids has small blind (0.50)
Player Cinch23 has big blind (1)
Player IlxxxlI received card: [3h]
Player IlxxxlI received card: [Ac]
Player 38979 folds
Player Bhodisattva raises (2)
Player TranscendencE folds
Player IlxxxlI folds
Player meandkids folds
Player Cinch23 folds
Uncalled bet (1) returned to Bhodisattva
Player Bhodisattva mucks cards
------ Summary ------
Pot: 2.50. Rake 0
Player Cinch23 does not show cards.Bets: 1. Collects: 0. Loses: 1.
Player 38979 does not show cards.Bets: 0. Collects: 0. Wins: 0.
*Player Bhodisattva mucks (does not show cards). Bets: 1. Collects: 2.50. Wins: 1.50.
Player TranscendencE does not show cards.Bets: 0. Collects: 0. Wins: 0.
Player IlxxxlI does not show cards.Bets: 0. Collects: 0. Wins: 0.
Player meandkids does not show cards.Bets: 0.50. Collects: 0. Loses: 0.50.
Game ended at: 2016/11/28 19:54:1

Game started
Game ID: 786366661 0.25/0.50 (PRR) Gorgons - 2 (Hold'em)
Seat 4 is the button
Seat 1: DonkReaper (68.14).
Seat 2: legenda99 (120.31).
Seat 3: Goomashroom (73.48).
Seat 4: IlxxxlI (22.85).
Seat 6: caballeroXXX (59.80).
Player caballeroXXX has small blind (0.25)
Player DonkReaper has big blind (0.50)
Player IlxxxlI received card: [Kh]
Player IlxxxlI received card: [6s]
Player legenda99 folds
Player Goomashroom raises (1.25)
Player IlxxxlI folds
Player caballeroXXX folds
Player DonkReaper folds
Uncalled bet (0.75) returned to Goomashroom
Player Goomashroom mucks cards
------ Summary ------
Pot: 1.25. Rake 0
Player DonkReaper does not show cards.Bets: 0.50. Collects: 0. Loses: 0.50.
Player legenda99 does not show cards.Bets: 0. Collects: 0. Wins: 0.
*Player Goomashroom mucks (does not show cards). Bets: 0.50. Collects: 1.25. Wins: 0.75.
Player IlxxxlI does not show cards.Bets: 0. Collects: 0. Wins: 0.
Player caballeroXXX does not show cards.Bets: 0.25. Collects: 0. Loses: 0.25.
Game ended at: 2016/11/28 19:53:54

Game started
Game ID: 786366650 0.50/1 (PRR) Kraken (short) (Hold'em)
Seat 4 is the button
Seat 2: 38979 (69.26).
Seat 3: Bhodisattva (35.98).
Seat 4: TranscendencE (79.60).
Seat 5: IlxxxlI (20).
Seat 6: meandkids (50).
Player IlxxxlI has small blind (0.50)
Player meandkids has big blind (1)
Player IlxxxlI received card: [4s]
Player IlxxxlI received card: [10s]
Player 38979 folds
Player Bhodisattva folds
Player TranscendencE raises (2)
Player IlxxxlI folds
Player meandkids folds
Uncalled bet (1) returned to TranscendencE
Player TranscendencE mucks cards
------ Summary ------
Pot: 2.50. Rake 0
Player 38979 does not show cards.Bets: 0. Collects: 0. Wins: 0.
Player Bhodisattva does not show cards.Bets: 0. Collects: 0. Wins: 0.
*Player TranscendencE mucks (does not show cards). Bets: 1. Collects: 2.50. Wins: 1.50.
Player IlxxxlI does not show cards.Bets: 0.50. Collects: 0. Loses: 0.50.
Player meandkids does not show cards.Bets: 1. Collects: 0. Loses: 1.
Game ended at: 2016/11/28 19:53:38

Game started
Game ID: 786366603 0.50/1 (PRR) Kraken (short) (Hold'em)
Seat 3 is the button
Seat 2: 38979 (69.26).
Seat 3: Bhodisattva (34.48).
Seat 4: TranscendencE (80.10).
Seat 5: IlxxxlI (20).
Seat 6: meandkids (50).
Player TranscendencE has small blind (0.50)
Player IlxxxlI has big blind (1)
Player IlxxxlI received card: [3d]
Player IlxxxlI received card: [6c]
Player meandkids folds
Player 38979 folds
Player Bhodisattva raises (2)
Player TranscendencE folds
Player IlxxxlI folds
Uncalled bet (1) returned to Bhodisattva
Player Bhodisattva mucks cards
------ Summary ------
Pot: 2.50. Rake 0
Player 38979 does not show cards.Bets: 0. Collects: 0. Wins: 0.
*Player Bhodisattva mucks (does not show cards). Bets: 1. Collects: 2.50. Wins: 1.50.
Player TranscendencE does not show cards.Bets: 0.50. Collects: 0. Loses: 0.50.
Player IlxxxlI does not show cards.Bets: 1. Collects: 0. Loses: 1.
Player meandkids does not show cards.Bets: 0. Collects: 0. Wins: 0.
Game ended at: 2016/11/28 19:53:20

Game started
Game ID: 786366605 0.25/0.50 (PRR) Gorgons - 3 (Hold'em)
Seat 6 is the button
Seat 1: Goomashroom (51.60).
Seat 3: RetardedGenius (48.45).
Seat 4: 38979 (50).
Seat 6: IlxxxlI (24.81).
Player Goomashroom has small blind (0.25)
Player RetardedGenius has big blind (0.50)
Player IlxxxlI received card: [Qs]
Player IlxxxlI received card: [9d]
Player 38979 raises (1.50)
Player IlxxxlI folds
Player Goomashroom folds
Player RetardedGenius calls (1)
*** FLOP ***: [7c 5s 4h]
Player RetardedGenius checks
Player 38979 bets (2.50)
Player RetardedGenius calls (2.50)
*** TURN ***: [7c 5s 4h] [Jc]
Player RetardedGenius checks
Player 38979 bets (5.50)
Player RetardedGenius raises (11)
Player 38979 allin (40.50)
Player RetardedGenius allin (33.45)
Uncalled bet (1.55) returned to 38979
*** RIVER ***: [7c 5s 4h Jc] [7s]
------ Summary ------
Pot: 95.15. Rake 1.76. JP fee 0.24
Board: [7c 5s 4h Jc 7s]
Player Goomashroom does not show cards.Bets: 0.25. Collects: 0. Loses: 0.25.
Player RetardedGenius shows: Two pairs. Js and 7s [Js 6s]. Bets: 48.45. Collects: 0. Loses: 48.45.
*Player 38979 shows: Four of kind of 7s [7h 7d]. Bets: 48.45. Collects: 95.15. Wins: 46.70.
Player IlxxxlI does not show cards.Bets: 0. Collects: 0. Wins: 0.
Game ended at: 2016/11/28 19:53:58

Game started
Game ID: 786366601 1/2 (PRR) Lakhey (Short) (Hold'em)
Seat 2 is the button
Seat 1: IlxxxlI (40).
Seat 2: 38979 (229.12).
Seat 3: BBDub27 (100).
Seat 4: Wollverin (109.95).
Seat 5: meandkids (121.48).
Player BBDub27 has small blind (1)
Player Wollverin has big blind (2)
Player IlxxxlI received card: [4s]
Player IlxxxlI received card: [3d]
Player meandkids calls (2)
Player IlxxxlI folds
Player 38979 folds
Player BBDub27 folds
Player Wollverin checks
*** FLOP ***: [5c 6c 2h]
Player Wollverin checks
Player meandkids checks
*** TURN ***: [5c 6c 2h] [7h]
Player Wollverin bets (3.16)
Player meandkids calls (3.16)
*** RIVER ***: [5c 6c 2h 7h] [Jd]
Player Wollverin bets (7)
Player meandkids folds
Uncalled bet (7) returned to Wollverin
Player Wollverin mucks cards
------ Summary ------
Pot: 10.76. Rake 0.38. JP fee 0.18
Board: [5c 6c 2h 7h Jd]
Player IlxxxlI does not show cards.Bets: 0. Collects: 0. Wins: 0.
Player 38979 does not show cards.Bets: 0. Collects: 0. Wins: 0.
Player BBDub27 does not show cards.Bets: 1. Collects: 0. Loses: 1.
*Player Wollverin mucks (does not show cards). Bets: 5.16. Collects: 10.76. Wins: 5.60.
Player meandkids does not show cards.Bets: 5.16. Collects: 0. Loses: 5.16.
Game ended at: 2016/11/28 19:54:24

Game started
Game ID: 786366563 0.25/0.50 (PRR) Gorgons - 5 (Hold'em)
Seat 1 is the button
Seat 1: caballeroXXX (56.10).
Seat 2: 38979 (50.25).
Seat 3: meandkids (80.35).
Seat 4: Goomashroom (111.17).
Seat 5: legenda99 (112.10).
Seat 6: IlxxxlI (20).
Player 38979 has small blind (0.25)
Player meandkids has big blind (0.50)
Player IlxxxlI received card: [2s]
Player IlxxxlI received card: [9d]
Player Goomashroom raises (1.50)
Player legenda99 raises (4.50)
Player IlxxxlI folds
Player caballeroXXX raises (13.50)
Player 38979 folds
Player meandkids folds
Player Goomashroom folds
Player legenda99 folds
Uncalled bet (9) returned to caballeroXXX
Player caballeroXXX mucks cards
------ Summary ------
Pot: 11.25. Rake 0
*Player caballeroXXX mucks (does not show cards). Bets: 4.50. Collects: 11.25. Wins: 6.75.
Player 38979 does not show cards.Bets: 0.25. Collects: 0. Loses: 0.25.
Player meandkids does not show cards.Bets: 0.50. Collects: 0. Loses: 0.50.
Player Goomashroom does not show cards.Bets: 1.50. Collects: 0. Loses: 1.50.
Player legenda99 does not show cards.Bets: 4.50. Collects: 0. Loses: 4.50.
Player IlxxxlI does not show cards.Bets: 0. Collects: 0. Wins: 0.
Game ended at: 2016/11/28 19:53:44

Game started
Game ID: 786366547 0.25/0.50 (PRR) Gorgons - 3 (Hold'em)
Seat 4 is the button
Seat 1: Goomashroom (52.10).
Seat 2: allaebalaamballa (32.97).
Seat 3: RetardedGenius (47.70).
Seat 4: 38979 (50).
Seat 6: IlxxxlI (25.06).
Player IlxxxlI has small blind (0.25)
Player Goomashroom has big blind (0.50)
Player IlxxxlI received card: [Qs]
Player IlxxxlI received card: [3h]
Player allaebalaamballa folds
Player RetardedGenius raises (1)
Player 38979 folds
Player IlxxxlI folds
Player Goomashroom folds
Uncalled bet (0.50) returned to RetardedGenius
Player RetardedGenius mucks cards
------ Summary ------
Pot: 1.25. Rake 0
Player Goomashroom does not show cards.Bets: 0.50. Collects: 0. Loses: 0.50.
Player allaebalaamballa does not show cards.Bets: 0. Collects: 0. Wins: 0.
*Player RetardedGenius mucks (does not show cards). Bets: 0.50. Collects: 1.25. Wins: 0.75.
Player 38979 does not show cards.Bets: 0. Collects: 0. Wins: 0.
Player IlxxxlI does not show cards.Bets: 0.25. Collects: 0. Loses: 0.25.
Game ended at: 2016/11/28 19:53:4

Game started
Game ID: 786366515 0.25/0.50 (PRR) Gorgons - 8 (Hold'em)
Seat 4 is the button
Seat 1: legenda99 (110.93).
Seat 3: Goomashroom (50).
Seat 4: lovecola (50).
Seat 5: IlxxxlI (20.25).
Seat 6: caballeroXXX (126.71).
Player IlxxxlI has small blind (0.25)
Player caballeroXXX has big blind (0.50)
Player IlxxxlI received card: [10s]
Player IlxxxlI received card: [9s]
Player legenda99 folds
Player Goomashroom folds
Player lovecola raises (1.25)
Player IlxxxlI raises (1.75)
Player caballeroXXX folds
Player lovecola raises (3.75)
Player IlxxxlI calls (3)
*** FLOP ***: [Ac Jc 10c]
Player IlxxxlI checks
Player lovecola bets (8)
Player IlxxxlI folds
Uncalled bet (8) returned to lovecola
Player lovecola mucks cards
------ Summary ------
Pot: 9.98. Rake 0.36. JP fee 0.16
Board: [Ac Jc 10c]
Player legenda99 does not show cards.Bets: 0. Collects: 0. Wins: 0.
Player Goomashroom does not show cards.Bets: 0. Collects: 0. Wins: 0.
*Player lovecola mucks (does not show cards). Bets: 5. Collects: 9.98. Wins: 4.98.
Player IlxxxlI does not show cards.Bets: 5. Collects: 0. Loses: 5.
Player caballeroXXX does not show cards.Bets: 0.50. Collects: 0. Loses: 0.50.
Game ended at: 2016/11/28 19:53:38

Game started
Game ID: 786366496 0.25/0.50 (PRR) Gorgons - 5 (Hold'em)
Seat 6 is the button
Seat 1: caballeroXXX (56.35).
Seat 2: 38979 (50).
Seat 3: meandkids (80.35).
Seat 4: Goomashroom (111.17).
Seat 5: legenda99 (112.10).
Seat 6: IlxxxlI (20).
Player caballeroXXX has small blind (0.25)
Player 38979 has big blind (0.50)
Player IlxxxlI received card: [4s]
Player IlxxxlI received card: [6d]
Player meandkids folds
Player Goomashroom folds
Player legenda99 folds
Player IlxxxlI folds
Player caballeroXXX folds
Uncalled bet (0.25) returned to 38979
Player 38979 mucks cards
------ Summary ------
Pot: 0.50. Rake 0
Player caballeroXXX does not show cards.Bets: 0.25. Collects: 0. Loses: 0.25.
*Player 38979 mucks (does not show cards). Bets: 0.25. Collects: 0.50. Wins: 0.25.
Player meandkids does not show cards.Bets: 0. Collects: 0. Wins: 0.
Player Goomashroom does not show cards.Bets: 0. Collects: 0. Wins: 0.
Player legenda99 does not show cards.Bets: 0. Collects: 0. Wins: 0.
Player IlxxxlI does not show cards.Bets: 0. Collects: 0. Wins: 0.
Game ended at: 2016/11/28 19:52:48

Game started
Game ID: 786366484 1/2 (PRR) Lakhey (Short) - 2 (Hold'em)
Seat 1 is the button
Seat 1: IlxxxlI (40).
Seat 2: 38979 (100).
Seat 3: sheenius81 (95.25).
Seat 4: brokenlucks (209.18).
Seat 5: GamblerPaul (40).
Seat 6: gfclbv (114).
Player 38979 has small blind (1)
Player sheenius81 has big blind (2)
Player IlxxxlI received card: [5h]
Player IlxxxlI received card: [6d]
Player brokenlucks calls (2)
Player GamblerPaul calls (2)
Player gfclbv raises (8)
Player IlxxxlI folds
Player 38979 folds
Player sheenius81 folds
Player brokenlucks calls (6)
Player GamblerPaul calls (6)
*** FLOP ***: [Jh 5d As]
Player brokenlucks checks
Player GamblerPaul checks
Player gfclbv bets (12)
Player brokenlucks calls (12)
Player GamblerPaul folds
*** TURN ***: [Jh 5d As] [Js]
Player brokenlucks checks
Player gfclbv bets (26)
Player brokenlucks calls (26)
*** RIVER ***: [Jh 5d As Js] [4h]
Player brokenlucks checks
Player gfclbv allin (68)
Player brokenlucks calls (68)
------ Summary ------
Pot: 236. Rake 2.76. JP fee 0.24
Board: [Jh 5d As Js 4h]
Player IlxxxlI does not show cards.Bets: 0. Collects: 0. Wins: 0.
Player 38979 does not show cards.Bets: 1. Collects: 0. Loses: 1.
Player sheenius81 does not show cards.Bets: 2. Collects: 0. Loses: 2.
Player brokenlucks shows: Two pairs. As and Js [Ks Ac]. Bets: 114. Collects: 0. Loses: 114.
Player GamblerPaul does not show cards.Bets: 8. Collects: 0. Loses: 8.
*Player gfclbv shows: Three Of Kind of Js [Qs Jc]. Bets: 114. Collects: 236. Wins: 122.
Game ended at: 2016/11/28 19:54:12

Game started
Game ID: 786366460 1/2 (PRR) Lakhey (Short) (Hold'em)
Seat 1 is the button
Seat 1: IlxxxlI (40).
Seat 2: 38979 (223.72).
Seat 3: BBDub27 (105).
Seat 4: Wollverin (109.95).
Seat 5: meandkids (121.48).
Player 38979 has small blind (1)
Player BBDub27 has big blind (2)
Player IlxxxlI received card: [9d]
Player IlxxxlI received card: [2h]
Player Wollverin folds
Player meandkids folds
Player IlxxxlI folds
Player 38979 raises (5)
Player BBDub27 calls (4)
*** FLOP ***: [Qs 8c 2d]
Player 38979 checks
Player BBDub27 checks
*** TURN ***: [Qs 8c 2d] [10s]
Player 38979 bets (7.60)
Player BBDub27 folds
Uncalled bet (7.60) returned to 38979
Player 38979 mucks cards
------ Summary ------
Pot: 11.40. Rake 0.40. JP fee 0.20
Board: [Qs 8c 2d 10s]
Player IlxxxlI does not show cards.Bets: 0. Collects: 0. Wins: 0.
*Player 38979 mucks (does not show cards). Bets: 6. Collects: 11.40. Wins: 5.40.
Player BBDub27 does not show cards.Bets: 6. Collects: 0. Loses: 6.
Player Wollverin does not show cards.Bets: 0. Collects: 0. Wins: 0.
Player meandkids does not show cards.Bets: 0. Collects: 0. Wins: 0.
Game ended at: 2016/11/28 19:53:3

Game started
Game ID: 786366442 0.25/0.50 (PRR) Gorgons - 8 (Hold'em)
Seat 3 is the button
Seat 1: legenda99 (110.93).
Seat 3: Goomashroom (50).
Seat 4: lovecola (50.25).
Seat 5: IlxxxlI (20).
Seat 6: caballeroXXX (126.71).
Player lovecola has small blind (0.25)
Player IlxxxlI has big blind (0.50)
Player IlxxxlI received card: [7h]
Player IlxxxlI received card: [9d]
Player caballeroXXX folds
Player legenda99 folds
Player Goomashroom folds
Player lovecola folds
Uncalled bet (0.25) returned to IlxxxlI
Player IlxxxlI mucks cards
------ Summary ------
Pot: 0.50. Rake 0
Player legenda99 does not show cards.Bets: 0. Collects: 0. Wins: 0.
Player Goomashroom does not show cards.Bets: 0. Collects: 0. Wins: 0.
Player lovecola does not show cards.Bets: 0.25. Collects: 0. Loses: 0.25.
*Player IlxxxlI mucks (does not show cards). Bets: 0.25. Collects: 0.50. Wins: 0.25.
Player caballeroXXX does not show cards.Bets: 0. Collects: 0. Wins: 0.
Game ended at: 2016/11/28 19:52:30

Game started
Game ID: 786366441 0.25/0.50 (PRR) Gorgons - 3 (Hold'em)
Seat 3 is the button
Seat 1: Goomashroom (52.10).
Seat 2: allaebalaamballa (32.97).
Seat 3: RetardedGenius (46.32).
Seat 4: 38979 (50).
Seat 6: IlxxxlI (25.56).
Player 38979 has small blind (0.25)
Player IlxxxlI has big blind (0.50)
Player IlxxxlI received card: [8c]
Player IlxxxlI received card: [7d]
Player Goomashroom folds
Player allaebalaamballa folds
Player RetardedGenius raises (1)
Player 38979 calls (0.75)
Player IlxxxlI folds
*** FLOP ***: [4h 3s 4c]
Player 38979 checks
Player RetardedGenius bets (1.58)
Player 38979 folds
Uncalled bet (1.58) returned to RetardedGenius
Player RetardedGenius mucks cards
------ Summary ------
Pot: 2.38. Rake 0.08. JP fee 0.04
Board: [4h 3s 4c]
Player Goomashroom does not show cards.Bets: 0. Collects: 0. Wins: 0.
Player allaebalaamballa does not show cards.Bets: 0. Collects: 0. Wins: 0.
*Player RetardedGenius mucks (does not show cards). Bets: 1. Collects: 2.38. Wins: 1.38.
Player 38979 does not show cards.Bets: 1. Collects: 0. Loses: 1.
Player IlxxxlI does not show cards.Bets: 0.50. Collects: 0. Loses: 0.50.
Game ended at: 2016/11/28 19:52:41

Game started
Game ID: 786366429 0.25/0.50 (PRR) Gorgons - 5 (Hold'em)
Seat 5 is the button
Seat 1: caballeroXXX (56.85).
Seat 2: 38979 (50).
Seat 3: meandkids (79.60).
Seat 4: Goomashroom (111.17).
Seat 5: legenda99 (112.10).
Seat 6: IlxxxlI (20).
Player IlxxxlI has small blind (0.25)
Player caballeroXXX has big blind (0.50)
Player IlxxxlI received card: [5c]
Player IlxxxlI received card: [2s]
Player 38979 folds
Player meandkids raises (3)
Player Goomashroom folds
Player legenda99 folds
Player IlxxxlI folds
Player caballeroXXX folds
Uncalled bet (2.50) returned to meandkids
Player meandkids mucks cards
------ Summary ------
Pot: 1.25. Rake 0
Player caballeroXXX does not show cards.Bets: 0.50. Collects: 0. Loses: 0.50.
Player 38979 does not show cards.Bets: 0. Collects: 0. Wins: 0.
*Player meandkids mucks (does not show cards). Bets: 0.50. Collects: 1.25. Wins: 0.75.
Player Goomashroom does not show cards.Bets: 0. Collects: 0. Wins: 0.
Player legenda99 does not show cards.Bets: 0. Collects: 0. Wins: 0.
Player IlxxxlI does not show cards.Bets: 0.25. Collects: 0. Loses: 0.25.
Game ended at: 2016/11/28 19:52:25

Game started
Game ID: 786366421 0.25/0.50 (PRR) Gorgons - 2 (Hold'em)
Seat 3 is the button
Seat 1: DonkReaper (68.14).
Seat 2: legenda99 (121.81).
Seat 3: Goomashroom (73.48).
Seat 4: IlxxxlI (23.10).
Seat 6: caballeroXXX (58.21).
Player IlxxxlI has small blind (0.25)
Player caballeroXXX has big blind (0.50)
Player IlxxxlI received card: [5h]
Player IlxxxlI received card: [Ac]
Player DonkReaper folds
Player legenda99 raises (1.50)
Player Goomashroom folds
Player IlxxxlI folds
Player caballeroXXX calls (1)
*** FLOP ***: [9h 6d As]
Player caballeroXXX checks
Player legenda99 checks
*** TURN ***: [9h 6d As] [Jh]
Player caballeroXXX checks
Player legenda99 checks
*** RIVER ***: [9h 6d As Jh] [8s]
Player caballeroXXX bets (2)
Player legenda99 folds
Uncalled bet (2) returned to caballeroXXX
Player caballeroXXX mucks cards
------ Summary ------
Pot: 3.09. Rake 0.12. JP fee 0.04
Board: [9h 6d As Jh 8s]
Player DonkReaper does not show cards.Bets: 0. Collects: 0. Wins: 0.
Player legenda99 does not show cards.Bets: 1.50. Collects: 0. Loses: 1.50.
Player Goomashroom does not show cards.Bets: 0. Collects: 0. Wins: 0.
Player IlxxxlI does not show cards.Bets: 0.25. Collects: 0. Loses: 0.25.
*Player caballeroXXX mucks (does not show cards). Bets: 1.50. Collects: 3.09. Wins: 1.59.
Game ended at: 2016/11/28 19:53:23

Game started
Game ID: 786366373 0.25/0.50 (PRR) Gorgons - 3 (Hold'em)
Seat 2 is the button
Seat 1: Goomashroom (52.10).
Seat 2: allaebalaamballa (32.97).
Seat 3: RetardedGenius (46.57).
Seat 4: 38979 (50).
Seat 6: IlxxxlI (24.81).
Player RetardedGenius has small blind (0.25)
Player 38979 has big blind (0.50)
Player IlxxxlI received card: [Ah]
Player IlxxxlI received card: [Qd]
Player IlxxxlI raises (1.75)
Player Goomashroom folds
Player allaebalaamballa folds
Player RetardedGenius folds
Player 38979 folds
Uncalled bet (1.25) returned to IlxxxlI
Player IlxxxlI mucks cards
------ Summary ------
Pot: 1.25. Rake 0
Player Goomashroom does not show cards.Bets: 0. Collects: 0. Wins: 0.
Player allaebalaamballa does not show cards.Bets: 0. Collects: 0. Wins: 0.
Player RetardedGenius does not show cards.Bets: 0.25. Collects: 0. Loses: 0.25.
Player 38979 does not show cards.Bets: 0.50. Collects: 0. Loses: 0.50.
*Player IlxxxlI mucks (does not show cards). Bets: 0.50. Collects: 1.25. Wins: 0.75.
Game ended at: 2016/11/28 19:52:3

Game started
Game ID: 786366367 1/2 (PRR) Lakhey (Short) (Hold'em)
Seat 5 is the button
Seat 1: IlxxxlI (40).
Seat 2: 38979 (225.72).
Seat 3: BBDub27 (102).
Seat 4: Wollverin (109.95).
Seat 5: meandkids (121.48).
Player IlxxxlI has small blind (1)
Player 38979 has big blind (2)
Player IlxxxlI received card: [4c]
Player IlxxxlI received card: [4s]
Player BBDub27 raises (8)
Player Wollverin folds
Player meandkids folds
Player IlxxxlI folds
Player 38979 folds
Uncalled bet (6) returned to BBDub27
Player BBDub27 mucks cards
------ Summary ------
Pot: 5. Rake 0
Player IlxxxlI does not show cards.Bets: 1. Collects: 0. Loses: 1.
Player 38979 does not show cards.Bets: 2. Collects: 0. Loses: 2.
*Player BBDub27 mucks (does not show cards). Bets: 2. Collects: 5. Wins: 3.
Player Wollverin does not show cards.Bets: 0. Collects: 0. Wins: 0.
Player meandkids does not show cards.Bets: 0. Collects: 0. Wins: 0.
Game ended at: 2016/11/28 19:52:12

Game started
Game ID: 786366364 1/2 (PRR) Lakhey (Short) - 2 (Hold'em)
Seat 6 is the button
Seat 1: IlxxxlI (40).
Seat 2: 38979 (103).
Seat 3: sheenius81 (90.70).
Seat 4: brokenlucks (209.18).
Seat 5: GamblerPaul (40).
Seat 6: gfclbv (114).
Player IlxxxlI has small blind (1)
Player 38979 has big blind (2)
Player IlxxxlI received card: [8c]
Player IlxxxlI received card: [2s]
Player sheenius81 raises (4)
Player brokenlucks folds
Player GamblerPaul folds
Player gfclbv folds
Player IlxxxlI folds
Player 38979 calls (2)
*** FLOP ***: [4s Jc 6h]
Player 38979 checks
Player sheenius81 checks
*** TURN ***: [4s Jc 6h] [3c]
Player 38979 checks
Player sheenius81 checks
*** RIVER ***: [4s Jc 6h 3c] [Js]
Player 38979 checks
Player sheenius81 checks
Player 38979 mucks cards
------ Summary ------
Pot: 8.55. Rake 0.31. JP fee 0.14
Board: [4s Jc 6h 3c Js]
Player IlxxxlI does not show cards.Bets: 1. Collects: 0. Loses: 1.
Player 38979 mucks (does not show cards). Bets: 4. Collects: 0. Loses: 4.
*Player sheenius81 shows: One pair of Js [Ah 9c]. Bets: 4. Collects: 8.55. Wins: 4.55.
Player brokenlucks does not show cards.Bets: 0. Collects: 0. Wins: 0.
Player GamblerPaul does not show cards.Bets: 0. Collects: 0. Wins: 0.
Player gfclbv does not show cards.Bets: 0. Collects: 0. Wins: 0.
Game ended at: 2016/11/28 19:52:19

Game started
Game ID: 786366314 0.25/0.50 (PRR) Gorgons - 2 (Hold'em)
Seat 2 is the button
Seat 1: DonkReaper (67.39).
Seat 2: legenda99 (121.81).
Seat 3: Goomashroom (73.73).
Seat 4: IlxxxlI (23.60).
Seat 6: caballeroXXX (58.21).
Player Goomashroom has small blind (0.25)
Player IlxxxlI has big blind (0.50)
Player IlxxxlI received card: [Kd]
Player IlxxxlI received card: [9c]
Player caballeroXXX folds
Player DonkReaper raises (1.50)
Player legenda99 folds
Player Goomashroom folds
Player IlxxxlI folds
Uncalled bet (1) returned to DonkReaper
Player DonkReaper mucks cards
------ Summary ------
Pot: 1.25. Rake 0
*Player DonkReaper mucks (does not show cards). Bets: 0.50. Collects: 1.25. Wins: 0.75.
Player legenda99 does not show cards.Bets: 0. Collects: 0. Wins: 0.
Player Goomashroom does not show cards.Bets: 0.25. Collects: 0. Loses: 0.25.
Player IlxxxlI does not show cards.Bets: 0.50. Collects: 0. Loses: 0.50.
Player caballeroXXX does not show cards.Bets: 0. Collects: 0. Wins: 0.
Game ended at: 2016/11/28 19:51:57

Game started
Game ID: 786366307 0.25/0.50 (PRR) Gorgons - 3 (Hold'em)
Seat 1 is the button
Seat 1: Goomashroom (51.35).
Seat 2: allaebalaamballa (33.22).
Seat 3: RetardedGenius (47.07).
Seat 4: 38979 (50).
Seat 6: IlxxxlI (24.81).
Player allaebalaamballa has small blind (0.25)
Player RetardedGenius has big blind (0.50)
Player IlxxxlI received card: [2c]
Player IlxxxlI received card: [6d]
Player 38979 folds
Player IlxxxlI folds
Player Goomashroom raises (1.13)
Player allaebalaamballa folds
Player RetardedGenius folds
Uncalled bet (0.63) returned to Goomashroom
Player Goomashroom mucks cards
------ Summary ------
Pot: 1.25. Rake 0
*Player Goomashroom mucks (does not show cards). Bets: 0.50. Collects: 1.25. Wins: 0.75.
Player allaebalaamballa does not show cards.Bets: 0.25. Collects: 0. Loses: 0.25.
Player RetardedGenius does not show cards.Bets: 0.50. Collects: 0. Loses: 0.50.
Player 38979 does not show cards.Bets: 0. Collects: 0. Wins: 0.
Player IlxxxlI does not show cards.Bets: 0. Collects: 0. Wins: 0.
Game ended at: 2016/11/28 19:51:42

Game started
Game ID: 786366284 0.25/0.50 (PRR) Gorgons - 5 (Hold'em)
Seat 4 is the button
Seat 1: caballeroXXX (56.85).
Seat 2: 38979 (50).
Seat 3: meandkids (79.60).
Seat 4: Goomashroom (109.91).
Seat 5: legenda99 (112.35).
Seat 6: IlxxxlI (20).
Player legenda99 has small blind (0.25)
Player IlxxxlI has big blind (0.50)
Player IlxxxlI received card: [2s]
Player IlxxxlI received card: [As]
Player caballeroXXX folds
Player 38979 folds
Player meandkids folds
Player Goomashroom raises (1.13)
Player legenda99 folds
Player IlxxxlI calls (0.63)
*** FLOP ***: [6h 5s 10d]
Player IlxxxlI checks
Player Goomashroom bets (1.50)
Player IlxxxlI folds
Uncalled bet (1.50) returned to Goomashroom
Player Goomashroom mucks cards
------ Summary ------
Pot: 2.39. Rake 0.08. JP fee 0.04
Board: [6h 5s 10d]
Player caballeroXXX does not show cards.Bets: 0. Collects: 0. Wins: 0.
Player 38979 does not show cards.Bets: 0. Collects: 0. Wins: 0.
Player meandkids does not show cards.Bets: 0. Collects: 0. Wins: 0.
*Player Goomashroom mucks (does not show cards). Bets: 1.13. Collects: 2.39. Wins: 1.26.
Player legenda99 does not show cards.Bets: 0.25. Collects: 0. Loses: 0.25.
Player IlxxxlI does not show cards.Bets: 1.13. Collects: 0. Loses: 1.13.
Game ended at: 2016/11/28 19:52:0

Game started
Game ID: 786366241 0.25/0.50 (PRR) Gorgons - 2 (Hold'em)
Seat 1 is the button
Seat 1: DonkReaper (67.39).
Seat 2: legenda99 (122.06).
Seat 3: Goomashroom (73.48).
Seat 4: IlxxxlI (23.60).
Seat 6: caballeroXXX (58.21).
Player legenda99 has small blind (0.25)
Player Goomashroom has big blind (0.50)
Player IlxxxlI received card: [Qc]
Player IlxxxlI received card: [6s]
Player IlxxxlI folds
Player caballeroXXX folds
Player DonkReaper folds
Player legenda99 folds
Uncalled bet (0.25) returned to Goomashroom
Player Goomashroom mucks cards
------ Summary ------
Pot: 0.50. Rake 0
Player DonkReaper does not show cards.Bets: 0. Collects: 0. Wins: 0.
Player legenda99 does not show cards.Bets: 0.25. Collects: 0. Loses: 0.25.
*Player Goomashroom mucks (does not show cards). Bets: 0.25. Collects: 0.50. Wins: 0.25.
Player IlxxxlI does not show cards.Bets: 0. Collects: 0. Wins: 0.
Player caballeroXXX does not show cards.Bets: 0. Collects: 0. Wins: 0.
Game ended at: 2016/11/28 19:51:19

Game started
Game ID: 786366191 0.25/0.50 (PRR) Gorgons - 3 (Hold'em)
Seat 6 is the button
Seat 1: Goomashroom (51.60).
Seat 2: allaebalaamballa (26.63).
Seat 3: RetardedGenius (54.12).
Seat 4: 38979 (50).
Seat 6: IlxxxlI (24.81).
Player Goomashroom has small blind (0.25)
Player allaebalaamballa has big blind (0.50)
Player RetardedGenius straddle (1)
Player IlxxxlI received card: [Kc]
Player IlxxxlI received card: [7d]
Player 38979 folds
Player IlxxxlI folds
Player Goomashroom folds
Player allaebalaamballa calls (0.50)
Player RetardedGenius checks
*** FLOP ***: [8c 7s 2d]
Player allaebalaamballa bets (0.95)
Player RetardedGenius calls (0.95)
*** TURN ***: [8c 7s 2d] [10d]
Player allaebalaamballa bets (1.80)
Player RetardedGenius calls (1.80)
*** RIVER ***: [8c 7s 2d 10d] [10h]
Player allaebalaamballa bets (3.30)
Player RetardedGenius calls (3.30)
Player RetardedGenius mucks cards
------ Summary ------
Pot: 13.64. Rake 0.49. JP fee 0.22
Board: [8c 7s 2d 10d 10h]
Player Goomashroom does not show cards.Bets: 0.25. Collects: 0. Loses: 0.25.
*Player allaebalaamballa shows: Two pairs. 10s and 8s [8s 9s]. Bets: 7.05. Collects: 13.64. Wins: 6.59.
Player RetardedGenius mucks (does not show cards). Bets: 7.05. Collects: 0. Loses: 7.05.
Player 38979 does not show cards.Bets: 0. Collects: 0. Wins: 0.
Player IlxxxlI does not show cards.Bets: 0. Collects: 0. Wins: 0.
Game ended at: 2016/11/28 19:51:16

Game started
Game ID: 786366169 0.25/0.50 (PRR) Gorgons - 2 (Hold'em)
Seat 6 is the button
Seat 1: DonkReaper (67.64).
Seat 2: legenda99 (122.56).
Seat 3: Goomashroom (72.73).
Seat 4: IlxxxlI (23.60).
Seat 6: caballeroXXX (58.21).
Player DonkReaper has small blind (0.25)
Player legenda99 has big blind (0.50)
Player IlxxxlI received card: [6s]
Player IlxxxlI received card: [4d]
Player Goomashroom raises (1.50)
Player IlxxxlI folds
Player caballeroXXX folds
Player DonkReaper folds
Player legenda99 folds
Uncalled bet (1) returned to Goomashroom
Player Goomashroom mucks cards
------ Summary ------
Pot: 1.25. Rake 0
Player DonkReaper does not show cards.Bets: 0.25. Collects: 0. Loses: 0.25.
Player legenda99 does not show cards.Bets: 0.50. Collects: 0. Loses: 0.50.
*Player Goomashroom mucks (does not show cards). Bets: 0.50. Collects: 1.25. Wins: 0.75.
Player IlxxxlI does not show cards.Bets: 0. Collects: 0. Wins: 0.
Player caballeroXXX does not show cards.Bets: 0. Collects: 0. Wins: 0.
Game ended at: 2016/11/28 19:50:56

Game started
Game ID: 786366162 1/2 (PRR) Lakhey (Short) - 2 (Hold'em)
Seat 5 is the button
Seat 1: IlxxxlI (40).
Seat 2: 38979 (103).
Seat 3: sheenius81 (52.70).
Seat 4: brokenlucks (209.18).
Seat 5: GamblerPaul (40).
Seat 6: gfclbv (115).
Player gfclbv has small blind (1)
Player IlxxxlI has big blind (2)
Player IlxxxlI received card: [Jd]
Player IlxxxlI received card: [Qc]
Player 38979 folds
Player sheenius81 raises (4)
Player brokenlucks folds
Player GamblerPaul folds
Player gfclbv folds
Player IlxxxlI calls (2)
*** FLOP ***: [Qh 5s 2h]
Player IlxxxlI checks
Player sheenius81 bets (5.70)
Player IlxxxlI calls (5.70)
*** TURN ***: [Qh 5s 2h] [Js]
Player IlxxxlI checks
Player sheenius81 bets (12.92)
Player IlxxxlI allin (30.30)
Player sheenius81 calls (17.38)
*** RIVER ***: [Qh 5s 2h Js] [Kh]
------ Summary ------
Pot: 78. Rake 2.76. JP fee 0.24
Board: [Qh 5s 2h Js Kh]
Player IlxxxlI shows: Two pairs. Qs and Js [Jd Qc]. Bets: 40. Collects: 0. Loses: 40.
Player 38979 does not show cards.Bets: 0. Collects: 0. Wins: 0.
*Player sheenius81 shows: Flush, A high [Ah 5h]. Bets: 40. Collects: 78. Wins: 38.
Player brokenlucks does not show cards.Bets: 0. Collects: 0. Wins: 0.
Player GamblerPaul does not show cards.Bets: 0. Collects: 0. Wins: 0.
Player gfclbv does not show cards.Bets: 1. Collects: 0. Loses: 1.
Game ended at: 2016/11/28 19:51:37

Game started
Game ID: 786366138 1/2 (PRR) Lakhey (Short) (Hold'em)
Seat 4 is the button
Seat 1: IlxxxlI (40).
Seat 2: 38979 (225.72).
Seat 3: BBDub27 (102).
Seat 4: Wollverin (100).
Seat 5: meandkids (122.48).
Seat 6: gfclbv (158).
Player meandkids has small blind (1)
Player gfclbv sitting out
Player IlxxxlI has big blind (2)
Player IlxxxlI received card: [10h]
Player IlxxxlI received card: [Qc]
Player 38979 folds
Player BBDub27 folds
Player Wollverin raises (4)
Player meandkids folds
Player IlxxxlI calls (2)
*** FLOP ***: [Qd Kc 8c]
Player IlxxxlI checks
Player Wollverin bets (6)
Player IlxxxlI calls (6)
*** TURN ***: [Qd Kc 8c] [Ac]
Player IlxxxlI checks
Player Wollverin checks
*** RIVER ***: [Qd Kc 8c Ac] [3s]
Player IlxxxlI checks
Player Wollverin checks
Player IlxxxlI mucks cards
------ Summary ------
Pot: 19.95. Rake 0.81. JP fee 0.24
Board: [Qd Kc 8c Ac 3s]
Player IlxxxlI mucks (does not show: [10h Qc]). Bets: 10. Collects: 0. Loses: 10.
Player 38979 does not show cards.Bets: 0. Collects: 0. Wins: 0.
Player BBDub27 does not show cards.Bets: 0. Collects: 0. Wins: 0.
*Player Wollverin shows: One pair of Ks [7h Ks]. Bets: 10. Collects: 19.95. Wins: 9.95.
Player meandkids does not show cards.Bets: 1. Collects: 0. Loses: 1.
Player gfclbv does not show cards.Bets: 0. Collects: 0. Wins: 0.
Game ended at: 2016/11/28 19:51:38

Game started
Game ID: 786366119 0.25/0.50 (PRR) Gorgons - 3 (Hold'em)
Seat 4 is the button
Seat 1: Goomashroom (52.10).
Seat 2: allaebalaamballa (26.63).
Seat 3: RetardedGenius (54.12).
Seat 4: 38979 (50).
Seat 6: IlxxxlI (24.31).
Player IlxxxlI has small blind (0.25)
Player Goomashroom has big blind (0.50)
Player IlxxxlI received card: [Kh]
Player IlxxxlI received card: [Ks]
Player allaebalaamballa folds
Player RetardedGenius folds
Player 38979 folds
Player IlxxxlI raises (1)
Player Goomashroom folds
Uncalled bet (0.75) returned to IlxxxlI
Player IlxxxlI mucks cards
------ Summary ------
Pot: 1. Rake 0
Player Goomashroom does not show cards.Bets: 0.50. Collects: 0. Loses: 0.50.
Player allaebalaamballa does not show cards.Bets: 0. Collects: 0. Wins: 0.
Player RetardedGenius does not show cards.Bets: 0. Collects: 0. Wins: 0.
Player 38979 does not show cards.Bets: 0. Collects: 0. Wins: 0.
*Player IlxxxlI mucks (does not show cards). Bets: 0.50. Collects: 1. Wins: 0.50.
Game ended at: 2016/11/28 19:50:39

Game started
Game ID: 786366114 0.25/0.50 (PRR) Gorgons - 8 (Hold'em)
Seat 1 is the button
Seat 1: legenda99 (103.56).
Seat 3: Goomashroom (54.92).
Seat 4: lovecola (50.75).
Seat 5: IlxxxlI (20).
Seat 6: caballeroXXX (126.71).
Player Goomashroom has small blind (0.25)
Player lovecola has big blind (0.50)
Player IlxxxlI received card: [3h]
Player IlxxxlI received card: [7d]
Player IlxxxlI folds
Player caballeroXXX folds
Player legenda99 raises (1)
Player Goomashroom raises (3.25)
Player lovecola folds
Player legenda99 calls (2.50)
*** FLOP ***: [6c 2h 2s]
Player Goomashroom bets (4.16)
Player legenda99 calls (4.16)
*** TURN ***: [6c 2h 2s] [7h]
Player Goomashroom checks
Player legenda99 checks
*** RIVER ***: [6c 2h 2s 7h] [10h]
Player Goomashroom checks
Player legenda99 checks
Player Goomashroom mucks cards
------ Summary ------
Pot: 15.03. Rake 0.55. JP fee 0.24
Board: [6c 2h 2s 7h 10h]
*Player legenda99 shows: Two pairs. 4s and 2s [4c 4h]. Bets: 7.66. Collects: 15.03. Wins: 7.37.
Player Goomashroom mucks (does not show cards). Bets: 7.66. Collects: 0. Loses: 7.66.
Player lovecola does not show cards.Bets: 0.50. Collects: 0. Loses: 0.50.
Player IlxxxlI does not show cards.Bets: 0. Collects: 0. Wins: 0.
Player caballeroXXX does not show cards.Bets: 0. Collects: 0. Wins: 0.
Game ended at: 2016/11/28 19:52:1

Game started
Game ID: 786366108 0.25/0.50 (PRR) Gorgons - 2 (Hold'em)
Seat 4 is the button
Seat 1: DonkReaper (68.14).
Seat 2: legenda99 (122.56).
Seat 3: Goomashroom (71.98).
Seat 4: IlxxxlI (23.60).
Seat 6: caballeroXXX (58.46).
Player caballeroXXX has small blind (0.25)
Player DonkReaper has big blind (0.50)
Player IlxxxlI received card: [6h]
Player IlxxxlI received card: [Qs]
Player legenda99 folds
Player Goomashroom raises (1.25)
Player IlxxxlI folds
Player caballeroXXX folds
Player DonkReaper folds
Uncalled bet (0.75) returned to Goomashroom
Player Goomashroom mucks cards
------ Summary ------
Pot: 1.25. Rake 0
Player DonkReaper does not show cards.Bets: 0.50. Collects: 0. Loses: 0.50.
Player legenda99 does not show cards.Bets: 0. Collects: 0. Wins: 0.
*Player Goomashroom mucks (does not show cards). Bets: 0.50. Collects: 1.25. Wins: 0.75.
Player IlxxxlI does not show cards.Bets: 0. Collects: 0. Wins: 0.
Player caballeroXXX does not show cards.Bets: 0.25. Collects: 0. Loses: 0.25.
Game ended at: 2016/11/28 19:50:31

Game started
Game ID: 786366032 1/2 (PRR) Lakhey (Short) (Hold'em)
Seat 3 is the button
Seat 1: IlxxxlI (40).
Seat 2: 38979 (225.72).
Seat 3: BBDub27 (102).
Seat 4: Wollverin (101).
Seat 5: meandkids (202.48).
Seat 6: gfclbv (80).
Player Wollverin has small blind (1)
Player meandkids has big blind (2)
Player IlxxxlI received card: [6c]
Player IlxxxlI received card: [8s]
Player gfclbv raises (4)
Player IlxxxlI folds
Player 38979 folds
Player BBDub27 folds
Player Wollverin folds
Player meandkids raises (10)
Player gfclbv allin (76)
Player meandkids calls (68)
*** FLOP ***: [3s 7s 3d]
*** TURN ***: [3s 7s 3d] [Ac]
*** RIVER ***: [3s 7s 3d Ac] [9h]
------ Summary ------
Pot: 158. Rake 2.76. JP fee 0.24
Board: [3s 7s 3d Ac 9h]
Player IlxxxlI does not show cards.Bets: 0. Collects: 0. Wins: 0.
Player 38979 does not show cards.Bets: 0. Collects: 0. Wins: 0.
Player BBDub27 does not show cards.Bets: 0. Collects: 0. Wins: 0.
Player Wollverin does not show cards.Bets: 1. Collects: 0. Loses: 1.
Player meandkids shows: Two pairs. 6s and 3s [6d 6h]. Bets: 80. Collects: 0. Loses: 80.
*Player gfclbv shows: Two pairs. As and 3s [Ad Qh]. Bets: 80. Collects: 158. Wins: 78.
Game ended at: 2016/11/28 19:50:19

Game started
Game ID: 786366031 0.25/0.50 (PRR) Gorgons - 8 (Hold'em)
Seat 6 is the button
Seat 1: legenda99 (103.81).
Seat 3: Goomashroom (55.42).
Seat 4: lovecola (50).
Seat 5: IlxxxlI (20).
Seat 6: caballeroXXX (126.71).
Player legenda99 has small blind (0.25)
Player Goomashroom has big blind (0.50)
Player IlxxxlI received card: [2s]
Player IlxxxlI received card: [6c]
Player lovecola raises (1.50)
Player IlxxxlI folds
Player caballeroXXX folds
Player legenda99 folds
Player Goomashroom folds
Uncalled bet (1) returned to lovecola
Player lovecola mucks cards
------ Summary ------
Pot: 1.25. Rake 0
Player legenda99 does not show cards.Bets: 0.25. Collects: 0. Loses: 0.25.
Player Goomashroom does not show cards.Bets: 0.50. Collects: 0. Loses: 0.50.
*Player lovecola mucks (does not show cards). Bets: 0.50. Collects: 1.25. Wins: 0.75.
Player IlxxxlI does not show cards.Bets: 0. Collects: 0. Wins: 0.
Player caballeroXXX does not show cards.Bets: 0. Collects: 0. Wins: 0.
Game ended at: 2016/11/28 19:50:11

Game started
Game ID: 786366010 0.25/0.50 (PRR) Gorgons - 3 (Hold'em)
Seat 3 is the button
Seat 1: Goomashroom (52.10).
Seat 2: allaebalaamballa (26.63).
Seat 3: RetardedGenius (52.29).
Seat 4: 38979 (50.25).
Seat 6: IlxxxlI (24.81).
Player 38979 has small blind (0.25)
Player IlxxxlI has big blind (0.50)
Player IlxxxlI received card: [Kc]
Player IlxxxlI received card: [5h]
Player Goomashroom folds
Player allaebalaamballa folds
Player RetardedGenius raises (1.50)
Player 38979 calls (1.25)
Player IlxxxlI folds
*** FLOP ***: [Ac 6c Jd]
Player 38979 checks
Player RetardedGenius bets (1.66)
Player 38979 folds
Uncalled bet (1.66) returned to RetardedGenius
Player RetardedGenius mucks cards
------ Summary ------
Pot: 3.33. Rake 0.13. JP fee 0.04
Board: [Ac 6c Jd]
Player Goomashroom does not show cards.Bets: 0. Collects: 0. Wins: 0.
Player allaebalaamballa does not show cards.Bets: 0. Collects: 0. Wins: 0.
*Player RetardedGenius mucks (does not show cards). Bets: 1.50. Collects: 3.33. Wins: 1.83.
Player 38979 does not show cards.Bets: 1.50. Collects: 0. Loses: 1.50.
Player IlxxxlI does not show cards.Bets: 0.50. Collects: 0. Loses: 0.50.
Game ended at: 2016/11/28 19:50:13

Game started
Game ID: 786365992 0.25/0.50 (PRR) Garuda - 3 (Hold'em)
Seat 8 is the button
Seat 5: legenda99 (102.98).
Seat 8: allaebalaamballa (70.91).
Seat 9: IlxxxlI (28.85).
Player IlxxxlI has small blind (0.25)
Player legenda99 has big blind (0.50)
Player IlxxxlI received card: [8d]
Player IlxxxlI received card: [7h]
Player allaebalaamballa folds
Player IlxxxlI folds
Uncalled bet (0.25) returned to legenda99
Player legenda99 mucks cards
------ Summary ------
Pot: 0.50. Rake 0
*Player legenda99 mucks (does not show cards). Bets: 0.25. Collects: 0.50. Wins: 0.25.
Player allaebalaamballa does not show cards.Bets: 0. Collects: 0. Wins: 0.
Player IlxxxlI does not show cards.Bets: 0.25. Collects: 0. Loses: 0.25.
Game ended at: 2016/11/28 19:49:44

Game started
Game ID: 786365939 0.25/0.50 (PRR) Gorgons - 3 (Hold'em)
Seat 2 is the button
Seat 1: Goomashroom (52.10).
Seat 2: allaebalaamballa (26.63).
Seat 3: RetardedGenius (52.54).
Seat 4: 38979 (50.75).
Seat 6: IlxxxlI (24.06).
Player RetardedGenius has small blind (0.25)
Player 38979 has big blind (0.50)
Player IlxxxlI received card: [Ac]
Player IlxxxlI received card: [8c]
Player IlxxxlI raises (1)
Player Goomashroom folds
Player allaebalaamballa folds
Player RetardedGenius folds
Player 38979 folds
Uncalled bet (0.50) returned to IlxxxlI
Player IlxxxlI mucks cards
------ Summary ------
Pot: 1.25. Rake 0
Player Goomashroom does not show cards.Bets: 0. Collects: 0. Wins: 0.
Player allaebalaamballa does not show cards.Bets: 0. Collects: 0. Wins: 0.
Player RetardedGenius does not show cards.Bets: 0.25. Collects: 0. Loses: 0.25.
Player 38979 does not show cards.Bets: 0.50. Collects: 0. Loses: 0.50.
*Player IlxxxlI mucks (does not show cards). Bets: 0.50. Collects: 1.25. Wins: 0.75.
Game ended at: 2016/11/28 19:49:39

Game started
Game ID: 786365913 0.25/0.50 (PRR) Gorgons - 2 (Hold'em)
Seat 3 is the button
Seat 1: DonkReaper (68.14).
Seat 2: legenda99 (122.56).
Seat 3: Goomashroom (81.11).
Seat 4: IlxxxlI (23.85).
Seat 6: caballeroXXX (50).
Player IlxxxlI has small blind (0.25)
Player caballeroXXX has big blind (0.50)
Player IlxxxlI received card: [Kc]
Player IlxxxlI received card: [4s]
Player DonkReaper folds
Player legenda99 folds
Player Goomashroom raises (1.13)
Player IlxxxlI folds
Player caballeroXXX calls (0.63)
*** FLOP ***: [8h 6c Ah]
Player caballeroXXX checks
Player Goomashroom checks
*** TURN ***: [8h 6c Ah] [5d]
Player caballeroXXX bets (2)
Player Goomashroom calls (2)
*** RIVER ***: [8h 6c Ah 5d] [3s]
Player caballeroXXX bets (6)
Player Goomashroom calls (6)
Player Goomashroom mucks cards
------ Summary ------
Pot: 17.59. Rake 0.68. JP fee 0.24
Board: [8h 6c Ah 5d 3s]
Player DonkReaper does not show cards.Bets: 0. Collects: 0. Wins: 0.
Player legenda99 does not show cards.Bets: 0. Collects: 0. Wins: 0.
Player Goomashroom mucks (does not show cards). Bets: 9.13. Collects: 0. Loses: 9.13.
Player IlxxxlI does not show cards.Bets: 0.25. Collects: 0. Loses: 0.25.
*Player caballeroXXX shows: Three Of Kind of 6s [6s 6h]. Bets: 9.13. Collects: 17.59. Wins: 8.46.
Game ended at: 2016/11/28 19:50:7

Game started
Game ID: 786365909 1/2 (PRR) Lakhey (Short) (Hold'em)
Seat 2 is the button
Seat 1: IlxxxlI (40).
Seat 2: 38979 (225.72).
Seat 3: BBDub27 (103).
Seat 4: Wollverin (100).
Seat 5: meandkids (202.48).
Seat 6: gfclbv (80).
Player BBDub27 has small blind (1)
Player Wollverin has big blind (2)
Player IlxxxlI received card: [7d]
Player IlxxxlI received card: [Qd]
Player meandkids folds
Player gfclbv folds
Player IlxxxlI folds
Player 38979 folds
Player BBDub27 is timed out.
Player BBDub27 folds
Uncalled bet (1) returned to Wollverin
Player Wollverin mucks cards
------ Summary ------
Pot: 2. Rake 0
Player IlxxxlI does not show cards.Bets: 0. Collects: 0. Wins: 0.
Player 38979 does not show cards.Bets: 0. Collects: 0. Wins: 0.
Player BBDub27 does not show cards.Bets: 1. Collects: 0. Loses: 1.
*Player Wollverin mucks (does not show cards). Bets: 1. Collects: 2. Wins: 1.
Player meandkids does not show cards.Bets: 0. Collects: 0. Wins: 0.
Player gfclbv does not show cards.Bets: 0. Collects: 0. Wins: 0.
Game ended at: 2016/11/28 19:49:46

Game started
Game ID: 786365873 0.25/0.50 (PRR) Gorgons - 3 (Hold'em)
Seat 1 is the button
Seat 1: Goomashroom (51.35).
Seat 2: allaebalaamballa (26.88).
Seat 3: RetardedGenius (53.04).
Seat 4: 38979 (50.75).
Seat 6: IlxxxlI (24.06).
Player allaebalaamballa has small blind (0.25)
Player RetardedGenius has big blind (0.50)
Player IlxxxlI received card: [Ac]
Player IlxxxlI received card: [3s]
Player 38979 folds
Player IlxxxlI folds
Player Goomashroom raises (1.13)
Player allaebalaamballa folds
Player RetardedGenius folds
Uncalled bet (0.63) returned to Goomashroom
Player Goomashroom mucks cards
------ Summary ------
Pot: 1.25. Rake 0
*Player Goomashroom mucks (does not show cards). Bets: 0.50. Collects: 1.25. Wins: 0.75.
Player allaebalaamballa does not show cards.Bets: 0.25. Collects: 0. Loses: 0.25.
Player RetardedGenius does not show cards.Bets: 0.50. Collects: 0. Loses: 0.50.
Player 38979 does not show cards.Bets: 0. Collects: 0. Wins: 0.
Player IlxxxlI does not show cards.Bets: 0. Collects: 0. Wins: 0.
Game ended at: 2016/11/28 19:49:17

Game started
Game ID: 786365821 0.25/0.50 (PRR) Garuda - 3 (Hold'em)
Seat 5 is the button
Seat 1: 6betThreat (24.31).
Seat 5: legenda99 (102.98).
Seat 8: allaebalaamballa (48.10).
Seat 9: IlxxxlI (29.35).
Player allaebalaamballa has small blind (0.25)
Player IlxxxlI has big blind (0.50)
Player IlxxxlI received card: [4c]
Player IlxxxlI received card: [8c]
Player 6betThreat raises (1)
Player legenda99 folds
Player allaebalaamballa raises (4.25)
Player IlxxxlI folds
Player 6betThreat calls (3.50)
*** FLOP ***: [Jh 4s Js]
Player allaebalaamballa checks
Player 6betThreat checks
*** TURN ***: [Jh 4s Js] [7s]
Player allaebalaamballa checks
Player 6betThreat bets (9)
Player allaebalaamballa calls (9)
*** RIVER ***: [Jh 4s Js 7s] [8s]
Player allaebalaamballa bets (11.75)
Player 6betThreat allin (10.81)
Uncalled bet (0.94) returned to allaebalaamballa
------ Summary ------
Pot: 47.12. Rake 1.76. JP fee 0.24
Board: [Jh 4s Js 7s 8s]
Player 6betThreat shows: Flush, K high [Ks 9s]. Bets: 24.31. Collects: 0. Loses: 24.31.
Player legenda99 does not show cards.Bets: 0. Collects: 0. Wins: 0.
*Player allaebalaamballa shows: Flush, A high [Qc As]. Bets: 24.31. Collects: 47.12. Wins: 22.81.
Player IlxxxlI does not show cards.Bets: 0.50. Collects: 0. Loses: 0.50.
Game ended at: 2016/11/28 19:49:34

Game started
Game ID: 786365819 0.25/0.50 (PRR) Gorgons - 2 (Hold'em)
Seat 2 is the button
Seat 1: DonkReaper (67.39).
Seat 2: legenda99 (122.56).
Seat 3: Goomashroom (81.36).
Seat 4: IlxxxlI (24.35).
Seat 5: in_ur_i (69.78).
Seat 6: caballeroXXX (50).
Player Goomashroom has small blind (0.25)
Player IlxxxlI has big blind (0.50)
Player IlxxxlI received card: [9d]
Player IlxxxlI received card: [Js]
Player in_ur_i folds
Player caballeroXXX folds
Player DonkReaper raises (1.50)
Player legenda99 folds
Player Goomashroom folds
Player IlxxxlI folds
Uncalled bet (1) returned to DonkReaper
Player DonkReaper mucks cards
------ Summary ------
Pot: 1.25. Rake 0
*Player DonkReaper mucks (does not show cards). Bets: 0.50. Collects: 1.25. Wins: 0.75.
Player legenda99 does not show cards.Bets: 0. Collects: 0. Wins: 0.
Player Goomashroom does not show cards.Bets: 0.25. Collects: 0. Loses: 0.25.
Player IlxxxlI does not show cards.Bets: 0.50. Collects: 0. Loses: 0.50.
Player in_ur_i does not show cards.Bets: 0. Collects: 0. Wins: 0.
Player caballeroXXX does not show cards.Bets: 0. Collects: 0. Wins: 0.
Game ended at: 2016/11/28 19:49:9

Game started
Game ID: 786365763 0.25/0.50 (PRR) Gorgons - 8 (Hold'em)
Seat 5 is the button
Seat 1: legenda99 (107.06).
Seat 2: in_ur_i (30.09).
Seat 3: Goomashroom (55.42).
Seat 4: lovecola (50).
Seat 5: IlxxxlI (20).
Seat 6: caballeroXXX (123.78).
Player caballeroXXX has small blind (0.25)
Player legenda99 has big blind (0.50)
Player IlxxxlI received card: [7h]
Player IlxxxlI received card: [Qc]
Player in_ur_i folds
Player Goomashroom folds
Player lovecola folds
Player IlxxxlI folds
Player caballeroXXX raises (1.25)
Player legenda99 calls (1)
*** FLOP ***: [3s 3c 4d]
Player caballeroXXX bets (1.75)
Player legenda99 calls (1.75)
*** TURN ***: [3s 3c 4d] [4c]
Player caballeroXXX bets (4.50)
Player legenda99 folds
Uncalled bet (4.50) returned to caballeroXXX
Player caballeroXXX mucks cards
------ Summary ------
Pot: 6.18. Rake 0.22. JP fee 0.10
Board: [3s 3c 4d 4c]
Player legenda99 does not show cards.Bets: 3.25. Collects: 0. Loses: 3.25.
Player in_ur_i does not show cards.Bets: 0. Collects: 0. Wins: 0.
Player Goomashroom does not show cards.Bets: 0. Collects: 0. Wins: 0.
Player lovecola does not show cards.Bets: 0. Collects: 0. Wins: 0.
Player IlxxxlI does not show cards.Bets: 0. Collects: 0. Wins: 0.
*Player caballeroXXX mucks (does not show cards). Bets: 3.25. Collects: 6.18. Wins: 2.93.
Game ended at: 2016/11/28 19:49:46

Game started
Game ID: 786365736 0.25/0.50 (PRR) Gorgons - 3 (Hold'em)
Seat 6 is the button
Seat 1: Goomashroom (50).
Seat 2: allaebalaamballa (28.38).
Seat 3: RetardedGenius (53.04).
Seat 4: 38979 (50.75).
Seat 6: IlxxxlI (24.06).
Player Goomashroom has small blind (0.25)
Player allaebalaamballa has big blind (0.50)
Player IlxxxlI received card: [7s]
Player IlxxxlI received card: [3d]
Player RetardedGenius folds
Player 38979 folds
Player IlxxxlI folds
Player Goomashroom raises (1.25)
Player allaebalaamballa calls (1)
*** FLOP ***: [4s Jc 5h]
Player Goomashroom bets (2)
Player allaebalaamballa folds
Uncalled bet (2) returned to Goomashroom
Player Goomashroom mucks cards
------ Summary ------
Pot: 2.85. Rake 0.11. JP fee 0.04
Board: [4s Jc 5h]
*Player Goomashroom mucks (does not show cards). Bets: 1.50. Collects: 2.85. Wins: 1.35.
Player allaebalaamballa does not show cards.Bets: 1.50. Collects: 0. Loses: 1.50.
Player RetardedGenius does not show cards.Bets: 0. Collects: 0. Wins: 0.
Player 38979 does not show cards.Bets: 0. Collects: 0. Wins: 0.
Player IlxxxlI does not show cards.Bets: 0. Collects: 0. Wins: 0.
Game ended at: 2016/11/28 19:48:56

Game started
Game ID: 786365723 1/2 (PRR) Lakhey (Short) (Hold'em)
Seat 1 is the button
Seat 1: IlxxxlI (40).
Seat 2: 38979 (226.72).
Seat 3: BBDub27 (105).
Seat 4: Wollverin (100).
Seat 5: meandkids (179.83).
Seat 6: gfclbv (85.30).
Player 38979 has small blind (1)
Player BBDub27 has big blind (2)
Player IlxxxlI received card: [3s]
Player IlxxxlI received card: [8c]
Player Wollverin folds
Player meandkids raises (8)
Player gfclbv raises (14)
Player IlxxxlI folds
Player 38979 folds
Player BBDub27 folds
Player meandkids calls (6)
*** FLOP ***: [10c Kd 3d]
Player meandkids checks
Player gfclbv bets (8)
Player meandkids calls (8)
*** TURN ***: [10c Kd 3d] [10h]
Player meandkids checks
Player gfclbv checks
*** RIVER ***: [10c Kd 3d 10h] [Qs]
Player meandkids checks
Player gfclbv checks
Player gfclbv mucks cards
------ Summary ------
Pot: 44.65. Rake 2.11. JP fee 0.24
Board: [10c Kd 3d 10h Qs]
Player IlxxxlI does not show cards.Bets: 0. Collects: 0. Wins: 0.
Player 38979 does not show cards.Bets: 1. Collects: 0. Loses: 1.
Player BBDub27 does not show cards.Bets: 2. Collects: 0. Loses: 2.
Player Wollverin does not show cards.Bets: 0. Collects: 0. Wins: 0.
*Player meandkids shows: Two pairs. Qs and 10s [Qc Js]. Bets: 22. Collects: 44.65. Wins: 22.65.
Player gfclbv mucks (does not show cards). Bets: 22. Collects: 0. Loses: 22.
Game ended at: 2016/11/28 19:49:7

Game started
Game ID: 786365681 0.25/0.50 (PRR) Gorgons - 8 (Hold'em)
Seat 4 is the button
Seat 1: legenda99 (106.31).
Seat 2: in_ur_i (30.09).
Seat 3: Goomashroom (55.42).
Seat 4: lovecola (50).
Seat 5: IlxxxlI (20.25).
Seat 6: caballeroXXX (124.28).
Player IlxxxlI has small blind (0.25)
Player caballeroXXX has big blind (0.50)
Player IlxxxlI received card: [5h]
Player IlxxxlI received card: [Qh]
Player legenda99 raises (1.50)
Player in_ur_i folds
Player Goomashroom folds
Player lovecola folds
Player IlxxxlI folds
Player caballeroXXX folds
Uncalled bet (1) returned to legenda99
Player legenda99 mucks cards
------ Summary ------
Pot: 1.25. Rake 0
*Player legenda99 mucks (does not show cards). Bets: 0.50. Collects: 1.25. Wins: 0.75.
Player in_ur_i does not show cards.Bets: 0. Collects: 0. Wins: 0.
Player Goomashroom does not show cards.Bets: 0. Collects: 0. Wins: 0.
Player lovecola does not show cards.Bets: 0. Collects: 0. Wins: 0.
Player IlxxxlI does not show cards.Bets: 0.25. Collects: 0. Loses: 0.25.
Player caballeroXXX does not show cards.Bets: 0.50. Collects: 0. Loses: 0.50.
Game ended at: 2016/11/28 19:48:20

Game started
Game ID: 786365640 0.25/0.50 (PRR) Gorgons - 3 (Hold'em)
Seat 4 is the button
Seat 1: Goomashroom (50).
Seat 2: allaebalaamballa (28.38).
Seat 3: RetardedGenius (53.04).
Seat 4: 38979 (50).
Seat 6: IlxxxlI (24.31).
Player IlxxxlI has small blind (0.25)
Player Goomashroom has big blind (0.50)
Player IlxxxlI received card: [5h]
Player IlxxxlI received card: [Kd]
Player allaebalaamballa folds
Player RetardedGenius folds
Player 38979 raises (1)
Player IlxxxlI folds
Player Goomashroom folds
Uncalled bet (0.50) returned to 38979
Player 38979 mucks cards
------ Summary ------
Pot: 1.25. Rake 0
Player Goomashroom does not show cards.Bets: 0.50. Collects: 0. Loses: 0.50.
Player allaebalaamballa does not show cards.Bets: 0. Collects: 0. Wins: 0.
Player RetardedGenius does not show cards.Bets: 0. Collects: 0. Wins: 0.
*Player 38979 mucks (does not show cards). Bets: 0.50. Collects: 1.25. Wins: 0.75.
Player IlxxxlI does not show cards.Bets: 0.25. Collects: 0. Loses: 0.25.
Game ended at: 2016/11/28 19:48:10

Game started
Game ID: 786365613 1/2 (PRR) Lakhey (Short) (Hold'em)
Seat 6 is the button
Seat 1: IlxxxlI (40).
Seat 2: 38979 (228.72).
Seat 3: BBDub27 (102).
Seat 4: Wollverin (100).
Seat 5: meandkids (179.83).
Seat 6: gfclbv (85.30).
Player IlxxxlI has small blind (1)
Player 38979 has big blind (2)
Player IlxxxlI received card: [5d]
Player IlxxxlI received card: [8h]
Player BBDub27 raises (6)
Player Wollverin folds
Player meandkids folds
Player gfclbv folds
Player IlxxxlI folds
Player 38979 folds
Uncalled bet (4) returned to BBDub27
Player BBDub27 mucks cards
------ Summary ------
Pot: 5. Rake 0
Player IlxxxlI does not show cards.Bets: 1. Collects: 0. Loses: 1.
Player 38979 does not show cards.Bets: 2. Collects: 0. Loses: 2.
*Player BBDub27 mucks (does not show cards). Bets: 2. Collects: 5. Wins: 3.
Player Wollverin does not show cards.Bets: 0. Collects: 0. Wins: 0.
Player meandkids does not show cards.Bets: 0. Collects: 0. Wins: 0.
Player gfclbv does not show cards.Bets: 0. Collects: 0. Wins: 0.
Game ended at: 2016/11/28 19:48:8

Game started
Game ID: 786365601 0.25/0.50 (PRR) Gorgons - 8 (Hold'em)
Seat 3 is the button
Seat 1: legenda99 (106.31).
Seat 2: in_ur_i (30.09).
Seat 3: Goomashroom (54.67).
Seat 4: lovecola (50).
Seat 5: IlxxxlI (20.75).
Seat 6: caballeroXXX (124.28).
Player lovecola has small blind (0.25)
Player IlxxxlI has big blind (0.50)
Player IlxxxlI received card: [Kc]
Player IlxxxlI received card: [6d]
Player caballeroXXX folds
Player legenda99 folds
Player in_ur_i folds
Player Goomashroom raises (1.13)
Player lovecola folds
Player IlxxxlI folds
Uncalled bet (0.63) returned to Goomashroom
Player Goomashroom mucks cards
------ Summary ------
Pot: 1.25. Rake 0
Player legenda99 does not show cards.Bets: 0. Collects: 0. Wins: 0.
Player in_ur_i does not show cards.Bets: 0. Collects: 0. Wins: 0.
*Player Goomashroom mucks (does not show cards). Bets: 0.50. Collects: 1.25. Wins: 0.75.
Player lovecola does not show cards.Bets: 0.25. Collects: 0. Loses: 0.25.
Player IlxxxlI does not show cards.Bets: 0.50. Collects: 0. Loses: 0.50.
Player caballeroXXX does not show cards.Bets: 0. Collects: 0. Wins: 0.
Game ended at: 2016/11/28 19:47:50

Game started
Game ID: 786365583 0.25/0.50 (PRR) Gorgons - 3 (Hold'em)
Seat 3 is the button
Seat 2: allaebalaamballa (28.38).
Seat 3: RetardedGenius (53.04).
Seat 4: 38979 (50.25).
Seat 6: IlxxxlI (24.06).
Player 38979 has small blind (0.25)
Player IlxxxlI has big blind (0.50)
Player IlxxxlI received card: [7d]
Player IlxxxlI received card: [Ks]
Player allaebalaamballa folds
Player RetardedGenius folds
Player 38979 folds
Uncalled bet (0.25) returned to IlxxxlI
Player IlxxxlI mucks cards
------ Summary ------
Pot: 0.50. Rake 0
Player allaebalaamballa does not show cards.Bets: 0. Collects: 0. Wins: 0.
Player RetardedGenius does not show cards.Bets: 0. Collects: 0. Wins: 0.
Player 38979 does not show cards.Bets: 0.25. Collects: 0. Loses: 0.25.
*Player IlxxxlI mucks (does not show cards). Bets: 0.25. Collects: 0.50. Wins: 0.25.
Game ended at: 2016/11/28 19:47:39

Game started
Game ID: 786365582 0.25/0.50 (PRR) Gorgons - 2 (Hold'em)
Seat 1 is the button
Seat 1: DonkReaper (67.39).
Seat 2: legenda99 (122.81).
Seat 3: Goomashroom (81.86).
Seat 4: IlxxxlI (24.35).
Seat 5: in_ur_i (47.75).
Seat 6: caballeroXXX (50.75).
Player legenda99 has small blind (0.25)
Player Goomashroom has big blind (0.50)
Player IlxxxlI received card: [9s]
Player IlxxxlI received card: [Kc]
Player IlxxxlI folds
Player in_ur_i raises (1.50)
Player caballeroXXX calls (1.50)
Player DonkReaper folds
Player legenda99 folds
Player Goomashroom folds
*** FLOP ***: [10h Kd As]
Player in_ur_i bets (2.38)
Player caballeroXXX calls (2.38)
*** TURN ***: [10h Kd As] [10d]
Player in_ur_i bets (4.04)
Player caballeroXXX raises (8.08)
Player in_ur_i calls (4.04)
*** RIVER ***: [10h Kd As 10d] [2h]
Player in_ur_i bets (11.72)
Player caballeroXXX calls (11.72)
Player caballeroXXX mucks cards
------ Summary ------
Pot: 45.71. Rake 2.16. JP fee 0.24
Board: [10h Kd As 10d 2h]
Player DonkReaper does not show cards.Bets: 0. Collects: 0. Wins: 0.
Player legenda99 does not show cards.Bets: 0.25. Collects: 0. Loses: 0.25.
Player Goomashroom does not show cards.Bets: 0.50. Collects: 0. Loses: 0.50.
Player IlxxxlI does not show cards.Bets: 0. Collects: 0. Wins: 0.
*Player in_ur_i shows: Straight to A [Js Qd]. Bets: 23.68. Collects: 45.71. Wins: 22.03.
Player caballeroXXX mucks (does not show cards). Bets: 23.68. Collects: 0. Loses: 23.68.
Game ended at: 2016/11/28 19:48:35

Game started
Game ID: 786365556 0.25/0.50 (PRR) Gorgons - 3 (Hold'em)
Seat 2 is the button
Seat 2: allaebalaamballa (28.38).
Seat 3: RetardedGenius (53.29).
Seat 4: 38979 (50).
Seat 6: IlxxxlI (24.06).
Player RetardedGenius has small blind (0.25)
Player 38979 has big blind (0.50)
Player IlxxxlI received card: [8s]
Player IlxxxlI received card: [7h]
Player IlxxxlI folds
Player allaebalaamballa folds
Player RetardedGenius folds
Uncalled bet (0.25) returned to 38979
Player 38979 mucks cards
------ Summary ------
Pot: 0.50. Rake 0
Player allaebalaamballa does not show cards.Bets: 0. Collects: 0. Wins: 0.
Player RetardedGenius does not show cards.Bets: 0.25. Collects: 0. Loses: 0.25.
*Player 38979 mucks (does not show cards). Bets: 0.25. Collects: 0.50. Wins: 0.25.
Player IlxxxlI does not show cards.Bets: 0. Collects: 0. Wins: 0.
Game ended at: 2016/11/28 19:47:20

Game started
Game ID: 786365508 0.25/0.50 (PRR) Gorgons - 2 (Hold'em)
Seat 6 is the button
Seat 1: DonkReaper (67.64).
Seat 2: legenda99 (123.31).
Seat 3: Goomashroom (81.86).
Seat 4: IlxxxlI (24.35).
Seat 5: in_ur_i (47.75).
Seat 6: caballeroXXX (50).
Player DonkReaper has small blind (0.25)
Player legenda99 has big blind (0.50)
Player IlxxxlI received card: [Kc]
Player IlxxxlI received card: [8h]
Player Goomashroom folds
Player IlxxxlI folds
Player in_ur_i folds
Player caballeroXXX raises (1)
Player DonkReaper folds
Player legenda99 folds
Uncalled bet (0.50) returned to caballeroXXX
Player caballeroXXX mucks cards
------ Summary ------
Pot: 1.25. Rake 0
Player DonkReaper does not show cards.Bets: 0.25. Collects: 0. Loses: 0.25.
Player legenda99 does not show cards.Bets: 0.50. Collects: 0. Loses: 0.50.
Player Goomashroom does not show cards.Bets: 0. Collects: 0. Wins: 0.
Player IlxxxlI does not show cards.Bets: 0. Collects: 0. Wins: 0.
Player in_ur_i does not show cards.Bets: 0. Collects: 0. Wins: 0.
*Player caballeroXXX mucks (does not show cards). Bets: 0.50. Collects: 1.25. Wins: 0.75.
Game ended at: 2016/11/28 19:47:19

Game started
Game ID: 786365480 0.25/0.50 (PRR) Gorgons - 3 (Hold'em)
Seat 6 is the button
Seat 2: allaebalaamballa (27.25).
Seat 3: RetardedGenius (54.54).
Seat 4: 38979 (50).
Seat 6: IlxxxlI (24.06).
Player allaebalaamballa has small blind (0.25)
Player RetardedGenius has big blind (0.50)
Player IlxxxlI received card: [7d]
Player IlxxxlI received card: [2h]
Player 38979 folds
Player IlxxxlI folds
Player allaebalaamballa raises (1)
Player RetardedGenius calls (0.75)
*** FLOP ***: [4d 9c 9d]
Player allaebalaamballa bets (1.05)
Player RetardedGenius folds
Uncalled bet (1.05) returned to allaebalaamballa
Player allaebalaamballa mucks cards
------ Summary ------
Pot: 2.38. Rake 0.08. JP fee 0.04
Board: [4d 9c 9d]
*Player allaebalaamballa mucks (does not show cards). Bets: 1.25. Collects: 2.38. Wins: 1.13.
Player RetardedGenius does not show cards.Bets: 1.25. Collects: 0. Loses: 1.25.
Player 38979 does not show cards.Bets: 0. Collects: 0. Wins: 0.
Player IlxxxlI does not show cards.Bets: 0. Collects: 0. Wins: 0.
Game ended at: 2016/11/28 19:47:11

Game started
Game ID: 786365472 1/2 (PRR) Lakhey (Short) (Hold'em)
Seat 5 is the button
Seat 1: IlxxxlI (40).
Seat 2: 38979 (228.72).
Seat 3: BBDub27 (102).
Seat 4: Wollverin (100).
Seat 5: meandkids (176.83).
Seat 6: gfclbv (86.30).
Player gfclbv has small blind (1)
Player IlxxxlI has big blind (2)
Player IlxxxlI received card: [3c]
Player IlxxxlI received card: [Ad]
Player 38979 folds
Player BBDub27 is timed out.
Player BBDub27 folds
Player Wollverin folds
Player meandkids raises (10)
Player gfclbv folds
Player IlxxxlI folds
Uncalled bet (8) returned to meandkids
Player meandkids mucks cards
------ Summary ------
Pot: 5. Rake 0
Player IlxxxlI does not show cards.Bets: 2. Collects: 0. Loses: 2.
Player 38979 does not show cards.Bets: 0. Collects: 0. Wins: 0.
Player BBDub27 does not show cards.Bets: 0. Collects: 0. Wins: 0.
Player Wollverin does not show cards.Bets: 0. Collects: 0. Wins: 0.
*Player meandkids mucks (does not show cards). Bets: 2. Collects: 5. Wins: 3.
Player gfclbv does not show cards.Bets: 1. Collects: 0. Loses: 1.
Game ended at: 2016/11/28 19:47:29

Game started
Game ID: 786365448 0.25/0.50 (PRR) Gorgons - 8 (Hold'em)
Seat 2 is the button
Seat 1: legenda99 (104.72).
Seat 2: in_ur_i (30.09).
Seat 3: Goomashroom (54.92).
Seat 4: lovecola (50.50).
Seat 5: IlxxxlI (20.75).
Seat 6: caballeroXXX (124.28).
Player Goomashroom has small blind (0.25)
Player lovecola has big blind (0.50)
Player IlxxxlI received card: [Kd]
Player IlxxxlI received card: [9d]
Player IlxxxlI folds
Player caballeroXXX folds
Player legenda99 raises (1.50)
Player in_ur_i folds
Player Goomashroom folds
Player lovecola calls (1)
*** FLOP ***: [Kc 8d 5s]
Player lovecola checks
Player legenda99 bets (1.54)
Player lovecola folds
Uncalled bet (1.54) returned to legenda99
Player legenda99 mucks cards
------ Summary ------
Pot: 3.09. Rake 0.12. JP fee 0.04
Board: [Kc 8d 5s]
*Player legenda99 mucks (does not show cards). Bets: 1.50. Collects: 3.09. Wins: 1.59.
Player in_ur_i does not show cards.Bets: 0. Collects: 0. Wins: 0.
Player Goomashroom does not show cards.Bets: 0.25. Collects: 0. Loses: 0.25.
Player lovecola does not show cards.Bets: 1.50. Collects: 0. Loses: 1.50.
Player IlxxxlI does not show cards.Bets: 0. Collects: 0. Wins: 0.
Player caballeroXXX does not show cards.Bets: 0. Collects: 0. Wins: 0.
Game ended at: 2016/11/28 19:47:25

Game started
Game ID: 786365418 0.25/0.50 (PRR) Gorgons - 3 (Hold'em)
Seat 5 is the button
Seat 2: allaebalaamballa (27.75).
Seat 3: RetardedGenius (53.79).
Seat 4: 38979 (50).
Seat 5: in_ur_i (100.13).
Seat 6: IlxxxlI (24.31).
Player IlxxxlI has small blind (0.25)
Player allaebalaamballa has big blind (0.50)
Player RetardedGenius straddle (1)
Player IlxxxlI received card: [5d]
Player IlxxxlI received card: [Kh]
Player 38979 folds
Player in_ur_i folds
Player IlxxxlI folds
Player allaebalaamballa folds
Uncalled bet (0.50) returned to RetardedGenius
Player RetardedGenius mucks cards
------ Summary ------
Pot: 1.25. Rake 0
Player allaebalaamballa does not show cards.Bets: 0.50. Collects: 0. Loses: 0.50.
*Player RetardedGenius mucks (does not show cards). Bets: 0.50. Collects: 1.25. Wins: 0.75.
Player 38979 does not show cards.Bets: 0. Collects: 0. Wins: 0.
Player in_ur_i does not show cards.Bets: 0. Collects: 0. Wins: 0.
Player IlxxxlI does not show cards.Bets: 0.25. Collects: 0. Loses: 0.25.
Game ended at: 2016/11/28 19:46:45

Game started
Game ID: 786365369 1/2 (PRR) Lakhey (Short) (Hold'em)
Seat 4 is the button
Seat 1: IlxxxlI (40).
Seat 2: 38979 (228.72).
Seat 3: BBDub27 (102).
Seat 4: Wollverin (100).
Seat 5: meandkids (183.83).
Seat 6: gfclbv (80).
Player meandkids has small blind (1)
Player gfclbv has big blind (2)
Player IlxxxlI received card: [Jd]
Player IlxxxlI received card: [4h]
Player IlxxxlI folds
Player 38979 folds
Player BBDub27 folds
Player Wollverin folds
Player meandkids calls (1)
Player gfclbv raises (5)
Player meandkids calls (5)
*** FLOP ***: [Ac 3c Kc]
Player meandkids checks
Player gfclbv bets (6.65)
Player meandkids folds
Uncalled bet (6.65) returned to gfclbv
Player gfclbv mucks cards
------ Summary ------
Pot: 13.30. Rake 0.48. JP fee 0.22
Board: [Ac 3c Kc]
Player IlxxxlI does not show cards.Bets: 0. Collects: 0. Wins: 0.
Player 38979 does not show cards.Bets: 0. Collects: 0. Wins: 0.
Player BBDub27 does not show cards.Bets: 0. Collects: 0. Wins: 0.
Player Wollverin does not show cards.Bets: 0. Collects: 0. Wins: 0.
Player meandkids does not show cards.Bets: 7. Collects: 0. Loses: 7.
*Player gfclbv mucks (does not show cards). Bets: 7. Collects: 13.30. Wins: 6.30.
Game ended at: 2016/11/28 19:46:44

Game started
Game ID: 786365367 0.25/0.50 (PRR) Gorgons - 8 (Hold'em)
Seat 1 is the button
Seat 1: legenda99 (104.72).
Seat 2: in_ur_i (30.34).
Seat 3: Goomashroom (55.42).
Seat 4: lovecola (50.50).
Seat 5: IlxxxlI (20).
Seat 6: caballeroXXX (124.28).
Player in_ur_i has small blind (0.25)
Player Goomashroom has big blind (0.50)
Player IlxxxlI received card: [Kh]
Player IlxxxlI received card: [10h]
Player lovecola folds
Player IlxxxlI raises (1.75)
Player caballeroXXX folds
Player legenda99 folds
Player in_ur_i folds
Player Goomashroom folds
Uncalled bet (1.25) returned to IlxxxlI
Player IlxxxlI mucks cards
------ Summary ------
Pot: 1.25. Rake 0
Player legenda99 does not show cards.Bets: 0. Collects: 0. Wins: 0.
Player in_ur_i does not show cards.Bets: 0.25. Collects: 0. Loses: 0.25.
Player Goomashroom does not show cards.Bets: 0.50. Collects: 0. Loses: 0.50.
Player lovecola does not show cards.Bets: 0. Collects: 0. Wins: 0.
*Player IlxxxlI mucks (does not show cards). Bets: 0.50. Collects: 1.25. Wins: 0.75.
Player caballeroXXX does not show cards.Bets: 0. Collects: 0. Wins: 0.
Game ended at: 2016/11/28 19:46:34

Game started
Game ID: 786365348 0.25/0.50 (PRR) Gorgons - 3 (Hold'em)
Seat 4 is the button
Seat 2: allaebalaamballa (27).
Seat 3: RetardedGenius (53.79).
Seat 4: 38979 (50).
Seat 5: in_ur_i (100.38).
Seat 6: IlxxxlI (24.81).
Player in_ur_i has small blind (0.25)
Player IlxxxlI has big blind (0.50)
Player IlxxxlI received card: [9h]
Player IlxxxlI received card: [4h]
Player allaebalaamballa raises (1.10)
Player RetardedGenius folds
Player 38979 folds
Player in_ur_i folds
Player IlxxxlI folds
Uncalled bet (0.60) returned to allaebalaamballa
Player allaebalaamballa mucks cards
------ Summary ------
Pot: 1.25. Rake 0
*Player allaebalaamballa mucks (does not show cards). Bets: 0.50. Collects: 1.25. Wins: 0.75.
Player RetardedGenius does not show cards.Bets: 0. Collects: 0. Wins: 0.
Player 38979 does not show cards.Bets: 0. Collects: 0. Wins: 0.
Player in_ur_i does not show cards.Bets: 0.25. Collects: 0. Loses: 0.25.
Player IlxxxlI does not show cards.Bets: 0.50. Collects: 0. Loses: 0.50.
Game ended at: 2016/11/28 19:46:22

Game started
Game ID: 786365309 0.25/0.50 (PRR) Garuda - 3 (Hold'em)
Seat 3 is the button
Seat 1: 6betThreat (31.31).
Seat 3: shureg22 (64.27).
Seat 5: legenda99 (104.48).
Seat 8: allaebalaamballa (38.80).
Seat 9: IlxxxlI (31.10).
Player legenda99 has small blind (0.25)
Player allaebalaamballa has big blind (0.50)
Player IlxxxlI received card: [Qc]
Player IlxxxlI received card: [Kh]
Player IlxxxlI raises (1.75)
Player 6betThreat calls (1.75)
Player shureg22 folds
Player legenda99 folds
Player allaebalaamballa raises (6.50)
Player IlxxxlI folds
Player 6betThreat calls (5.25)
*** FLOP ***: [5c Ks 10h]
Player allaebalaamballa checks
Player 6betThreat checks
*** TURN ***: [5c Ks 10h] [5h]
Player allaebalaamballa bets (6.85)
Player 6betThreat folds
Uncalled bet (6.85) returned to allaebalaamballa
Player allaebalaamballa mucks cards
------ Summary ------
Pot: 15.20. Rake 0.56. JP fee 0.24
Board: [5c Ks 10h 5h]
Player 6betThreat does not show cards.Bets: 7. Collects: 0. Loses: 7.
Player shureg22 does not show cards.Bets: 0. Collects: 0. Wins: 0.
Player legenda99 does not show cards.Bets: 0.25. Collects: 0. Loses: 0.25.
*Player allaebalaamballa mucks (does not show cards). Bets: 7. Collects: 15.20. Wins: 8.20.
Player IlxxxlI does not show cards.Bets: 1.75. Collects: 0. Loses: 1.75.
Game ended at: 2016/11/28 19:46:53

Game started
Game ID: 786365275 0.25/0.50 (PRR) Gorgons - 3 (Hold'em)
Seat 3 is the button
Seat 2: allaebalaamballa (27).
Seat 3: RetardedGenius (53.04).
Seat 4: 38979 (50).
Seat 5: in_ur_i (100.88).
Seat 6: IlxxxlI (24.81).
Player 38979 has small blind (0.25)
Player in_ur_i has big blind (0.50)
Player IlxxxlI received card: [Kd]
Player IlxxxlI received card: [2d]
Player IlxxxlI folds
Player allaebalaamballa folds
Player RetardedGenius raises (1)
Player 38979 folds
Player in_ur_i folds
Uncalled bet (0.50) returned to RetardedGenius
Player RetardedGenius mucks cards
------ Summary ------
Pot: 1.25. Rake 0
Player allaebalaamballa does not show cards.Bets: 0. Collects: 0. Wins: 0.
*Player RetardedGenius mucks (does not show cards). Bets: 0.50. Collects: 1.25. Wins: 0.75.
Player 38979 does not show cards.Bets: 0.25. Collects: 0. Loses: 0.25.
Player in_ur_i does not show cards.Bets: 0.50. Collects: 0. Loses: 0.50.
Player IlxxxlI does not show cards.Bets: 0. Collects: 0. Wins: 0.
Game ended at: 2016/11/28 19:46:3

Game started
Game ID: 786365250 0.25/0.50 (PRR) Gorgons - 2 (Hold'em)
Seat 5 is the button
Seat 1: DonkReaper (60.21).
Seat 2: legenda99 (123.31).
Seat 3: Goomashroom (81.86).
Seat 4: IlxxxlI (24.35).
Seat 5: in_ur_i (47.75).
Seat 6: caballeroXXX (50).
Player caballeroXXX has small blind (0.25)
Player DonkReaper has big blind (0.50)
Player IlxxxlI received card: [8h]
Player IlxxxlI received card: [Qc]
Player legenda99 folds
Player Goomashroom folds
Player IlxxxlI folds
Player in_ur_i folds
Player caballeroXXX raises (1.25)
Player DonkReaper calls (1)
*** FLOP ***: [10c 5d Jh]
Player caballeroXXX bets (2.25)
Player DonkReaper calls (2.25)
*** TURN ***: [10c 5d Jh] [5h]
Player caballeroXXX checks
Player DonkReaper checks
*** RIVER ***: [10c 5d Jh 5h] [7h]
Player caballeroXXX bets (4.50)
Player DonkReaper calls (4.50)
------ Summary ------
Pot: 15.68. Rake 0.58. JP fee 0.24
Board: [10c 5d Jh 5h 7h]
*Player DonkReaper shows: Two pairs. Js and 5s [9h Js]. Bets: 8.25. Collects: 15.68. Wins: 7.43.
Player legenda99 does not show cards.Bets: 0. Collects: 0. Wins: 0.
Player Goomashroom does not show cards.Bets: 0. Collects: 0. Wins: 0.
Player IlxxxlI does not show cards.Bets: 0. Collects: 0. Wins: 0.
Player in_ur_i does not show cards.Bets: 0. Collects: 0. Wins: 0.
Player caballeroXXX shows: Two pairs. 10s and 5s [10d Kh]. Bets: 8.25. Collects: 0. Loses: 8.25.
Game ended at: 2016/11/28 19:46:54

Game started
Game ID: 786365174 1/2 (PRR) Lakhey (Short) (Hold'em)
Seat 3 is the button
Seat 1: IlxxxlI (40).
Seat 2: 38979 (228.72).
Seat 3: BBDub27 (102).
Seat 4: Wollverin (101).
Seat 5: meandkids (179.83).
Player Wollverin has small blind (1)
Player meandkids has big blind (2)
Player IlxxxlI received card: [Ks]
Player IlxxxlI received card: [5d]
Player IlxxxlI folds
Player 38979 folds
Player BBDub27 is timed out.
Player BBDub27 folds
Player Wollverin raises (3)
Player meandkids raises (12)
Player Wollverin folds
Uncalled bet (10) returned to meandkids
Player meandkids mucks cards
------ Summary ------
Pot: 8. Rake 0
Player IlxxxlI does not show cards.Bets: 0. Collects: 0. Wins: 0.
Player 38979 does not show cards.Bets: 0. Collects: 0. Wins: 0.
Player BBDub27 does not show cards.Bets: 0. Collects: 0. Wins: 0.
Player Wollverin does not show cards.Bets: 4. Collects: 0. Loses: 4.
*Player meandkids mucks (does not show cards). Bets: 4. Collects: 8. Wins: 4.
Game ended at: 2016/11/28 19:46:8

Game started
Game ID: 786365144 0.25/0.50 (PRR) Gorgons - 3 (Hold'em)
Seat 2 is the button
Seat 2: allaebalaamballa (28.50).
Seat 3: RetardedGenius (51.21).
Seat 4: 38979 (50).
Seat 5: in_ur_i (100.88).
Seat 6: IlxxxlI (24.81).
Player RetardedGenius has small blind (0.25)
Player 38979 has big blind (0.50)
Player IlxxxlI received card: [Ks]
Player IlxxxlI received card: [4s]
Player in_ur_i folds
Player IlxxxlI folds
Player allaebalaamballa raises (1)
Player RetardedGenius raises (1.25)
Player 38979 folds
Player allaebalaamballa calls (0.50)
*** FLOP ***: [9h Jc Kd]
Player RetardedGenius bets (2.22)
Player allaebalaamballa folds
Uncalled bet (2.22) returned to RetardedGenius
Player RetardedGenius mucks cards
------ Summary ------
Pot: 3.33. Rake 0.13. JP fee 0.04
Board: [9h Jc Kd]
Player allaebalaamballa does not show cards.Bets: 1.50. Collects: 0. Loses: 1.50.
*Player RetardedGenius mucks (does not show cards). Bets: 1.50. Collects: 3.33. Wins: 1.83.
Player 38979 does not show cards.Bets: 0.50. Collects: 0. Loses: 0.50.
Player in_ur_i does not show cards.Bets: 0. Collects: 0. Wins: 0.
Player IlxxxlI does not show cards.Bets: 0. Collects: 0. Wins: 0.
Game ended at: 2016/11/28 19:45:36

Game started
Game ID: 786365092 0.25/0.50 (PRR) Gorgons - 8 (Hold'em)
Seat 6 is the button
Seat 1: legenda99 (104.97).
Seat 2: in_ur_i (26.72).
Seat 3: Goomashroom (59.17).
Seat 4: lovecola (50.50).
Seat 5: IlxxxlI (20).
Seat 6: caballeroXXX (124.28).
Player legenda99 has small blind (0.25)
Player in_ur_i has big blind (0.50)
Player IlxxxlI received card: [2h]
Player IlxxxlI received card: [Kc]
Player Goomashroom raises (1.50)
Player lovecola folds
Player IlxxxlI folds
Player caballeroXXX folds
Player legenda99 folds
Player in_ur_i calls (1)
*** FLOP ***: [10h 5s 10s]
Player in_ur_i checks
Player Goomashroom bets (2.25)
Player in_ur_i calls (2.25)
*** TURN ***: [10h 5s 10s] [10c]
Player in_ur_i checks
Player Goomashroom checks
*** RIVER ***: [10h 5s 10s 10c] [Kh]
Player in_ur_i checks
Player Goomashroom checks
Player Goomashroom mucks cards
------ Summary ------
Pot: 7.37. Rake 0.26. JP fee 0.12
Board: [10h 5s 10s 10c Kh]
Player legenda99 does not show cards.Bets: 0.25. Collects: 0. Loses: 0.25.
*Player in_ur_i shows: Full House (10/5) [5d 7h]. Bets: 3.75. Collects: 7.37. Wins: 3.62.
Player Goomashroom mucks (does not show cards). Bets: 3.75. Collects: 0. Loses: 3.75.
Player lovecola does not show cards.Bets: 0. Collects: 0. Wins: 0.
Player IlxxxlI does not show cards.Bets: 0. Collects: 0. Wins: 0.
Player caballeroXXX does not show cards.Bets: 0. Collects: 0. Wins: 0.
Game ended at: 2016/11/28 19:46:5

Game started
Game ID: 786365060 1/2 (PRR) Lakhey (Short) (Hold'em)
Seat 2 is the button
Seat 1: IlxxxlI (40).
Seat 2: 38979 (228.72).
Seat 3: BBDub27 (100).
Seat 4: Wollverin (103).
Seat 5: meandkids (179.83).
Player BBDub27 has small blind (1)
Player Wollverin has big blind (2)
Player IlxxxlI received card: [2h]
Player IlxxxlI received card: [6s]
Player meandkids folds
Player IlxxxlI folds
Player 38979 folds
Player BBDub27 allin (99)
Player Wollverin folds
Uncalled bet (98) returned to BBDub27
Player BBDub27 mucks cards
------ Summary ------
Pot: 4. Rake 0
Player IlxxxlI does not show cards.Bets: 0. Collects: 0. Wins: 0.
Player 38979 does not show cards.Bets: 0. Collects: 0. Wins: 0.
*Player BBDub27 mucks (does not show cards). Bets: 2. Collects: 4. Wins: 2.
Player Wollverin does not show cards.Bets: 2. Collects: 0. Loses: 2.
Player meandkids does not show cards.Bets: 0. Collects: 0. Wins: 0.
Game ended at: 2016/11/28 19:45:6

Game started
Game ID: 786365041 0.25/0.50 (PRR) Garuda - 3 (Hold'em)
Seat 1 is the button
Seat 1: 6betThreat (34.95).
Seat 3: shureg22 (64.52).
Seat 5: legenda99 (99.82).
Seat 8: allaebalaamballa (38.80).
Seat 9: IlxxxlI (32.30).
Player shureg22 has small blind (0.25)
Player legenda99 has big blind (0.50)
Player IlxxxlI received card: [5d]
Player IlxxxlI received card: [Kd]
Player allaebalaamballa folds
Player IlxxxlI raises (1.20)
Player 6betThreat calls (1.20)
Player shureg22 folds
Player legenda99 calls (0.70)
*** FLOP ***: [2c 8d Qh]
Player legenda99 checks
Player IlxxxlI checks
Player 6betThreat checks
*** TURN ***: [2c 8d Qh] [5h]
Player legenda99 checks
Player IlxxxlI checks
Player 6betThreat checks
*** RIVER ***: [2c 8d Qh 5h] [2d]
Player legenda99 checks
Player IlxxxlI checks
Player 6betThreat bets (2.44)
Player legenda99 calls (2.44)
Player IlxxxlI folds
------ Summary ------
Pot: 8.30. Rake 0.29. JP fee 0.14
Board: [2c 8d Qh 5h 2d]
Player 6betThreat shows: One pair of 2s [9d 7d]. Bets: 3.64. Collects: 0. Loses: 3.64.
Player shureg22 does not show cards.Bets: 0.25. Collects: 0. Loses: 0.25.
*Player legenda99 shows: Two pairs. 4s and 2s [4h 4d]. Bets: 3.64. Collects: 8.30. Wins: 4.66.
Player allaebalaamballa does not show cards.Bets: 0. Collects: 0. Wins: 0.
Player IlxxxlI does not show cards.Bets: 1.20. Collects: 0. Loses: 1.20.
Game ended at: 2016/11/28 19:45:48

Game started
Game ID: 786365009 0.25/0.50 (PRR) Gorgons - 3 (Hold'em)
Seat 6 is the button
Seat 2: allaebalaamballa (29).
Seat 3: RetardedGenius (51.71).
Seat 4: 38979 (50).
Seat 5: in_ur_i (100.88).
Seat 6: IlxxxlI (23.88).
Player allaebalaamballa has small blind (0.25)
Player RetardedGenius has big blind (0.50)
Player IlxxxlI received card: [Jh]
Player IlxxxlI received card: [8h]
Player 38979 folds
Player in_ur_i folds
Player IlxxxlI calls (0.50)
Player allaebalaamballa calls (0.25)
Player RetardedGenius checks
*** FLOP ***: [9c 2d 3d]
Player allaebalaamballa checks
Player RetardedGenius checks
Player IlxxxlI bets (0.74)
Player allaebalaamballa folds
Player RetardedGenius folds
Uncalled bet (0.74) returned to IlxxxlI
Player IlxxxlI mucks cards
------ Summary ------
Pot: 1.43. Rake 0.05. JP fee 0.02
Board: [9c 2d 3d]
Player allaebalaamballa does not show cards.Bets: 0.50. Collects: 0. Loses: 0.50.
Player RetardedGenius does not show cards.Bets: 0.50. Collects: 0. Loses: 0.50.
Player 38979 does not show cards.Bets: 0. Collects: 0. Wins: 0.
Player in_ur_i does not show cards.Bets: 0. Collects: 0. Wins: 0.
*Player IlxxxlI mucks (does not show cards). Bets: 0.50. Collects: 1.43. Wins: 0.93.
Game ended at: 2016/11/28 19:44:55

Game started
Game ID: 786364993 0.25/0.50 (PRR) Gorgons - 8 (Hold'em)
Seat 5 is the button
Seat 1: legenda99 (105.47).
Seat 3: Goomashroom (58.42).
Seat 4: lovecola (50.50).
Seat 5: IlxxxlI (20).
Seat 6: caballeroXXX (124.53).
Player caballeroXXX has small blind (0.25)
Player legenda99 has big blind (0.50)
Player IlxxxlI received card: [3c]
Player IlxxxlI received card: [7c]
Player Goomashroom raises (1.50)
Player lovecola folds
Player IlxxxlI folds
Player caballeroXXX folds
Player legenda99 folds
Uncalled bet (1) returned to Goomashroom
Player Goomashroom mucks cards
------ Summary ------
Pot: 1.25. Rake 0
Player legenda99 does not show cards.Bets: 0.50. Collects: 0. Loses: 0.50.
*Player Goomashroom mucks (does not show cards). Bets: 0.50. Collects: 1.25. Wins: 0.75.
Player lovecola does not show cards.Bets: 0. Collects: 0. Wins: 0.
Player IlxxxlI does not show cards.Bets: 0. Collects: 0. Wins: 0.
Player caballeroXXX does not show cards.Bets: 0.25. Collects: 0. Loses: 0.25.
Game ended at: 2016/11/28 19:44:54

Game started
Game ID: 786364928 0.25/0.50 (PRR) Gorgons - 2 (Hold'em)
Seat 4 is the button
Seat 1: DonkReaper (49.99).
Seat 2: legenda99 (123.31).
Seat 3: Goomashroom (83.36).
Seat 4: IlxxxlI (24.35).
Seat 5: in_ur_i (48).
Seat 6: caballeroXXX (50).
Player in_ur_i has small blind (0.25)
Player caballeroXXX has big blind (0.50)
Player IlxxxlI received card: [7d]
Player IlxxxlI received card: [Js]
Player DonkReaper raises (1.50)
Player legenda99 folds
Player Goomashroom calls (1.50)
Player IlxxxlI folds
Player in_ur_i folds
Player caballeroXXX calls (1)
*** FLOP ***: [7s 9h 5d]
Player caballeroXXX checks
Player DonkReaper bets (3.01)
Player Goomashroom folds
Player caballeroXXX raises (8)
Player DonkReaper allin (45.48)
Player caballeroXXX folds
Uncalled bet (40.49) returned to DonkReaper
Player DonkReaper mucks cards
------ Summary ------
Pot: 19.72. Rake 0.79. JP fee 0.24
Board: [7s 9h 5d]
*Player DonkReaper mucks (does not show cards). Bets: 9.50. Collects: 19.72. Wins: 10.22.
Player legenda99 does not show cards.Bets: 0. Collects: 0. Wins: 0.
Player Goomashroom does not show cards.Bets: 1.50. Collects: 0. Loses: 1.50.
Player IlxxxlI does not show cards.Bets: 0. Collects: 0. Wins: 0.
Player in_ur_i does not show cards.Bets: 0.25. Collects: 0. Loses: 0.25.
Player caballeroXXX does not show cards.Bets: 9.50. Collects: 0. Loses: 9.50.
Game ended at: 2016/11/28 19:45:28

Game started
Game ID: 786364918 1/2 (PRR) Lakhey (Short) (Hold'em)
Seat 1 is the button
Seat 1: IlxxxlI (40).
Seat 2: 38979 (223.32).
Seat 3: BBDub27 (100).
Seat 4: Wollverin (103).
Seat 5: meandkids (179.83).
Seat 6: IbetUmuck (193.89).
Player 38979 has small blind (1)
Player BBDub27 has big blind (2)
Player IbetUmuck is timed out.
Player IbetUmuck wait BB
Player IlxxxlI received card: [2h]
Player IlxxxlI received card: [10s]
Player Wollverin folds
Player meandkids folds
Player IlxxxlI folds
Player 38979 raises (5)
Player BBDub27 calls (4)
*** FLOP ***: [Kh 5h As]
Player 38979 bets (8)
Player BBDub27 folds
Uncalled bet (8) returned to 38979
Player 38979 mucks cards
------ Summary ------
Pot: 11.40. Rake 0.40. JP fee 0.20
Board: [Kh 5h As]
Player IlxxxlI does not show cards.Bets: 0. Collects: 0. Wins: 0.
*Player 38979 mucks (does not show cards). Bets: 6. Collects: 11.40. Wins: 5.40.
Player BBDub27 does not show cards.Bets: 6. Collects: 0. Loses: 6.
Player Wollverin does not show cards.Bets: 0. Collects: 0. Wins: 0.
Player meandkids does not show cards.Bets: 0. Collects: 0. Wins: 0.
Player IbetUmuck does not show cards.Bets: 0. Collects: 0. Wins: 0.
Game ended at: 2016/11/28 19:44:28

Game started
Game ID: 786364893 0.25/0.50 (PRR) Gorgons - 8 (Hold'em)
Seat 4 is the button
Seat 1: legenda99 (104.72).
Seat 2: in_ur_i (26.72).
Seat 3: Goomashroom (58.42).
Seat 4: lovecola (50.50).
Seat 5: IlxxxlI (20).
Seat 6: caballeroXXX (125.03).
Player IlxxxlI has small blind (0.25)
Player caballeroXXX has big blind (0.50)
Player in_ur_i is timed out.
Player in_ur_i wait BB
Player IlxxxlI received card: [Qh]
Player IlxxxlI received card: [Ks]
Player legenda99 raises (1.50)
Player Goomashroom folds
Player lovecola folds
Player IlxxxlI folds
Player caballeroXXX folds
Uncalled bet (1) returned to legenda99
Player legenda99 mucks cards
------ Summary ------
Pot: 1.25. Rake 0
*Player legenda99 mucks (does not show cards). Bets: 0.50. Collects: 1.25. Wins: 0.75.
Player in_ur_i does not show cards.Bets: 0. Collects: 0. Wins: 0.
Player Goomashroom does not show cards.Bets: 0. Collects: 0. Wins: 0.
Player lovecola does not show cards.Bets: 0. Collects: 0. Wins: 0.
Player IlxxxlI does not show cards.Bets: 0.25. Collects: 0. Loses: 0.25.
Player caballeroXXX does not show cards.Bets: 0.50. Collects: 0. Loses: 0.50.
Game ended at: 2016/11/28 19:44:6

Game started
Game ID: 786364871 1/2 (PRR) Lakhey (Short) (Hold'em)
Seat 5 is the button
Seat 1: IlxxxlI (40).
Seat 2: 38979 (225.32).
Seat 3: BBDub27 (100).
Seat 4: Wollverin (100).
Seat 5: meandkids (179.83).
Player IlxxxlI has small blind (1)
Player 38979 has big blind (2)
Player BBDub27 is timed out.
Player BBDub27 wait BB
Player IlxxxlI received card: [6h]
Player IlxxxlI received card: [Ad]
Player Wollverin raises (4)
Player meandkids folds
Player IlxxxlI folds
Player 38979 folds
Uncalled bet (2) returned to Wollverin
Player Wollverin mucks cards
------ Summary ------
Pot: 5. Rake 0
Player IlxxxlI does not show cards.Bets: 1. Collects: 0. Loses: 1.
Player 38979 does not show cards.Bets: 2. Collects: 0. Loses: 2.
Player BBDub27 does not show cards.Bets: 0. Collects: 0. Wins: 0.
*Player Wollverin mucks (does not show cards). Bets: 2. Collects: 5. Wins: 3.
Player meandkids does not show cards.Bets: 0. Collects: 0. Wins: 0.
Game ended at: 2016/11/28 19:43:41

Game started
Game ID: 786364800 0.25/0.50 (PRR) Gorgons - 3 (Hold'em)
Seat 5 is the button
Seat 1: tintinhsl (11.70).
Seat 2: allaebalaamballa (29).
Seat 3: RetardedGenius (39.99).
Seat 4: 38979 (50).
Seat 5: in_ur_i (101.88).
Seat 6: IlxxxlI (24.13).
Player IlxxxlI has small blind (0.25)
Player tintinhsl has big blind (0.50)
Player IlxxxlI received card: [4d]
Player IlxxxlI received card: [Ah]
Player allaebalaamballa folds
Player RetardedGenius raises (1)
Player 38979 folds
Player in_ur_i calls (1)
Player IlxxxlI folds
Player tintinhsl calls (0.50)
*** FLOP ***: [7s 10c Ks]
Player tintinhsl bets (2.06)
Player RetardedGenius raises (4.12)
Player in_ur_i folds
Player tintinhsl allin (8.64)
Player RetardedGenius calls (6.58)
*** TURN ***: [7s 10c Ks] [6c]
*** RIVER ***: [7s 10c Ks 6c] [6h]
------ Summary ------
Pot: 23.42. Rake 0.99. JP fee 0.24
Board: [7s 10c Ks 6c 6h]
Player tintinhsl shows: Two pairs. Ks and 6s [Kc 2h]. Bets: 11.70. Collects: 0. Loses: 11.70.
Player allaebalaamballa does not show cards.Bets: 0. Collects: 0. Wins: 0.
*Player RetardedGenius shows: Two pairs. As and 6s [Ad Ac]. Bets: 11.70. Collects: 23.42. Wins: 11.72.
Player 38979 does not show cards.Bets: 0. Collects: 0. Wins: 0.
Player in_ur_i does not show cards.Bets: 1. Collects: 0. Loses: 1.
Player IlxxxlI does not show cards.Bets: 0.25. Collects: 0. Loses: 0.25.
Game ended at: 2016/11/28 19:44:9

Game started
Game ID: 786364797 0.25/0.50 (PRR) Garuda - 3 (Hold'em)
Seat 9 is the button
Seat 1: 6betThreat (49.50).
Seat 3: shureg22 (50).
Seat 5: legenda99 (99.82).
Seat 8: allaebalaamballa (38.80).
Seat 9: IlxxxlI (33.80).
Player 6betThreat has small blind (0.25)
Player shureg22 has big blind (0.50)
Player IlxxxlI received card: [Qh]
Player IlxxxlI received card: [Jd]
Player legenda99 folds
Player allaebalaamballa folds
Player IlxxxlI raises (1.50)
Player 6betThreat calls (1.25)
Player shureg22 raises (5.50)
Player IlxxxlI folds
Player 6betThreat calls (4.50)
*** FLOP ***: [6d 7s 6s]
Player 6betThreat checks
Player shureg22 bets (8.55)
Player 6betThreat calls (8.55)
*** TURN ***: [6d 7s 6s] [Ad]
Player 6betThreat checks
Player shureg22 checks
*** RIVER ***: [6d 7s 6s Ad] [Kd]
Player 6betThreat checks
Player shureg22 checks
Player 6betThreat mucks cards
------ Summary ------
Pot: 29.07. Rake 1.29. JP fee 0.24
Board: [6d 7s 6s Ad Kd]
Player 6betThreat mucks (does not show cards). Bets: 14.55. Collects: 0. Loses: 14.55.
*Player shureg22 shows: Two pairs. Ks and 6s [Qc Kh]. Bets: 14.55. Collects: 29.07. Wins: 14.52.
Player legenda99 does not show cards.Bets: 0. Collects: 0. Wins: 0.
Player allaebalaamballa does not show cards.Bets: 0. Collects: 0. Wins: 0.
Player IlxxxlI does not show cards.Bets: 1.50. Collects: 0. Loses: 1.50.
Game ended at: 2016/11/28 19:44:18

Game started
Game ID: 786364790 0.25/0.50 (PRR) Gorgons - 8 (Hold'em)
Seat 3 is the button
Seat 1: legenda99 (104.72).
Seat 3: Goomashroom (58.42).
Seat 4: lovecola (50).
Seat 5: IlxxxlI (20).
Seat 6: caballeroXXX (125.03).
Player lovecola has small blind (0.25)
Player IlxxxlI has big blind (0.50)
Player IlxxxlI received card: [6d]
Player IlxxxlI received card: [9h]
Player caballeroXXX folds
Player legenda99 folds
Player Goomashroom folds
Player lovecola raises (0.75)
Player IlxxxlI folds
Uncalled bet (0.50) returned to lovecola
Player lovecola mucks cards
------ Summary ------
Pot: 1. Rake 0
Player legenda99 does not show cards.Bets: 0. Collects: 0. Wins: 0.
Player Goomashroom does not show cards.Bets: 0. Collects: 0. Wins: 0.
*Player lovecola mucks (does not show cards). Bets: 0.50. Collects: 1. Wins: 0.50.
Player IlxxxlI does not show cards.Bets: 0.50. Collects: 0. Loses: 0.50.
Player caballeroXXX does not show cards.Bets: 0. Collects: 0. Wins: 0.
Game ended at: 2016/11/28 19:43:30

Game started
Game ID: 786364775 0.25/0.50 (PRR) Gorgons - 2 (Hold'em)
Seat 3 is the button
Seat 1: DonkReaper (49.99).
Seat 2: legenda99 (123.31).
Seat 3: Goomashroom (83.36).
Seat 4: IlxxxlI (23.22).
Seat 5: in_ur_i (49.25).
Seat 6: caballeroXXX (50).
Player IlxxxlI has small blind (0.25)
Player in_ur_i has big blind (0.50)
Player IlxxxlI received card: [Ks]
Player IlxxxlI received card: [Qs]
Player caballeroXXX folds
Player DonkReaper folds
Player legenda99 folds
Player Goomashroom folds
Player IlxxxlI raises (1)
Player in_ur_i calls (0.75)
*** FLOP ***: [Qh Ah As]
Player IlxxxlI checks
Player in_ur_i checks
*** TURN ***: [Qh Ah As] [7c]
Player IlxxxlI bets (1.31)
Player in_ur_i folds
Uncalled bet (1.31) returned to IlxxxlI
Player IlxxxlI mucks cards
------ Summary ------
Pot: 2.38. Rake 0.08. JP fee 0.04
Board: [Qh Ah As 7c]
Player DonkReaper does not show cards.Bets: 0. Collects: 0. Wins: 0.
Player legenda99 does not show cards.Bets: 0. Collects: 0. Wins: 0.
Player Goomashroom does not show cards.Bets: 0. Collects: 0. Wins: 0.
*Player IlxxxlI mucks (does not show cards). Bets: 1.25. Collects: 2.38. Wins: 1.13.
Player in_ur_i does not show cards.Bets: 1.25. Collects: 0. Loses: 1.25.
Player caballeroXXX does not show cards.Bets: 0. Collects: 0. Wins: 0.
Game ended at: 2016/11/28 19:43:46

Game started
Game ID: 786364734 0.25/0.50 (PRR) Garuda - 3 (Hold'em)
Seat 8 is the button
Seat 1: 6betThreat (50).
Seat 3: shureg22 (50).
Seat 5: legenda99 (99.82).
Seat 8: allaebalaamballa (38.05).
Seat 9: IlxxxlI (34.05).
Player IlxxxlI has small blind (0.25)
Player 6betThreat has big blind (0.50)
Player IlxxxlI received card: [6d]
Player IlxxxlI received card: [9d]
Player shureg22 folds
Player legenda99 folds
Player allaebalaamballa raises (1)
Player IlxxxlI folds
Player 6betThreat folds
Uncalled bet (0.50) returned to allaebalaamballa
Player allaebalaamballa mucks cards
------ Summary ------
Pot: 1.25. Rake 0
Player 6betThreat does not show cards.Bets: 0.50. Collects: 0. Loses: 0.50.
Player shureg22 does not show cards.Bets: 0. Collects: 0. Wins: 0.
Player legenda99 does not show cards.Bets: 0. Collects: 0. Wins: 0.
*Player allaebalaamballa mucks (does not show cards). Bets: 0.50. Collects: 1.25. Wins: 0.75.
Player IlxxxlI does not show cards.Bets: 0.25. Collects: 0. Loses: 0.25.
Game ended at: 2016/11/28 19:42:58

Game started
Game ID: 786364710 0.25/0.50 (PRR) Gorgons - 2 (Hold'em)
Seat 2 is the button
Seat 1: DonkReaper (49.99).
Seat 2: legenda99 (122.56).
Seat 3: Goomashroom (83.61).
Seat 4: IlxxxlI (23.72).
Seat 5: in_ur_i (49.25).
Seat 6: caballeroXXX (50).
Player Goomashroom has small blind (0.25)
Player IlxxxlI has big blind (0.50)
Player IlxxxlI received card: [10d]
Player IlxxxlI received card: [4s]
Player in_ur_i folds
Player caballeroXXX folds
Player DonkReaper folds
Player legenda99 raises (1)
Player Goomashroom folds
Player IlxxxlI folds
Uncalled bet (0.50) returned to legenda99
Player legenda99 mucks cards
------ Summary ------
Pot: 1.25. Rake 0
Player DonkReaper does not show cards.Bets: 0. Collects: 0. Wins: 0.
*Player legenda99 mucks (does not show cards). Bets: 0.50. Collects: 1.25. Wins: 0.75.
Player Goomashroom does not show cards.Bets: 0.25. Collects: 0. Loses: 0.25.
Player IlxxxlI does not show cards.Bets: 0.50. Collects: 0. Loses: 0.50.
Player in_ur_i does not show cards.Bets: 0. Collects: 0. Wins: 0.
Player caballeroXXX does not show cards.Bets: 0. Collects: 0. Wins: 0.
Game ended at: 2016/11/28 19:42:50

Game started
Game ID: 786364681 0.25/0.50 (PRR) Gorgons - 8 (Hold'em)
Seat 1 is the button
Seat 1: legenda99 (103.58).
Seat 3: Goomashroom (58.67).
Seat 4: lovecola (50).
Seat 5: IlxxxlI (20).
Seat 6: caballeroXXX (125.03).
Player Goomashroom has small blind (0.25)
Player lovecola has big blind (0.50)
Player IlxxxlI received card: [Jh]
Player IlxxxlI received card: [2h]
Player IlxxxlI folds
Player caballeroXXX folds
Player legenda99 raises (1)
Player Goomashroom folds
Player lovecola calls (0.50)
*** FLOP ***: [3d Ks 3s]
Player lovecola checks
Player legenda99 bets (1.07)
Player lovecola folds
Uncalled bet (1.07) returned to legenda99
Player legenda99 mucks cards
------ Summary ------
Pot: 2.14. Rake 0.09. JP fee 0.02
Board: [3d Ks 3s]
*Player legenda99 mucks (does not show cards). Bets: 1. Collects: 2.14. Wins: 1.14.
Player Goomashroom does not show cards.Bets: 0.25. Collects: 0. Loses: 0.25.
Player lovecola does not show cards.Bets: 1. Collects: 0. Loses: 1.
Player IlxxxlI does not show cards.Bets: 0. Collects: 0. Wins: 0.
Player caballeroXXX does not show cards.Bets: 0. Collects: 0. Wins: 0.
Game ended at: 2016/11/28 19:42:55

Game started
Game ID: 786364683 0.25/0.50 (PRR) Gorgons - 3 (Hold'em)
Seat 4 is the button
Seat 1: tintinhsl (11.70).
Seat 2: allaebalaamballa (29).
Seat 3: RetardedGenius (39.99).
Seat 4: 38979 (50).
Seat 5: in_ur_i (102.13).
Seat 6: IlxxxlI (22.99).
Player in_ur_i has small blind (0.25)
Player IlxxxlI has big blind (0.50)
Player IlxxxlI received card: [9c]
Player IlxxxlI received card: [10c]
Player tintinhsl folds
Player allaebalaamballa folds
Player RetardedGenius folds
Player 38979 raises (1)
Player in_ur_i folds
Player IlxxxlI calls (0.50)
*** FLOP ***: [6d 8s Jd]
Player IlxxxlI checks
Player 38979 checks
*** TURN ***: [6d 8s Jd] [Jc]
Player IlxxxlI bets (4)
Player 38979 folds
Uncalled bet (4) returned to IlxxxlI
Player IlxxxlI mucks cards
------ Summary ------
Pot: 2.14. Rake 0.09. JP fee 0.02
Board: [6d 8s Jd Jc]
Player tintinhsl does not show cards.Bets: 0. Collects: 0. Wins: 0.
Player allaebalaamballa does not show cards.Bets: 0. Collects: 0. Wins: 0.
Player RetardedGenius does not show cards.Bets: 0. Collects: 0. Wins: 0.
Player 38979 does not show cards.Bets: 1. Collects: 0. Loses: 1.
Player in_ur_i does not show cards.Bets: 0.25. Collects: 0. Loses: 0.25.
*Player IlxxxlI mucks (does not show cards). Bets: 1. Collects: 2.14. Wins: 1.14.
Game ended at: 2016/11/28 19:42:59

Game started
Game ID: 786364642 0.25/0.50 (PRR) Garuda - 3 (Hold'em)
Seat 5 is the button
Seat 3: shureg22 (50).
Seat 5: legenda99 (97.57).
Seat 6: flyzlcomb07 (136.82).
Seat 8: allaebalaamballa (38.55).
Seat 9: IlxxxlI (34.05).
Player flyzlcomb07 has small blind (0.25)
Player allaebalaamballa has big blind (0.50)
Player IlxxxlI received card: [5s]
Player IlxxxlI received card: [3h]
Player IlxxxlI folds
Player shureg22 raises (1.50)
Player legenda99 raises (4.50)
Player flyzlcomb07 folds
Player allaebalaamballa folds
Player shureg22 folds
Uncalled bet (3) returned to legenda99
Player legenda99 mucks cards
------ Summary ------
Pot: 3.75. Rake 0
Player shureg22 does not show cards.Bets: 1.50. Collects: 0. Loses: 1.50.
*Player legenda99 mucks (does not show cards). Bets: 1.50. Collects: 3.75. Wins: 2.25.
Player flyzlcomb07 does not show cards.Bets: 0.25. Collects: 0. Loses: 0.25.
Player allaebalaamballa does not show cards.Bets: 0.50. Collects: 0. Loses: 0.50.
Player IlxxxlI does not show cards.Bets: 0. Collects: 0. Wins: 0.
Game ended at: 2016/11/28 19:42:35

Game started
Game ID: 786364604 0.25/0.50 (PRR) Gorgons - 2 (Hold'em)
Seat 1 is the button
Seat 1: DonkReaper (49.99).
Seat 2: legenda99 (122.06).
Seat 3: Goomashroom (84.11).
Seat 4: IlxxxlI (23.72).
Seat 5: in_ur_i (49.25).
Seat 6: caballeroXXX (50).
Player legenda99 has small blind (0.25)
Player Goomashroom has big blind (0.50)
Player IlxxxlI received card: [6c]
Player IlxxxlI received card: [3h]
Player IlxxxlI folds
Player in_ur_i folds
Player caballeroXXX folds
Player DonkReaper folds
Player legenda99 raises (1.25)
Player Goomashroom folds
Uncalled bet (1) returned to legenda99
Player legenda99 mucks cards
------ Summary ------
Pot: 1. Rake 0
Player DonkReaper does not show cards.Bets: 0. Collects: 0. Wins: 0.
*Player legenda99 mucks (does not show cards). Bets: 0.50. Collects: 1. Wins: 0.50.
Player Goomashroom does not show cards.Bets: 0.50. Collects: 0. Loses: 0.50.
Player IlxxxlI does not show cards.Bets: 0. Collects: 0. Wins: 0.
Player in_ur_i does not show cards.Bets: 0. Collects: 0. Wins: 0.
Player caballeroXXX does not show cards.Bets: 0. Collects: 0. Wins: 0.
Game ended at: 2016/11/28 19:42:28

Game started
Game ID: 786364559 0.25/0.50 (PRR) Gorgons - 3 (Hold'em)
Seat 3 is the button
Seat 1: tintinhsl (5.28).
Seat 2: allaebalaamballa (29).
Seat 3: RetardedGenius (45.27).
Seat 4: 38979 (50).
Seat 5: in_ur_i (102.63).
Seat 6: IlxxxlI (23.99).
Player 38979 has small blind (0.25)
Player in_ur_i has big blind (0.50)
Player IlxxxlI received card: [6c]
Player IlxxxlI received card: [Ac]
Player IlxxxlI raises (1)
Player tintinhsl allin (5.28)
Player allaebalaamballa folds
Player RetardedGenius calls (5.28)
Player 38979 folds
Player in_ur_i folds
Player IlxxxlI folds
*** FLOP ***: [9c 3c 5s]
*** TURN ***: [9c 3c 5s] [4c]
*** RIVER ***: [9c 3c 5s 4c] [Js]
------ Summary ------
Pot: 11.70. Rake 0.41. JP fee 0.20
Board: [9c 3c 5s 4c Js]
*Player tintinhsl shows: Flush, 9 high [8c 5c]. Bets: 5.28. Collects: 11.70. Wins: 6.42.
Player allaebalaamballa does not show cards.Bets: 0. Collects: 0. Wins: 0.
Player RetardedGenius shows: One pair of 9s [9d 8d]. Bets: 5.28. Collects: 0. Loses: 5.28.
Player 38979 does not show cards.Bets: 0.25. Collects: 0. Loses: 0.25.
Player in_ur_i does not show cards.Bets: 0.50. Collects: 0. Loses: 0.50.
Player IlxxxlI does not show cards.Bets: 1. Collects: 0. Loses: 1.
Game ended at: 2016/11/28 19:42:19

Game started
Game ID: 786364462 0.25/0.50 (PRR) Gorgons - 3 (Hold'em)
Seat 2 is the button
Seat 1: tintinhsl (57.72).
Seat 2: allaebalaamballa (29).
Seat 3: RetardedGenius (45.52).
Seat 4: 38979 (50).
Seat 5: in_ur_i (52.44).
Seat 6: IlxxxlI (23.99).
Player RetardedGenius has small blind (0.25)
Player 38979 has big blind (0.50)
Player IlxxxlI received card: [8d]
Player IlxxxlI received card: [Ac]
Player in_ur_i raises (1.50)
Player IlxxxlI folds
Player tintinhsl allin (57.72)
Player allaebalaamballa folds
Player RetardedGenius folds
Player 38979 folds
Player in_ur_i allin (50.94)
Uncalled bet (5.28) returned to tintinhsl
*** FLOP ***: [9c 10c 3h]
*** TURN ***: [9c 10c 3h] [4h]
*** RIVER ***: [9c 10c 3h 4h] [7c]
------ Summary ------
Pot: 102.63. Rake 2.76. JP fee 0.24
Board: [9c 10c 3h 4h 7c]
Player tintinhsl shows: High card A [As Jd]. Bets: 52.44. Collects: 0. Loses: 52.44.
Player allaebalaamballa does not show cards.Bets: 0. Collects: 0. Wins: 0.
Player RetardedGenius does not show cards.Bets: 0.25. Collects: 0. Loses: 0.25.
Player 38979 does not show cards.Bets: 0.50. Collects: 0. Loses: 0.50.
*Player in_ur_i shows: One pair of Qs [Qd Qc]. Bets: 52.44. Collects: 102.63. Wins: 50.19.
Player IlxxxlI does not show cards.Bets: 0. Collects: 0. Wins: 0.
Game ended at: 2016/11/28 19:41:42

Game started
Game ID: 786364395 0.25/0.50 (PRR) Gorgons - 8 (Hold'em)
Seat 6 is the button
Seat 1: legenda99 (100.43).
Seat 2: in_ur_i (27.22).
Seat 3: Goomashroom (58.67).
Seat 4: lovecola (50).
Seat 5: IlxxxlI (20).
Seat 6: caballeroXXX (126.23).
Player legenda99 has small blind (0.25)
Player in_ur_i has big blind (0.50)
Player IlxxxlI received card: [10s]
Player IlxxxlI received card: [Ad]
Player Goomashroom folds
Player lovecola folds
Player IlxxxlI raises (1.20)
Player caballeroXXX calls (1.20)
Player legenda99 calls (0.95)
Player in_ur_i is timed out.
Player in_ur_i folds
*** FLOP ***: [Kc 3h 4s]
Player legenda99 checks
Player IlxxxlI bets (0.50)
Player caballeroXXX folds
Player legenda99 raises (2.50)
Player IlxxxlI folds
Uncalled bet (2) returned to legenda99
Player legenda99 mucks cards
------ Summary ------
Pot: 4.85. Rake 0.17. JP fee 0.08
Board: [Kc 3h 4s]
*Player legenda99 mucks (does not show cards). Bets: 1.70. Collects: 4.85. Wins: 3.15.
Player in_ur_i does not show cards.Bets: 0.50. Collects: 0. Loses: 0.50.
Player Goomashroom does not show cards.Bets: 0. Collects: 0. Wins: 0.
Player lovecola does not show cards.Bets: 0. Collects: 0. Wins: 0.
Player IlxxxlI does not show cards.Bets: 1.70. Collects: 0. Loses: 1.70.
Player caballeroXXX does not show cards.Bets: 1.20. Collects: 0. Loses: 1.20.
Game ended at: 2016/11/28 19:42:20

Game started
Game ID: 786364349 0.25/0.50 (PRR) Gorgons - 3 (Hold'em)
Seat 1 is the button
Seat 1: tintinhsl (57.72).
Seat 2: allaebalaamballa (29.25).
Seat 3: RetardedGenius (46.02).
Seat 4: 38979 (50).
Seat 5: in_ur_i (56.08).
Seat 6: IlxxxlI (20).
Player allaebalaamballa has small blind (0.25)
Player RetardedGenius has big blind (0.50)
Player IlxxxlI received card: [Kc]
Player IlxxxlI received card: [Ac]
Player 38979 folds
Player in_ur_i raises (1.50)
Player IlxxxlI raises (3.64)
Player tintinhsl folds
Player allaebalaamballa folds
Player RetardedGenius folds
Player in_ur_i calls (2.14)
*** FLOP ***: [6s As 7s]
Player in_ur_i checks
Player IlxxxlI bets (2.54)
Player in_ur_i folds
Uncalled bet (2.54) returned to IlxxxlI
Player IlxxxlI mucks cards
------ Summary ------
Pot: 7.63. Rake 0.28. JP fee 0.12
Board: [6s As 7s]
Player tintinhsl does not show cards.Bets: 0. Collects: 0. Wins: 0.
Player allaebalaamballa does not show cards.Bets: 0.25. Collects: 0. Loses: 0.25.
Player RetardedGenius does not show cards.Bets: 0.50. Collects: 0. Loses: 0.50.
Player 38979 does not show cards.Bets: 0. Collects: 0. Wins: 0.
Player in_ur_i does not show cards.Bets: 3.64. Collects: 0. Loses: 3.64.
*Player IlxxxlI mucks (does not show cards). Bets: 3.64. Collects: 7.63. Wins: 3.99.
Game ended at: 2016/11/28 19:41:8

Game started
Game ID: 786364335 0.25/0.50 (PRR) Gorgons - 2 (Hold'em)
Seat 6 is the button
Seat 1: DonkReaper (50.24).
Seat 2: legenda99 (119.95).
Seat 3: Goomashroom (84.11).
Seat 4: IlxxxlI (23.72).
Seat 5: in_ur_i (49.25).
Seat 6: caballeroXXX (50.75).
Player DonkReaper has small blind (0.25)
Player legenda99 has big blind (0.50)
Player IlxxxlI received card: [4h]
Player IlxxxlI received card: [2d]
Player Goomashroom folds
Player IlxxxlI folds
Player in_ur_i folds
Player caballeroXXX raises (1)
Player DonkReaper folds
Player legenda99 calls (0.50)
*** FLOP ***: [5s Kd 5h]
Player legenda99 checks
Player caballeroXXX bets (1.07)
Player legenda99 calls (1.07)
*** TURN ***: [5s Kd 5h] [2h]
Player legenda99 checks
Player caballeroXXX checks
*** RIVER ***: [5s Kd 5h 2h] [2c]
Player legenda99 bets (2.50)
Player caballeroXXX folds
Uncalled bet (2.50) returned to legenda99
Player legenda99 mucks cards
------ Summary ------
Pot: 4.18. Rake 0.15. JP fee 0.06
Board: [5s Kd 5h 2h 2c]
Player DonkReaper does not show cards.Bets: 0.25. Collects: 0. Loses: 0.25.
*Player legenda99 mucks (does not show cards). Bets: 2.07. Collects: 4.18. Wins: 2.11.
Player Goomashroom does not show cards.Bets: 0. Collects: 0. Wins: 0.
Player IlxxxlI does not show cards.Bets: 0. Collects: 0. Wins: 0.
Player in_ur_i does not show cards.Bets: 0. Collects: 0. Wins: 0.
Player caballeroXXX does not show cards.Bets: 2.07. Collects: 0. Loses: 2.07.
Game ended at: 2016/11/28 19:41:58

Game started
Game ID: 786364297 0.25/0.50 (PRR) Garuda - 3 (Hold'em)
Seat 3 is the button
Seat 1: 6betThreat (49.64).
Seat 3: shureg22 (50).
Seat 5: legenda99 (111.43).
Seat 6: flyzlcomb07 (75.22).
Seat 8: allaebalaamballa (39.65).
Seat 9: IlxxxlI (34.05).
Player legenda99 has small blind (0.25)
Player flyzlcomb07 has big blind (0.50)
Player IlxxxlI received card: [5d]
Player IlxxxlI received card: [8s]
Player allaebalaamballa raises (1.10)
Player IlxxxlI folds
Player 6betThreat calls (1.10)
Player shureg22 folds
Player legenda99 raises (5.25)
Player flyzlcomb07 calls (5)
Player allaebalaamballa folds
Player 6betThreat calls (4.40)
*** FLOP ***: [9c Kc 2c]
Player legenda99 checks
Player flyzlcomb07 bets (8.36)
Player 6betThreat calls (8.36)
Player legenda99 calls (8.36)
*** TURN ***: [9c Kc 2c] [7s]
Player legenda99 checks
Player flyzlcomb07 allin (61.36)
Player 6betThreat allin (35.78)
Player legenda99 folds
Uncalled bet (25.58) returned to flyzlcomb07
*** RIVER ***: [9c Kc 2c 7s] [6s]
------ Summary ------
Pot: 111.24. Rake 2.76. JP fee 0.24
Board: [9c Kc 2c 7s 6s]
Player 6betThreat shows: Two pairs. 9s and 7s [9s 7h]. Bets: 49.64. Collects: 0. Loses: 49.64.
Player shureg22 does not show cards.Bets: 0. Collects: 0. Wins: 0.
Player legenda99 does not show cards.Bets: 13.86. Collects: 0. Loses: 13.86.
*Player flyzlcomb07 shows: Flush, K high [3c 4c]. Bets: 49.64. Collects: 111.24. Wins: 61.60.
Player allaebalaamballa does not show cards.Bets: 1.10. Collects: 0. Loses: 1.10.
Player IlxxxlI does not show cards.Bets: 0. Collects: 0. Wins: 0.
Game ended at: 2016/11/28 19:42:5

Game started
Game ID: 786364273 0.25/0.50 (PRR) Gorgons - 2 (Hold'em)
Seat 5 is the button
Seat 1: DonkReaper (49.99).
Seat 2: legenda99 (119.95).
Seat 3: Goomashroom (84.11).
Seat 4: IlxxxlI (23.72).
Seat 5: in_ur_i (49.25).
Seat 6: caballeroXXX (51).
Player caballeroXXX has small blind (0.25)
Player DonkReaper has big blind (0.50)
Player IlxxxlI received card: [5h]
Player IlxxxlI received card: [Jc]
Player legenda99 folds
Player Goomashroom folds
Player IlxxxlI folds
Player in_ur_i folds
Player caballeroXXX folds
Uncalled bet (0.25) returned to DonkReaper
Player DonkReaper mucks cards
------ Summary ------
Pot: 0.50. Rake 0
*Player DonkReaper mucks (does not show cards). Bets: 0.25. Collects: 0.50. Wins: 0.25.
Player legenda99 does not show cards.Bets: 0. Collects: 0. Wins: 0.
Player Goomashroom does not show cards.Bets: 0. Collects: 0. Wins: 0.
Player IlxxxlI does not show cards.Bets: 0. Collects: 0. Wins: 0.
Player in_ur_i does not show cards.Bets: 0. Collects: 0. Wins: 0.
Player caballeroXXX does not show cards.Bets: 0.25. Collects: 0. Loses: 0.25.
Game ended at: 2016/11/28 19:40:28

Game started
Game ID: 786364159 0.25/0.50 (PRR) Gorgons - 2 (Hold'em)
Seat 4 is the button
Seat 1: DonkReaper (49.99).
Seat 2: legenda99 (119.95).
Seat 3: Goomashroom (84.11).
Seat 4: IlxxxlI (23.72).
Seat 5: in_ur_i (49.50).
Seat 6: caballeroXXX (50.75).
Player in_ur_i has small blind (0.25)
Player caballeroXXX has big blind (0.50)
Player IlxxxlI received card: [6c]
Player IlxxxlI received card: [Qs]
Player DonkReaper folds
Player legenda99 folds
Player Goomashroom folds
Player IlxxxlI folds
Player in_ur_i folds
Uncalled bet (0.25) returned to caballeroXXX
Player caballeroXXX mucks cards
------ Summary ------
Pot: 0.50. Rake 0
Player DonkReaper does not show cards.Bets: 0. Collects: 0. Wins: 0.
Player legenda99 does not show cards.Bets: 0. Collects: 0. Wins: 0.
Player Goomashroom does not show cards.Bets: 0. Collects: 0. Wins: 0.
Player IlxxxlI does not show cards.Bets: 0. Collects: 0. Wins: 0.
Player in_ur_i does not show cards.Bets: 0.25. Collects: 0. Loses: 0.25.
*Player caballeroXXX mucks (does not show cards). Bets: 0.25. Collects: 0.50. Wins: 0.25.
Game ended at: 2016/11/28 19:40:10

Game started
Game ID: 786363985 0.25/0.50 (PRR) Gorgons - 8 (Hold'em)
Seat 5 is the button
Seat 1: legenda99 (51.59).
Seat 3: Goomashroom (58.67).
Seat 4: lovecola (69.56).
Seat 5: IlxxxlI (20).
Seat 6: caballeroXXX (126.48).
Player caballeroXXX has small blind (0.25)
Player legenda99 has big blind (0.50)
Player IlxxxlI received card: [7d]
Player IlxxxlI received card: [9d]
Player Goomashroom folds
Player lovecola raises (1.25)
Player IlxxxlI folds
Player caballeroXXX folds
Player legenda99 raises (4)
Player lovecola calls (3.25)
*** FLOP ***: [10h 7c Qh]
Player legenda99 bets (5.86)
Player lovecola calls (5.86)
*** TURN ***: [10h 7c Qh] [3s]
Player legenda99 bets (14)
Player lovecola calls (14)
*** RIVER ***: [10h 7c Qh 3s] [Qd]
Player legenda99 checks
Player lovecola bets (31.02)
Player legenda99 allin (27.23)
Uncalled bet (3.79) returned to lovecola
------ Summary ------
Pot: 100.43. Rake 2.76. JP fee 0.24
Board: [10h 7c Qh 3s Qd]
*Player legenda99 shows: Three Of Kind of Qs [Ad Qc]. Bets: 51.59. Collects: 100.43. Wins: 48.84.
Player Goomashroom does not show cards.Bets: 0. Collects: 0. Wins: 0.
Player lovecola shows: One pair of Qs [Kc Jd]. Bets: 51.59. Collects: 0. Loses: 51.59.
Player IlxxxlI does not show cards.Bets: 0. Collects: 0. Wins: 0.
Player caballeroXXX does not show cards.Bets: 0.25. Collects: 0. Loses: 0.25.
Game ended at: 2016/11/28 19:40:46

Game started
Game ID: 786363968 0.25/0.50 (PRR) Gorgons - 3 (Hold'em)
Seat 6 is the button
Seat 1: tintinhsl (57.97).
Seat 2: allaebalaamballa (29.75).
Seat 3: RetardedGenius (46.02).
Seat 4: 38979 (52.90).
Seat 5: in_ur_i (51.87).
Seat 6: IlxxxlI (20).
Player tintinhsl has small blind (0.25)
Player allaebalaamballa has big blind (0.50)
Player IlxxxlI received card: [Ks]
Player IlxxxlI received card: [5c]
Player RetardedGenius folds
Player 38979 raises (1.50)
Player in_ur_i calls (1.50)
Player IlxxxlI folds
Player tintinhsl folds
Player allaebalaamballa folds
*** FLOP ***: [9d 7d 4h]
Player 38979 bets (2.38)
Player in_ur_i calls (2.38)
*** TURN ***: [9d 7d 4h] [6d]
Player 38979 checks
Player in_ur_i checks
*** RIVER ***: [9d 7d 4h 6d] [Kc]
Player 38979 checks
Player in_ur_i bets (2.69)
Player 38979 folds
Uncalled bet (2.69) returned to in_ur_i
Player in_ur_i mucks cards
------ Summary ------
Pot: 8.09. Rake 0.28. JP fee 0.14
Board: [9d 7d 4h 6d Kc]
Player tintinhsl does not show cards.Bets: 0.25. Collects: 0. Loses: 0.25.
Player allaebalaamballa does not show cards.Bets: 0.50. Collects: 0. Loses: 0.50.
Player RetardedGenius does not show cards.Bets: 0. Collects: 0. Wins: 0.
Player 38979 does not show cards.Bets: 3.88. Collects: 0. Loses: 3.88.
*Player in_ur_i mucks (does not show cards). Bets: 3.88. Collects: 8.09. Wins: 4.21.
Player IlxxxlI does not show cards.Bets: 0. Collects: 0. Wins: 0.
Game ended at: 2016/11/28 19:40:33

Game started
Game ID: 786363962 0.25/0.50 (PRR) Garuda - 3 (Hold'em)
Seat 1 is the button
Seat 1: 6betThreat (46.28).
Seat 3: shureg22 (50).
Seat 5: legenda99 (112.63).
Seat 6: flyzlcomb07 (75.22).
Seat 8: allaebalaamballa (39.65).
Seat 9: IlxxxlI (36.25).
Player shureg22 has small blind (0.25)
Player legenda99 has big blind (0.50)
Player IlxxxlI received card: [Jc]
Player IlxxxlI received card: [Kc]
Player flyzlcomb07 folds
Player allaebalaamballa folds
Player IlxxxlI raises (1.20)
Player 6betThreat calls (1.20)
Player shureg22 folds
Player legenda99 calls (0.70)
*** FLOP ***: [8d Ah 10h]
Player legenda99 checks
Player IlxxxlI bets (1)
Player 6betThreat raises (2)
Player legenda99 folds
Player IlxxxlI folds
Uncalled bet (1) returned to 6betThreat
Player 6betThreat mucks cards
------ Summary ------
Pot: 5.56. Rake 0.21. JP fee 0.08
Board: [8d Ah 10h]
*Player 6betThreat mucks (does not show cards). Bets: 2.20. Collects: 5.56. Wins: 3.36.
Player shureg22 does not show cards.Bets: 0.25. Collects: 0. Loses: 0.25.
Player legenda99 does not show cards.Bets: 1.20. Collects: 0. Loses: 1.20.
Player flyzlcomb07 does not show cards.Bets: 0. Collects: 0. Wins: 0.
Player allaebalaamballa does not show cards.Bets: 0. Collects: 0. Wins: 0.
Player IlxxxlI does not show cards.Bets: 2.20. Collects: 0. Loses: 2.20.
Game ended at: 2016/11/28 19:40:17

Game started
Game ID: 786363961 0.25/0.50 (PRR) Gorgons - 2 (Hold'em)
Seat 3 is the button
Seat 1: DonkReaper (49.99).
Seat 2: legenda99 (119.95).
Seat 3: Goomashroom (84.11).
Seat 4: IlxxxlI (23.97).
Seat 5: in_ur_i (50).
Seat 6: caballeroXXX (50).
Player IlxxxlI has small blind (0.25)
Player in_ur_i has big blind (0.50)
Player IlxxxlI received card: [3h]
Player IlxxxlI received card: [4h]
Player caballeroXXX raises (1.50)
Player DonkReaper folds
Player legenda99 folds
Player Goomashroom folds
Player IlxxxlI folds
Player in_ur_i folds
Uncalled bet (1) returned to caballeroXXX
Player caballeroXXX mucks cards
------ Summary ------
Pot: 1.25. Rake 0
Player DonkReaper does not show cards.Bets: 0. Collects: 0. Wins: 0.
Player legenda99 does not show cards.Bets: 0. Collects: 0. Wins: 0.
Player Goomashroom does not show cards.Bets: 0. Collects: 0. Wins: 0.
Player IlxxxlI does not show cards.Bets: 0.25. Collects: 0. Loses: 0.25.
Player in_ur_i does not show cards.Bets: 0.50. Collects: 0. Loses: 0.50.
*Player caballeroXXX mucks (does not show cards). Bets: 0.50. Collects: 1.25. Wins: 0.75.
Game ended at: 2016/11/28 19:39:34

Game started
Game ID: 786363885 0.25/0.50 (PRR) Gorgons (Hold'em)
Seat 4 is the button
Seat 2: meandkids (47).
Seat 3: IlxxxlI (27.77).
Seat 4: caballeroXXX (50).
Seat 5: Goomashroom (54.28).
Seat 6: allaebalaamballa (20).
Player Goomashroom has small blind (0.25)
Player allaebalaamballa has big blind (0.50)
Player IlxxxlI received card: [3h]
Player IlxxxlI received card: [5s]
Player meandkids raises (3)
Player IlxxxlI folds
Player caballeroXXX folds
Player Goomashroom folds
Player allaebalaamballa folds
Uncalled bet (2.50) returned to meandkids
Player meandkids mucks cards
------ Summary ------
Pot: 1.25. Rake 0
*Player meandkids mucks (does not show cards). Bets: 0.50. Collects: 1.25. Wins: 0.75.
Player IlxxxlI does not show cards.Bets: 0. Collects: 0. Wins: 0.
Player caballeroXXX does not show cards.Bets: 0. Collects: 0. Wins: 0.
Player Goomashroom does not show cards.Bets: 0.25. Collects: 0. Loses: 0.25.
Player allaebalaamballa does not show cards.Bets: 0.50. Collects: 0. Loses: 0.50.
Game ended at: 2016/11/28 19:38:35

Game started
Game ID: 786363761 0.25/0.50 (PRR) Garuda - 3 (Hold'em)
Seat 9 is the button
Seat 1: 6betThreat (50).
Seat 3: shureg22 (50).
Seat 5: legenda99 (112.63).
Seat 6: flyzlcomb07 (71.39).
Seat 8: allaebalaamballa (39.65).
Seat 9: IlxxxlI (36.25).
Player 6betThreat has small blind (0.25)
Player shureg22 has big blind (0.50)
Player IlxxxlI received card: [Qd]
Player IlxxxlI received card: [6h]
Player legenda99 folds
Player flyzlcomb07 raises (1.50)
Player allaebalaamballa folds
Player IlxxxlI folds
Player 6betThreat calls (1.25)
Player shureg22 folds
*** FLOP ***: [7c 4d 4s]
Player 6betThreat checks
Player flyzlcomb07 bets (2.22)
Player 6betThreat calls (2.22)
*** TURN ***: [7c 4d 4s] [Qc]
Player 6betThreat checks
Player flyzlcomb07 checks
*** RIVER ***: [7c 4d 4s Qc] [6c]
Player 6betThreat checks
Player flyzlcomb07 checks
Player 6betThreat mucks cards
------ Summary ------
Pot: 7.55. Rake 0.27. JP fee 0.12
Board: [7c 4d 4s Qc 6c]
Player 6betThreat mucks (does not show cards). Bets: 3.72. Collects: 0. Loses: 3.72.
Player shureg22 does not show cards.Bets: 0.50. Collects: 0. Loses: 0.50.
Player legenda99 does not show cards.Bets: 0. Collects: 0. Wins: 0.
*Player flyzlcomb07 shows: Two pairs. 7s and 4s [7h As]. Bets: 3.72. Collects: 7.55. Wins: 3.83.
Player allaebalaamballa does not show cards.Bets: 0. Collects: 0. Wins: 0.
Player IlxxxlI does not show cards.Bets: 0. Collects: 0. Wins: 0.
Game ended at: 2016/11/28 19:38:29

Game started
Game ID: 786363753 0.25/0.50 (PRR) Gorgons - 8 (Hold'em)
Seat 4 is the button
Seat 1: legenda99 (51.59).
Seat 2: in_ur_i (29.39).
Seat 3: Goomashroom (55.75).
Seat 4: lovecola (69.56).
Seat 5: IlxxxlI (20.25).
Seat 6: caballeroXXX (126.98).
Player IlxxxlI has small blind (0.25)
Player caballeroXXX has big blind (0.50)
Player in_ur_i posts (0.50)
Player IlxxxlI received card: [7s]
Player IlxxxlI received card: [Jh]
Player legenda99 folds
Player in_ur_i raises (1.67)
Player Goomashroom raises (5)
Player lovecola folds
Player IlxxxlI folds
Player caballeroXXX folds
Player in_ur_i is timed out.
Player in_ur_i folds
Uncalled bet (2.83) returned to Goomashroom
Player Goomashroom mucks cards
------ Summary ------
Pot: 5.09. Rake 0
Player legenda99 does not show cards.Bets: 0. Collects: 0. Wins: 0.
Player in_ur_i does not show cards.Bets: 2.17. Collects: 0. Loses: 2.17.
*Player Goomashroom mucks (does not show cards). Bets: 2.17. Collects: 5.09. Wins: 2.92.
Player lovecola does not show cards.Bets: 0. Collects: 0. Wins: 0.
Player IlxxxlI does not show cards.Bets: 0.25. Collects: 0. Loses: 0.25.
Player caballeroXXX does not show cards.Bets: 0.50. Collects: 0. Loses: 0.50.
Game ended at: 2016/11/28 19:38:37

Game started
Game ID: 786363715 0.25/0.50 (PRR) Gorgons - 3 (Hold'em)
Seat 5 is the button
Seat 1: tintinhsl (58.47).
Seat 2: allaebalaamballa (29.75).
Seat 3: RetardedGenius (43.50).
Seat 4: 38979 (52.90).
Seat 5: in_ur_i (53.87).
Seat 6: IlxxxlI (20).
Player IlxxxlI has small blind (0.25)
Player tintinhsl has big blind (0.50)
Player IlxxxlI received card: [3c]
Player IlxxxlI received card: [Kc]
Player allaebalaamballa folds
Player RetardedGenius calls (0.50)
Player 38979 folds
Player in_ur_i raises (2)
Player IlxxxlI folds
Player tintinhsl folds
Player RetardedGenius calls (1.50)
*** FLOP ***: [5d 3s Qd]
Player RetardedGenius checks
Player in_ur_i checks
*** TURN ***: [5d 3s Qd] [6d]
Player RetardedGenius bets (3.01)
Player in_ur_i folds
Uncalled bet (3.01) returned to RetardedGenius
Player RetardedGenius mucks cards
------ Summary ------
Pot: 4.52. Rake 0.17. JP fee 0.06
Board: [5d 3s Qd 6d]
Player tintinhsl does not show cards.Bets: 0.50. Collects: 0. Loses: 0.50.
Player allaebalaamballa does not show cards.Bets: 0. Collects: 0. Wins: 0.
*Player RetardedGenius mucks (does not show cards). Bets: 2. Collects: 4.52. Wins: 2.52.
Player 38979 does not show cards.Bets: 0. Collects: 0. Wins: 0.
Player in_ur_i does not show cards.Bets: 2. Collects: 0. Loses: 2.
Player IlxxxlI does not show cards.Bets: 0.25. Collects: 0. Loses: 0.25.
Game ended at: 2016/11/28 19:38:32

Game started
Game ID: 786363708 0.25/0.50 (PRR) Gorgons - 2 (Hold'em)
Seat 2 is the button
Seat 1: DonkReaper (49.99).
Seat 2: legenda99 (120.95).
Seat 3: Goomashroom (84.36).
Seat 4: IlxxxlI (22.83).
Seat 6: caballeroXXX (50).
Player Goomashroom has small blind (0.25)
Player IlxxxlI has big blind (0.50)
Player IlxxxlI received card: [8d]
Player IlxxxlI received card: [8s]
Player caballeroXXX folds
Player DonkReaper folds
Player legenda99 raises (1)
Player Goomashroom folds
Player IlxxxlI calls (0.50)
*** FLOP ***: [As Jd 9s]
Player IlxxxlI checks
Player legenda99 checks
*** TURN ***: [As Jd 9s] [6d]
Player IlxxxlI checks
Player legenda99 checks
*** RIVER ***: [As Jd 9s 6d] [9d]
Player IlxxxlI checks
Player legenda99 checks
Player legenda99 mucks cards
------ Summary ------
Pot: 2.14. Rake 0.09. JP fee 0.02
Board: [As Jd 9s 6d 9d]
Player DonkReaper does not show cards.Bets: 0. Collects: 0. Wins: 0.
Player legenda99 mucks (does not show cards). Bets: 1. Collects: 0. Loses: 1.
Player Goomashroom does not show cards.Bets: 0.25. Collects: 0. Loses: 0.25.
*Player IlxxxlI shows: Two pairs. 9s and 8s [8d 8s]. Bets: 1. Collects: 2.14. Wins: 1.14.
Player caballeroXXX does not show cards.Bets: 0. Collects: 0. Wins: 0.
Game ended at: 2016/11/28 19:38:28

Game started
Game ID: 786363666 0.25/0.50 (PRR) Gorgons (Hold'em)
Seat 3 is the button
Seat 2: meandkids (47).
Seat 3: IlxxxlI (27.77).
Seat 4: caballeroXXX (53.62).
Seat 5: Goomashroom (50).
Seat 6: allaebalaamballa (20).
Player caballeroXXX has small blind (0.25)
Player Goomashroom has big blind (0.50)
Player IlxxxlI received card: [7c]
Player IlxxxlI received card: [Jh]
Player allaebalaamballa folds
Player meandkids folds
Player IlxxxlI folds
Player caballeroXXX raises (1.50)
Player Goomashroom calls (1.25)
*** FLOP ***: [As Qs 8d]
Player caballeroXXX checks
Player Goomashroom checks
*** TURN ***: [As Qs 8d] [Ad]
Player caballeroXXX bets (3)
Player Goomashroom calls (3)
*** RIVER ***: [As Qs 8d Ad] [6d]
Player caballeroXXX checks
Player Goomashroom bets (5.50)
Player caballeroXXX folds
Uncalled bet (5.50) returned to Goomashroom
Player Goomashroom mucks cards
------ Summary ------
Pot: 9.03. Rake 0.33. JP fee 0.14
Board: [As Qs 8d Ad 6d]
Player meandkids does not show cards.Bets: 0. Collects: 0. Wins: 0.
Player IlxxxlI does not show cards.Bets: 0. Collects: 0. Wins: 0.
Player caballeroXXX does not show cards.Bets: 4.75. Collects: 0. Loses: 4.75.
*Player Goomashroom mucks (does not show cards). Bets: 4.75. Collects: 9.03. Wins: 4.28.
Player allaebalaamballa does not show cards.Bets: 0. Collects: 0. Wins: 0.
Game ended at: 2016/11/28 19:38:7

Game started
Game ID: 786363651 0.25/0.50 (PRR) Gorgons - 8 (Hold'em)
Seat 3 is the button
Seat 1: legenda99 (51.59).
Seat 3: Goomashroom (56.88).
Seat 4: lovecola (67.93).
Seat 5: IlxxxlI (20.75).
Seat 6: caballeroXXX (126.98).
Player lovecola has small blind (0.25)
Player IlxxxlI has big blind (0.50)
Player IlxxxlI received card: [10h]
Player IlxxxlI received card: [6s]
Player caballeroXXX folds
Player legenda99 folds
Player Goomashroom raises (1.13)
Player lovecola raises (3.25)
Player IlxxxlI folds
Player Goomashroom folds
Uncalled bet (2.37) returned to lovecola
Player lovecola mucks cards
------ Summary ------
Pot: 2.76. Rake 0
Player legenda99 does not show cards.Bets: 0. Collects: 0. Wins: 0.
Player Goomashroom does not show cards.Bets: 1.13. Collects: 0. Loses: 1.13.
*Player lovecola mucks (does not show cards). Bets: 1.13. Collects: 2.76. Wins: 1.63.
Player IlxxxlI does not show cards.Bets: 0.50. Collects: 0. Loses: 0.50.
Player caballeroXXX does not show cards.Bets: 0. Collects: 0. Wins: 0.
Game ended at: 2016/11/28 19:37:30

Game started
Game ID: 786363640 0.25/0.50 (PRR) Garuda - 3 (Hold'em)
Seat 8 is the button
Seat 1: 6betThreat (6.27).
Seat 5: legenda99 (112.63).
Seat 6: flyzlcomb07 (71.39).
Seat 8: allaebalaamballa (39.65).
Seat 9: IlxxxlI (42.52).
Player IlxxxlI has small blind (0.25)
Player 6betThreat has big blind (0.50)
Player IlxxxlI received card: [Js]
Player IlxxxlI received card: [Ad]
Player legenda99 folds
Player flyzlcomb07 folds
Player allaebalaamballa folds
Player IlxxxlI raises (1)
Player 6betThreat allin (5.77)
Player IlxxxlI calls (5.02)
*** FLOP ***: [5c 10c 6s]
*** TURN ***: [5c 10c 6s] [7h]
*** RIVER ***: [5c 10c 6s 7h] [9h]
------ Summary ------
Pot: 11.92. Rake 0.42. JP fee 0.20
Board: [5c 10c 6s 7h 9h]
*Player 6betThreat shows: Straight to 10 [8c 9s]. Bets: 6.27. Collects: 11.92. Wins: 5.65.
Player legenda99 does not show cards.Bets: 0. Collects: 0. Wins: 0.
Player flyzlcomb07 does not show cards.Bets: 0. Collects: 0. Wins: 0.
Player allaebalaamballa does not show cards.Bets: 0. Collects: 0. Wins: 0.
Player IlxxxlI shows: High card A [Js Ad]. Bets: 6.27. Collects: 0. Loses: 6.27.
Game ended at: 2016/11/28 19:37:30

Game started
Game ID: 786363609 0.25/0.50 (PRR) Gorgons - 3 (Hold'em)
Seat 4 is the button
Seat 1: tintinhsl (58.47).
Seat 2: allaebalaamballa (29.75).
Seat 3: RetardedGenius (42.36).
Seat 4: 38979 (52.90).
Seat 5: in_ur_i (54.12).
Seat 6: IlxxxlI (20).
Player in_ur_i has small blind (0.25)
Player IlxxxlI has big blind (0.50)
Player IlxxxlI received card: [Jh]
Player IlxxxlI received card: [10d]
Player tintinhsl folds
Player allaebalaamballa folds
Player RetardedGenius raises (1)
Player 38979 folds
Player in_ur_i folds
Player IlxxxlI calls (0.50)
*** FLOP ***: [8h 6h 8s]
Player IlxxxlI checks
Player RetardedGenius bets (1.42)
Player IlxxxlI folds
Uncalled bet (1.42) returned to RetardedGenius
Player RetardedGenius mucks cards
------ Summary ------
Pot: 2.14. Rake 0.09. JP fee 0.02
Board: [8h 6h 8s]
Player tintinhsl does not show cards.Bets: 0. Collects: 0. Wins: 0.
Player allaebalaamballa does not show cards.Bets: 0. Collects: 0. Wins: 0.
*Player RetardedGenius mucks (does not show cards). Bets: 1. Collects: 2.14. Wins: 1.14.
Player 38979 does not show cards.Bets: 0. Collects: 0. Wins: 0.
Player in_ur_i does not show cards.Bets: 0.25. Collects: 0. Loses: 0.25.
Player IlxxxlI does not show cards.Bets: 1. Collects: 0. Loses: 1.
Game ended at: 2016/11/28 19:37:17

Game started
Game ID: 786363565 0.25/0.50 (PRR) Gorgons - 8 (Hold'em)
Seat 1 is the button
Seat 1: legenda99 (50.84).
Seat 3: Goomashroom (57.13).
Seat 4: lovecola (68.43).
Seat 5: IlxxxlI (20.75).
Seat 6: caballeroXXX (126.98).
Player Goomashroom has small blind (0.25)
Player lovecola has big blind (0.50)
Player IlxxxlI received card: [9d]
Player IlxxxlI received card: [3h]
Player IlxxxlI folds
Player caballeroXXX folds
Player legenda99 raises (1)
Player Goomashroom folds
Player lovecola folds
Uncalled bet (0.50) returned to legenda99
Player legenda99 mucks cards
------ Summary ------
Pot: 1.25. Rake 0
*Player legenda99 mucks (does not show cards). Bets: 0.50. Collects: 1.25. Wins: 0.75.
Player Goomashroom does not show cards.Bets: 0.25. Collects: 0. Loses: 0.25.
Player lovecola does not show cards.Bets: 0.50. Collects: 0. Loses: 0.50.
Player IlxxxlI does not show cards.Bets: 0. Collects: 0. Wins: 0.
Player caballeroXXX does not show cards.Bets: 0. Collects: 0. Wins: 0.
Game ended at: 2016/11/28 19:36:59

Game started
Game ID: 786363478 0.25/0.50 (PRR) Gorgons - 8 (Hold'em)
Seat 6 is the button
Seat 1: legenda99 (51.09).
Seat 3: Goomashroom (56.88).
Seat 4: lovecola (68.43).
Seat 5: IlxxxlI (20.75).
Seat 6: caballeroXXX (126.98).
Player legenda99 has small blind (0.25)
Player Goomashroom has big blind (0.50)
Player IlxxxlI received card: [Qc]
Player IlxxxlI received card: [7c]
Player lovecola folds
Player IlxxxlI folds
Player caballeroXXX folds
Player legenda99 folds
Uncalled bet (0.25) returned to Goomashroom
Player Goomashroom mucks cards
------ Summary ------
Pot: 0.50. Rake 0
Player legenda99 does not show cards.Bets: 0.25. Collects: 0. Loses: 0.25.
*Player Goomashroom mucks (does not show cards). Bets: 0.25. Collects: 0.50. Wins: 0.25.
Player lovecola does not show cards.Bets: 0. Collects: 0. Wins: 0.
Player IlxxxlI does not show cards.Bets: 0. Collects: 0. Wins: 0.
Player caballeroXXX does not show cards.Bets: 0. Collects: 0. Wins: 0.
Game ended at: 2016/11/28 19:36:34

Game started
Game ID: 786363445 0.25/0.50 (PRR) Gorgons - 2 (Hold'em)
Seat 1 is the button
Seat 1: DonkReaper (54.99).
Seat 2: legenda99 (115.97).
Seat 3: Goomashroom (84.86).
Seat 4: IlxxxlI (22.83).
Seat 6: caballeroXXX (50).
Player legenda99 has small blind (0.25)
Player Goomashroom has big blind (0.50)
Player IlxxxlI received card: [Qd]
Player IlxxxlI received card: [8d]
Player IlxxxlI folds
Player caballeroXXX folds
Player DonkReaper raises (1.50)
Player legenda99 raises (4.75)
Player Goomashroom folds
Player DonkReaper calls (3.50)
*** FLOP ***: [Jh Kd 6c]
Player legenda99 bets (5.50)
Player DonkReaper folds
Uncalled bet (5.50) returned to legenda99
Player legenda99 mucks cards
------ Summary ------
Pot: 9.98. Rake 0.36. JP fee 0.16
Board: [Jh Kd 6c]
Player DonkReaper does not show cards.Bets: 5. Collects: 0. Loses: 5.
*Player legenda99 mucks (does not show cards). Bets: 5. Collects: 9.98. Wins: 4.98.
Player Goomashroom does not show cards.Bets: 0.50. Collects: 0. Loses: 0.50.
Player IlxxxlI does not show cards.Bets: 0. Collects: 0. Wins: 0.
Player caballeroXXX does not show cards.Bets: 0. Collects: 0. Wins: 0.
Game ended at: 2016/11/28 19:37:15

Game started
Game ID: 786363442 0.25/0.50 (PRR) Gorgons (Hold'em)
Seat 2 is the button
Seat 2: meandkids (47).
Seat 3: IlxxxlI (28.02).
Seat 4: caballeroXXX (50).
Seat 5: Goomashroom (51.22).
Seat 6: allaebalaamballa (20).
Player IlxxxlI has small blind (0.25)
Player caballeroXXX has big blind (0.50)
Player IlxxxlI received card: [Kc]
Player IlxxxlI received card: [3c]
Player Goomashroom raises (1.50)
Player allaebalaamballa folds
Player meandkids folds
Player IlxxxlI folds
Player caballeroXXX calls (1)
*** FLOP ***: [Qs Kh 4s]
Player caballeroXXX checks
Player Goomashroom bets (2.25)
Player caballeroXXX calls (2.25)
*** TURN ***: [Qs Kh 4s] [5s]
Player caballeroXXX checks
Player Goomashroom checks
*** RIVER ***: [Qs Kh 4s 5s] [6h]
Player caballeroXXX checks
Player Goomashroom checks
Player Goomashroom mucks cards
------ Summary ------
Pot: 7.37. Rake 0.26. JP fee 0.12
Board: [Qs Kh 4s 5s 6h]
Player meandkids does not show cards.Bets: 0. Collects: 0. Wins: 0.
Player IlxxxlI does not show cards.Bets: 0.25. Collects: 0. Loses: 0.25.
*Player caballeroXXX shows: One pair of Qs [9d Qd]. Bets: 3.75. Collects: 7.37. Wins: 3.62.
Player Goomashroom mucks (does not show cards). Bets: 3.75. Collects: 0. Loses: 3.75.
Player allaebalaamballa does not show cards.Bets: 0. Collects: 0. Wins: 0.
Game ended at: 2016/11/28 19:37:0

Game started
Game ID: 786363428 0.25/0.50 (PRR) Gorgons - 8 (Hold'em)
Seat 5 is the button
Seat 1: legenda99 (51.59).
Seat 3: Goomashroom (56.88).
Seat 4: lovecola (68.43).
Seat 5: IlxxxlI (20).
Seat 6: caballeroXXX (127.23).
Player caballeroXXX has small blind (0.25)
Player legenda99 has big blind (0.50)
Player IlxxxlI received card: [9d]
Player IlxxxlI received card: [Qd]
Player Goomashroom folds
Player lovecola folds
Player IlxxxlI raises (1.50)
Player caballeroXXX folds
Player legenda99 folds
Uncalled bet (1) returned to IlxxxlI
Player IlxxxlI mucks cards
------ Summary ------
Pot: 1.25. Rake 0
Player legenda99 does not show cards.Bets: 0.50. Collects: 0. Loses: 0.50.
Player Goomashroom does not show cards.Bets: 0. Collects: 0. Wins: 0.
Player lovecola does not show cards.Bets: 0. Collects: 0. Wins: 0.
*Player IlxxxlI mucks (does not show cards). Bets: 0.50. Collects: 1.25. Wins: 0.75.
Player caballeroXXX does not show cards.Bets: 0.25. Collects: 0. Loses: 0.25.
Game ended at: 2016/11/28 19:36:12

Game started
Game ID: 786363383 0.25/0.50 (PRR) Garuda - 3 (Hold'em)
Seat 6 is the button
Seat 1: 6betThreat (26.27).
Seat 5: legenda99 (112.63).
Seat 6: flyzlcomb07 (75.89).
Seat 8: allaebalaamballa (39.90).
Seat 9: IlxxxlI (20).
Player allaebalaamballa has small blind (0.25)
Player IlxxxlI has big blind (0.50)
Player IlxxxlI received card: [5d]
Player IlxxxlI received card: [Kd]
Player 6betThreat raises (1)
Player legenda99 folds
Player flyzlcomb07 calls (1)
Player allaebalaamballa folds
Player IlxxxlI calls (0.50)
*** FLOP ***: [7d 10d 6h]
Player IlxxxlI checks
Player 6betThreat bets (3.50)
Player flyzlcomb07 calls (3.50)
Player IlxxxlI allin (19)
Player 6betThreat allin (21.77)
Player flyzlcomb07 folds
Uncalled bet (6.27) returned to 6betThreat
*** TURN ***: [7d 10d 6h] [9d]
*** RIVER ***: [7d 10d 6h 9d] [Ks]
------ Summary ------
Pot: 42.52. Rake 1.99. JP fee 0.24
Board: [7d 10d 6h 9d Ks]
Player 6betThreat shows: Flush, Q high [Qd 6d]. Bets: 20. Collects: 0. Loses: 20.
Player legenda99 does not show cards.Bets: 0. Collects: 0. Wins: 0.
Player flyzlcomb07 does not show cards.Bets: 4.50. Collects: 0. Loses: 4.50.
Player allaebalaamballa does not show cards.Bets: 0.25. Collects: 0. Loses: 0.25.
*Player IlxxxlI shows: Flush, K high [5d Kd]. Bets: 20. Collects: 42.52. Wins: 22.52.
Game ended at: 2016/11/28 19:36:54

Game started
Game ID: 786363380 0.25/0.50 (PRR) Gorgons (Hold'em)
Seat 6 is the button
Seat 2: meandkids (47.25).
Seat 3: IlxxxlI (27.77).
Seat 4: caballeroXXX (50).
Seat 5: Goomashroom (51.22).
Seat 6: allaebalaamballa (20).
Player meandkids has small blind (0.25)
Player IlxxxlI has big blind (0.50)
Player IlxxxlI received card: [Ah]
Player IlxxxlI received card: [7c]
Player caballeroXXX folds
Player Goomashroom folds
Player allaebalaamballa folds
Player meandkids folds
Uncalled bet (0.25) returned to IlxxxlI
Player IlxxxlI mucks cards
------ Summary ------
Pot: 0.50. Rake 0
Player meandkids does not show cards.Bets: 0.25. Collects: 0. Loses: 0.25.
*Player IlxxxlI mucks (does not show cards). Bets: 0.25. Collects: 0.50. Wins: 0.25.
Player caballeroXXX does not show cards.Bets: 0. Collects: 0. Wins: 0.
Player Goomashroom does not show cards.Bets: 0. Collects: 0. Wins: 0.
Player allaebalaamballa does not show cards.Bets: 0. Collects: 0. Wins: 0.
Game ended at: 2016/11/28 19:35:58

Game started
Game ID: 786363181 0.25/0.50 (PRR) Gorgons - 8 (Hold'em)
Seat 4 is the button
Seat 1: legenda99 (50).
Seat 3: Goomashroom (56.88).
Seat 4: lovecola (68.43).
Seat 5: IlxxxlI (20).
Seat 6: caballeroXXX (128.73).
Player IlxxxlI has small blind (0.25)
Player caballeroXXX has big blind (0.50)
Player IlxxxlI received card: [10s]
Player IlxxxlI received card: [6c]
Player legenda99 raises (1.50)
Player Goomashroom folds
Player lovecola folds
Player IlxxxlI folds
Player caballeroXXX calls (1)
*** FLOP ***: [6d 7s 7c]
Player caballeroXXX checks
Player legenda99 checks
*** TURN ***: [6d 7s 7c] [7h]
Player caballeroXXX checks
Player legenda99 bets (1.54)
Player caballeroXXX folds
Uncalled bet (1.54) returned to legenda99
Player legenda99 mucks cards
------ Summary ------
Pot: 3.09. Rake 0.12. JP fee 0.04
Board: [6d 7s 7c 7h]
*Player legenda99 mucks (does not show cards). Bets: 1.50. Collects: 3.09. Wins: 1.59.
Player Goomashroom does not show cards.Bets: 0. Collects: 0. Wins: 0.
Player lovecola does not show cards.Bets: 0. Collects: 0. Wins: 0.
Player IlxxxlI does not show cards.Bets: 0.25. Collects: 0. Loses: 0.25.
Player caballeroXXX does not show cards.Bets: 1.50. Collects: 0. Loses: 1.50.
Game ended at: 2016/11/28 19:35:54

Game started
Game ID: 786363148 0.25/0.50 (PRR) Garuda - 3 (Hold'em)
Seat 5 is the button
Seat 1: 6betThreat (27.27).
Seat 5: legenda99 (113.63).
Seat 6: flyzlcomb07 (95.89).
Seat 8: allaebalaamballa (20).
Seat 9: IlxxxlI (20).
Player flyzlcomb07 has small blind (0.25)
Player allaebalaamballa has big blind (0.50)
Player IlxxxlI received card: [5c]
Player IlxxxlI received card: [8d]
Player IlxxxlI folds
Player 6betThreat raises (1)
Player legenda99 calls (1)
Player flyzlcomb07 calls (0.75)
Player allaebalaamballa raises (6)
Player 6betThreat folds
Player legenda99 folds
Player flyzlcomb07 allin (94.89)
Player allaebalaamballa allin (13.50)
Uncalled bet (75.89) returned to flyzlcomb07
*** FLOP ***: [3d 7d Ac]
*** TURN ***: [3d 7d Ac] [8h]
*** RIVER ***: [3d 7d Ac 8h] [2h]
------ Summary ------
Pot: 39.90. Rake 1.86. JP fee 0.24
Board: [3d 7d Ac 8h 2h]
Player 6betThreat does not show cards.Bets: 1. Collects: 0. Loses: 1.
Player legenda99 does not show cards.Bets: 1. Collects: 0. Loses: 1.
Player flyzlcomb07 shows: One pair of As [Ah Qd]. Bets: 20. Collects: 0. Loses: 20.
*Player allaebalaamballa shows: Three Of Kind of 7s [7h 7c]. Bets: 20. Collects: 39.90. Wins: 19.90.
Player IlxxxlI does not show cards.Bets: 0. Collects: 0. Wins: 0.
Game ended at: 2016/11/28 19:35:39

Game started
Game ID: 786363118 0.25/0.50 (PRR) Gorgons (Hold'em)
Seat 5 is the button
Seat 2: meandkids (47.75).
Seat 3: IlxxxlI (21.20).
Seat 4: caballeroXXX (50).
Seat 5: Goomashroom (57.72).
Seat 6: allaebalaamballa (20).
Player allaebalaamballa has small blind (0.25)
Player meandkids has big blind (0.50)
Player IlxxxlI received card: [8s]
Player IlxxxlI received card: [8c]
Player IlxxxlI raises (1.75)
Player caballeroXXX folds
Player Goomashroom calls (1.75)
Player allaebalaamballa folds
Player meandkids folds
*** FLOP ***: [4s 9d 3c]
Player IlxxxlI checks
Player Goomashroom bets (2.75)
Player IlxxxlI calls (2.75)
*** TURN ***: [4s 9d 3c] [Qd]
Player IlxxxlI bets (2)
Player Goomashroom calls (2)
*** RIVER ***: [4s 9d 3c Qd] [2s]
Player IlxxxlI checks
Player Goomashroom checks
Player Goomashroom mucks cards
------ Summary ------
Pot: 13.07. Rake 0.46. JP fee 0.22
Board: [4s 9d 3c Qd 2s]
Player meandkids does not show cards.Bets: 0.50. Collects: 0. Loses: 0.50.
*Player IlxxxlI shows: One pair of 8s [8s 8c]. Bets: 6.50. Collects: 13.07. Wins: 6.57.
Player caballeroXXX does not show cards.Bets: 0. Collects: 0. Wins: 0.
Player Goomashroom mucks (does not show cards). Bets: 6.50. Collects: 0. Loses: 6.50.
Player allaebalaamballa does not show cards.Bets: 0.25. Collects: 0. Loses: 0.25.
Game ended at: 2016/11/28 19:35:39

Game started
Game ID: 786363092 0.25/0.50 (PRR) Gorgons - 2 (Hold'em)
Seat 6 is the button
Seat 1: DonkReaper (55.24).
Seat 2: legenda99 (60.49).
Seat 3: Goomashroom (86.36).
Seat 4: IlxxxlI (22.83).
Seat 6: caballeroXXX (56.73).
Player DonkReaper has small blind (0.25)
Player legenda99 has big blind (0.50)
Player IlxxxlI received card: [4c]
Player IlxxxlI received card: [Jc]
Player Goomashroom raises (1.50)
Player IlxxxlI folds
Player caballeroXXX calls (1.50)
Player DonkReaper folds
Player legenda99 raises (6)
Player Goomashroom folds
Player caballeroXXX calls (5)
*** FLOP ***: [2h Js Jd]
Player legenda99 bets (7.50)
Player caballeroXXX calls (7.50)
*** TURN ***: [2h Js Jd] [5d]
Player legenda99 bets (16.50)
Player caballeroXXX calls (16.50)
*** RIVER ***: [2h Js Jd 5d] [7s]
Player legenda99 allin (29.99)
Player caballeroXXX allin (26.23)
Uncalled bet (3.76) returned to legenda99
------ Summary ------
Pot: 112.21. Rake 2.76. JP fee 0.24
Board: [2h Js Jd 5d 7s]
Player DonkReaper does not show cards.Bets: 0.25. Collects: 0. Loses: 0.25.
*Player legenda99 shows: Two pairs. As and Js [As Ah]. Bets: 56.73. Collects: 112.21. Wins: 55.48.
Player Goomashroom does not show cards.Bets: 1.50. Collects: 0. Loses: 1.50.
Player IlxxxlI does not show cards.Bets: 0. Collects: 0. Wins: 0.
Player caballeroXXX shows: Two pairs. Qs and Js [Qh Qc]. Bets: 56.73. Collects: 0. Loses: 56.73.
Game ended at: 2016/11/28 19:35:58

Game started
Game ID: 786362999 0.25/0.50 (PRR) Gorgons - 8 (Hold'em)
Seat 3 is the button
Seat 1: legenda99 (50).
Seat 3: Goomashroom (55.62).
Seat 4: lovecola (68.68).
Seat 5: IlxxxlI (20).
Seat 6: caballeroXXX (128.73).
Player lovecola has small blind (0.25)
Player IlxxxlI has big blind (0.50)
Player IlxxxlI received card: [5h]
Player IlxxxlI received card: [10h]
Player caballeroXXX folds
Player legenda99 folds
Player Goomashroom raises (1.13)
Player lovecola folds
Player IlxxxlI calls (0.63)
*** FLOP ***: [As Js 4h]
Player IlxxxlI checks
Player Goomashroom bets (1.75)
Player IlxxxlI folds
Uncalled bet (1.75) returned to Goomashroom
Player Goomashroom mucks cards
------ Summary ------
Pot: 2.39. Rake 0.08. JP fee 0.04
Board: [As Js 4h]
Player legenda99 does not show cards.Bets: 0. Collects: 0. Wins: 0.
*Player Goomashroom mucks (does not show cards). Bets: 1.13. Collects: 2.39. Wins: 1.26.
Player lovecola does not show cards.Bets: 0.25. Collects: 0. Loses: 0.25.
Player IlxxxlI does not show cards.Bets: 1.13. Collects: 0. Loses: 1.13.
Player caballeroXXX does not show cards.Bets: 0. Collects: 0. Wins: 0.
Game ended at: 2016/11/28 19:34:37

Game started
Game ID: 786362896 0.25/0.50 (PRR) Gorgons - 2 (Hold'em)
Seat 4 is the button
Seat 1: DonkReaper (55.74).
Seat 2: legenda99 (60.49).
Seat 3: Goomashroom (86.36).
Seat 4: IlxxxlI (20).
Seat 6: caballeroXXX (59.34).
Player caballeroXXX has small blind (0.25)
Player DonkReaper has big blind (0.50)
Player IlxxxlI received card: [Kc]
Player IlxxxlI received card: [Kh]
Player legenda99 folds
Player Goomashroom folds
Player IlxxxlI raises (1.50)
Player caballeroXXX calls (1.25)
Player DonkReaper folds
*** FLOP ***: [Ah 4s 5h]
Player caballeroXXX checks
Player IlxxxlI checks
*** TURN ***: [Ah 4s 5h] [5d]
Player caballeroXXX checks
Player IlxxxlI bets (1.11)
Player caballeroXXX calls (1.11)
*** RIVER ***: [Ah 4s 5h 5d] [9s]
Player caballeroXXX checks
Player IlxxxlI checks
Player caballeroXXX mucks cards
------ Summary ------
Pot: 5.44. Rake 0.20. JP fee 0.08
Board: [Ah 4s 5h 5d 9s]
Player DonkReaper does not show cards.Bets: 0.50. Collects: 0. Loses: 0.50.
Player legenda99 does not show cards.Bets: 0. Collects: 0. Wins: 0.
Player Goomashroom does not show cards.Bets: 0. Collects: 0. Wins: 0.
*Player IlxxxlI shows: Two pairs. Ks and 5s [Kc Kh]. Bets: 2.61. Collects: 5.44. Wins: 2.83.
Player caballeroXXX mucks (does not show cards). Bets: 2.61. Collects: 0. Loses: 2.61.
Game ended at: 2016/11/28 19:34:10

Game started
Game ID: 786362877 0.25/0.50 (PRR) Garuda - 3 (Hold'em)
Seat 1 is the button
Seat 1: 6betThreat (23.64).
Seat 5: legenda99 (117.13).
Seat 6: flyzlcomb07 (96.39).
Seat 8: allaebalaamballa (20).
Seat 9: IlxxxlI (20).
Player legenda99 has small blind (0.25)
Player flyzlcomb07 has big blind (0.50)
Player IlxxxlI received card: [5s]
Player IlxxxlI received card: [10s]
Player allaebalaamballa folds
Player IlxxxlI folds
Player 6betThreat raises (1)
Player legenda99 raises (3.25)
Player flyzlcomb07 folds
Player 6betThreat calls (2.50)
*** FLOP ***: [3h 6h Qd]
Player legenda99 checks
Player 6betThreat bets (7.50)
Player legenda99 folds
Uncalled bet (7.50) returned to 6betThreat
Player 6betThreat mucks cards
------ Summary ------
Pot: 7.13. Rake 0.25. JP fee 0.12
Board: [3h 6h Qd]
*Player 6betThreat mucks (does not show cards). Bets: 3.50. Collects: 7.13. Wins: 3.63.
Player legenda99 does not show cards.Bets: 3.50. Collects: 0. Loses: 3.50.
Player flyzlcomb07 does not show cards.Bets: 0.50. Collects: 0. Loses: 0.50.
Player allaebalaamballa does not show cards.Bets: 0. Collects: 0. Wins: 0.
Player IlxxxlI does not show cards.Bets: 0. Collects: 0. Wins: 0.
Game ended at: 2016/11/28 19:34:28

Game started
Game ID: 786362821 0.25/0.50 (PRR) Gorgons (Hold'em)
Seat 4 is the button
Seat 1: 38979 (74.19).
Seat 2: meandkids (47.75).
Seat 3: IlxxxlI (21.20).
Seat 4: caballeroXXX (50).
Seat 5: Goomashroom (51.42).
Seat 6: allaebalaamballa (22).
Player Goomashroom has small blind (0.25)
Player allaebalaamballa has big blind (0.50)
Player IlxxxlI received card: [3c]
Player IlxxxlI received card: [5h]
Player 38979 folds
Player meandkids folds
Player IlxxxlI folds
Player caballeroXXX folds
Player Goomashroom raises (1.25)
Player allaebalaamballa calls (1)
*** FLOP ***: [6d 7d 3h]
Player Goomashroom bets (2)
Player allaebalaamballa raises (5.50)
Player Goomashroom calls (3.50)
*** TURN ***: [6d 7d 3h] [10c]
Player Goomashroom checks
Player allaebalaamballa checks
*** RIVER ***: [6d 7d 3h 10c] [10s]
Player Goomashroom checks
Player allaebalaamballa checks
Player allaebalaamballa mucks cards
------ Summary ------
Pot: 13.30. Rake 0.48. JP fee 0.22
Board: [6d 7d 3h 10c 10s]
Player 38979 does not show cards.Bets: 0. Collects: 0. Wins: 0.
Player meandkids does not show cards.Bets: 0. Collects: 0. Wins: 0.
Player IlxxxlI does not show cards.Bets: 0. Collects: 0. Wins: 0.
Player caballeroXXX does not show cards.Bets: 0. Collects: 0. Wins: 0.
*Player Goomashroom shows: Two pairs. 10s and 5s [5c 5d]. Bets: 7. Collects: 13.30. Wins: 6.30.
Player allaebalaamballa mucks (does not show cards). Bets: 7. Collects: 0. Loses: 7.
Game ended at: 2016/11/28 19:34:19

Game started
Game ID: 786362734 0.25/0.50 (PRR) Gorgons - 2 (Hold'em)
Seat 3 is the button
Seat 1: DonkReaper (53.67).
Seat 2: legenda99 (61.99).
Seat 3: Goomashroom (86.36).
Seat 4: IlxxxlI (20).
Seat 6: caballeroXXX (59.84).
Player IlxxxlI has small blind (0.25)
Player caballeroXXX has big blind (0.50)
Player IlxxxlI received card: [6s]
Player IlxxxlI received card: [5s]
Player DonkReaper raises (1.50)
Player legenda99 calls (1.50)
Player Goomashroom folds
Player IlxxxlI folds
Player caballeroXXX folds
*** FLOP ***: [7c Qh Qd]
Player DonkReaper bets (1.78)
Player legenda99 folds
Uncalled bet (1.78) returned to DonkReaper
Player DonkReaper mucks cards
------ Summary ------
Pot: 3.57. Rake 0.12. JP fee 0.06
Board: [7c Qh Qd]
*Player DonkReaper mucks (does not show cards). Bets: 1.50. Collects: 3.57. Wins: 2.07.
Player legenda99 does not show cards.Bets: 1.50. Collects: 0. Loses: 1.50.
Player Goomashroom does not show cards.Bets: 0. Collects: 0. Wins: 0.
Player IlxxxlI does not show cards.Bets: 0.25. Collects: 0. Loses: 0.25.
Player caballeroXXX does not show cards.Bets: 0.50. Collects: 0. Loses: 0.50.
Game ended at: 2016/11/28 19:33:17

Game started
Game ID: 786362695 0.25/0.50 (PRR) Gorgons (Hold'em)
Seat 3 is the button
Seat 1: 38979 (74.19).
Seat 2: meandkids (47.75).
Seat 3: IlxxxlI (20.45).
Seat 4: caballeroXXX (50).
Seat 5: Goomashroom (51.92).
Seat 6: allaebalaamballa (22).
Player caballeroXXX has small blind (0.25)
Player Goomashroom has big blind (0.50)
Player IlxxxlI received card: [As]
Player IlxxxlI received card: [7h]
Player allaebalaamballa folds
Player 38979 folds
Player meandkids folds
Player IlxxxlI raises (1.50)
Player caballeroXXX folds
Player Goomashroom folds
Uncalled bet (1) returned to IlxxxlI
Player IlxxxlI mucks cards
------ Summary ------
Pot: 1.25. Rake 0
Player 38979 does not show cards.Bets: 0. Collects: 0. Wins: 0.
Player meandkids does not show cards.Bets: 0. Collects: 0. Wins: 0.
*Player IlxxxlI mucks (does not show cards). Bets: 0.50. Collects: 1.25. Wins: 0.75.
Player caballeroXXX does not show cards.Bets: 0.25. Collects: 0. Loses: 0.25.
Player Goomashroom does not show cards.Bets: 0.50. Collects: 0. Loses: 0.50.
Player allaebalaamballa does not show cards.Bets: 0. Collects: 0. Wins: 0.
Game ended at: 2016/11/28 19:32:55

Game started
Game ID: 786362661 0.25/0.50 (PRR) Garuda - 3 (Hold'em)
Seat 9 is the button
Seat 1: 6betThreat (34.28).
Seat 2: in_ur_i (85.58).
Seat 5: legenda99 (117.13).
Seat 6: flyzlcomb07 (85.38).
Seat 8: allaebalaamballa (20).
Seat 9: IlxxxlI (20).
Player 6betThreat has small blind (0.25)
Player in_ur_i has big blind (0.50)
Player IlxxxlI received card: [7s]
Player IlxxxlI received card: [Ad]
Player legenda99 folds
Player flyzlcomb07 raises (1.50)
Player allaebalaamballa folds
Player IlxxxlI folds
Player 6betThreat calls (1.25)
Player in_ur_i calls (1)
*** FLOP ***: [6s 4h 2s]
Player 6betThreat checks
Player in_ur_i checks
Player flyzlcomb07 bets (2.14)
Player 6betThreat calls (2.14)
Player in_ur_i folds
*** TURN ***: [6s 4h 2s] [9h]
Player 6betThreat checks
Player flyzlcomb07 checks
*** RIVER ***: [6s 4h 2s 9h] [10s]
Player 6betThreat bets (7)
Player flyzlcomb07 calls (7)
------ Summary ------
Pot: 21.65. Rake 0.89. JP fee 0.24
Board: [6s 4h 2s 9h 10s]
Player 6betThreat shows: High card A [Jd As]. Bets: 10.64. Collects: 0. Loses: 10.64.
Player in_ur_i does not show cards.Bets: 1.50. Collects: 0. Loses: 1.50.
Player legenda99 does not show cards.Bets: 0. Collects: 0. Wins: 0.
*Player flyzlcomb07 shows: One pair of Js [Jc Jh]. Bets: 10.64. Collects: 21.65. Wins: 11.01.
Player allaebalaamballa does not show cards.Bets: 0. Collects: 0. Wins: 0.
Player IlxxxlI does not show cards.Bets: 0. Collects: 0. Wins: 0.
Game ended at: 2016/11/28 19:33:10

Game started
Game ID: 786362616 0.25/0.50 (PRR) Gorgons - 2 (Hold'em)
Seat 2 is the button
Seat 1: DonkReaper (52.92).
Seat 2: legenda99 (61.99).
Seat 3: Goomashroom (86.61).
Seat 4: IlxxxlI (20).
Seat 6: caballeroXXX (59.84).
Player Goomashroom has small blind (0.25)
Player IlxxxlI has big blind (0.50)
Player IlxxxlI received card: [Qs]
Player IlxxxlI received card: [5s]
Player caballeroXXX folds
Player DonkReaper raises (1.50)
Player legenda99 folds
Player Goomashroom folds
Player IlxxxlI folds
Uncalled bet (1) returned to DonkReaper
Player DonkReaper mucks cards
------ Summary ------
Pot: 1.25. Rake 0
*Player DonkReaper mucks (does not show cards). Bets: 0.50. Collects: 1.25. Wins: 0.75.
Player legenda99 does not show cards.Bets: 0. Collects: 0. Wins: 0.
Player Goomashroom does not show cards.Bets: 0.25. Collects: 0. Loses: 0.25.
Player IlxxxlI does not show cards.Bets: 0.50. Collects: 0. Loses: 0.50.
Player caballeroXXX does not show cards.Bets: 0. Collects: 0. Wins: 0.
Game ended at: 2016/11/28 19:32:32

Game started
Game ID: 786362570 0.25/0.50 (PRR) Gorgons (Hold'em)
Seat 2 is the button
Seat 1: 38979 (74.19).
Seat 2: meandkids (47.75).
Seat 3: IlxxxlI (20).
Seat 4: caballeroXXX (50.25).
Seat 5: Goomashroom (51.92).
Seat 6: allaebalaamballa (22).
Player IlxxxlI has small blind (0.25)
Player caballeroXXX has big blind (0.50)
Player IlxxxlI received card: [5c]
Player IlxxxlI received card: [9c]
Player Goomashroom folds
Player allaebalaamballa folds
Player 38979 folds
Player meandkids folds
Player IlxxxlI calls (0.25)
Player caballeroXXX checks
*** FLOP ***: [9d As 6s]
Player IlxxxlI bets (0.50)
Player caballeroXXX folds
Uncalled bet (0.50) returned to IlxxxlI
Player IlxxxlI mucks cards
------ Summary ------
Pot: 0.95. Rake 0.05
Board: [9d As 6s]
Player 38979 does not show cards.Bets: 0. Collects: 0. Wins: 0.
Player meandkids does not show cards.Bets: 0. Collects: 0. Wins: 0.
*Player IlxxxlI mucks (does not show cards). Bets: 0.50. Collects: 0.95. Wins: 0.45.
Player caballeroXXX does not show cards.Bets: 0.50. Collects: 0. Loses: 0.50.
Player Goomashroom does not show cards.Bets: 0. Collects: 0. Wins: 0.
Player allaebalaamballa does not show cards.Bets: 0. Collects: 0. Wins: 0.
Game ended at: 2016/11/28 19:32:20

Game started
Game ID: 786362520 0.25/0.50 (PRR) Gorgons - 2 (Hold'em)
Seat 1 is the button
Seat 1: DonkReaper (52.92).
Seat 2: legenda99 (61.49).
Seat 3: Goomashroom (87.11).
Seat 4: IlxxxlI (20).
Seat 6: caballeroXXX (59.84).
Player legenda99 has small blind (0.25)
Player Goomashroom has big blind (0.50)
Player IlxxxlI received card: [2c]
Player IlxxxlI received card: [10s]
Player IlxxxlI folds
Player caballeroXXX folds
Player DonkReaper folds
Player legenda99 raises (1.25)
Player Goomashroom folds
Uncalled bet (1) returned to legenda99
Player legenda99 mucks cards
------ Summary ------
Pot: 1. Rake 0
Player DonkReaper does not show cards.Bets: 0. Collects: 0. Wins: 0.
*Player legenda99 mucks (does not show cards). Bets: 0.50. Collects: 1. Wins: 0.50.
Player Goomashroom does not show cards.Bets: 0.50. Collects: 0. Loses: 0.50.
Player IlxxxlI does not show cards.Bets: 0. Collects: 0. Wins: 0.
Player caballeroXXX does not show cards.Bets: 0. Collects: 0. Wins: 0.
Game ended at: 2016/11/28 19:31:59

Game started
Game ID: 786362476 0.25/0.50 (PRR) Gorgons - 2 (Hold'em)
Seat 6 is the button
Seat 1: DonkReaper (53.17).
Seat 2: legenda99 (61.24).
Seat 3: Goomashroom (87.11).
Seat 4: IlxxxlI (20).
Seat 6: caballeroXXX (59.84).
Player DonkReaper has small blind (0.25)
Player legenda99 has big blind (0.50)
Player IlxxxlI received card: [5c]
Player IlxxxlI received card: [10h]
Player Goomashroom folds
Player IlxxxlI folds
Player caballeroXXX folds
Player DonkReaper folds
Uncalled bet (0.25) returned to legenda99
Player legenda99 mucks cards
------ Summary ------
Pot: 0.50. Rake 0
Player DonkReaper does not show cards.Bets: 0.25. Collects: 0. Loses: 0.25.
*Player legenda99 mucks (does not show cards). Bets: 0.25. Collects: 0.50. Wins: 0.25.
Player Goomashroom does not show cards.Bets: 0. Collects: 0. Wins: 0.
Player IlxxxlI does not show cards.Bets: 0. Collects: 0. Wins: 0.
Player caballeroXXX does not show cards.Bets: 0. Collects: 0. Wins: 0.
Game ended at: 2016/11/28 19:31:35

Game started
Game ID: 786362452 0.25/0.50 (PRR) Gorgons (Hold'em)
Seat 1 is the button
Seat 1: 38979 (73.05).
Seat 2: meandkids (48).
Seat 3: IlxxxlI (20).
Seat 4: caballeroXXX (50.25).
Seat 5: Goomashroom (51.92).
Seat 6: allaebalaamballa (22).
Player meandkids has small blind (0.25)
Player IlxxxlI has big blind (0.50)
Player IlxxxlI received card: [Qd]
Player IlxxxlI received card: [9c]
Player caballeroXXX folds
Player Goomashroom folds
Player allaebalaamballa folds
Player 38979 raises (1)
Player meandkids folds
Player IlxxxlI calls (0.50)
*** FLOP ***: [7s 6c Ah]
Player IlxxxlI checks
Player 38979 bets (1.42)
Player IlxxxlI folds
Uncalled bet (1.42) returned to 38979
Player 38979 mucks cards
------ Summary ------
Pot: 2.14. Rake 0.09. JP fee 0.02
Board: [7s 6c Ah]
*Player 38979 mucks (does not show cards). Bets: 1. Collects: 2.14. Wins: 1.14.
Player meandkids does not show cards.Bets: 0.25. Collects: 0. Loses: 0.25.
Player IlxxxlI does not show cards.Bets: 1. Collects: 0. Loses: 1.
Player caballeroXXX does not show cards.Bets: 0. Collects: 0. Wins: 0.
Player Goomashroom does not show cards.Bets: 0. Collects: 0. Wins: 0.
Player allaebalaamballa does not show cards.Bets: 0. Collects: 0. Wins: 0.
Game ended at: 2016/11/28 19:31:46

Game started
Game ID: 786362424 0.25/0.50 (PRR) Gorgons - 2 (Hold'em)
Seat 4 is the button
Seat 1: DonkReaper (53.67).
Seat 2: legenda99 (60.49).
Seat 3: Goomashroom (87.11).
Seat 4: IlxxxlI (20).
Seat 6: caballeroXXX (60.09).
Player caballeroXXX has small blind (0.25)
Player DonkReaper has big blind (0.50)
Player IlxxxlI received card: [7s]
Player IlxxxlI received card: [Qd]
Player legenda99 raises (1.50)
Player Goomashroom folds
Player IlxxxlI folds
Player caballeroXXX folds
Player DonkReaper folds
Uncalled bet (1) returned to legenda99
Player legenda99 mucks cards
------ Summary ------
Pot: 1.25. Rake 0
Player DonkReaper does not show cards.Bets: 0.50. Collects: 0. Loses: 0.50.
*Player legenda99 mucks (does not show cards). Bets: 0.50. Collects: 1.25. Wins: 0.75.
Player Goomashroom does not show cards.Bets: 0. Collects: 0. Wins: 0.
Player IlxxxlI does not show cards.Bets: 0. Collects: 0. Wins: 0.
Player caballeroXXX does not show cards.Bets: 0.25. Collects: 0. Loses: 0.25.
Game ended at: 2016/11/28 19:31:20

Game started
Game ID: 786362347 0.25/0.50 (PRR) Gorgons - 2 (Hold'em)
Seat 3 is the button
Seat 1: DonkReaper (53.67).
Seat 2: legenda99 (60.49).
Seat 3: Goomashroom (86.36).
Seat 4: IlxxxlI (20).
Seat 6: caballeroXXX (60.59).
Player IlxxxlI has small blind (0.25)
Player caballeroXXX has big blind (0.50)
Player IlxxxlI received card: [Qh]
Player IlxxxlI received card: [6h]
Player DonkReaper folds
Player legenda99 folds
Player Goomashroom raises (1.13)
Player IlxxxlI folds
Player caballeroXXX folds
Uncalled bet (0.63) returned to Goomashroom
Player Goomashroom mucks cards
------ Summary ------
Pot: 1.25. Rake 0
Player DonkReaper does not show cards.Bets: 0. Collects: 0. Wins: 0.
Player legenda99 does not show cards.Bets: 0. Collects: 0. Wins: 0.
*Player Goomashroom mucks (does not show cards). Bets: 0.50. Collects: 1.25. Wins: 0.75.
Player IlxxxlI does not show cards.Bets: 0.25. Collects: 0. Loses: 0.25.
Player caballeroXXX does not show cards.Bets: 0.50. Collects: 0. Loses: 0.50.
Game ended at: 2016/11/28 19:31:4

Game started
Game ID: 786362316 0.25/0.50 (PRR) Garuda - 3 (Hold'em)
Seat 8 is the button
Seat 1: 6betThreat (34.78).
Seat 2: in_ur_i (85.58).
Seat 5: legenda99 (108.07).
Seat 6: flyzlcomb07 (94.65).
Seat 8: allaebalaamballa (20).
Seat 9: IlxxxlI (20).
Player IlxxxlI has small blind (0.25)
Player 6betThreat has big blind (0.50)
Player IlxxxlI received card: [Qs]
Player IlxxxlI received card: [2d]
Player in_ur_i folds
Player legenda99 raises (1.50)
Player flyzlcomb07 calls (1.50)
Player allaebalaamballa folds
Player IlxxxlI folds
Player 6betThreat folds
*** FLOP ***: [5d 2c 3s]
Player legenda99 checks
Player flyzlcomb07 bets (2.38)
Player legenda99 calls (2.38)
*** TURN ***: [5d 2c 3s] [9d]
Player legenda99 checks
Player flyzlcomb07 bets (5.39)
Player legenda99 calls (5.39)
*** RIVER ***: [5d 2c 3s 9d] [5s]
Player legenda99 checks
Player flyzlcomb07 checks
------ Summary ------
Pot: 18.33. Rake 0.72. JP fee 0.24
Board: [5d 2c 3s 9d 5s]
Player 6betThreat does not show cards.Bets: 0.50. Collects: 0. Loses: 0.50.
Player in_ur_i does not show cards.Bets: 0. Collects: 0. Wins: 0.
*Player legenda99 shows: Two pairs. 9s and 5s [As 9h]. Bets: 9.27. Collects: 18.33. Wins: 9.06.
Player flyzlcomb07 shows: Two pairs. 6s and 5s [6c 6d]. Bets: 9.27. Collects: 0. Loses: 9.27.
Player allaebalaamballa does not show cards.Bets: 0. Collects: 0. Wins: 0.
Player IlxxxlI does not show cards.Bets: 0.25. Collects: 0. Loses: 0.25.
Game ended at: 2016/11/28 19:32:8

Game started
Game ID: 786362146 0.25/0.50 (PRR) Gorgons - 2 (Hold'em)
Seat 2 is the button
Seat 1: DonkReaper (50).
Seat 2: legenda99 (63.77).
Seat 3: Goomashroom (86.61).
Seat 4: IlxxxlI (20).
Seat 6: caballeroXXX (60.59).
Player Goomashroom has small blind (0.25)
Player IlxxxlI has big blind (0.50)
Player IlxxxlI received card: [4h]
Player IlxxxlI received card: [2c]
Player caballeroXXX folds
Player DonkReaper raises (1.50)
Player legenda99 calls (1.50)
Player Goomashroom folds
Player IlxxxlI folds
*** FLOP ***: [3c 8s Kd]
Player DonkReaper bets (1.78)
Player legenda99 calls (1.78)
*** TURN ***: [3c 8s Kd] [6c]
Player DonkReaper bets (5)
Player legenda99 folds
Uncalled bet (5) returned to DonkReaper
Player DonkReaper mucks cards
------ Summary ------
Pot: 6.95. Rake 0.24. JP fee 0.12
Board: [3c 8s Kd 6c]
*Player DonkReaper mucks (does not show cards). Bets: 3.28. Collects: 6.95. Wins: 3.67.
Player legenda99 does not show cards.Bets: 3.28. Collects: 0. Loses: 3.28.
Player Goomashroom does not show cards.Bets: 0.25. Collects: 0. Loses: 0.25.
Player IlxxxlI does not show cards.Bets: 0.50. Collects: 0. Loses: 0.50.
Player caballeroXXX does not show cards.Bets: 0. Collects: 0. Wins: 0.
Game ended at: 2016/11/28 19:30:39

Game started
Game ID: 786362070 0.25/0.50 (PRR) Garuda - 3 (Hold'em)
Seat 6 is the button
Seat 1: 6betThreat (32.69).
Seat 2: in_ur_i (85.58).
Seat 5: legenda99 (108.07).
Seat 6: flyzlcomb07 (95.65).
Seat 8: allaebalaamballa (20).
Seat 9: IlxxxlI (20).
Player allaebalaamballa has small blind (0.25)
Player IlxxxlI has big blind (0.50)
Player IlxxxlI received card: [3c]
Player IlxxxlI received card: [Ac]
Player 6betThreat raises (1)
Player in_ur_i folds
Player legenda99 folds
Player flyzlcomb07 calls (1)
Player allaebalaamballa folds
Player IlxxxlI calls (0.50)
*** FLOP ***: [Qs Kc Kd]
Player IlxxxlI checks
Player 6betThreat checks
Player flyzlcomb07 checks
*** TURN ***: [Qs Kc Kd] [5s]
Player IlxxxlI checks
Player 6betThreat bets (1)
Player flyzlcomb07 folds
Player IlxxxlI folds
Uncalled bet (1) returned to 6betThreat
Player 6betThreat mucks cards
------ Summary ------
Pot: 3.09. Rake 0.12. JP fee 0.04
Board: [Qs Kc Kd 5s]
*Player 6betThreat mucks (does not show cards). Bets: 1. Collects: 3.09. Wins: 2.09.
Player in_ur_i does not show cards.Bets: 0. Collects: 0. Wins: 0.
Player legenda99 does not show cards.Bets: 0. Collects: 0. Wins: 0.
Player flyzlcomb07 does not show cards.Bets: 1. Collects: 0. Loses: 1.
Player allaebalaamballa does not show cards.Bets: 0.25. Collects: 0. Loses: 0.25.
Player IlxxxlI does not show cards.Bets: 1. Collects: 0. Loses: 1.
Game ended at: 2016/11/28 19:30:31

Game started
Game ID: 786361848 0.25/0.50 (PRR) Garuda - 3 (Hold'em)
Seat 5 is the button
Seat 1: 6betThreat (32.69).
Seat 2: in_ur_i (78.37).
Seat 5: legenda99 (108.07).
Seat 6: flyzlcomb07 (103.13).
Seat 8: allaebalaamballa (20).
Seat 9: IlxxxlI (20).
Player flyzlcomb07 has small blind (0.25)
Player allaebalaamballa has big blind (0.50)
Player IlxxxlI received card: [4s]
Player IlxxxlI received card: [8c]
Player IlxxxlI folds
Player 6betThreat folds
Player in_ur_i raises (1.50)
Player legenda99 folds
Player flyzlcomb07 calls (1.25)
Player allaebalaamballa folds
*** FLOP ***: [7h 6c Qh]
Player flyzlcomb07 checks
Player in_ur_i bets (1.66)
Player flyzlcomb07 calls (1.66)
*** TURN ***: [7h 6c Qh] [Jh]
Player flyzlcomb07 checks
Player in_ur_i checks
*** RIVER ***: [7h 6c Qh Jh] [Ah]
Player flyzlcomb07 bets (4.32)
Player in_ur_i calls (4.32)
------ Summary ------
Pot: 14.69. Rake 0.53. JP fee 0.24
Board: [7h 6c Qh Jh Ah]
Player 6betThreat does not show cards.Bets: 0. Collects: 0. Wins: 0.
*Player in_ur_i shows: One pair of Qs [9s Qs]. Bets: 7.48. Collects: 14.69. Wins: 7.21.
Player legenda99 does not show cards.Bets: 0. Collects: 0. Wins: 0.
Player flyzlcomb07 shows: One pair of 3s [3c 3d]. Bets: 7.48. Collects: 0. Loses: 7.48.
Player allaebalaamballa does not show cards.Bets: 0.50. Collects: 0. Loses: 0.50.
Player IlxxxlI does not show cards.Bets: 0. Collects: 0. Wins: 0.
Game ended at: 2016/11/28 19:29:19

Game started
Game ID: 786361579 0.25/0.50 (PRR) Garuda - 3 (Hold'em)
Seat 2 is the button
Seat 1: 6betThreat (55.69).
Seat 2: in_ur_i (78.37).
Seat 5: legenda99 (86.89).
Seat 6: flyzlcomb07 (103.63).
Seat 8: allaebalaamballa (20).
Seat 9: IlxxxlI (20).
Player legenda99 has small blind (0.25)
Player flyzlcomb07 has big blind (0.50)
Player IlxxxlI received card: [4h]
Player IlxxxlI received card: [5c]
Player allaebalaamballa folds
Player IlxxxlI folds
Player 6betThreat raises (1)
Player in_ur_i folds
Player legenda99 raises (3.25)
Player flyzlcomb07 folds
Player 6betThreat calls (2.50)
*** FLOP ***: [Kh 9c Ac]
Player legenda99 bets (4)
Player 6betThreat raises (8)
Player legenda99 raises (15.50)
Player 6betThreat calls (11.50)
*** TURN ***: [Kh 9c Ac] [8s]
Player legenda99 allin (63.89)
Player 6betThreat folds
Uncalled bet (63.89) returned to legenda99
Player legenda99 mucks cards
------ Summary ------
Pot: 44.18. Rake 2.08. JP fee 0.24
Board: [Kh 9c Ac 8s]
Player 6betThreat does not show cards.Bets: 23. Collects: 0. Loses: 23.
Player in_ur_i does not show cards.Bets: 0. Collects: 0. Wins: 0.
*Player legenda99 mucks (does not show cards). Bets: 23. Collects: 44.18. Wins: 21.18.
Player flyzlcomb07 does not show cards.Bets: 0.50. Collects: 0. Loses: 0.50.
Player allaebalaamballa does not show cards.Bets: 0. Collects: 0. Wins: 0.
Player IlxxxlI does not show cards.Bets: 0. Collects: 0. Wins: 0.
Game ended at: 2016/11/28 19:28:17

Game started
Game ID: 786361457 0.25/0.50 (PRR) Gorgons - 2 (Hold'em)
Seat 4 is the button
Seat 1: DonkReaper (54.77).
Seat 2: legenda99 (50).
Seat 3: Goomashroom (87.61).
Seat 4: IlxxxlI (20).
Seat 6: caballeroXXX (60.09).
Player caballeroXXX has small blind (0.25)
Player DonkReaper has big blind (0.50)
Player IlxxxlI received card: [9c]
Player IlxxxlI received card: [Qc]
Player legenda99 folds
Player Goomashroom raises (1.25)
Player IlxxxlI is timed out.
Player IlxxxlI folds
Player caballeroXXX folds
Player DonkReaper folds
Uncalled bet (0.75) returned to Goomashroom
Player Goomashroom mucks cards
------ Summary ------
Pot: 1.25. Rake 0
Player DonkReaper does not show cards.Bets: 0.50. Collects: 0. Loses: 0.50.
Player legenda99 does not show cards.Bets: 0. Collects: 0. Wins: 0.
*Player Goomashroom mucks (does not show cards). Bets: 0.50. Collects: 1.25. Wins: 0.75.
Player IlxxxlI does not show cards.Bets: 0. Collects: 0. Wins: 0.
Player caballeroXXX does not show cards.Bets: 0.25. Collects: 0. Loses: 0.25.
Game ended at: 2016/11/28 19:27:4

Game started
Game ID: 786361269 0.25/0.50 (PRR) Garuda - 3 (Hold'em)
Seat 1 is the button
Seat 1: 6betThreat (55.69).
Seat 2: in_ur_i (78.62).
Seat 5: legenda99 (87.39).
Seat 6: flyzlcomb07 (97.39).
Seat 8: allaebalaamballa (20).
Seat 9: IlxxxlI (20).
Player in_ur_i has small blind (0.25)
Player legenda99 has big blind (0.50)
Player IlxxxlI received card: [Kh]
Player IlxxxlI received card: [Ad]
Player flyzlcomb07 raises (1.50)
Player allaebalaamballa folds
Player IlxxxlI raises (3.64)
Player 6betThreat folds
Player in_ur_i folds
Player legenda99 folds
Player flyzlcomb07 calls (2.14)
*** FLOP ***: [5c 3h Jh]
Player flyzlcomb07 checks
Player IlxxxlI bets (2.50)
Player flyzlcomb07 allin (93.75)
Player IlxxxlI is timed out.
Player IlxxxlI folds
Uncalled bet (91.25) returned to flyzlcomb07
Player flyzlcomb07 mucks cards
------ Summary ------
Pot: 12.38. Rake 0.45. JP fee 0.20
Board: [5c 3h Jh]
Player 6betThreat does not show cards.Bets: 0. Collects: 0. Wins: 0.
Player in_ur_i does not show cards.Bets: 0.25. Collects: 0. Loses: 0.25.
Player legenda99 does not show cards.Bets: 0.50. Collects: 0. Loses: 0.50.
*Player flyzlcomb07 mucks (does not show cards). Bets: 6.14. Collects: 12.38. Wins: 6.24.
Player allaebalaamballa does not show cards.Bets: 0. Collects: 0. Wins: 0.
Player IlxxxlI does not show cards.Bets: 6.14. Collects: 0. Loses: 6.14.
Game ended at: 2016/11/28 19:27:1

Game started
Game ID: 786361124 0.25/0.50 (PRR) Gorgons - 2 (Hold'em)
Seat 3 is the button
Seat 1: DonkReaper (54.77).
Seat 2: legenda99 (50).
Seat 3: Goomashroom (87.61).
Seat 4: IlxxxlI (20).
Seat 6: caballeroXXX (58.50).
Player IlxxxlI has small blind (0.25)
Player caballeroXXX has big blind (0.50)
Player IlxxxlI received card: [4d]
Player IlxxxlI received card: [9d]
Player DonkReaper folds
Player legenda99 raises (1.50)
Player Goomashroom folds
Player IlxxxlI is timed out.
Player IlxxxlI folds
Player caballeroXXX calls (1)
*** FLOP ***: [10d Qh 3h]
Player caballeroXXX checks
Player legenda99 checks
*** TURN ***: [10d Qh 3h] [7h]
Player caballeroXXX bets (2.75)
Player legenda99 folds
Uncalled bet (2.75) returned to caballeroXXX
Player caballeroXXX mucks cards
------ Summary ------
Pot: 3.09. Rake 0.12. JP fee 0.04
Board: [10d Qh 3h 7h]
Player DonkReaper does not show cards.Bets: 0. Collects: 0. Wins: 0.
Player legenda99 does not show cards.Bets: 1.50. Collects: 0. Loses: 1.50.
Player Goomashroom does not show cards.Bets: 0. Collects: 0. Wins: 0.
Player IlxxxlI does not show cards.Bets: 0.25. Collects: 0. Loses: 0.25.
*Player caballeroXXX mucks (does not show cards). Bets: 1.50. Collects: 3.09. Wins: 1.59.
Game ended at: 2016/11/28 19:26:25

Game started
Game ID: 786361111 0.25/0.50 (PRR) Garuda - 3 (Hold'em)
Seat 9 is the button
Seat 1: 6betThreat (55.94).
Seat 2: in_ur_i (80.12).
Seat 5: legenda99 (88.89).
Seat 6: flyzlcomb07 (94.37).
Seat 8: allaebalaamballa (20).
Seat 9: IlxxxlI (20).
Player 6betThreat has small blind (0.25)
Player in_ur_i has big blind (0.50)
Player IlxxxlI received card: [9d]
Player IlxxxlI received card: [4d]
Player legenda99 raises (1.50)
Player flyzlcomb07 calls (1.50)
Player allaebalaamballa folds
Player IlxxxlI folds
Player 6betThreat folds
Player in_ur_i calls (1)
*** FLOP ***: [4c 3c 8d]
Player in_ur_i checks
Player legenda99 checks
Player flyzlcomb07 bets (2.26)
Player in_ur_i folds
Player legenda99 folds
Uncalled bet (2.26) returned to flyzlcomb07
Player flyzlcomb07 mucks cards
------ Summary ------
Pot: 4.52. Rake 0.17. JP fee 0.06
Board: [4c 3c 8d]
Player 6betThreat does not show cards.Bets: 0.25. Collects: 0. Loses: 0.25.
Player in_ur_i does not show cards.Bets: 1.50. Collects: 0. Loses: 1.50.
Player legenda99 does not show cards.Bets: 1.50. Collects: 0. Loses: 1.50.
*Player flyzlcomb07 mucks (does not show cards). Bets: 1.50. Collects: 4.52. Wins: 3.02.
Player allaebalaamballa does not show cards.Bets: 0. Collects: 0. Wins: 0.
Player IlxxxlI does not show cards.Bets: 0. Collects: 0. Wins: 0.
Game ended at: 2016/11/28 19:25:36

Game started
Game ID: 786360712 0.25/0.50 (PRR) Garuda - 3 (Hold'em)
Seat 8 is the button
Seat 1: 6betThreat (46.50).
Seat 2: in_ur_i (80.12).
Seat 3: Scalloperik (26.86).
Seat 5: legenda99 (88.89).
Seat 6: flyzlcomb07 (99.34).
Seat 8: allaebalaamballa (20).
Seat 9: IlxxxlI (20.25).
Player IlxxxlI has small blind (0.25)
Player 6betThreat has big blind (0.50)
Player IlxxxlI received card: [Ks]
Player IlxxxlI received card: [8d]
Player in_ur_i folds
Player Scalloperik calls (0.50)
Player legenda99 folds
Player flyzlcomb07 raises (2)
Player allaebalaamballa folds
Player IlxxxlI is timed out.
Player IlxxxlI folds
Player 6betThreat calls (1.50)
Player Scalloperik calls (1.50)
*** FLOP ***: [2h 3c 9h]
Player 6betThreat checks
Player Scalloperik checks
Player flyzlcomb07 bets (2.97)
Player 6betThreat calls (2.97)
Player Scalloperik calls (2.97)
*** TURN ***: [2h 3c 9h] [5d]
Player 6betThreat checks
Player Scalloperik checks
Player flyzlcomb07 checks
*** RIVER ***: [2h 3c 9h 5d] [As]
Player 6betThreat checks
Player Scalloperik checks
Player flyzlcomb07 checks
Player Scalloperik mucks cards
Player flyzlcomb07 mucks cards
------ Summary ------
Pot: 14.41. Rake 0.51. JP fee 0.24
Board: [2h 3c 9h 5d As]
*Player 6betThreat shows: One pair of 2s [10c 2c]. Bets: 4.97. Collects: 14.41. Wins: 9.44.
Player in_ur_i does not show cards.Bets: 0. Collects: 0. Wins: 0.
Player Scalloperik mucks (does not show cards). Bets: 4.97. Collects: 0. Loses: 4.97.
Player legenda99 does not show cards.Bets: 0. Collects: 0. Wins: 0.
Player flyzlcomb07 mucks (does not show cards). Bets: 4.97. Collects: 0. Loses: 4.97.
Player allaebalaamballa does not show cards.Bets: 0. Collects: 0. Wins: 0.
Player IlxxxlI does not show cards.Bets: 0.25. Collects: 0. Loses: 0.25.
Game ended at: 2016/11/28 19:24:53

Game started
Game ID: 786360667 0.25/0.50 (PRR) Gorgons - 2 (Hold'em)
Seat 2 is the button
Seat 1: DonkReaper (50).
Seat 2: legenda99 (53.61).
Seat 3: Goomashroom (87.86).
Seat 4: IlxxxlI (20).
Seat 6: caballeroXXX (58.50).
Player Goomashroom has small blind (0.25)
Player IlxxxlI has big blind (0.50)
Player IlxxxlI received card: [7s]
Player IlxxxlI received card: [4h]
Player caballeroXXX folds
Player DonkReaper raises (1.50)
Player legenda99 raises (4.50)
Player Goomashroom folds
Player IlxxxlI is timed out.
Player IlxxxlI folds
Player DonkReaper calls (3)
*** FLOP ***: [5c As 9s]
Player DonkReaper checks
Player legenda99 checks
*** TURN ***: [5c As 9s] [2d]
Player DonkReaper bets (6.18)
Player legenda99 folds
Uncalled bet (6.18) returned to DonkReaper
Player DonkReaper mucks cards
------ Summary ------
Pot: 9.27. Rake 0.32. JP fee 0.16
Board: [5c As 9s 2d]
*Player DonkReaper mucks (does not show cards). Bets: 4.50. Collects: 9.27. Wins: 4.77.
Player legenda99 does not show cards.Bets: 4.50. Collects: 0. Loses: 4.50.
Player Goomashroom does not show cards.Bets: 0.25. Collects: 0. Loses: 0.25.
Player IlxxxlI does not show cards.Bets: 0.50. Collects: 0. Loses: 0.50.
Player caballeroXXX does not show cards.Bets: 0. Collects: 0. Wins: 0.
Game ended at: 2016/11/28 19:24:58

Game started
Game ID: 786360637 0.25/0.50 (PRR) Garuda - 3 (Hold'em)
Seat 6 is the button
Seat 1: 6betThreat (46.50).
Seat 2: in_ur_i (80.12).
Seat 3: Scalloperik (26.86).
Seat 5: legenda99 (88.89).
Seat 6: flyzlcomb07 (99.34).
Seat 8: allaebalaamballa (20).
Seat 9: IlxxxlI (20).
Player allaebalaamballa has small blind (0.25)
Player IlxxxlI has big blind (0.50)
Player IlxxxlI received card: [5d]
Player IlxxxlI received card: [2d]
Player 6betThreat folds
Player in_ur_i folds
Player Scalloperik folds
Player legenda99 folds
Player flyzlcomb07 folds
Player allaebalaamballa folds
Uncalled bet (0.25) returned to IlxxxlI
Player IlxxxlI mucks cards
------ Summary ------
Pot: 0.50. Rake 0
Player 6betThreat does not show cards.Bets: 0. Collects: 0. Wins: 0.
Player in_ur_i does not show cards.Bets: 0. Collects: 0. Wins: 0.
Player Scalloperik does not show cards.Bets: 0. Collects: 0. Wins: 0.
Player legenda99 does not show cards.Bets: 0. Collects: 0. Wins: 0.
Player flyzlcomb07 does not show cards.Bets: 0. Collects: 0. Wins: 0.
Player allaebalaamballa does not show cards.Bets: 0.25. Collects: 0. Loses: 0.25.
*Player IlxxxlI mucks (does not show cards). Bets: 0.25. Collects: 0.50. Wins: 0.25.
Game ended at: 2016/11/28 19:23:2

Game started
Game ID: 786360507 1/2 (PRR) Lakhey (Hold'em)
Seat 5 is the button
Seat 1: JJaromir (227.77).
Seat 2: dscshift (109.98).
Seat 3: IlxxxlI (101.65).
Seat 4: Are you with me (79.58).
Seat 5: Orondi (200).
Seat 6: 38979 (200).
Player 38979 has small blind (1)
Player JJaromir has big blind (2)
Player IlxxxlI received card: [6h]
Player IlxxxlI received card: [Kd]
Player dscshift folds
Player IlxxxlI folds
Player Are you with me raises (5)
Player Orondi folds
Player 38979 folds
Player JJaromir calls (3)
*** FLOP ***: [Ah 8h 9c]
Player JJaromir checks
Player Are you with me checks
*** TURN ***: [Ah 8h 9c] [2s]
Player JJaromir bets (8)
Player Are you with me calls (8)
*** RIVER ***: [Ah 8h 9c 2s] [6s]
Player JJaromir bets (14)
Player Are you with me folds
Uncalled bet (14) returned to JJaromir
Player JJaromir mucks cards
------ Summary ------
Pot: 25.65. Rake 1.11. JP fee 0.24
Board: [Ah 8h 9c 2s 6s]
*Player JJaromir mucks (does not show cards). Bets: 13. Collects: 25.65. Wins: 12.65.
Player dscshift does not show cards.Bets: 0. Collects: 0. Wins: 0.
Player IlxxxlI does not show cards.Bets: 0. Collects: 0. Wins: 0.
Player Are you with me does not show cards.Bets: 13. Collects: 0. Loses: 13.
Player Orondi does not show cards.Bets: 0. Collects: 0. Wins: 0.
Player 38979 does not show cards.Bets: 1. Collects: 0. Loses: 1.
Game ended at: 2016/11/28 19:23:18

Game started
Game ID: 786360313 1/2 (PRR) Lakhey (Hold'em)
Seat 4 is the button
Seat 1: JJaromir (227.77).
Seat 2: dscshift (109.98).
Seat 3: IlxxxlI (88).
Seat 4: Are you with me (91.58).
Seat 5: Orondi (200).
Seat 6: 38979 (200).
Player Orondi has small blind (1)
Player 38979 has big blind (2)
Player IlxxxlI received card: [Ad]
Player IlxxxlI received card: [Kd]
Player JJaromir folds
Player dscshift folds
Player IlxxxlI raises (4)
Player Are you with me raises (12)
Player Orondi folds
Player 38979 folds
Player IlxxxlI calls (8)
*** FLOP ***: [3s 7d Ah]
Player IlxxxlI checks
Player Are you with me checks
*** TURN ***: [3s 7d Ah] [As]
Player IlxxxlI bets (12.82)
Player Are you with me folds
Uncalled bet (12.82) returned to IlxxxlI
Player IlxxxlI mucks cards
------ Summary ------
Pot: 25.65. Rake 1.11. JP fee 0.24
Board: [3s 7d Ah As]
Player JJaromir does not show cards.Bets: 0. Collects: 0. Wins: 0.
Player dscshift does not show cards.Bets: 0. Collects: 0. Wins: 0.
*Player IlxxxlI mucks (does not show cards). Bets: 12. Collects: 25.65. Wins: 13.65.
Player Are you with me does not show cards.Bets: 12. Collects: 0. Loses: 12.
Player Orondi does not show cards.Bets: 1. Collects: 0. Loses: 1.
Player 38979 does not show cards.Bets: 2. Collects: 0. Loses: 2.
Game ended at: 2016/11/28 19:22:1

Game started
Game ID: 786360141 1/2 (PRR) Lakhey (Hold'em)
Seat 3 is the button
Seat 1: JJaromir (224.77).
Seat 2: dscshift (34.98).
Seat 3: IlxxxlI (88).
Seat 4: Are you with me (92.58).
Seat 5: Orondi (200).
Seat 6: 38979 (200).
Player Are you with me has small blind (1)
Player Orondi has big blind (2)
Player IlxxxlI received card: [5c]
Player IlxxxlI received card: [Kh]
Player 38979 folds
Player JJaromir raises (6)
Player dscshift folds
Player IlxxxlI folds
Player Are you with me folds
Player Orondi folds
Uncalled bet (4) returned to JJaromir
Player JJaromir mucks cards
------ Summary ------
Pot: 5. Rake 0
*Player JJaromir mucks (does not show cards). Bets: 2. Collects: 5. Wins: 3.
Player dscshift does not show cards.Bets: 0. Collects: 0. Wins: 0.
Player IlxxxlI does not show cards.Bets: 0. Collects: 0. Wins: 0.
Player Are you with me does not show cards.Bets: 1. Collects: 0. Loses: 1.
Player Orondi does not show cards.Bets: 2. Collects: 0. Loses: 2.
Player 38979 does not show cards.Bets: 0. Collects: 0. Wins: 0.
Game ended at: 2016/11/28 19:21:4

Game started
Game ID: 786360052 1/2 (PRR) Lakhey (Hold'em)
Seat 2 is the button
Seat 1: JJaromir (221.77).
Seat 2: dscshift (34.98).
Seat 3: IlxxxlI (89).
Seat 4: Are you with me (94.58).
Seat 6: 38979 (200).
Player IlxxxlI has small blind (1)
Player Are you with me has big blind (2)
Player IlxxxlI received card: [9h]
Player IlxxxlI received card: [Ac]
Player 38979 folds
Player JJaromir raises (4)
Player dscshift folds
Player IlxxxlI folds
Player Are you with me folds
Uncalled bet (2) returned to JJaromir
Player JJaromir is timed out.
Player JJaromir mucks cards
------ Summary ------
Pot: 5. Rake 0
*Player JJaromir mucks (does not show cards). Bets: 2. Collects: 5. Wins: 3.
Player dscshift does not show cards.Bets: 0. Collects: 0. Wins: 0.
Player IlxxxlI does not show cards.Bets: 1. Collects: 0. Loses: 1.
Player Are you with me does not show cards.Bets: 2. Collects: 0. Loses: 2.
Player 38979 does not show cards.Bets: 0. Collects: 0. Wins: 0.
Game ended at: 2016/11/28 19:20:16

Game started
Game ID: 786359865 1/2 (PRR) Lakhey (Hold'em)
Seat 1 is the button
Seat 1: JJaromir (221.77).
Seat 2: dscshift (44.98).
Seat 3: IlxxxlI (80).
Seat 4: Are you with me (94.58).
Seat 6: 38979 (200).
Player dscshift has small blind (1)
Player IlxxxlI has big blind (2)
Player IlxxxlI received card: [5d]
Player IlxxxlI received card: [Kh]
Player Are you with me folds
Player 38979 folds
Player JJaromir folds
Player dscshift calls (1)
Player IlxxxlI checks
*** FLOP ***: [7h 8c Kd]
Player dscshift checks
Player IlxxxlI bets (2)
Player dscshift calls (2)
*** TURN ***: [7h 8c Kd] [9s]
Player dscshift bets (6)
Player IlxxxlI calls (6)
*** RIVER ***: [7h 8c Kd 9s] [10d]
Player dscshift checks
Player IlxxxlI checks
------ Summary ------
Pot: 19. Rake 0.76. JP fee 0.24
Board: [7h 8c Kd 9s 10d]
Player JJaromir does not show cards.Bets: 0. Collects: 0. Wins: 0.
Player dscshift shows: One pair of 8s [8h 4h]. Bets: 10. Collects: 0. Loses: 10.
*Player IlxxxlI shows: One pair of Ks [5d Kh]. Bets: 10. Collects: 19. Wins: 9.
Player Are you with me does not show cards.Bets: 0. Collects: 0. Wins: 0.
Player 38979 does not show cards.Bets: 0. Collects: 0. Wins: 0.
Game ended at: 2016/11/28 19:19:46

Game started
Game ID: 786359208 0.25/0.50 (PRR) Gorgons - 17 (Hold'em)
Seat 6 is the button
Seat 1: caballeroXXX (51.75).
Seat 2: ILiK3PaStA (50).
Seat 3: Goomashroom (50.75).
Seat 4: IlxxxlI (41.43).
Seat 5: allaebalaamballa (20).
Seat 6: 38979 (50).
Player caballeroXXX has small blind (0.25)
Player ILiK3PaStA has big blind (0.50)
Player IlxxxlI received card: [10c]
Player IlxxxlI received card: [Qc]
Player Goomashroom folds
Player IlxxxlI raises (1)
Player allaebalaamballa folds
Player 38979 folds
Player caballeroXXX folds
Player ILiK3PaStA calls (0.50)
*** FLOP ***: [Qd 8h Qs]
Player ILiK3PaStA checks
Player IlxxxlI checks
*** TURN ***: [Qd 8h Qs] [Ac]
Player ILiK3PaStA checks
Player IlxxxlI bets (2.50)
Player ILiK3PaStA folds
Uncalled bet (2.50) returned to IlxxxlI
Player IlxxxlI mucks cards
------ Summary ------
Pot: 2.14. Rake 0.09. JP fee 0.02
Board: [Qd 8h Qs Ac]
Player caballeroXXX does not show cards.Bets: 0.25. Collects: 0. Loses: 0.25.
Player ILiK3PaStA does not show cards.Bets: 1. Collects: 0. Loses: 1.
Player Goomashroom does not show cards.Bets: 0. Collects: 0. Wins: 0.
*Player IlxxxlI mucks (does not show cards). Bets: 1. Collects: 2.14. Wins: 1.14.
Player allaebalaamballa does not show cards.Bets: 0. Collects: 0. Wins: 0.
Player 38979 does not show cards.Bets: 0. Collects: 0. Wins: 0.
Game ended at: 2016/11/28 19:16:53

Game started
Game ID: 786359124 0.25/0.50 (PRR) Gorgons - 17 (Hold'em)
Seat 5 is the button
Seat 1: caballeroXXX (51.50).
Seat 2: ILiK3PaStA (50).
Seat 3: Goomashroom (50.75).
Seat 4: IlxxxlI (41.43).
Seat 5: allaebalaamballa (20).
Seat 6: 38979 (50).
Player 38979 has small blind (0.25)
Player caballeroXXX has big blind (0.50)
Player IlxxxlI received card: [2c]
Player IlxxxlI received card: [Ah]
Player ILiK3PaStA folds
Player Goomashroom folds
Player IlxxxlI folds
Player allaebalaamballa folds
Player 38979 folds
Uncalled bet (0.25) returned to caballeroXXX
Player caballeroXXX mucks cards
------ Summary ------
Pot: 0.50. Rake 0
*Player caballeroXXX mucks (does not show cards). Bets: 0.25. Collects: 0.50. Wins: 0.25.
Player ILiK3PaStA does not show cards.Bets: 0. Collects: 0. Wins: 0.
Player Goomashroom does not show cards.Bets: 0. Collects: 0. Wins: 0.
Player IlxxxlI does not show cards.Bets: 0. Collects: 0. Wins: 0.
Player allaebalaamballa does not show cards.Bets: 0. Collects: 0. Wins: 0.
Player 38979 does not show cards.Bets: 0.25. Collects: 0. Loses: 0.25.
Game ended at: 2016/11/28 19:15:51

Game started
Game ID: 786358874 0.25/0.50 (PRR) Gorgons - 5 (Hold'em)
Seat 4 is the button
Seat 1: SenNoSen (57.47).
Seat 2: 38979 (56.33).
Seat 3: IlxxxlI (35.55).
Seat 4: Goomashroom (106.56).
Seat 5: legenda99 (50).
Seat 6: IWantYourChips (50).
Player legenda99 has small blind (0.25)
Player IWantYourChips has big blind (0.50)
Player IlxxxlI received card: [9s]
Player IlxxxlI received card: [Kc]
Player SenNoSen folds
Player 38979 folds
Player IlxxxlI folds
Player Goomashroom folds
Player legenda99 folds
Uncalled bet (0.25) returned to IWantYourChips
Player IWantYourChips mucks cards
------ Summary ------
Pot: 0.50. Rake 0
Player SenNoSen does not show cards.Bets: 0. Collects: 0. Wins: 0.
Player 38979 does not show cards.Bets: 0. Collects: 0. Wins: 0.
Player IlxxxlI does not show cards.Bets: 0. Collects: 0. Wins: 0.
Player Goomashroom does not show cards.Bets: 0. Collects: 0. Wins: 0.
Player legenda99 does not show cards.Bets: 0.25. Collects: 0. Loses: 0.25.
*Player IWantYourChips mucks (does not show cards). Bets: 0.25. Collects: 0.50. Wins: 0.25.
Game ended at: 2016/11/28 19:14:21

Game started
Game ID: 786358771 0.25/0.50 (PRR) Gorgons - 17 (Hold'em)
Seat 4 is the button
Seat 1: caballeroXXX (51.50).
Seat 2: ILiK3PaStA (50.75).
Seat 3: Goomashroom (50.75).
Seat 4: IlxxxlI (23.34).
Seat 5: allaebalaamballa (20).
Seat 6: 38979 (50).
Player allaebalaamballa has small blind (0.25)
Player 38979 has big blind (0.50)
Player IlxxxlI received card: [10h]
Player IlxxxlI received card: [Ah]
Player caballeroXXX folds
Player ILiK3PaStA raises (1.25)
Player Goomashroom folds
Player IlxxxlI calls (1.25)
Player allaebalaamballa folds
Player 38979 folds
*** FLOP ***: [2s Qd 10c]
Player ILiK3PaStA checks
Player IlxxxlI bets (1.54)
Player ILiK3PaStA calls (1.54)
*** TURN ***: [2s Qd 10c] [4s]
Player ILiK3PaStA checks
Player IlxxxlI bets (3.01)
Player ILiK3PaStA calls (3.01)
*** RIVER ***: [2s Qd 10c 4s] [10d]
Player ILiK3PaStA checks
Player IlxxxlI bets (13.50)
Player ILiK3PaStA calls (13.50)
Player ILiK3PaStA mucks cards
------ Summary ------
Pot: 37.39. Rake 1.72. JP fee 0.24
Board: [2s Qd 10c 4s 10d]
Player caballeroXXX does not show cards.Bets: 0. Collects: 0. Wins: 0.
Player ILiK3PaStA mucks (does not show cards). Bets: 19.30. Collects: 0. Loses: 19.30.
Player Goomashroom does not show cards.Bets: 0. Collects: 0. Wins: 0.
*Player IlxxxlI shows: Three Of Kind of 10s [10h Ah]. Bets: 19.30. Collects: 37.39. Wins: 18.09.
Player allaebalaamballa does not show cards.Bets: 0.25. Collects: 0. Loses: 0.25.
Player 38979 does not show cards.Bets: 0.50. Collects: 0. Loses: 0.50.
Game ended at: 2016/11/28 19:15:21

Game started
Game ID: 786358762 0.25/0.50 (PRR) Gorgons - 5 (Hold'em)
Seat 3 is the button
Seat 1: SenNoSen (57.47).
Seat 2: 38979 (56.33).
Seat 3: IlxxxlI (37.05).
Seat 4: Goomashroom (104.56).
Seat 5: legenda99 (50).
Player Goomashroom has small blind (0.25)
Player legenda99 has big blind (0.50)
Player IlxxxlI received card: [Qh]
Player IlxxxlI received card: [10d]
Player SenNoSen folds
Player 38979 folds
Player IlxxxlI raises (1.50)
Player Goomashroom raises (5)
Player legenda99 folds
Player IlxxxlI folds
Uncalled bet (3.75) returned to Goomashroom
Player Goomashroom mucks cards
------ Summary ------
Pot: 3.50. Rake 0
Player SenNoSen does not show cards.Bets: 0. Collects: 0. Wins: 0.
Player 38979 does not show cards.Bets: 0. Collects: 0. Wins: 0.
Player IlxxxlI does not show cards.Bets: 1.50. Collects: 0. Loses: 1.50.
*Player Goomashroom mucks (does not show cards). Bets: 1.50. Collects: 3.50. Wins: 2.
Player legenda99 does not show cards.Bets: 0.50. Collects: 0. Loses: 0.50.
Game ended at: 2016/11/28 19:13:55

Game started
Game ID: 786358687 0.25/0.50 (PRR) Gorgons - 17 (Hold'em)
Seat 3 is the button
Seat 1: caballeroXXX (51.50).
Seat 2: ILiK3PaStA (50).
Seat 3: Goomashroom (50.75).
Seat 4: IlxxxlI (23.59).
Seat 5: allaebalaamballa (20).
Seat 6: 38979 (50).
Player IlxxxlI has small blind (0.25)
Player allaebalaamballa has big blind (0.50)
Player IlxxxlI received card: [3h]
Player IlxxxlI received card: [Ad]
Player 38979 folds
Player caballeroXXX folds
Player ILiK3PaStA raises (1.25)
Player Goomashroom folds
Player IlxxxlI folds
Player allaebalaamballa folds
Uncalled bet (0.75) returned to ILiK3PaStA
Player ILiK3PaStA mucks cards
------ Summary ------
Pot: 1.25. Rake 0
Player caballeroXXX does not show cards.Bets: 0. Collects: 0. Wins: 0.
*Player ILiK3PaStA mucks (does not show cards). Bets: 0.50. Collects: 1.25. Wins: 0.75.
Player Goomashroom does not show cards.Bets: 0. Collects: 0. Wins: 0.
Player IlxxxlI does not show cards.Bets: 0.25. Collects: 0. Loses: 0.25.
Player allaebalaamballa does not show cards.Bets: 0.50. Collects: 0. Loses: 0.50.
Player 38979 does not show cards.Bets: 0. Collects: 0. Wins: 0.
Game ended at: 2016/11/28 19:13:21

Game started
Game ID: 786358587 0.25/0.50 (PRR) Gorgons - 5 (Hold'em)
Seat 2 is the button
Seat 1: SenNoSen (57.47).
Seat 2: 38979 (54.08).
Seat 3: IlxxxlI (37.30).
Seat 4: Goomashroom (105.06).
Seat 5: legenda99 (50.75).
Player IlxxxlI has small blind (0.25)
Player Goomashroom has big blind (0.50)
Player IlxxxlI received card: [10d]
Player IlxxxlI received card: [Jd]
Player legenda99 raises (1.50)
Player SenNoSen folds
Player 38979 raises (5.50)
Player IlxxxlI folds
Player Goomashroom folds
Player legenda99 folds
Uncalled bet (4) returned to 38979
Player 38979 mucks cards
------ Summary ------
Pot: 3.75. Rake 0
Player SenNoSen does not show cards.Bets: 0. Collects: 0. Wins: 0.
*Player 38979 mucks (does not show cards). Bets: 1.50. Collects: 3.75. Wins: 2.25.
Player IlxxxlI does not show cards.Bets: 0.25. Collects: 0. Loses: 0.25.
Player Goomashroom does not show cards.Bets: 0.50. Collects: 0. Loses: 0.50.
Player legenda99 does not show cards.Bets: 1.50. Collects: 0. Loses: 1.50.
Game ended at: 2016/11/28 19:13:17

Game started
Game ID: 786358573 0.25/0.50 (PRR) Gorgons - 17 (Hold'em)
Seat 2 is the button
Seat 1: caballeroXXX (50.75).
Seat 2: ILiK3PaStA (50).
Seat 3: Goomashroom (51).
Seat 4: IlxxxlI (24.09).
Seat 6: 38979 (50).
Player Goomashroom has small blind (0.25)
Player IlxxxlI has big blind (0.50)
Player IlxxxlI received card: [3h]
Player IlxxxlI received card: [2c]
Player 38979 folds
Player caballeroXXX raises (1.25)
Player ILiK3PaStA folds
Player Goomashroom folds
Player IlxxxlI folds
Uncalled bet (0.75) returned to caballeroXXX
Player caballeroXXX mucks cards
------ Summary ------
Pot: 1.25. Rake 0
*Player caballeroXXX mucks (does not show cards). Bets: 0.50. Collects: 1.25. Wins: 0.75.
Player ILiK3PaStA does not show cards.Bets: 0. Collects: 0. Wins: 0.
Player Goomashroom does not show cards.Bets: 0.25. Collects: 0. Loses: 0.25.
Player IlxxxlI does not show cards.Bets: 0.50. Collects: 0. Loses: 0.50.
Player 38979 does not show cards.Bets: 0. Collects: 0. Wins: 0.
Game ended at: 2016/11/28 19:12:55

Game started
Game ID: 786358493 0.25/0.50 (PRR) Gorgons - 17 (Hold'em)
Seat 1 is the button
Seat 1: caballeroXXX (50).
Seat 2: ILiK3PaStA (50).
Seat 3: Goomashroom (51.50).
Seat 4: IlxxxlI (24.09).
Seat 6: 38979 (50).
Player ILiK3PaStA has small blind (0.25)
Player Goomashroom has big blind (0.50)
Player IlxxxlI received card: [7d]
Player IlxxxlI received card: [8d]
Player IlxxxlI folds
Player 38979 folds
Player caballeroXXX raises (1)
Player ILiK3PaStA folds
Player Goomashroom folds
Uncalled bet (0.50) returned to caballeroXXX
Player caballeroXXX mucks cards
------ Summary ------
Pot: 1.25. Rake 0
*Player caballeroXXX mucks (does not show cards). Bets: 0.50. Collects: 1.25. Wins: 0.75.
Player ILiK3PaStA does not show cards.Bets: 0.25. Collects: 0. Loses: 0.25.
Player Goomashroom does not show cards.Bets: 0.50. Collects: 0. Loses: 0.50.
Player IlxxxlI does not show cards.Bets: 0. Collects: 0. Wins: 0.
Player 38979 does not show cards.Bets: 0. Collects: 0. Wins: 0.
Game ended at: 2016/11/28 19:12:19

Game started
Game ID: 786358418 0.25/0.50 (PRR) Gorgons - 17 (Hold'em)
Seat 6 is the button
Seat 1: caballeroXXX (50.25).
Seat 2: ILiK3PaStA (50).
Seat 3: Goomashroom (50.75).
Seat 4: IlxxxlI (24.09).
Seat 6: 38979 (50).
Player caballeroXXX has small blind (0.25)
Player ILiK3PaStA has big blind (0.50)
Player IlxxxlI received card: [7h]
Player IlxxxlI received card: [8d]
Player Goomashroom raises (1.50)
Player IlxxxlI folds
Player 38979 folds
Player caballeroXXX folds
Player ILiK3PaStA folds
Uncalled bet (1) returned to Goomashroom
Player Goomashroom mucks cards
------ Summary ------
Pot: 1.25. Rake 0
Player caballeroXXX does not show cards.Bets: 0.25. Collects: 0. Loses: 0.25.
Player ILiK3PaStA does not show cards.Bets: 0.50. Collects: 0. Loses: 0.50.
*Player Goomashroom mucks (does not show cards). Bets: 0.50. Collects: 1.25. Wins: 0.75.
Player IlxxxlI does not show cards.Bets: 0. Collects: 0. Wins: 0.
Player 38979 does not show cards.Bets: 0. Collects: 0. Wins: 0.
Game ended at: 2016/11/28 19:11:54

Game started
Game ID: 786358381 0.25/0.50 (PRR) Gorgons - 17 (Hold'em)
Seat 4 is the button
Seat 1: caballeroXXX (50).
Seat 3: Goomashroom (50.75).
Seat 4: IlxxxlI (24.09).
Seat 6: 38979 (50).
Player 38979 has small blind (0.25)
Player caballeroXXX has big blind (0.50)
Player IlxxxlI received card: [3h]
Player IlxxxlI received card: [2h]
Player Goomashroom folds
Player IlxxxlI folds
Player 38979 folds
Uncalled bet (0.25) returned to caballeroXXX
Player caballeroXXX mucks cards
------ Summary ------
Pot: 0.50. Rake 0
*Player caballeroXXX mucks (does not show cards). Bets: 0.25. Collects: 0.50. Wins: 0.25.
Player Goomashroom does not show cards.Bets: 0. Collects: 0. Wins: 0.
Player IlxxxlI does not show cards.Bets: 0. Collects: 0. Wins: 0.
Player 38979 does not show cards.Bets: 0.25. Collects: 0. Loses: 0.25.
Game ended at: 2016/11/28 19:11:26

Game started
Game ID: 786358369 0.25/0.50 (PRR) Gorgons - 5 (Hold'em)
Seat 1 is the button
Seat 1: SenNoSen (57.47).
Seat 2: 38979 (50).
Seat 3: IlxxxlI (41.83).
Seat 4: Goomashroom (105.06).
Seat 5: legenda99 (50.75).
Seat 6: wethco (62).
Player 38979 has small blind (0.25)
Player IlxxxlI has big blind (0.50)
Player IlxxxlI received card: [4c]
Player IlxxxlI received card: [8c]
Player Goomashroom folds
Player legenda99 folds
Player wethco folds
Player SenNoSen folds
Player 38979 raises (1.25)
Player IlxxxlI calls (1)
*** FLOP ***: [5s 5h Qc]
Player 38979 bets (0.50)
Player IlxxxlI calls (0.50)
*** TURN ***: [5s 5h Qc] [Ac]
Player 38979 bets (2.53)
Player IlxxxlI calls (2.53)
*** RIVER ***: [5s 5h Qc Ac] [9s]
Player 38979 checks
Player IlxxxlI checks
Player IlxxxlI mucks cards
------ Summary ------
Pot: 8.61. Rake 0.31. JP fee 0.14
Board: [5s 5h Qc Ac 9s]
Player SenNoSen does not show cards.Bets: 0. Collects: 0. Wins: 0.
*Player 38979 shows: One pair of 5s [Kh Js]. Bets: 4.53. Collects: 8.61. Wins: 4.08.
Player IlxxxlI mucks (does not show: [4c 8c]). Bets: 4.53. Collects: 0. Loses: 4.53.
Player Goomashroom does not show cards.Bets: 0. Collects: 0. Wins: 0.
Player legenda99 does not show cards.Bets: 0. Collects: 0. Wins: 0.
Player wethco does not show cards.Bets: 0. Collects: 0. Wins: 0.
Game ended at: 2016/11/28 19:12:22

Game started
Game ID: 786358277 0.25/0.50 (PRR) Gorgons - 17 (Hold'em)
Seat 1 is the button
Seat 1: caballeroXXX (50).
Seat 3: Goomashroom (50.25).
Seat 4: IlxxxlI (24.84).
Seat 5: BoTPuMHeDichBro (96.23).
Player Goomashroom has small blind (0.25)
Player IlxxxlI has big blind (0.50)
Player IlxxxlI received card: [4h]
Player IlxxxlI received card: [7s]
Player BoTPuMHeDichBro raises (1.50)
Player caballeroXXX folds
Player Goomashroom folds
Player IlxxxlI folds
Uncalled bet (1) returned to BoTPuMHeDichBro
Player BoTPuMHeDichBro mucks cards
------ Summary ------
Pot: 1.25. Rake 0
Player caballeroXXX does not show cards.Bets: 0. Collects: 0. Wins: 0.
Player Goomashroom does not show cards.Bets: 0.25. Collects: 0. Loses: 0.25.
Player IlxxxlI does not show cards.Bets: 0.50. Collects: 0. Loses: 0.50.
*Player BoTPuMHeDichBro mucks (does not show cards). Bets: 0.50. Collects: 1.25. Wins: 0.75.
Game ended at: 2016/11/28 19:10:55

Game started
Game ID: 786358258 0.25/0.50 (PRR) Gorgons - 17 (Hold'em)
Seat 5 is the button
Seat 1: caballeroXXX (50).
Seat 2: SenNoSen (88.21).
Seat 3: Goomashroom (50).
Seat 4: IlxxxlI (24.84).
Seat 5: BoTPuMHeDichBro (96.23).
Player caballeroXXX has small blind (0.25)
Player SenNoSen sitting out
Player Goomashroom has big blind (0.50)
Player IlxxxlI received card: [Jd]
Player IlxxxlI received card: [5h]
Player IlxxxlI folds
Player BoTPuMHeDichBro folds
Player caballeroXXX folds
Uncalled bet (0.25) returned to Goomashroom
Player Goomashroom mucks cards
------ Summary ------
Pot: 0.50. Rake 0
Player caballeroXXX does not show cards.Bets: 0.25. Collects: 0. Loses: 0.25.
Player SenNoSen does not show cards.Bets: 0. Collects: 0. Wins: 0.
*Player Goomashroom mucks (does not show cards). Bets: 0.25. Collects: 0.50. Wins: 0.25.
Player IlxxxlI does not show cards.Bets: 0. Collects: 0. Wins: 0.
Player BoTPuMHeDichBro does not show cards.Bets: 0. Collects: 0. Wins: 0.
Game ended at: 2016/11/28 19:10:33

Game started
Game ID: 786358216 0.25/0.50 (PRR) Gorgons - 5 (Hold'em)
Seat 6 is the button
Seat 1: SenNoSen (57.72).
Seat 2: 38979 (50).
Seat 3: IlxxxlI (21.89).
Seat 4: Goomashroom (105.06).
Seat 5: legenda99 (50.75).
Seat 6: wethco (62).
Player SenNoSen has small blind (0.25)
Player 38979 has big blind (0.50)
Player IlxxxlI received card: [Qh]
Player IlxxxlI received card: [Qs]
Player IlxxxlI raises (1.75)
Player Goomashroom folds
Player legenda99 folds
Player wethco folds
Player SenNoSen folds
Player 38979 calls (1.25)
*** FLOP ***: [3d 7c 6c]
Player 38979 checks
Player IlxxxlI bets (2.38)
Player 38979 raises (4.76)
Player IlxxxlI allin (17.76)
Player 38979 calls (15.38)
*** TURN ***: [3d 7c 6c] [Kh]
*** RIVER ***: [3d 7c 6c Kh] [10d]
------ Summary ------
Pot: 41.83. Rake 1.96. JP fee 0.24
Board: [3d 7c 6c Kh 10d]
Player SenNoSen does not show cards.Bets: 0.25. Collects: 0. Loses: 0.25.
Player 38979 shows: One pair of 9s [9d 9s]. Bets: 21.89. Collects: 0. Loses: 21.89.
*Player IlxxxlI shows: One pair of Qs [Qh Qs]. Bets: 21.89. Collects: 41.83. Wins: 19.94.
Player Goomashroom does not show cards.Bets: 0. Collects: 0. Wins: 0.
Player legenda99 does not show cards.Bets: 0. Collects: 0. Wins: 0.
Player wethco does not show cards.Bets: 0. Collects: 0. Wins: 0.
Game ended at: 2016/11/28 19:11:7

Game started
Game ID: 786358126 0.25/0.50 (PRR) Gorgons - 5 (Hold'em)
Seat 5 is the button
Seat 1: SenNoSen (58.22).
Seat 3: IlxxxlI (21.14).
Seat 4: Goomashroom (105.06).
Seat 5: legenda99 (50.75).
Seat 6: wethco (62.25).
Player wethco has small blind (0.25)
Player SenNoSen has big blind (0.50)
Player IlxxxlI received card: [Qc]
Player IlxxxlI received card: [Ah]
Player IlxxxlI raises (1.75)
Player Goomashroom folds
Player legenda99 folds
Player wethco folds
Player SenNoSen folds
Uncalled bet (1.25) returned to IlxxxlI
Player IlxxxlI mucks cards
------ Summary ------
Pot: 1.25. Rake 0
Player SenNoSen does not show cards.Bets: 0.50. Collects: 0. Loses: 0.50.
*Player IlxxxlI mucks (does not show cards). Bets: 0.50. Collects: 1.25. Wins: 0.75.
Player Goomashroom does not show cards.Bets: 0. Collects: 0. Wins: 0.
Player legenda99 does not show cards.Bets: 0. Collects: 0. Wins: 0.
Player wethco does not show cards.Bets: 0.25. Collects: 0. Loses: 0.25.
Game ended at: 2016/11/28 19:10:12

Game started
Game ID: 786357966 0.25/0.50 (PRR) Gorgons - 5 (Hold'em)
Seat 4 is the button
Seat 1: SenNoSen (58.22).
Seat 3: IlxxxlI (20).
Seat 4: Goomashroom (105.06).
Seat 5: legenda99 (51).
Seat 6: wethco (63.25).
Player legenda99 has small blind (0.25)
Player wethco has big blind (0.50)
Player IlxxxlI received card: [Ad]
Player IlxxxlI received card: [Qs]
Player SenNoSen folds
Player IlxxxlI raises (1)
Player Goomashroom folds
Player legenda99 folds
Player wethco calls (0.50)
*** FLOP ***: [Jh 8s 4h]
Player wethco checks
Player IlxxxlI bets (1.07)
Player wethco folds
Uncalled bet (1.07) returned to IlxxxlI
Player IlxxxlI mucks cards
------ Summary ------
Pot: 2.14. Rake 0.09. JP fee 0.02
Board: [Jh 8s 4h]
Player SenNoSen does not show cards.Bets: 0. Collects: 0. Wins: 0.
*Player IlxxxlI mucks (does not show cards). Bets: 1. Collects: 2.14. Wins: 1.14.
Player Goomashroom does not show cards.Bets: 0. Collects: 0. Wins: 0.
Player legenda99 does not show cards.Bets: 0.25. Collects: 0. Loses: 0.25.
Player wethco does not show cards.Bets: 1. Collects: 0. Loses: 1.
Game ended at: 2016/11/28 19:9:38

Game started
Game ID: 786357917 0.25/0.50 (PRR) Gorgons - 5 (Hold'em)
Seat 3 is the button
Seat 1: SenNoSen (58.22).
Seat 3: IlxxxlI (20).
Seat 4: Goomashroom (105.31).
Seat 5: legenda99 (50.75).
Seat 6: wethco (63.25).
Player Goomashroom has small blind (0.25)
Player legenda99 has big blind (0.50)
Player IlxxxlI received card: [9c]
Player IlxxxlI received card: [10s]
Player wethco folds
Player SenNoSen folds
Player IlxxxlI folds
Player Goomashroom folds
Uncalled bet (0.25) returned to legenda99
Player legenda99 mucks cards
------ Summary ------
Pot: 0.50. Rake 0
Player SenNoSen does not show cards.Bets: 0. Collects: 0. Wins: 0.
Player IlxxxlI does not show cards.Bets: 0. Collects: 0. Wins: 0.
Player Goomashroom does not show cards.Bets: 0.25. Collects: 0. Loses: 0.25.
*Player legenda99 mucks (does not show cards). Bets: 0.25. Collects: 0.50. Wins: 0.25.
Player wethco does not show cards.Bets: 0. Collects: 0. Wins: 0.
Game ended at: 2016/11/28 19:8:42

Game started
Game ID: 786357841 0.25/0.50 (PRR) Gorgons - 5 (Hold'em)
Seat 1 is the button
Seat 1: SenNoSen (58.22).
Seat 3: IlxxxlI (20).
Seat 4: Goomashroom (105.81).
Seat 5: legenda99 (50).
Seat 6: wethco (63.25).
Player IlxxxlI has small blind (0.25)
Player Goomashroom has big blind (0.50)
Player IlxxxlI received card: [7d]
Player IlxxxlI received card: [Ah]
Player legenda99 raises (1.50)
Player wethco folds
Player SenNoSen folds
Player IlxxxlI folds
Player Goomashroom folds
Uncalled bet (1) returned to legenda99
Player legenda99 mucks cards
------ Summary ------
Pot: 1.25. Rake 0
Player SenNoSen does not show cards.Bets: 0. Collects: 0. Wins: 0.
Player IlxxxlI does not show cards.Bets: 0.25. Collects: 0. Loses: 0.25.
Player Goomashroom does not show cards.Bets: 0.50. Collects: 0. Loses: 0.50.
*Player legenda99 mucks (does not show cards). Bets: 0.50. Collects: 1.25. Wins: 0.75.
Player wethco does not show cards.Bets: 0. Collects: 0. Wins: 0.
Game ended at: 2016/11/28 19:8:23

Game started
Game ID: 786357825 0.25/0.50 (PRR) Gorgons - 17 (Hold'em)
Seat 3 is the button
Seat 2: SenNoSen (88.21).
Seat 3: Goomashroom (55.50).
Seat 4: IlxxxlI (24.34).
Seat 5: BoTPuMHeDichBro (76.82).
Seat 6: eu4ria (56.31).
Player IlxxxlI has small blind (0.25)
Player BoTPuMHeDichBro has big blind (0.50)
Player IlxxxlI received card: [6c]
Player IlxxxlI received card: [10s]
Player eu4ria folds
Player SenNoSen folds
Player Goomashroom raises (1.13)
Player IlxxxlI folds
Player BoTPuMHeDichBro raises (4)
Player Goomashroom calls (3.37)
*** FLOP ***: [3s 7c 3c]
Player BoTPuMHeDichBro checks
Player Goomashroom bets (4.64)
Player BoTPuMHeDichBro calls (4.64)
*** TURN ***: [3s 7c 3c] [10d]
Player BoTPuMHeDichBro checks
Player Goomashroom checks
*** RIVER ***: [3s 7c 3c 10d] [5c]
Player BoTPuMHeDichBro bets (12.44)
Player Goomashroom calls (12.44)
Player Goomashroom mucks cards
------ Summary ------
Pot: 41.24. Rake 1.93. JP fee 0.24
Board: [3s 7c 3c 10d 5c]
Player SenNoSen does not show cards.Bets: 0. Collects: 0. Wins: 0.
Player Goomashroom mucks (does not show cards). Bets: 21.58. Collects: 0. Loses: 21.58.
Player IlxxxlI does not show cards.Bets: 0.25. Collects: 0. Loses: 0.25.
*Player BoTPuMHeDichBro shows: Two pairs. Ks and 3s [Kc Kh]. Bets: 21.58. Collects: 41.24. Wins: 19.66.
Player eu4ria does not show cards.Bets: 0. Collects: 0. Wins: 0.
Game ended at: 2016/11/28 19:9:52

Game started
Game ID: 786357743 0.25/0.50 (PRR) Gorgons - 17 (Hold'em)
Seat 2 is the button
Seat 2: SenNoSen (87.46).
Seat 3: Goomashroom (55.75).
Seat 4: IlxxxlI (24.84).
Seat 5: BoTPuMHeDichBro (76.82).
Seat 6: eu4ria (56.31).
Player Goomashroom has small blind (0.25)
Player IlxxxlI has big blind (0.50)
Player IlxxxlI received card: [10d]
Player IlxxxlI received card: [4c]
Player BoTPuMHeDichBro folds
Player eu4ria folds
Player SenNoSen raises (1)
Player Goomashroom folds
Player IlxxxlI folds
Uncalled bet (0.50) returned to SenNoSen
Player SenNoSen mucks cards
------ Summary ------
Pot: 1.25. Rake 0
*Player SenNoSen mucks (does not show cards). Bets: 0.50. Collects: 1.25. Wins: 0.75.
Player Goomashroom does not show cards.Bets: 0.25. Collects: 0. Loses: 0.25.
Player IlxxxlI does not show cards.Bets: 0.50. Collects: 0. Loses: 0.50.
Player BoTPuMHeDichBro does not show cards.Bets: 0. Collects: 0. Wins: 0.
Player eu4ria does not show cards.Bets: 0. Collects: 0. Wins: 0.
Game ended at: 2016/11/28 19:7:52

Game started
Game ID: 786357586 0.25/0.50 (PRR) Gorgons - 5 (Hold'em)
Seat 6 is the button
Seat 1: SenNoSen (50.25).
Seat 2: eu4ria (288.86).
Seat 3: IlxxxlI (20).
Seat 4: Goomashroom (105.81).
Seat 5: legenda99 (53.42).
Seat 6: wethco (63.25).
Player SenNoSen has small blind (0.25)
Player eu4ria sitting out
Player IlxxxlI has big blind (0.50)
Player IlxxxlI received card: [8d]
Player IlxxxlI received card: [Ah]
Player Goomashroom folds
Player legenda99 raises (1.50)
Player wethco folds
Player SenNoSen raises (4.75)
Player IlxxxlI folds
Player legenda99 calls (3.50)
*** FLOP ***: [2c 4d 6s]
Player SenNoSen bets (3.32)
Player legenda99 calls (3.32)
*** TURN ***: [2c 4d 6s] [9h]
Player SenNoSen bets (10.86)
Player legenda99 folds
Uncalled bet (10.86) returned to SenNoSen
Player SenNoSen mucks cards
------ Summary ------
Pot: 16.29. Rake 0.61. JP fee 0.24
Board: [2c 4d 6s 9h]
*Player SenNoSen mucks (does not show cards). Bets: 8.32. Collects: 16.29. Wins: 7.97.
Player eu4ria does not show cards.Bets: 0. Collects: 0. Wins: 0.
Player IlxxxlI does not show cards.Bets: 0.50. Collects: 0. Loses: 0.50.
Player Goomashroom does not show cards.Bets: 0. Collects: 0. Wins: 0.
Player legenda99 does not show cards.Bets: 8.32. Collects: 0. Loses: 8.32.
Player wethco does not show cards.Bets: 0. Collects: 0. Wins: 0.
Game ended at: 2016/11/28 19:7:59

Game started
Game ID: 786357487 0.25/0.50 (PRR) Gorgons - 17 (Hold'em)
Seat 6 is the button
Seat 2: SenNoSen (93.01).
Seat 3: Goomashroom (50.75).
Seat 4: IlxxxlI (24.84).
Seat 5: BoTPuMHeDichBro (76.82).
Seat 6: eu4ria (56.31).
Player SenNoSen has small blind (0.25)
Player Goomashroom has big blind (0.50)
Player IlxxxlI received card: [9h]
Player IlxxxlI received card: [Qd]
Player IlxxxlI folds
Player BoTPuMHeDichBro folds
Player eu4ria folds
Player SenNoSen raises (1.25)
Player Goomashroom calls (1)
*** FLOP ***: [3h 7d 6c]
Player SenNoSen bets (0.95)
Player Goomashroom calls (0.95)
*** TURN ***: [3h 7d 6c] [8d]
Player SenNoSen bets (3.10)
Player Goomashroom calls (3.10)
*** RIVER ***: [3h 7d 6c 8d] [3d]
Player SenNoSen checks
Player Goomashroom bets (4.82)
Player SenNoSen folds
Uncalled bet (4.82) returned to Goomashroom
Player Goomashroom mucks cards
------ Summary ------
Pot: 10.55. Rake 0.37. JP fee 0.18
Board: [3h 7d 6c 8d 3d]
Player SenNoSen does not show cards.Bets: 5.55. Collects: 0. Loses: 5.55.
*Player Goomashroom mucks (does not show cards). Bets: 5.55. Collects: 10.55. Wins: 5.
Player IlxxxlI does not show cards.Bets: 0. Collects: 0. Wins: 0.
Player BoTPuMHeDichBro does not show cards.Bets: 0. Collects: 0. Wins: 0.
Player eu4ria does not show cards.Bets: 0. Collects: 0. Wins: 0.
Game ended at: 2016/11/28 19:7:23

Game started
Game ID: 786357452 0.25/0.50 (PRR) Gorgons - 5 (Hold'em)
Seat 5 is the button
Seat 1: SenNoSen (50.75).
Seat 2: eu4ria (288.11).
Seat 3: IlxxxlI (20).
Seat 4: Goomashroom (105.81).
Seat 5: legenda99 (53.42).
Seat 6: wethco (63.50).
Player wethco has small blind (0.25)
Player SenNoSen has big blind (0.50)
Player IlxxxlI received card: [4d]
Player IlxxxlI received card: [10c]
Player eu4ria raises (1.50)
Player IlxxxlI folds
Player Goomashroom folds
Player legenda99 folds
Player wethco folds
Player SenNoSen folds
Uncalled bet (1) returned to eu4ria
Player eu4ria mucks cards
------ Summary ------
Pot: 1.25. Rake 0
Player SenNoSen does not show cards.Bets: 0.50. Collects: 0. Loses: 0.50.
*Player eu4ria mucks (does not show cards). Bets: 0.50. Collects: 1.25. Wins: 0.75.
Player IlxxxlI does not show cards.Bets: 0. Collects: 0. Wins: 0.
Player Goomashroom does not show cards.Bets: 0. Collects: 0. Wins: 0.
Player legenda99 does not show cards.Bets: 0. Collects: 0. Wins: 0.
Player wethco does not show cards.Bets: 0.25. Collects: 0. Loses: 0.25.
Game ended at: 2016/11/28 19:6:27

Game started
Game ID: 786357418 0.25/0.50 (PRR) Gorgons - 17 (Hold'em)
Seat 5 is the button
Seat 2: SenNoSen (93.51).
Seat 3: Goomashroom (50.75).
Seat 4: IlxxxlI (24.84).
Seat 5: BoTPuMHeDichBro (78.32).
Seat 6: eu4ria (54.31).
Player eu4ria has small blind (0.25)
Player SenNoSen has big blind (0.50)
Player IlxxxlI received card: [6c]
Player IlxxxlI received card: [2s]
Player Goomashroom folds
Player IlxxxlI folds
Player BoTPuMHeDichBro raises (1.50)
Player eu4ria raises (4.75)
Player SenNoSen folds
Player BoTPuMHeDichBro folds
Uncalled bet (3.50) returned to eu4ria
Player eu4ria mucks cards
------ Summary ------
Pot: 3.50. Rake 0
Player SenNoSen does not show cards.Bets: 0.50. Collects: 0. Loses: 0.50.
Player Goomashroom does not show cards.Bets: 0. Collects: 0. Wins: 0.
Player IlxxxlI does not show cards.Bets: 0. Collects: 0. Wins: 0.
Player BoTPuMHeDichBro does not show cards.Bets: 1.50. Collects: 0. Loses: 1.50.
*Player eu4ria mucks (does not show cards). Bets: 1.50. Collects: 3.50. Wins: 2.
Game ended at: 2016/11/28 19:5:50

Game started
Game ID: 786357362 0.25/0.50 (PRR) Gorgons - 17 (Hold'em)
Seat 4 is the button
Seat 1: Smok5 Js (28.31).
Seat 2: SenNoSen (93.51).
Seat 3: Goomashroom (50).
Seat 4: IlxxxlI (24.84).
Seat 5: BoTPuMHeDichBro (78.57).
Seat 6: eu4ria (54.81).
Player BoTPuMHeDichBro has small blind (0.25)
Player eu4ria has big blind (0.50)
Player IlxxxlI received card: [Qd]
Player IlxxxlI received card: [9c]
Player Smok5 Js folds
Player SenNoSen folds
Player Goomashroom raises (1.25)
Player IlxxxlI folds
Player BoTPuMHeDichBro folds
Player eu4ria folds
Uncalled bet (0.75) returned to Goomashroom
Player Goomashroom mucks cards
------ Summary ------
Pot: 1.25. Rake 0
Player Smok5 Js does not show cards.Bets: 0. Collects: 0. Wins: 0.
Player SenNoSen does not show cards.Bets: 0. Collects: 0. Wins: 0.
*Player Goomashroom mucks (does not show cards). Bets: 0.50. Collects: 1.25. Wins: 0.75.
Player IlxxxlI does not show cards.Bets: 0. Collects: 0. Wins: 0.
Player BoTPuMHeDichBro does not show cards.Bets: 0.25. Collects: 0. Loses: 0.25.
Player eu4ria does not show cards.Bets: 0.50. Collects: 0. Loses: 0.50.
Game ended at: 2016/11/28 19:5:20

Game started
Game ID: 786357361 0.25/0.50 (PRR) Gorgons - 5 (Hold'em)
Seat 4 is the button
Seat 1: SenNoSen (50).
Seat 2: eu4ria (288.11).
Seat 3: IlxxxlI (20).
Seat 4: Goomashroom (105.81).
Seat 5: legenda99 (53.67).
Seat 6: wethco (64).
Player legenda99 has small blind (0.25)
Player wethco has big blind (0.50)
Player IlxxxlI received card: [3c]
Player IlxxxlI received card: [8c]
Player SenNoSen raises (1.50)
Player eu4ria folds
Player IlxxxlI folds
Player Goomashroom folds
Player legenda99 folds
Player wethco folds
Uncalled bet (1) returned to SenNoSen
Player SenNoSen mucks cards
------ Summary ------
Pot: 1.25. Rake 0
*Player SenNoSen mucks (does not show cards). Bets: 0.50. Collects: 1.25. Wins: 0.75.
Player eu4ria does not show cards.Bets: 0. Collects: 0. Wins: 0.
Player IlxxxlI does not show cards.Bets: 0. Collects: 0. Wins: 0.
Player Goomashroom does not show cards.Bets: 0. Collects: 0. Wins: 0.
Player legenda99 does not show cards.Bets: 0.25. Collects: 0. Loses: 0.25.
Player wethco does not show cards.Bets: 0.50. Collects: 0. Loses: 0.50.
Game ended at: 2016/11/28 19:5:34

Game started
Game ID: 786357290 0.25/0.50 (PRR) Gorgons - 5 (Hold'em)
Seat 3 is the button
Seat 1: SenNoSen (50).
Seat 2: eu4ria (288.11).
Seat 3: IlxxxlI (20).
Seat 4: Goomashroom (106.06).
Seat 5: legenda99 (53.42).
Seat 6: wethco (64).
Player Goomashroom has small blind (0.25)
Player legenda99 has big blind (0.50)
Player IlxxxlI received card: [4c]
Player IlxxxlI received card: [2s]
Player wethco folds
Player SenNoSen folds
Player eu4ria folds
Player IlxxxlI folds
Player Goomashroom folds
Uncalled bet (0.25) returned to legenda99
Player legenda99 mucks cards
------ Summary ------
Pot: 0.50. Rake 0
Player SenNoSen does not show cards.Bets: 0. Collects: 0. Wins: 0.
Player eu4ria does not show cards.Bets: 0. Collects: 0. Wins: 0.
Player IlxxxlI does not show cards.Bets: 0. Collects: 0. Wins: 0.
Player Goomashroom does not show cards.Bets: 0.25. Collects: 0. Loses: 0.25.
*Player legenda99 mucks (does not show cards). Bets: 0.25. Collects: 0.50. Wins: 0.25.
Player wethco does not show cards.Bets: 0. Collects: 0. Wins: 0.
Game ended at: 2016/11/28 19:4:59

Game started
Game ID: 786357172 0.25/0.50 (PRR) Gorgons - 5 (Hold'em)
Seat 2 is the button
Seat 1: SenNoSen (50).
Seat 2: eu4ria (287.36).
Seat 3: IlxxxlI (20).
Seat 4: Goomashroom (106.56).
Seat 5: legenda99 (53.42).
Seat 6: wethco (64).
Player IlxxxlI has small blind (0.25)
Player Goomashroom has big blind (0.50)
Player IlxxxlI received card: [10d]
Player IlxxxlI received card: [Jc]
Player legenda99 folds
Player wethco folds
Player SenNoSen folds
Player eu4ria raises (1.25)
Player IlxxxlI folds
Player Goomashroom folds
Uncalled bet (0.75) returned to eu4ria
Player eu4ria mucks cards
------ Summary ------
Pot: 1.25. Rake 0
Player SenNoSen does not show cards.Bets: 0. Collects: 0. Wins: 0.
*Player eu4ria mucks (does not show cards). Bets: 0.50. Collects: 1.25. Wins: 0.75.
Player IlxxxlI does not show cards.Bets: 0.25. Collects: 0. Loses: 0.25.
Player Goomashroom does not show cards.Bets: 0.50. Collects: 0. Loses: 0.50.
Player legenda99 does not show cards.Bets: 0. Collects: 0. Wins: 0.
Player wethco does not show cards.Bets: 0. Collects: 0. Wins: 0.
Game ended at: 2016/11/28 19:4:27

Game started
Game ID: 786357099 0.25/0.50 (PRR) Gorgons - 5 (Hold'em)
Seat 1 is the button
Seat 1: SenNoSen (50).
Seat 2: eu4ria (287.61).
Seat 3: IlxxxlI (20).
Seat 4: Goomashroom (106.56).
Seat 5: legenda99 (52.67).
Seat 6: wethco (64).
Player eu4ria has small blind (0.25)
Player IlxxxlI has big blind (0.50)
Player IlxxxlI received card: [5h]
Player IlxxxlI received card: [Jh]
Player Goomashroom folds
Player legenda99 raises (1.50)
Player wethco folds
Player SenNoSen folds
Player eu4ria folds
Player IlxxxlI folds
Uncalled bet (1) returned to legenda99
Player legenda99 mucks cards
------ Summary ------
Pot: 1.25. Rake 0
Player SenNoSen does not show cards.Bets: 0. Collects: 0. Wins: 0.
Player eu4ria does not show cards.Bets: 0.25. Collects: 0. Loses: 0.25.
Player IlxxxlI does not show cards.Bets: 0.50. Collects: 0. Loses: 0.50.
Player Goomashroom does not show cards.Bets: 0. Collects: 0. Wins: 0.
*Player legenda99 mucks (does not show cards). Bets: 0.50. Collects: 1.25. Wins: 0.75.
Player wethco does not show cards.Bets: 0. Collects: 0. Wins: 0.
Game ended at: 2016/11/28 19:3:47

Game started
Game ID: 786357049 0.25/0.50 (PRR) Gorgons - 17 (Hold'em)
Seat 3 is the button
Seat 1: Smok5 Js (28.81).
Seat 2: SenNoSen (77.31).
Seat 3: Goomashroom (52.88).
Seat 4: IlxxxlI (25.09).
Seat 5: BoTPuMHeDichBro (79.07).
Seat 6: eu4ria (54.81).
Player IlxxxlI has small blind (0.25)
Player BoTPuMHeDichBro has big blind (0.50)
Player IlxxxlI received card: [Ks]
Player IlxxxlI received card: [7c]
Player eu4ria folds
Player Smok5 Js calls (0.50)
Player SenNoSen raises (2.50)
Player Goomashroom raises (7.26)
Player IlxxxlI folds
Player BoTPuMHeDichBro folds
Player Smok5 Js folds
Player SenNoSen calls (4.76)
*** FLOP ***: [7d 7s 8d]
Player SenNoSen checks
Player Goomashroom bets (5.92)
Player SenNoSen calls (5.92)
*** TURN ***: [7d 7s 8d] [7h]
Player SenNoSen checks
Player Goomashroom checks
*** RIVER ***: [7d 7s 8d 7h] [6h]
Player SenNoSen bets (3.50)
Player Goomashroom calls (3.50)
Player Goomashroom mucks cards
------ Summary ------
Pot: 32.88. Rake 1.49. JP fee 0.24
Board: [7d 7s 8d 7h 6h]
Player Smok5 Js does not show cards.Bets: 0.50. Collects: 0. Loses: 0.50.
*Player SenNoSen shows: Straight to 8 [4d 5d]. Bets: 16.68. Collects: 32.88. Wins: 16.20.
Player Goomashroom mucks (does not show cards). Bets: 16.68. Collects: 0. Loses: 16.68.
Player IlxxxlI does not show cards.Bets: 0.25. Collects: 0. Loses: 0.25.
Player BoTPuMHeDichBro does not show cards.Bets: 0.50. Collects: 0. Loses: 0.50.
Player eu4ria does not show cards.Bets: 0. Collects: 0. Wins: 0.
Game ended at: 2016/11/28 19:4:56

Game started
Game ID: 786356976 0.25/0.50 (PRR) Gorgons - 17 (Hold'em)
Seat 2 is the button
Seat 1: Smok5 Js (28.81).
Seat 2: SenNoSen (77.31).
Seat 3: Goomashroom (53.13).
Seat 4: IlxxxlI (24.84).
Seat 5: BoTPuMHeDichBro (79.07).
Seat 6: eu4ria (54.81).
Player Goomashroom has small blind (0.25)
Player IlxxxlI has big blind (0.50)
Player IlxxxlI received card: [8d]
Player IlxxxlI received card: [8h]
Player BoTPuMHeDichBro folds
Player eu4ria folds
Player Smok5 Js folds
Player SenNoSen folds
Player Goomashroom folds
Uncalled bet (0.25) returned to IlxxxlI
Player IlxxxlI mucks cards
------ Summary ------
Pot: 0.50. Rake 0
Player Smok5 Js does not show cards.Bets: 0. Collects: 0. Wins: 0.
Player SenNoSen does not show cards.Bets: 0. Collects: 0. Wins: 0.
Player Goomashroom does not show cards.Bets: 0.25. Collects: 0. Loses: 0.25.
*Player IlxxxlI mucks (does not show cards). Bets: 0.25. Collects: 0.50. Wins: 0.25.
Player BoTPuMHeDichBro does not show cards.Bets: 0. Collects: 0. Wins: 0.
Player eu4ria does not show cards.Bets: 0. Collects: 0. Wins: 0.
Game ended at: 2016/11/28 19:2:58

Game started
Game ID: 786356811 0.25/0.50 (PRR) Gorgons - 17 (Hold'em)
Seat 1 is the button
Seat 1: Smok5 Js (28.12).
Seat 2: SenNoSen (77.56).
Seat 3: Goomashroom (53.63).
Seat 4: IlxxxlI (24.84).
Seat 5: BoTPuMHeDichBro (79.07).
Seat 6: eu4ria (54.81).
Player SenNoSen has small blind (0.25)
Player Goomashroom has big blind (0.50)
Player IlxxxlI received card: [Qs]
Player IlxxxlI received card: [8c]
Player IlxxxlI folds
Player BoTPuMHeDichBro folds
Player eu4ria folds
Player Smok5 Js calls (0.50)
Player SenNoSen folds
Player Goomashroom checks
*** FLOP ***: [6d 7c 9d]
Player Goomashroom checks
Player Smok5 Js bets (0.50)
Player Goomashroom folds
Uncalled bet (0.50) returned to Smok5 Js
------ Summary ------
Pot: 1.19. Rake 0.04. JP fee 0.02
Board: [6d 7c 9d]
*Player Smok5 Js shows: Three Of Kind of 6s [6h 6s]. Bets: 0.50. Collects: 1.19. Wins: 0.69.
Player SenNoSen does not show cards.Bets: 0.25. Collects: 0. Loses: 0.25.
Player Goomashroom does not show cards.Bets: 0.50. Collects: 0. Loses: 0.50.
Player IlxxxlI does not show cards.Bets: 0. Collects: 0. Wins: 0.
Player BoTPuMHeDichBro does not show cards.Bets: 0. Collects: 0. Wins: 0.
Player eu4ria does not show cards.Bets: 0. Collects: 0. Wins: 0.
Game ended at: 2016/11/28 19:2:30

Game started
Game ID: 786356798 0.25/0.50 (PRR) Gorgons - 5 (Hold'em)
Seat 6 is the button
Seat 1: SenNoSen (57.28).
Seat 2: eu4ria (233.33).
Seat 3: IlxxxlI (20).
Seat 4: Goomashroom (106.56).
Seat 5: legenda99 (52.67).
Seat 6: wethco (64).
Player SenNoSen has small blind (0.25)
Player eu4ria has big blind (0.50)
Player IlxxxlI received card: [5s]
Player IlxxxlI received card: [Ac]
Player IlxxxlI folds
Player Goomashroom folds
Player legenda99 folds
Player wethco folds
Player SenNoSen raises (1.25)
Player eu4ria raises (4)
Player SenNoSen calls (3)
*** FLOP ***: [4s 3c 10d]
Player SenNoSen checks
Player eu4ria bets (4.27)
Player SenNoSen raises (12.81)
Player eu4ria calls (8.54)
*** TURN ***: [4s 3c 10d] [3s]
Player SenNoSen checks
Player eu4ria checks
*** RIVER ***: [4s 3c 10d 3s] [Qd]
Player SenNoSen checks
Player eu4ria allin (216.02)
Player SenNoSen allin (39.97)
Uncalled bet (176.05) returned to eu4ria
------ Summary ------
Pot: 111.56. Rake 2.76. JP fee 0.24
Board: [4s 3c 10d 3s Qd]
Player SenNoSen shows: Two pairs. Qs and 3s [Qc 7c]. Bets: 57.28. Collects: 0. Loses: 57.28.
*Player eu4ria shows: Full House (10/3) [10h 10c]. Bets: 57.28. Collects: 111.56. Wins: 54.28.
Player IlxxxlI does not show cards.Bets: 0. Collects: 0. Wins: 0.
Player Goomashroom does not show cards.Bets: 0. Collects: 0. Wins: 0.
Player legenda99 does not show cards.Bets: 0. Collects: 0. Wins: 0.
Player wethco does not show cards.Bets: 0. Collects: 0. Wins: 0.
Game ended at: 2016/11/28 19:3:16

Game started
Game ID: 786356698 0.25/0.50 (PRR) Gorgons - 5 (Hold'em)
Seat 5 is the button
Seat 1: SenNoSen (57.78).
Seat 2: eu4ria (232.58).
Seat 3: IlxxxlI (20).
Seat 4: Goomashroom (106.56).
Seat 5: legenda99 (52.67).
Seat 6: wethco (64.25).
Player wethco has small blind (0.25)
Player SenNoSen has big blind (0.50)
Player IlxxxlI received card: [10h]
Player IlxxxlI received card: [5d]
Player eu4ria raises (1.50)
Player IlxxxlI folds
Player Goomashroom folds
Player legenda99 folds
Player wethco folds
Player SenNoSen folds
Uncalled bet (1) returned to eu4ria
Player eu4ria mucks cards
------ Summary ------
Pot: 1.25. Rake 0
Player SenNoSen does not show cards.Bets: 0.50. Collects: 0. Loses: 0.50.
*Player eu4ria mucks (does not show cards). Bets: 0.50. Collects: 1.25. Wins: 0.75.
Player IlxxxlI does not show cards.Bets: 0. Collects: 0. Wins: 0.
Player Goomashroom does not show cards.Bets: 0. Collects: 0. Wins: 0.
Player legenda99 does not show cards.Bets: 0. Collects: 0. Wins: 0.
Player wethco does not show cards.Bets: 0.25. Collects: 0. Loses: 0.25.
Game ended at: 2016/11/28 19:1:26

Game started
Game ID: 786356669 0.25/0.50 (PRR) Gorgons - 5 (Hold'em)
Seat 4 is the button
Seat 1: SenNoSen (57.03).
Seat 2: eu4ria (232.58).
Seat 3: IlxxxlI (20).
Seat 4: Goomashroom (106.56).
Seat 5: legenda99 (52.92).
Seat 6: wethco (64.75).
Player legenda99 has small blind (0.25)
Player wethco has big blind (0.50)
Player IlxxxlI received card: [Jd]
Player IlxxxlI received card: [6c]
Player SenNoSen raises (2)
Player eu4ria folds
Player IlxxxlI folds
Player Goomashroom folds
Player legenda99 folds
Player wethco folds
Uncalled bet (1.50) returned to SenNoSen
Player SenNoSen mucks cards
------ Summary ------
Pot: 1.25. Rake 0
*Player SenNoSen mucks (does not show cards). Bets: 0.50. Collects: 1.25. Wins: 0.75.
Player eu4ria does not show cards.Bets: 0. Collects: 0. Wins: 0.
Player IlxxxlI does not show cards.Bets: 0. Collects: 0. Wins: 0.
Player Goomashroom does not show cards.Bets: 0. Collects: 0. Wins: 0.
Player legenda99 does not show cards.Bets: 0.25. Collects: 0. Loses: 0.25.
Player wethco does not show cards.Bets: 0.50. Collects: 0. Loses: 0.50.
Game ended at: 2016/11/28 19:0:46

Game started
Game ID: 786356632 0.25/0.50 (PRR) Gorgons - 17 (Hold'em)
Seat 6 is the button
Seat 1: Smok5 Js (29.37).
Seat 2: SenNoSen (78.06).
Seat 3: Goomashroom (53.63).
Seat 4: IlxxxlI (24.84).
Seat 5: BoTPuMHeDichBro (79.07).
Seat 6: eu4ria (53.21).
Player Smok5 Js has small blind (0.25)
Player SenNoSen has big blind (0.50)
Player IlxxxlI received card: [4h]
Player IlxxxlI received card: [4c]
Player Goomashroom folds
Player IlxxxlI folds
Player BoTPuMHeDichBro folds
Player eu4ria raises (1.25)
Player Smok5 Js calls (1)
Player SenNoSen folds
*** FLOP ***: [7c 3h 4d]
Player Smok5 Js checks
Player eu4ria bets (1.42)
Player Smok5 Js folds
Uncalled bet (1.42) returned to eu4ria
Player eu4ria mucks cards
------ Summary ------
Pot: 2.85. Rake 0.11. JP fee 0.04
Board: [7c 3h 4d]
Player Smok5 Js does not show cards.Bets: 1.25. Collects: 0. Loses: 1.25.
Player SenNoSen does not show cards.Bets: 0.50. Collects: 0. Loses: 0.50.
Player Goomashroom does not show cards.Bets: 0. Collects: 0. Wins: 0.
Player IlxxxlI does not show cards.Bets: 0. Collects: 0. Wins: 0.
Player BoTPuMHeDichBro does not show cards.Bets: 0. Collects: 0. Wins: 0.
*Player eu4ria mucks (does not show cards). Bets: 1.25. Collects: 2.85. Wins: 1.60.
Game ended at: 2016/11/28 19:1:31

Game started
Game ID: 786356581 0.25/0.50 (PRR) Gorgons - 5 (Hold'em)
Seat 3 is the button
Seat 1: SenNoSen (57.03).
Seat 2: eu4ria (231.83).
Seat 3: IlxxxlI (20).
Seat 4: Goomashroom (106.81).
Seat 5: legenda99 (53.42).
Seat 6: wethco (64.75).
Player Goomashroom has small blind (0.25)
Player legenda99 has big blind (0.50)
Player IlxxxlI received card: [8h]
Player IlxxxlI received card: [3h]
Player wethco folds
Player SenNoSen folds
Player eu4ria raises (1.50)
Player IlxxxlI folds
Player Goomashroom folds
Player legenda99 folds
Uncalled bet (1) returned to eu4ria
Player eu4ria mucks cards
------ Summary ------
Pot: 1.25. Rake 0
Player SenNoSen does not show cards.Bets: 0. Collects: 0. Wins: 0.
*Player eu4ria mucks (does not show cards). Bets: 0.50. Collects: 1.25. Wins: 0.75.
Player IlxxxlI does not show cards.Bets: 0. Collects: 0. Wins: 0.
Player Goomashroom does not show cards.Bets: 0.25. Collects: 0. Loses: 0.25.
Player legenda99 does not show cards.Bets: 0.50. Collects: 0. Loses: 0.50.
Player wethco does not show cards.Bets: 0. Collects: 0. Wins: 0.
Game ended at: 2016/11/28 19:0:30

Game started
Game ID: 786356521 0.25/0.50 (PRR) Gorgons - 17 (Hold'em)
Seat 5 is the button
Seat 1: Smok5 Js (30.87).
Seat 2: SenNoSen (78.06).
Seat 3: Goomashroom (53.63).
Seat 4: IlxxxlI (24.84).
Seat 5: BoTPuMHeDichBro (79.07).
Seat 6: eu4ria (51.86).
Player eu4ria has small blind (0.25)
Player Smok5 Js has big blind (0.50)
Player IlxxxlI received card: [7s]
Player IlxxxlI received card: [4s]
Player SenNoSen folds
Player Goomashroom folds
Player IlxxxlI folds
Player BoTPuMHeDichBro folds
Player eu4ria raises (1.25)
Player Smok5 Js calls (1)
*** FLOP ***: [Kc 10h 3s]
Player eu4ria bets (2)
Player Smok5 Js folds
Uncalled bet (2) returned to eu4ria
Player eu4ria mucks cards
------ Summary ------
Pot: 2.85. Rake 0.11. JP fee 0.04
Board: [Kc 10h 3s]
Player Smok5 Js does not show cards.Bets: 1.50. Collects: 0. Loses: 1.50.
Player SenNoSen does not show cards.Bets: 0. Collects: 0. Wins: 0.
Player Goomashroom does not show cards.Bets: 0. Collects: 0. Wins: 0.
Player IlxxxlI does not show cards.Bets: 0. Collects: 0. Wins: 0.
Player BoTPuMHeDichBro does not show cards.Bets: 0. Collects: 0. Wins: 0.
*Player eu4ria mucks (does not show cards). Bets: 1.50. Collects: 2.85. Wins: 1.35.
Game ended at: 2016/11/28 19:0:14

Game started
Game ID: 786356444 0.25/0.50 (PRR) Gorgons - 17 (Hold'em)
Seat 4 is the button
Seat 1: Smok5 Js (30.87).
Seat 2: SenNoSen (77.31).
Seat 3: Goomashroom (53.63).
Seat 4: IlxxxlI (24.84).
Seat 5: BoTPuMHeDichBro (79.32).
Seat 6: eu4ria (52.36).
Player BoTPuMHeDichBro has small blind (0.25)
Player eu4ria has big blind (0.50)
Player IlxxxlI received card: [2c]
Player IlxxxlI received card: [6c]
Player Smok5 Js folds
Player SenNoSen raises (1.50)
Player Goomashroom folds
Player IlxxxlI folds
Player BoTPuMHeDichBro folds
Player eu4ria folds
Uncalled bet (1) returned to SenNoSen
Player SenNoSen mucks cards
------ Summary ------
Pot: 1.25. Rake 0
Player Smok5 Js does not show cards.Bets: 0. Collects: 0. Wins: 0.
*Player SenNoSen mucks (does not show cards). Bets: 0.50. Collects: 1.25. Wins: 0.75.
Player Goomashroom does not show cards.Bets: 0. Collects: 0. Wins: 0.
Player IlxxxlI does not show cards.Bets: 0. Collects: 0. Wins: 0.
Player BoTPuMHeDichBro does not show cards.Bets: 0.25. Collects: 0. Loses: 0.25.
Player eu4ria does not show cards.Bets: 0.50. Collects: 0. Loses: 0.50.
Game ended at: 2016/11/28 18:59:22

Game started
Game ID: 786356400 0.25/0.50 (PRR) Gorgons - 5 (Hold'em)
Seat 2 is the button
Seat 1: SenNoSen (57.03).
Seat 2: eu4ria (234.83).
Seat 3: IlxxxlI (20).
Seat 4: Goomashroom (107.31).
Seat 5: legenda99 (50).
Seat 6: wethco (64.75).
Player IlxxxlI has small blind (0.25)
Player Goomashroom has big blind (0.50)
Player IlxxxlI received card: [9c]
Player IlxxxlI received card: [3s]
Player legenda99 raises (1.50)
Player wethco folds
Player SenNoSen folds
Player eu4ria calls (1.50)
Player IlxxxlI folds
Player Goomashroom folds
*** FLOP ***: [7c 7s Kc]
Player legenda99 checks
Player eu4ria bets (1.50)
Player legenda99 calls (1.50)
*** TURN ***: [7c 7s Kc] [6d]
Player legenda99 checks
Player eu4ria checks
*** RIVER ***: [7c 7s Kc 6d] [2s]
Player legenda99 bets (4)
Player eu4ria folds
Uncalled bet (4) returned to legenda99
Player legenda99 mucks cards
------ Summary ------
Pot: 6.42. Rake 0.23. JP fee 0.10
Board: [7c 7s Kc 6d 2s]
Player SenNoSen does not show cards.Bets: 0. Collects: 0. Wins: 0.
Player eu4ria does not show cards.Bets: 3. Collects: 0. Loses: 3.
Player IlxxxlI does not show cards.Bets: 0.25. Collects: 0. Loses: 0.25.
Player Goomashroom does not show cards.Bets: 0.50. Collects: 0. Loses: 0.50.
*Player legenda99 mucks (does not show cards). Bets: 3. Collects: 6.42. Wins: 3.42.
Player wethco does not show cards.Bets: 0. Collects: 0. Wins: 0.
Game ended at: 2016/11/28 18:59:52

Game started
Game ID: 786356324 0.25/0.50 (PRR) Gorgons - 5 (Hold'em)
Seat 1 is the button
Seat 1: SenNoSen (56.28).
Seat 2: eu4ria (235.08).
Seat 3: IlxxxlI (20).
Seat 4: Goomashroom (107.31).
Seat 5: legenda99 (50).
Seat 6: wethco (64.75).
Player eu4ria has small blind (0.25)
Player IlxxxlI has big blind (0.50)
Player IlxxxlI received card: [9h]
Player IlxxxlI received card: [5s]
Player Goomashroom folds
Player legenda99 folds
Player wethco folds
Player SenNoSen raises (1)
Player eu4ria folds
Player IlxxxlI folds
Uncalled bet (0.50) returned to SenNoSen
Player SenNoSen mucks cards
------ Summary ------
Pot: 1.25. Rake 0
*Player SenNoSen mucks (does not show cards). Bets: 0.50. Collects: 1.25. Wins: 0.75.
Player eu4ria does not show cards.Bets: 0.25. Collects: 0. Loses: 0.25.
Player IlxxxlI does not show cards.Bets: 0.50. Collects: 0. Loses: 0.50.
Player Goomashroom does not show cards.Bets: 0. Collects: 0. Wins: 0.
Player legenda99 does not show cards.Bets: 0. Collects: 0. Wins: 0.
Player wethco does not show cards.Bets: 0. Collects: 0. Wins: 0.
Game ended at: 2016/11/28 18:58:27

Game started
Game ID: 786356294 1/2 (PRR) Lakhey - 10 (Hold'em)
Seat 3 is the button
Seat 1: Popka1337 (71.50).
Seat 3: IlxxxlI (87.90).
Seat 5: JJaromir (495.50).
Player JJaromir has small blind (1)
Player Popka1337 sitting out
Player IlxxxlI has big blind (2)
Player IlxxxlI received card: [5s]
Player IlxxxlI received card: [3c]
Player JJaromir calls (1)
Player IlxxxlI checks
*** FLOP ***: [6d 4c 4s]
Player JJaromir checks
Player IlxxxlI checks
*** TURN ***: [6d 4c 4s] [Qh]
Player JJaromir bets (4)
Player IlxxxlI raises (14)
Player JJaromir folds
Uncalled bet (10) returned to IlxxxlI
Player IlxxxlI mucks cards
------ Summary ------
Pot: 11.40. Rake 0.56. JP fee 0.04
Board: [6d 4c 4s Qh]
Player Popka1337 does not show cards.Bets: 0. Collects: 0. Wins: 0.
*Player IlxxxlI mucks (does not show cards). Bets: 6. Collects: 11.40. Wins: 5.40.
Player JJaromir does not show cards.Bets: 6. Collects: 0. Loses: 6.
Game ended at: 2016/11/28 18:58:33

Game started
Game ID: 786356284 0.25/0.50 (PRR) Gorgons - 17 (Hold'em)
Seat 3 is the button
Seat 1: Smok5 Js (30.87).
Seat 2: SenNoSen (77.31).
Seat 3: Goomashroom (53.63).
Seat 4: IlxxxlI (24.39).
Seat 5: BoTPuMHeDichBro (79.82).
Seat 6: eu4ria (52.36).
Player IlxxxlI has small blind (0.25)
Player BoTPuMHeDichBro has big blind (0.50)
Player IlxxxlI received card: [2c]
Player IlxxxlI received card: [9c]
Player eu4ria folds
Player Smok5 Js folds
Player SenNoSen folds
Player Goomashroom folds
Player IlxxxlI calls (0.25)
Player BoTPuMHeDichBro checks
*** FLOP ***: [Ac Kd Ad]
Player IlxxxlI bets (0.50)
Player BoTPuMHeDichBro folds
Uncalled bet (0.50) returned to IlxxxlI
Player IlxxxlI mucks cards
------ Summary ------
Pot: 0.95. Rake 0.05
Board: [Ac Kd Ad]
Player Smok5 Js does not show cards.Bets: 0. Collects: 0. Wins: 0.
Player SenNoSen does not show cards.Bets: 0. Collects: 0. Wins: 0.
Player Goomashroom does not show cards.Bets: 0. Collects: 0. Wins: 0.
*Player IlxxxlI mucks (does not show cards). Bets: 0.50. Collects: 0.95. Wins: 0.45.
Player BoTPuMHeDichBro does not show cards.Bets: 0.50. Collects: 0. Loses: 0.50.
Player eu4ria does not show cards.Bets: 0. Collects: 0. Wins: 0.
Game ended at: 2016/11/28 18:58:47

Game started
Game ID: 786356277 1/2 (PRR) Lakhey - 10 (Hold'em)
Seat 1 is the button
Seat 1: Popka1337 (71.50).
Seat 3: IlxxxlI (88.90).
Seat 5: JJaromir (494.50).
Player IlxxxlI has small blind (1)
Player JJaromir has big blind (2)
Player IlxxxlI received card: [8c]
Player IlxxxlI received card: [4s]
Player Popka1337 folds
Player IlxxxlI folds
Uncalled bet (1) returned to JJaromir
Player JJaromir mucks cards
------ Summary ------
Pot: 2. Rake 0
Player Popka1337 does not show cards.Bets: 0. Collects: 0. Wins: 0.
Player IlxxxlI does not show cards.Bets: 1. Collects: 0. Loses: 1.
*Player JJaromir mucks (does not show cards). Bets: 1. Collects: 2. Wins: 1.
Game ended at: 2016/11/28 18:57:39

Game started
Game ID: 786356260 1/2 (PRR) Lakhey - 10 (Hold'em)
Seat 5 is the button
Seat 1: Popka1337 (72.50).
Seat 2: DonCesarGrinder (446.99).
Seat 3: IlxxxlI (87.90).
Seat 5: JJaromir (494.50).
Player Popka1337 has small blind (1)
Player DonCesarGrinder sitting out
Player IlxxxlI has big blind (2)
Player IlxxxlI received card: [3s]
Player IlxxxlI received card: [4s]
Player JJaromir folds
Player Popka1337 folds
Uncalled bet (1) returned to IlxxxlI
Player IlxxxlI mucks cards
------ Summary ------
Pot: 2. Rake 0
Player Popka1337 does not show cards.Bets: 1. Collects: 0. Loses: 1.
Player DonCesarGrinder does not show cards.Bets: 0. Collects: 0. Wins: 0.
*Player IlxxxlI mucks (does not show cards). Bets: 1. Collects: 2. Wins: 1.
Player JJaromir does not show cards.Bets: 0. Collects: 0. Wins: 0.
Game ended at: 2016/11/28 18:57:28

Game started
Game ID: 786356221 0.25/0.50 (PRR) Gorgons - 5 (Hold'em)
Seat 6 is the button
Seat 1: SenNoSen (56.53).
Seat 2: eu4ria (234.83).
Seat 3: IlxxxlI (20).
Seat 4: Goomashroom (107.31).
Seat 5: legenda99 (50).
Seat 6: wethco (64.75).
Player SenNoSen has small blind (0.25)
Player eu4ria has big blind (0.50)
Player IlxxxlI received card: [5c]
Player IlxxxlI received card: [Ad]
Player IlxxxlI folds
Player Goomashroom folds
Player legenda99 folds
Player wethco folds
Player SenNoSen folds
Uncalled bet (0.25) returned to eu4ria
Player eu4ria mucks cards
------ Summary ------
Pot: 0.50. Rake 0
Player SenNoSen does not show cards.Bets: 0.25. Collects: 0. Loses: 0.25.
*Player eu4ria mucks (does not show cards). Bets: 0.25. Collects: 0.50. Wins: 0.25.
Player IlxxxlI does not show cards.Bets: 0. Collects: 0. Wins: 0.
Player Goomashroom does not show cards.Bets: 0. Collects: 0. Wins: 0.
Player legenda99 does not show cards.Bets: 0. Collects: 0. Wins: 0.
Player wethco does not show cards.Bets: 0. Collects: 0. Wins: 0.
Game ended at: 2016/11/28 18:57:51

Game started
Game ID: 786356219 1/2 (PRR) Lakhey - 10 (Hold'em)
Seat 3 is the button
Seat 1: Popka1337 (71.50).
Seat 2: DonCesarGrinder (446.99).
Seat 3: IlxxxlI (87.90).
Seat 5: JJaromir (495.50).
Seat 6: bunchy (398.81).
Player JJaromir has small blind (1)
Player bunchy sitting out
Player Popka1337 has big blind (2)
Player IlxxxlI received card: [6s]
Player IlxxxlI received card: [Qd]
Player DonCesarGrinder folds
Player IlxxxlI folds
Player JJaromir folds
Uncalled bet (1) returned to Popka1337
Player Popka1337 mucks cards
------ Summary ------
Pot: 2. Rake 0
*Player Popka1337 mucks (does not show cards). Bets: 1. Collects: 2. Wins: 1.
Player DonCesarGrinder does not show cards.Bets: 0. Collects: 0. Wins: 0.
Player IlxxxlI does not show cards.Bets: 0. Collects: 0. Wins: 0.
Player JJaromir does not show cards.Bets: 1. Collects: 0. Loses: 1.
Player bunchy does not show cards.Bets: 0. Collects: 0. Wins: 0.
Game ended at: 2016/11/28 18:57:20

Game started
Game ID: 786356144 0.25/0.50 (PRR) Gorgons - 5 (Hold'em)
Seat 5 is the button
Seat 1: SenNoSen (57.03).
Seat 2: eu4ria (234.83).
Seat 3: IlxxxlI (20).
Seat 4: Goomashroom (105.71).
Seat 5: legenda99 (50).
Seat 6: wethco (66).
Player wethco has small blind (0.25)
Player SenNoSen has big blind (0.50)
Player IlxxxlI received card: [10d]
Player IlxxxlI received card: [5c]
Player eu4ria folds
Player IlxxxlI folds
Player Goomashroom raises (1.25)
Player legenda99 folds
Player wethco calls (1)
Player SenNoSen folds
*** FLOP ***: [6h 6c 10s]
Player wethco checks
Player Goomashroom bets (2)
Player wethco folds
Uncalled bet (2) returned to Goomashroom
Player Goomashroom mucks cards
------ Summary ------
Pot: 2.85. Rake 0.11. JP fee 0.04
Board: [6h 6c 10s]
Player SenNoSen does not show cards.Bets: 0.50. Collects: 0. Loses: 0.50.
Player eu4ria does not show cards.Bets: 0. Collects: 0. Wins: 0.
Player IlxxxlI does not show cards.Bets: 0. Collects: 0. Wins: 0.
*Player Goomashroom mucks (does not show cards). Bets: 1.25. Collects: 2.85. Wins: 1.60.
Player legenda99 does not show cards.Bets: 0. Collects: 0. Wins: 0.
Player wethco does not show cards.Bets: 1.25. Collects: 0. Loses: 1.25.
Game ended at: 2016/11/28 18:57:1

Game started
Game ID: 786356102 1/2 (PRR) Lakhey - 10 (Hold'em)
Seat 2 is the button
Seat 1: Popka1337 (71.50).
Seat 2: DonCesarGrinder (446.99).
Seat 3: IlxxxlI (89.90).
Seat 4: KingGuciGuci (203).
Seat 5: JJaromir (493.70).
Seat 6: bunchy (398.81).
Player IlxxxlI has small blind (1)
Player KingGuciGuci sitting out
Player JJaromir has big blind (2)
Player IlxxxlI received card: [9d]
Player IlxxxlI received card: [10h]
Player bunchy folds
Player Popka1337 folds
Player DonCesarGrinder folds
Player IlxxxlI calls (1)
Player JJaromir checks
*** FLOP ***: [2h 6c Kh]
Player IlxxxlI checks
Player JJaromir bets (4)
Player IlxxxlI folds
Uncalled bet (4) returned to JJaromir
Player JJaromir mucks cards
------ Summary ------
Pot: 3.80. Rake 0.14. JP fee 0.06
Board: [2h 6c Kh]
Player Popka1337 does not show cards.Bets: 0. Collects: 0. Wins: 0.
Player DonCesarGrinder does not show cards.Bets: 0. Collects: 0. Wins: 0.
Player IlxxxlI does not show cards.Bets: 2. Collects: 0. Loses: 2.
Player KingGuciGuci does not show cards.Bets: 0. Collects: 0. Wins: 0.
*Player JJaromir mucks (does not show cards). Bets: 2. Collects: 3.80. Wins: 1.80.
Player bunchy does not show cards.Bets: 0. Collects: 0. Wins: 0.
Game ended at: 2016/11/28 18:57:1

Game started
Game ID: 786356051 0.25/0.50 (PRR) Gorgons - 17 (Hold'em)
Seat 2 is the button
Seat 1: Smok5 Js (34.37).
Seat 2: SenNoSen (77.31).
Seat 3: Goomashroom (50).
Seat 4: IlxxxlI (24.89).
Seat 5: BoTPuMHeDichBro (79.82).
Seat 6: eu4ria (52.36).
Player Goomashroom has small blind (0.25)
Player IlxxxlI has big blind (0.50)
Player IlxxxlI received card: [Kh]
Player IlxxxlI received card: [4h]
Player BoTPuMHeDichBro folds
Player eu4ria folds
Player Smok5 Js calls (0.50)
Player SenNoSen folds
Player Goomashroom calls (0.25)
Player IlxxxlI checks
*** FLOP ***: [Ac Qs 4c]
Player Goomashroom checks
Player IlxxxlI checks
Player Smok5 Js bets (1)
Player Goomashroom calls (1)
Player IlxxxlI folds
*** TURN ***: [Ac Qs 4c] [5h]
Player Goomashroom checks
Player Smok5 Js checks
*** RIVER ***: [Ac Qs 4c 5h] [3c]
Player Goomashroom bets (2)
Player Smok5 Js calls (2)
Player Smok5 Js is timed out.
Player Smok5 Js mucks cards
------ Summary ------
Pot: 7.13. Rake 0.25. JP fee 0.12
Board: [Ac Qs 4c 5h 3c]
Player Smok5 Js mucks (does not show cards). Bets: 3.50. Collects: 0. Loses: 3.50.
Player SenNoSen does not show cards.Bets: 0. Collects: 0. Wins: 0.
*Player Goomashroom shows: One pair of As [6s As]. Bets: 3.50. Collects: 7.13. Wins: 3.63.
Player IlxxxlI does not show cards.Bets: 0.50. Collects: 0. Loses: 0.50.
Player BoTPuMHeDichBro does not show cards.Bets: 0. Collects: 0. Wins: 0.
Player eu4ria does not show cards.Bets: 0. Collects: 0. Wins: 0.
Game ended at: 2016/11/28 18:57:32

Game started
Game ID: 786356021 0.25/0.50 (PRR) Gorgons - 5 (Hold'em)
Seat 4 is the button
Seat 1: SenNoSen (57.03).
Seat 2: eu4ria (234.83).
Seat 3: IlxxxlI (20).
Seat 4: Goomashroom (104.45).
Seat 5: legenda99 (50).
Seat 6: wethco (67.13).
Player legenda99 has small blind (0.25)
Player wethco has big blind (0.50)
Player IlxxxlI received card: [7c]
Player IlxxxlI received card: [5h]
Player SenNoSen folds
Player eu4ria folds
Player IlxxxlI folds
Player Goomashroom raises (1.13)
Player legenda99 folds
Player wethco calls (0.63)
*** FLOP ***: [Jh Jd Kh]
Player wethco checks
Player Goomashroom checks
*** TURN ***: [Jh Jd Kh] [2c]
Player wethco checks
Player Goomashroom bets (1.75)
Player wethco folds
Uncalled bet (1.75) returned to Goomashroom
Player Goomashroom mucks cards
------ Summary ------
Pot: 2.39. Rake 0.08. JP fee 0.04
Board: [Jh Jd Kh 2c]
Player SenNoSen does not show cards.Bets: 0. Collects: 0. Wins: 0.
Player eu4ria does not show cards.Bets: 0. Collects: 0. Wins: 0.
Player IlxxxlI does not show cards.Bets: 0. Collects: 0. Wins: 0.
*Player Goomashroom mucks (does not show cards). Bets: 1.13. Collects: 2.39. Wins: 1.26.
Player legenda99 does not show cards.Bets: 0.25. Collects: 0. Loses: 0.25.
Player wethco does not show cards.Bets: 1.13. Collects: 0. Loses: 1.13.
Game ended at: 2016/11/28 18:56:26

Game started
Game ID: 786356008 1/2 (PRR) Lakhey - 10 (Hold'em)
Seat 1 is the button
Seat 1: Popka1337 (71.50).
Seat 2: DonCesarGrinder (438.99).
Seat 3: IlxxxlI (91.90).
Seat 4: KingGuciGuci (203).
Seat 5: JJaromir (493.70).
Seat 6: bunchy (404.81).
Player DonCesarGrinder has small blind (1)
Player IlxxxlI has big blind (2)
Player IlxxxlI received card: [4s]
Player IlxxxlI received card: [Jd]
Player KingGuciGuci folds
Player JJaromir folds
Player bunchy raises (6)
Player Popka1337 folds
Player DonCesarGrinder raises (19.04)
Player IlxxxlI folds
Player bunchy folds
Uncalled bet (14.04) returned to DonCesarGrinder
Player DonCesarGrinder mucks cards
------ Summary ------
Pot: 14. Rake 0
Player Popka1337 does not show cards.Bets: 0. Collects: 0. Wins: 0.
*Player DonCesarGrinder mucks (does not show cards). Bets: 6. Collects: 14. Wins: 8.
Player IlxxxlI does not show cards.Bets: 2. Collects: 0. Loses: 2.
Player KingGuciGuci does not show cards.Bets: 0. Collects: 0. Wins: 0.
Player JJaromir does not show cards.Bets: 0. Collects: 0. Wins: 0.
Player bunchy does not show cards.Bets: 6. Collects: 0. Loses: 6.
Game ended at: 2016/11/28 18:56:4

Game started
Game ID: 786355959 0.25/0.50 (PRR) Gorgons - 17 (Hold'em)
Seat 1 is the button
Seat 1: Smok5 Js (34.37).
Seat 2: SenNoSen (76.81).
Seat 3: Goomashroom (50).
Seat 4: IlxxxlI (24.89).
Seat 5: BoTPuMHeDichBro (79.82).
Seat 6: eu4ria (52.36).
Player SenNoSen has small blind (0.25)
Player Goomashroom has big blind (0.50)
Player IlxxxlI received card: [8s]
Player IlxxxlI received card: [5d]
Player IlxxxlI folds
Player BoTPuMHeDichBro folds
Player eu4ria folds
Player Smok5 Js folds
Player SenNoSen raises (1.25)
Player Goomashroom folds
Uncalled bet (1) returned to SenNoSen
Player SenNoSen mucks cards
------ Summary ------
Pot: 1. Rake 0
Player Smok5 Js does not show cards.Bets: 0. Collects: 0. Wins: 0.
*Player SenNoSen mucks (does not show cards). Bets: 0.50. Collects: 1. Wins: 0.50.
Player Goomashroom does not show cards.Bets: 0.50. Collects: 0. Loses: 0.50.
Player IlxxxlI does not show cards.Bets: 0. Collects: 0. Wins: 0.
Player BoTPuMHeDichBro does not show cards.Bets: 0. Collects: 0. Wins: 0.
Player eu4ria does not show cards.Bets: 0. Collects: 0. Wins: 0.
Game ended at: 2016/11/28 18:55:37

Game started
Game ID: 786355894 0.25/0.50 (PRR) Gorgons - 17 (Hold'em)
Seat 6 is the button
Seat 1: Smok5 Js (34.62).
Seat 2: SenNoSen (77.31).
Seat 4: IlxxxlI (24.14).
Seat 5: BoTPuMHeDichBro (79.82).
Seat 6: eu4ria (52.36).
Player Smok5 Js has small blind (0.25)
Player SenNoSen has big blind (0.50)
Player IlxxxlI received card: [Kd]
Player IlxxxlI received card: [Kh]
Player IlxxxlI raises (1.75)
Player BoTPuMHeDichBro folds
Player eu4ria folds
Player Smok5 Js folds
Player SenNoSen folds
Uncalled bet (1.25) returned to IlxxxlI
Player IlxxxlI mucks cards
------ Summary ------
Pot: 1.25. Rake 0
Player Smok5 Js does not show cards.Bets: 0.25. Collects: 0. Loses: 0.25.
Player SenNoSen does not show cards.Bets: 0.50. Collects: 0. Loses: 0.50.
*Player IlxxxlI mucks (does not show cards). Bets: 0.50. Collects: 1.25. Wins: 0.75.
Player BoTPuMHeDichBro does not show cards.Bets: 0. Collects: 0. Wins: 0.
Player eu4ria does not show cards.Bets: 0. Collects: 0. Wins: 0.
Game ended at: 2016/11/28 18:55:0

Game started
Game ID: 786355843 1/2 (PRR) Lakhey - 10 (Hold'em)
Seat 6 is the button
Seat 1: Popka1337 (76).
Seat 2: DonCesarGrinder (434.49).
Seat 3: IlxxxlI (91.90).
Seat 4: KingGuciGuci (203).
Seat 5: JJaromir (493.70).
Seat 6: bunchy (404.81).
Player Popka1337 has small blind (1)
Player DonCesarGrinder has big blind (2)
Player IlxxxlI received card: [Ad]
Player IlxxxlI received card: [6d]
Player IlxxxlI folds
Player KingGuciGuci folds
Player JJaromir folds
Player bunchy folds
Player Popka1337 raises (3.50)
Player DonCesarGrinder raises (8.78)
Player Popka1337 folds
Uncalled bet (6.28) returned to DonCesarGrinder
Player DonCesarGrinder mucks cards
------ Summary ------
Pot: 9. Rake 0
Player Popka1337 does not show cards.Bets: 4.50. Collects: 0. Loses: 4.50.
*Player DonCesarGrinder mucks (does not show cards). Bets: 4.50. Collects: 9. Wins: 4.50.
Player IlxxxlI does not show cards.Bets: 0. Collects: 0. Wins: 0.
Player KingGuciGuci does not show cards.Bets: 0. Collects: 0. Wins: 0.
Player JJaromir does not show cards.Bets: 0. Collects: 0. Wins: 0.
Player bunchy does not show cards.Bets: 0. Collects: 0. Wins: 0.
Game ended at: 2016/11/28 18:55:20

Game started
Game ID: 786355836 0.25/0.50 (PRR) Gorgons - 5 (Hold'em)
Seat 3 is the button
Seat 1: SenNoSen (57.03).
Seat 2: eu4ria (231.81).
Seat 3: IlxxxlI (20.17).
Seat 4: Goomashroom (104.70).
Seat 5: legenda99 (50).
Seat 6: wethco (67.13).
Player Goomashroom has small blind (0.25)
Player legenda99 has big blind (0.50)
Player IlxxxlI received card: [5d]
Player IlxxxlI received card: [5c]
Player wethco folds
Player SenNoSen folds
Player eu4ria raises (1.50)
Player IlxxxlI calls (1.50)
Player Goomashroom folds
Player legenda99 calls (1)
*** FLOP ***: [Jc 8c 6c]
Player legenda99 checks
Player eu4ria checks
Player IlxxxlI checks
*** TURN ***: [Jc 8c 6c] [10h]
Player legenda99 checks
Player eu4ria bets (4)
Player IlxxxlI folds
Player legenda99 folds
Uncalled bet (4) returned to eu4ria
Player eu4ria mucks cards
------ Summary ------
Pot: 4.52. Rake 0.17. JP fee 0.06
Board: [Jc 8c 6c 10h]
Player SenNoSen does not show cards.Bets: 0. Collects: 0. Wins: 0.
*Player eu4ria mucks (does not show cards). Bets: 1.50. Collects: 4.52. Wins: 3.02.
Player IlxxxlI does not show cards.Bets: 1.50. Collects: 0. Loses: 1.50.
Player Goomashroom does not show cards.Bets: 0.25. Collects: 0. Loses: 0.25.
Player legenda99 does not show cards.Bets: 1.50. Collects: 0. Loses: 1.50.
Player wethco does not show cards.Bets: 0. Collects: 0. Wins: 0.
Game ended at: 2016/11/28 18:55:23

Game started
Game ID: 786355807 0.25/0.50 (PRR) Gorgons - 17 (Hold'em)
Seat 5 is the button
Seat 1: Smok5 Js (34.37).
Seat 2: SenNoSen (77.31).
Seat 4: IlxxxlI (24.14).
Seat 5: BoTPuMHeDichBro (79.82).
Seat 6: eu4ria (52.61).
Player eu4ria has small blind (0.25)
Player Smok5 Js has big blind (0.50)
Player IlxxxlI received card: [7h]
Player IlxxxlI received card: [6s]
Player SenNoSen folds
Player IlxxxlI folds
Player BoTPuMHeDichBro folds
Player eu4ria folds
Uncalled bet (0.25) returned to Smok5 Js
------ Summary ------
Pot: 0.50. Rake 0
*Player Smok5 Js shows: One pair of 9s [9d 9s]. Bets: 0.25. Collects: 0.50. Wins: 0.25.
Player SenNoSen does not show cards.Bets: 0. Collects: 0. Wins: 0.
Player IlxxxlI does not show cards.Bets: 0. Collects: 0. Wins: 0.
Player BoTPuMHeDichBro does not show cards.Bets: 0. Collects: 0. Wins: 0.
Player eu4ria does not show cards.Bets: 0.25. Collects: 0. Loses: 0.25.
Game ended at: 2016/11/28 18:54:28

Game started
Game ID: 786355767 0.25/0.50 (PRR) Gorgons - 5 (Hold'em)
Seat 2 is the button
Seat 1: SenNoSen (57.03).
Seat 2: eu4ria (231.81).
Seat 3: IlxxxlI (20.67).
Seat 4: Goomashroom (104.20).
Seat 6: wethco (67.13).
Player IlxxxlI has small blind (0.25)
Player Goomashroom has big blind (0.50)
Player IlxxxlI received card: [4d]
Player IlxxxlI received card: [Jd]
Player wethco folds
Player SenNoSen folds
Player eu4ria folds
Player IlxxxlI calls (0.25)
Player Goomashroom raises (1.50)
Player IlxxxlI folds
Uncalled bet (1.50) returned to Goomashroom
Player Goomashroom mucks cards
------ Summary ------
Pot: 1. Rake 0
Player SenNoSen does not show cards.Bets: 0. Collects: 0. Wins: 0.
Player eu4ria does not show cards.Bets: 0. Collects: 0. Wins: 0.
Player IlxxxlI does not show cards.Bets: 0.50. Collects: 0. Loses: 0.50.
*Player Goomashroom mucks (does not show cards). Bets: 0.50. Collects: 1. Wins: 0.50.
Player wethco does not show cards.Bets: 0. Collects: 0. Wins: 0.
Game ended at: 2016/11/28 18:54:8

Game started
Game ID: 786355670 1/2 (PRR) Lakhey - 10 (Hold'em)
Seat 5 is the button
Seat 1: Popka1337 (80).
Seat 2: DonCesarGrinder (434.49).
Seat 3: IlxxxlI (87.35).
Seat 4: KingGuciGuci (203).
Seat 5: JJaromir (493.70).
Seat 6: bunchy (405.81).
Player bunchy has small blind (1)
Player Popka1337 has big blind (2)
Player IlxxxlI received card: [9s]
Player IlxxxlI received card: [Ks]
Player DonCesarGrinder folds
Player IlxxxlI raises (4)
Player KingGuciGuci folds
Player JJaromir folds
Player bunchy folds
Player Popka1337 calls (2)
*** FLOP ***: [8s 9c 2s]
Player Popka1337 checks
Player IlxxxlI bets (5.70)
Player Popka1337 folds
Uncalled bet (5.70) returned to IlxxxlI
Player IlxxxlI mucks cards
------ Summary ------
Pot: 8.55. Rake 0.31. JP fee 0.14
Board: [8s 9c 2s]
Player Popka1337 does not show cards.Bets: 4. Collects: 0. Loses: 4.
Player DonCesarGrinder does not show cards.Bets: 0. Collects: 0. Wins: 0.
*Player IlxxxlI mucks (does not show cards). Bets: 4. Collects: 8.55. Wins: 4.55.
Player KingGuciGuci does not show cards.Bets: 0. Collects: 0. Wins: 0.
Player JJaromir does not show cards.Bets: 0. Collects: 0. Wins: 0.
Player bunchy does not show cards.Bets: 1. Collects: 0. Loses: 1.
Game ended at: 2016/11/28 18:54:12

Game started
Game ID: 786355657 0.25/0.50 (PRR) Gorgons - 17 (Hold'em)
Seat 4 is the button
Seat 1: Smok5 Js (34.87).
Seat 2: SenNoSen (77.31).
Seat 4: IlxxxlI (22.97).
Seat 5: BoTPuMHeDichBro (80.07).
Seat 6: eu4ria (53.11).
Player BoTPuMHeDichBro has small blind (0.25)
Player eu4ria has big blind (0.50)
Player IlxxxlI received card: [Jc]
Player IlxxxlI received card: [9c]
Player Smok5 Js calls (0.50)
Player SenNoSen folds
Player IlxxxlI calls (0.50)
Player BoTPuMHeDichBro folds
Player eu4ria checks
*** FLOP ***: [3c Jh 3s]
Player eu4ria checks
Player Smok5 Js checks
Player IlxxxlI bets (0.87)
Player eu4ria folds
Player Smok5 Js folds
Uncalled bet (0.87) returned to IlxxxlI
Player IlxxxlI mucks cards
------ Summary ------
Pot: 1.67. Rake 0.06. JP fee 0.02
Board: [3c Jh 3s]
Player Smok5 Js does not show cards.Bets: 0.50. Collects: 0. Loses: 0.50.
Player SenNoSen does not show cards.Bets: 0. Collects: 0. Wins: 0.
*Player IlxxxlI mucks (does not show cards). Bets: 0.50. Collects: 1.67. Wins: 1.17.
Player BoTPuMHeDichBro does not show cards.Bets: 0.25. Collects: 0. Loses: 0.25.
Player eu4ria does not show cards.Bets: 0.50. Collects: 0. Loses: 0.50.
Game ended at: 2016/11/28 18:53:56

Game started
Game ID: 786355640 0.25/0.50 (PRR) Gorgons - 5 (Hold'em)
Seat 1 is the button
Seat 1: SenNoSen (54.06).
Seat 2: eu4ria (232.06).
Seat 3: IlxxxlI (21.17).
Seat 4: Goomashroom (104.20).
Seat 6: wethco (69.63).
Player eu4ria has small blind (0.25)
Player IlxxxlI has big blind (0.50)
Player IlxxxlI received card: [4c]
Player IlxxxlI received card: [7h]
Player Goomashroom folds
Player wethco calls (0.50)
Player SenNoSen raises (2.50)
Player eu4ria folds
Player IlxxxlI folds
Player wethco calls (2)
*** FLOP ***: [4d Qd 5d]
Player wethco checks
Player SenNoSen bets (1.82)
Player wethco folds
Uncalled bet (1.82) returned to SenNoSen
Player SenNoSen mucks cards
------ Summary ------
Pot: 5.47. Rake 0.20. JP fee 0.08
Board: [4d Qd 5d]
*Player SenNoSen mucks (does not show cards). Bets: 2.50. Collects: 5.47. Wins: 2.97.
Player eu4ria does not show cards.Bets: 0.25. Collects: 0. Loses: 0.25.
Player IlxxxlI does not show cards.Bets: 0.50. Collects: 0. Loses: 0.50.
Player Goomashroom does not show cards.Bets: 0. Collects: 0. Wins: 0.
Player wethco does not show cards.Bets: 2.50. Collects: 0. Loses: 2.50.
Game ended at: 2016/11/28 18:53:41

Game started
Game ID: 786355622 1/2 (PRR) Lakhey - 10 (Hold'em)
Seat 4 is the button
Seat 2: DonCesarGrinder (434.49).
Seat 3: IlxxxlI (87.35).
Seat 4: KingGuciGuci (200).
Seat 5: JJaromir (494.70).
Seat 6: bunchy (407.81).
Player JJaromir has small blind (1)
Player bunchy has big blind (2)
Player IlxxxlI received card: [8h]
Player IlxxxlI received card: [3c]
Player DonCesarGrinder folds
Player IlxxxlI folds
Player KingGuciGuci raises (4.40)
Player JJaromir folds
Player bunchy folds
Uncalled bet (2.40) returned to KingGuciGuci
Player KingGuciGuci mucks cards
------ Summary ------
Pot: 5. Rake 0
Player DonCesarGrinder does not show cards.Bets: 0. Collects: 0. Wins: 0.
Player IlxxxlI does not show cards.Bets: 0. Collects: 0. Wins: 0.
*Player KingGuciGuci mucks (does not show cards). Bets: 2. Collects: 5. Wins: 3.
Player JJaromir does not show cards.Bets: 1. Collects: 0. Loses: 1.
Player bunchy does not show cards.Bets: 2. Collects: 0. Loses: 2.
Game ended at: 2016/11/28 18:53:3

Game started
Game ID: 786355601 0.25/0.50 (PRR) Gorgons - 17 (Hold'em)
Seat 2 is the button
Seat 1: Smok5 Js (34.87).
Seat 2: SenNoSen (77.31).
Seat 4: IlxxxlI (23.22).
Seat 5: BoTPuMHeDichBro (80.57).
Seat 6: eu4ria (52.36).
Player IlxxxlI has small blind (0.25)
Player BoTPuMHeDichBro has big blind (0.50)
Player IlxxxlI received card: [2d]
Player IlxxxlI received card: [8d]
Player eu4ria raises (1.50)
Player Smok5 Js folds
Player SenNoSen folds
Player IlxxxlI folds
Player BoTPuMHeDichBro folds
Uncalled bet (1) returned to eu4ria
Player eu4ria mucks cards
------ Summary ------
Pot: 1.25. Rake 0
Player Smok5 Js does not show cards.Bets: 0. Collects: 0. Wins: 0.
Player SenNoSen does not show cards.Bets: 0. Collects: 0. Wins: 0.
Player IlxxxlI does not show cards.Bets: 0.25. Collects: 0. Loses: 0.25.
Player BoTPuMHeDichBro does not show cards.Bets: 0.50. Collects: 0. Loses: 0.50.
*Player eu4ria mucks (does not show cards). Bets: 0.50. Collects: 1.25. Wins: 0.75.
Game ended at: 2016/11/28 18:52:57

Game started
Game ID: 786355552 0.25/0.50 (PRR) Gorgons - 17 (Hold'em)
Seat 1 is the button
Seat 1: Smok5 Js (34.87).
Seat 2: SenNoSen (77.56).
Seat 3: Hakuna_Matata777 (63.09).
Seat 4: IlxxxlI (22.97).
Seat 5: BoTPuMHeDichBro (80.57).
Seat 6: eu4ria (52.36).
Player SenNoSen has small blind (0.25)
Player Hakuna_Matata777 sitting out
Player IlxxxlI has big blind (0.50)
Player IlxxxlI received card: [8s]
Player IlxxxlI received card: [5h]
Player BoTPuMHeDichBro folds
Player eu4ria folds
Player Smok5 Js folds
Player SenNoSen folds
Uncalled bet (0.25) returned to IlxxxlI
Player IlxxxlI mucks cards
------ Summary ------
Pot: 0.50. Rake 0
Player Smok5 Js does not show cards.Bets: 0. Collects: 0. Wins: 0.
Player SenNoSen does not show cards.Bets: 0.25. Collects: 0. Loses: 0.25.
Player Hakuna_Matata777 does not show cards.Bets: 0. Collects: 0. Wins: 0.
*Player IlxxxlI mucks (does not show cards). Bets: 0.25. Collects: 0.50. Wins: 0.25.
Player BoTPuMHeDichBro does not show cards.Bets: 0. Collects: 0. Wins: 0.
Player eu4ria does not show cards.Bets: 0. Collects: 0. Wins: 0.
Game ended at: 2016/11/28 18:52:36

Game started
Game ID: 786355488 0.25/0.50 (PRR) Gorgons - 5 (Hold'em)
Seat 6 is the button
Seat 1: SenNoSen (51).
Seat 2: eu4ria (235.46).
Seat 3: IlxxxlI (21.17).
Seat 4: Goomashroom (104.20).
Seat 6: wethco (69.63).
Player SenNoSen has small blind (0.25)
Player eu4ria has big blind (0.50)
Player IlxxxlI received card: [Ad]
Player IlxxxlI received card: [8d]
Player IlxxxlI folds
Player Goomashroom folds
Player wethco folds
Player SenNoSen raises (1.25)
Player eu4ria calls (1)
*** FLOP ***: [6s Ah Kd]
Player SenNoSen checks
Player eu4ria checks
*** TURN ***: [6s Ah Kd] [6h]
Player SenNoSen checks
Player eu4ria checks
*** RIVER ***: [6s Ah Kd 6h] [4h]
Player SenNoSen bets (1.90)
Player eu4ria calls (1.90)
Player eu4ria mucks cards
------ Summary ------
Pot: 6.46. Rake 0.24. JP fee 0.10
Board: [6s Ah Kd 6h 4h]
*Player SenNoSen shows: Two pairs. Ks and 6s [Ks Qd]. Bets: 3.40. Collects: 6.46. Wins: 3.06.
Player eu4ria mucks (does not show cards). Bets: 3.40. Collects: 0. Loses: 3.40.
Player IlxxxlI does not show cards.Bets: 0. Collects: 0. Wins: 0.
Player Goomashroom does not show cards.Bets: 0. Collects: 0. Wins: 0.
Player wethco does not show cards.Bets: 0. Collects: 0. Wins: 0.
Game ended at: 2016/11/28 18:52:50

Game started
Game ID: 786355452 0.25/0.50 (PRR) Gorgons - 5 (Hold'em)
Seat 4 is the button
Seat 1: SenNoSen (50.75).
Seat 2: eu4ria (235.46).
Seat 3: IlxxxlI (21.17).
Seat 4: Goomashroom (104.20).
Seat 6: wethco (69.88).
Player wethco has small blind (0.25)
Player SenNoSen has big blind (0.50)
Player IlxxxlI received card: [As]
Player IlxxxlI received card: [4d]
Player eu4ria folds
Player IlxxxlI folds
Player Goomashroom folds
Player wethco folds
Uncalled bet (0.25) returned to SenNoSen
Player SenNoSen mucks cards
------ Summary ------
Pot: 0.50. Rake 0
*Player SenNoSen mucks (does not show cards). Bets: 0.25. Collects: 0.50. Wins: 0.25.
Player eu4ria does not show cards.Bets: 0. Collects: 0. Wins: 0.
Player IlxxxlI does not show cards.Bets: 0. Collects: 0. Wins: 0.
Player Goomashroom does not show cards.Bets: 0. Collects: 0. Wins: 0.
Player wethco does not show cards.Bets: 0.25. Collects: 0. Loses: 0.25.
Game ended at: 2016/11/28 18:51:52

Game started
Game ID: 786355403 1/2 (PRR) Lakhey - 10 (Hold'em)
Seat 3 is the button
Seat 2: DonCesarGrinder (439.49).
Seat 3: IlxxxlI (80).
Seat 4: KingGuciGuci (200).
Seat 5: JJaromir (496.70).
Seat 6: bunchy (407.81).
Player KingGuciGuci has small blind (1)
Player JJaromir has big blind (2)
Player IlxxxlI received card: [7d]
Player IlxxxlI received card: [7c]
Player bunchy folds
Player DonCesarGrinder raises (5)
Player IlxxxlI calls (5)
Player KingGuciGuci folds
Player JJaromir folds
*** FLOP ***: [6c 3c Qd]
Player DonCesarGrinder checks
Player IlxxxlI checks
*** TURN ***: [6c 3c Qd] [7s]
Player DonCesarGrinder checks
Player IlxxxlI bets (12)
Player DonCesarGrinder folds
Uncalled bet (12) returned to IlxxxlI
Player IlxxxlI mucks cards
------ Summary ------
Pot: 12.35. Rake 0.45. JP fee 0.20
Board: [6c 3c Qd 7s]
Player DonCesarGrinder does not show cards.Bets: 5. Collects: 0. Loses: 5.
*Player IlxxxlI mucks (does not show cards). Bets: 5. Collects: 12.35. Wins: 7.35.
Player KingGuciGuci does not show cards.Bets: 1. Collects: 0. Loses: 1.
Player JJaromir does not show cards.Bets: 2. Collects: 0. Loses: 2.
Player bunchy does not show cards.Bets: 0. Collects: 0. Wins: 0.
Game ended at: 2016/11/28 18:52:44

Game started
Game ID: 786355399 0.25/0.50 (PRR) Gorgons - 5 (Hold'em)
Seat 3 is the button
Seat 1: SenNoSen (50).
Seat 2: eu4ria (235.46).
Seat 3: IlxxxlI (21.17).
Seat 4: Goomashroom (104.45).
Seat 6: wethco (70.38).
Player Goomashroom has small blind (0.25)
Player wethco has big blind (0.50)
Player IlxxxlI received card: [Jc]
Player IlxxxlI received card: [Kh]
Player SenNoSen raises (1.50)
Player eu4ria folds
Player IlxxxlI folds
Player Goomashroom folds
Player wethco folds
Uncalled bet (1) returned to SenNoSen
Player SenNoSen mucks cards
------ Summary ------
Pot: 1.25. Rake 0
*Player SenNoSen mucks (does not show cards). Bets: 0.50. Collects: 1.25. Wins: 0.75.
Player eu4ria does not show cards.Bets: 0. Collects: 0. Wins: 0.
Player IlxxxlI does not show cards.Bets: 0. Collects: 0. Wins: 0.
Player Goomashroom does not show cards.Bets: 0.25. Collects: 0. Loses: 0.25.
Player wethco does not show cards.Bets: 0.50. Collects: 0. Loses: 0.50.
Game ended at: 2016/11/28 18:51:39

Game started
Game ID: 786355174 0.25/0.50 (PRR) Gorgons - 17 (Hold'em)
Seat 6 is the button
Seat 1: Smok5 Js (38.59).
Seat 2: SenNoSen (78.06).
Seat 3: Hakuna_Matata777 (63.09).
Seat 4: IlxxxlI (22.97).
Seat 5: BoTPuMHeDichBro (76.74).
Seat 6: eu4ria (52.36).
Player Smok5 Js has small blind (0.25)
Player SenNoSen has big blind (0.50)
Player IlxxxlI received card: [5s]
Player IlxxxlI received card: [2s]
Player Hakuna_Matata777 folds
Player IlxxxlI folds
Player BoTPuMHeDichBro raises (1.50)
Player eu4ria folds
Player Smok5 Js calls (1.25)
Player SenNoSen folds
*** FLOP ***: [9s 8s 6h]
Player Smok5 Js checks
Player BoTPuMHeDichBro bets (2.22)
Player Smok5 Js calls (2.22)
*** TURN ***: [9s 8s 6h] [10c]
Player Smok5 Js checks
Player BoTPuMHeDichBro bets (6)
Player Smok5 Js folds
Uncalled bet (6) returned to BoTPuMHeDichBro
Player BoTPuMHeDichBro mucks cards
------ Summary ------
Pot: 7.55. Rake 0.27. JP fee 0.12
Board: [9s 8s 6h 10c]
Player Smok5 Js does not show cards.Bets: 3.72. Collects: 0. Loses: 3.72.
Player SenNoSen does not show cards.Bets: 0.50. Collects: 0. Loses: 0.50.
Player Hakuna_Matata777 does not show cards.Bets: 0. Collects: 0. Wins: 0.
Player IlxxxlI does not show cards.Bets: 0. Collects: 0. Wins: 0.
*Player BoTPuMHeDichBro mucks (does not show cards). Bets: 3.72. Collects: 7.55. Wins: 3.83.
Player eu4ria does not show cards.Bets: 0. Collects: 0. Wins: 0.
Game ended at: 2016/11/28 18:52:16

Game started
Game ID: 786355168 0.25/0.50 (PRR) Gorgons - 5 (Hold'em)
Seat 2 is the button
Seat 1: SenNoSen (50).
Seat 2: eu4ria (235.46).
Seat 3: IlxxxlI (23.66).
Seat 4: Goomashroom (102.20).
Seat 5: GreinSeint (35.07).
Seat 6: wethco (70.38).
Player IlxxxlI has small blind (0.25)
Player Goomashroom has big blind (0.50)
Player IlxxxlI received card: [Js]
Player IlxxxlI received card: [Qd]
Player GreinSeint folds
Player wethco folds
Player SenNoSen folds
Player eu4ria folds
Player IlxxxlI raises (1)
Player Goomashroom calls (0.75)
*** FLOP ***: [4d 4h 2h]
Player IlxxxlI bets (1.24)
Player Goomashroom calls (1.24)
*** TURN ***: [4d 4h 2h] [7s]
Player IlxxxlI checks
Player Goomashroom bets (2.64)
Player IlxxxlI folds
Uncalled bet (2.64) returned to Goomashroom
Player Goomashroom mucks cards
------ Summary ------
Pot: 4.74. Rake 0.16. JP fee 0.08
Board: [4d 4h 2h 7s]
Player SenNoSen does not show cards.Bets: 0. Collects: 0. Wins: 0.
Player eu4ria does not show cards.Bets: 0. Collects: 0. Wins: 0.
Player IlxxxlI does not show cards.Bets: 2.49. Collects: 0. Loses: 2.49.
*Player Goomashroom mucks (does not show cards). Bets: 2.49. Collects: 4.74. Wins: 2.25.
Player GreinSeint does not show cards.Bets: 0. Collects: 0. Wins: 0.
Player wethco does not show cards.Bets: 0. Collects: 0. Wins: 0.
Game ended at: 2016/11/28 18:51:21

Game started
Game ID: 786355153 1/2 (PRR) Lakhey - 10 (Hold'em)
Seat 2 is the button
Seat 2: DonCesarGrinder (426.11).
Seat 3: IlxxxlI (80).
Seat 4: KingGuciGuci (200).
Seat 5: JJaromir (496.70).
Seat 6: bunchy (407.81).
Player IlxxxlI has small blind (1)
Player KingGuciGuci has big blind (2)
Player IlxxxlI received card: [Ah]
Player IlxxxlI received card: [Qd]
Player JJaromir folds
Player bunchy folds
Player DonCesarGrinder raises (5)
Player IlxxxlI raises (11.75)
Player KingGuciGuci folds
Player DonCesarGrinder calls (7.75)
*** FLOP ***: [9s 10c 7h]
Player IlxxxlI checks
Player DonCesarGrinder checks
*** TURN ***: [9s 10c 7h] [9c]
Player IlxxxlI checks
Player DonCesarGrinder bets (14.29)
Player IlxxxlI folds
Uncalled bet (14.29) returned to DonCesarGrinder
Player DonCesarGrinder mucks cards
------ Summary ------
Pot: 26.13. Rake 1.13. JP fee 0.24
Board: [9s 10c 7h 9c]
*Player DonCesarGrinder mucks (does not show cards). Bets: 12.75. Collects: 26.13. Wins: 13.38.
Player IlxxxlI does not show cards.Bets: 12.75. Collects: 0. Loses: 12.75.
Player KingGuciGuci does not show cards.Bets: 2. Collects: 0. Loses: 2.
Player JJaromir does not show cards.Bets: 0. Collects: 0. Wins: 0.
Player bunchy does not show cards.Bets: 0. Collects: 0. Wins: 0.
Game ended at: 2016/11/28 18:51:24

Game started
Game ID: 786355094 0.25/0.50 (PRR) Gorgons - 17 (Hold'em)
Seat 5 is the button
Seat 1: Smok5 Js (39.09).
Seat 2: SenNoSen (78.06).
Seat 3: Hakuna_Matata777 (63.09).
Seat 4: IlxxxlI (22.22).
Seat 5: BoTPuMHeDichBro (76.74).
Seat 6: eu4ria (52.61).
Player eu4ria has small blind (0.25)
Player Smok5 Js has big blind (0.50)
Player IlxxxlI received card: [Kh]
Player IlxxxlI received card: [10c]
Player SenNoSen folds
Player Hakuna_Matata777 folds
Player IlxxxlI raises (1.20)
Player BoTPuMHeDichBro folds
Player eu4ria folds
Player Smok5 Js folds
Uncalled bet (0.70) returned to IlxxxlI
Player IlxxxlI mucks cards
------ Summary ------
Pot: 1.25. Rake 0
Player Smok5 Js does not show cards.Bets: 0.50. Collects: 0. Loses: 0.50.
Player SenNoSen does not show cards.Bets: 0. Collects: 0. Wins: 0.
Player Hakuna_Matata777 does not show cards.Bets: 0. Collects: 0. Wins: 0.
*Player IlxxxlI mucks (does not show cards). Bets: 0.50. Collects: 1.25. Wins: 0.75.
Player BoTPuMHeDichBro does not show cards.Bets: 0. Collects: 0. Wins: 0.
Player eu4ria does not show cards.Bets: 0.25. Collects: 0. Loses: 0.25.
Game ended at: 2016/11/28 18:49:57

Game started
Game ID: 786355054 1/2 (PRR) Lakhey - 10 (Hold'em)
Seat 6 is the button
Seat 2: DonCesarGrinder (413.96).
Seat 3: IlxxxlI (83).
Seat 4: KingGuciGuci (200).
Seat 5: JJaromir (496.70).
Seat 6: bunchy (407.81).
Player DonCesarGrinder has small blind (1)
Player IlxxxlI has big blind (2)
Player IlxxxlI received card: [7c]
Player IlxxxlI received card: [Ac]
Player KingGuciGuci folds
Player JJaromir folds
Player bunchy folds
Player DonCesarGrinder raises (4)
Player IlxxxlI raises (10.15)
Player DonCesarGrinder allin (408.96)
Player IlxxxlI folds
Uncalled bet (401.81) returned to DonCesarGrinder
Player DonCesarGrinder mucks cards
------ Summary ------
Pot: 24.30. Rake 0
*Player DonCesarGrinder mucks (does not show cards). Bets: 12.15. Collects: 24.30. Wins: 12.15.
Player IlxxxlI does not show cards.Bets: 12.15. Collects: 0. Loses: 12.15.
Player KingGuciGuci does not show cards.Bets: 0. Collects: 0. Wins: 0.
Player JJaromir does not show cards.Bets: 0. Collects: 0. Wins: 0.
Player bunchy does not show cards.Bets: 0. Collects: 0. Wins: 0.
Game ended at: 2016/11/28 18:49:52

Game started
Game ID: 786355008 0.25/0.50 (PRR) Gorgons - 5 (Hold'em)
Seat 1 is the button
Seat 1: SenNoSen (50).
Seat 2: eu4ria (235.71).
Seat 3: IlxxxlI (22.07).
Seat 4: Goomashroom (102.20).
Seat 5: GreinSeint (36.57).
Seat 6: wethco (70.38).
Player eu4ria has small blind (0.25)
Player IlxxxlI has big blind (0.50)
Player IlxxxlI received card: [9h]
Player IlxxxlI received card: [Ah]
Player Goomashroom folds
Player GreinSeint raises (1.50)
Player wethco folds
Player SenNoSen folds
Player eu4ria folds
Player IlxxxlI calls (1)
*** FLOP ***: [5d Qc 4h]
Player IlxxxlI checks
Player GreinSeint checks
*** TURN ***: [5d Qc 4h] [3h]
Player IlxxxlI bets (6)
Player GreinSeint folds
Uncalled bet (6) returned to IlxxxlI
Player IlxxxlI mucks cards
------ Summary ------
Pot: 3.09. Rake 0.12. JP fee 0.04
Board: [5d Qc 4h 3h]
Player SenNoSen does not show cards.Bets: 0. Collects: 0. Wins: 0.
Player eu4ria does not show cards.Bets: 0.25. Collects: 0. Loses: 0.25.
*Player IlxxxlI mucks (does not show cards). Bets: 1.50. Collects: 3.09. Wins: 1.59.
Player Goomashroom does not show cards.Bets: 0. Collects: 0. Wins: 0.
Player GreinSeint does not show cards.Bets: 1.50. Collects: 0. Loses: 1.50.
Player wethco does not show cards.Bets: 0. Collects: 0. Wins: 0.
Game ended at: 2016/11/28 18:49:55

Game started
Game ID: 786354979 0.25/0.50 (PRR) Gorgons - 17 (Hold'em)
Seat 4 is the button
Seat 1: Smok5 Js (39.09).
Seat 2: SenNoSen (78.06).
Seat 3: Hakuna_Matata777 (63.09).
Seat 4: IlxxxlI (21.47).
Seat 5: BoTPuMHeDichBro (76.99).
Seat 6: eu4ria (53.11).
Player BoTPuMHeDichBro has small blind (0.25)
Player eu4ria has big blind (0.50)
Player IlxxxlI received card: [Kc]
Player IlxxxlI received card: [Qc]
Player Smok5 Js folds
Player SenNoSen folds
Player Hakuna_Matata777 folds
Player IlxxxlI raises (1.50)
Player BoTPuMHeDichBro folds
Player eu4ria folds
Uncalled bet (1) returned to IlxxxlI
Player IlxxxlI mucks cards
------ Summary ------
Pot: 1.25. Rake 0
Player Smok5 Js does not show cards.Bets: 0. Collects: 0. Wins: 0.
Player SenNoSen does not show cards.Bets: 0. Collects: 0. Wins: 0.
Player Hakuna_Matata777 does not show cards.Bets: 0. Collects: 0. Wins: 0.
*Player IlxxxlI mucks (does not show cards). Bets: 0.50. Collects: 1.25. Wins: 0.75.
Player BoTPuMHeDichBro does not show cards.Bets: 0.25. Collects: 0. Loses: 0.25.
Player eu4ria does not show cards.Bets: 0.50. Collects: 0. Loses: 0.50.
Game ended at: 2016/11/28 18:49:31

Game started
Game ID: 786354807 0.25/0.50 (PRR) Gorgons - 17 (Hold'em)
Seat 3 is the button
Seat 1: Smok5 Js (39.09).
Seat 2: SenNoSen (78.06).
Seat 3: Hakuna_Matata777 (63.09).
Seat 4: IlxxxlI (22.72).
Seat 5: BoTPuMHeDichBro (75.86).
Seat 6: eu4ria (53.11).
Player IlxxxlI has small blind (0.25)
Player BoTPuMHeDichBro has big blind (0.50)
Player IlxxxlI received card: [Ad]
Player IlxxxlI received card: [2d]
Player eu4ria folds
Player Smok5 Js folds
Player SenNoSen folds
Player Hakuna_Matata777 folds
Player IlxxxlI raises (1)
Player BoTPuMHeDichBro calls (0.75)
*** FLOP ***: [2c 9s Qh]
Player IlxxxlI checks
Player BoTPuMHeDichBro checks
*** TURN ***: [2c 9s Qh] [10h]
Player IlxxxlI checks
Player BoTPuMHeDichBro bets (1.58)
Player IlxxxlI folds
Uncalled bet (1.58) returned to BoTPuMHeDichBro
Player BoTPuMHeDichBro mucks cards
------ Summary ------
Pot: 2.38. Rake 0.08. JP fee 0.04
Board: [2c 9s Qh 10h]
Player Smok5 Js does not show cards.Bets: 0. Collects: 0. Wins: 0.
Player SenNoSen does not show cards.Bets: 0. Collects: 0. Wins: 0.
Player Hakuna_Matata777 does not show cards.Bets: 0. Collects: 0. Wins: 0.
Player IlxxxlI does not show cards.Bets: 1.25. Collects: 0. Loses: 1.25.
*Player BoTPuMHeDichBro mucks (does not show cards). Bets: 1.25. Collects: 2.38. Wins: 1.13.
Player eu4ria does not show cards.Bets: 0. Collects: 0. Wins: 0.
Game ended at: 2016/11/28 18:48:57

Game started
Game ID: 786354804 0.25/0.50 (PRR) Gorgons - 5 (Hold'em)
Seat 6 is the button
Seat 1: SenNoSen (100.61).
Seat 2: eu4ria (236.21).
Seat 3: IlxxxlI (22.07).
Seat 4: Goomashroom (52.35).
Seat 5: GreinSeint (36.57).
Seat 6: wethco (70.38).
Player SenNoSen has small blind (0.25)
Player eu4ria has big blind (0.50)
Player IlxxxlI received card: [3s]
Player IlxxxlI received card: [10h]
Player IlxxxlI folds
Player Goomashroom raises (1.50)
Player GreinSeint folds
Player wethco folds
Player SenNoSen raises (4.75)
Player eu4ria folds
Player Goomashroom raises (10.04)
Player SenNoSen allin (95.61)
Player Goomashroom allin (40.81)
Uncalled bet (48.26) returned to SenNoSen
*** FLOP ***: [6c Jc 2s]
*** TURN ***: [6c Jc 2s] [5d]
*** RIVER ***: [6c Jc 2s 5d] [8d]
------ Summary ------
Pot: 102.20. Rake 2.76. JP fee 0.24
Board: [6c Jc 2s 5d 8d]
Player SenNoSen shows: One pair of Ks [Kc Ks]. Bets: 52.35. Collects: 0. Loses: 52.35.
Player eu4ria does not show cards.Bets: 0.50. Collects: 0. Loses: 0.50.
Player IlxxxlI does not show cards.Bets: 0. Collects: 0. Wins: 0.
*Player Goomashroom shows: One pair of As [Ah As]. Bets: 52.35. Collects: 102.20. Wins: 49.85.
Player GreinSeint does not show cards.Bets: 0. Collects: 0. Wins: 0.
Player wethco does not show cards.Bets: 0. Collects: 0. Wins: 0.
Game ended at: 2016/11/28 18:49:4

Game started
Game ID: 786354751 0.25/0.50 (PRR) Gorgons - 5 (Hold'em)
Seat 5 is the button
Seat 1: SenNoSen (101.11).
Seat 2: eu4ria (236.21).
Seat 3: IlxxxlI (21.32).
Seat 4: Goomashroom (52.35).
Seat 5: GreinSeint (36.57).
Seat 6: wethco (70.63).
Player wethco has small blind (0.25)
Player SenNoSen has big blind (0.50)
Player IlxxxlI received card: [Qc]
Player IlxxxlI received card: [Ac]
Player eu4ria folds
Player IlxxxlI raises (1.75)
Player Goomashroom folds
Player GreinSeint folds
Player wethco folds
Player SenNoSen folds
Uncalled bet (1.25) returned to IlxxxlI
Player IlxxxlI mucks cards
------ Summary ------
Pot: 1.25. Rake 0
Player SenNoSen does not show cards.Bets: 0.50. Collects: 0. Loses: 0.50.
Player eu4ria does not show cards.Bets: 0. Collects: 0. Wins: 0.
*Player IlxxxlI mucks (does not show cards). Bets: 0.50. Collects: 1.25. Wins: 0.75.
Player Goomashroom does not show cards.Bets: 0. Collects: 0. Wins: 0.
Player GreinSeint does not show cards.Bets: 0. Collects: 0. Wins: 0.
Player wethco does not show cards.Bets: 0.25. Collects: 0. Loses: 0.25.
Game ended at: 2016/11/28 18:47:56

Game started
Game ID: 786354677 1/2 (PRR) Lakhey - 10 (Hold'em)
Seat 5 is the button
Seat 2: DonCesarGrinder (415.96).
Seat 3: IlxxxlI (83).
Seat 4: KingGuciGuci (214.60).
Seat 5: JJaromir (496.70).
Seat 6: bunchy (359.31).
Player bunchy has small blind (1)
Player DonCesarGrinder has big blind (2)
Player IlxxxlI received card: [3h]
Player IlxxxlI received card: [2c]
Player IlxxxlI folds
Player KingGuciGuci raises (4.40)
Player JJaromir folds
Player bunchy raises (15)
Player DonCesarGrinder folds
Player KingGuciGuci calls (11.60)
*** FLOP ***: [10h 7h 2h]
Player bunchy checks
Player KingGuciGuci bets (13.90)
Player bunchy calls (13.90)
*** TURN ***: [10h 7h 2h] [8h]
Player bunchy checks
Player KingGuciGuci checks
*** RIVER ***: [10h 7h 2h 8h] [Ac]
Player bunchy bets (19.60)
Player KingGuciGuci calls (19.60)
Player KingGuciGuci mucks cards
------ Summary ------
Pot: 98. Rake 2.76. JP fee 0.24
Board: [10h 7h 2h 8h Ac]
Player DonCesarGrinder does not show cards.Bets: 2. Collects: 0. Loses: 2.
Player IlxxxlI does not show cards.Bets: 0. Collects: 0. Wins: 0.
Player KingGuciGuci mucks (does not show cards). Bets: 49.50. Collects: 0. Loses: 49.50.
Player JJaromir does not show cards.Bets: 0. Collects: 0. Wins: 0.
*Player bunchy shows: Flush, K high [Kc Kh]. Bets: 49.50. Collects: 98. Wins: 48.50.
Game ended at: 2016/11/28 18:49:15

Game started
Game ID: 786354675 0.25/0.50 (PRR) Gorgons - 5 (Hold'em)
Seat 4 is the button
Seat 1: SenNoSen (101.11).
Seat 2: eu4ria (236.21).
Seat 3: IlxxxlI (20).
Seat 4: Goomashroom (52.35).
Seat 5: GreinSeint (36.82).
Seat 6: wethco (71.83).
Player GreinSeint has small blind (0.25)
Player wethco has big blind (0.50)
Player IlxxxlI received card: [Kc]
Player IlxxxlI received card: [Kd]
Player SenNoSen folds
Player eu4ria folds
Player IlxxxlI raises (1.20)
Player Goomashroom folds
Player GreinSeint folds
Player wethco calls (0.70)
*** FLOP ***: [Jd Ks 6s]
Player wethco checks
Player IlxxxlI bets (1.31)
Player wethco folds
Uncalled bet (1.31) returned to IlxxxlI
Player IlxxxlI mucks cards
------ Summary ------
Pot: 2.52. Rake 0.09. JP fee 0.04
Board: [Jd Ks 6s]
Player SenNoSen does not show cards.Bets: 0. Collects: 0. Wins: 0.
Player eu4ria does not show cards.Bets: 0. Collects: 0. Wins: 0.
*Player IlxxxlI mucks (does not show cards). Bets: 1.20. Collects: 2.52. Wins: 1.32.
Player Goomashroom does not show cards.Bets: 0. Collects: 0. Wins: 0.
Player GreinSeint does not show cards.Bets: 0.25. Collects: 0. Loses: 0.25.
Player wethco does not show cards.Bets: 1.20. Collects: 0. Loses: 1.20.
Game ended at: 2016/11/28 18:47:37

Game started
Game ID: 786354647 0.25/0.50 (PRR) Gorgons - 17 (Hold'em)
Seat 2 is the button
Seat 1: Smok5 Js (39.21).
Seat 2: SenNoSen (78.06).
Seat 3: Hakuna_Matata777 (63.34).
Seat 4: IlxxxlI (22.83).
Seat 5: BoTPuMHeDichBro (75.86).
Seat 6: eu4ria (53.11).
Player Hakuna_Matata777 has small blind (0.25)
Player IlxxxlI has big blind (0.50)
Player IlxxxlI received card: [10s]
Player IlxxxlI received card: [Ad]
Player BoTPuMHeDichBro folds
Player eu4ria folds
Player Smok5 Js calls (0.50)
Player SenNoSen folds
Player Hakuna_Matata777 folds
Player IlxxxlI raises (1.75)
Player Smok5 Js calls (1.75)
*** FLOP ***: [As 8s Kd]
Player IlxxxlI checks
Player Smok5 Js checks
*** TURN ***: [As 8s Kd] [Jc]
Player IlxxxlI bets (1.50)
Player Smok5 Js calls (1.50)
*** RIVER ***: [As 8s Kd Jc] [Kh]
Player IlxxxlI checks
Player Smok5 Js bets (1)
Player IlxxxlI calls (1)
------ Summary ------
Pot: 9.27. Rake 0.32. JP fee 0.16
Board: [As 8s Kd Jc Kh]
*Player Smok5 Js shows: Two pairs. As and Ks [4c Ac]. Bets: 4.75. Collects: 4.63. Loses: 0.12.
Player SenNoSen does not show cards.Bets: 0. Collects: 0. Wins: 0.
Player Hakuna_Matata777 does not show cards.Bets: 0.25. Collects: 0. Loses: 0.25.
*Player IlxxxlI shows: Two pairs. As and Ks [10s Ad]. Bets: 4.75. Collects: 4.64. Loses: 0.11.
Player BoTPuMHeDichBro does not show cards.Bets: 0. Collects: 0. Wins: 0.
Player eu4ria does not show cards.Bets: 0. Collects: 0. Wins: 0.
Game ended at: 2016/11/28 18:47:55

Game started
Game ID: 786354621 1/2 (PRR) Lakhey - 10 (Hold'em)
Seat 4 is the button
Seat 2: DonCesarGrinder (415.96).
Seat 3: IlxxxlI (83).
Seat 4: KingGuciGuci (211.60).
Seat 5: JJaromir (497.70).
Seat 6: bunchy (361.31).
Player JJaromir has small blind (1)
Player bunchy has big blind (2)
Player IlxxxlI received card: [2d]
Player IlxxxlI received card: [7s]
Player DonCesarGrinder folds
Player IlxxxlI folds
Player KingGuciGuci raises (4.40)
Player JJaromir folds
Player bunchy folds
Uncalled bet (2.40) returned to KingGuciGuci
Player KingGuciGuci mucks cards
------ Summary ------
Pot: 5. Rake 0
Player DonCesarGrinder does not show cards.Bets: 0. Collects: 0. Wins: 0.
Player IlxxxlI does not show cards.Bets: 0. Collects: 0. Wins: 0.
*Player KingGuciGuci mucks (does not show cards). Bets: 2. Collects: 5. Wins: 3.
Player JJaromir does not show cards.Bets: 1. Collects: 0. Loses: 1.
Player bunchy does not show cards.Bets: 2. Collects: 0. Loses: 2.
Game ended at: 2016/11/28 18:47:13

Game started
Game ID: 786354568 0.25/0.50 (PRR) Gorgons - 17 (Hold'em)
Seat 1 is the button
Seat 1: Smok5 Js (39.21).
Seat 2: SenNoSen (78.31).
Seat 3: Hakuna_Matata777 (63.84).
Seat 4: IlxxxlI (22.83).
Seat 5: BoTPuMHeDichBro (75.11).
Seat 6: eu4ria (53.11).
Player SenNoSen has small blind (0.25)
Player Hakuna_Matata777 has big blind (0.50)
Player IlxxxlI received card: [7h]
Player IlxxxlI received card: [Ks]
Player IlxxxlI folds
Player BoTPuMHeDichBro raises (1.50)
Player eu4ria folds
Player Smok5 Js folds
Player SenNoSen folds
Player Hakuna_Matata777 folds
Uncalled bet (1) returned to BoTPuMHeDichBro
Player BoTPuMHeDichBro mucks cards
------ Summary ------
Pot: 1.25. Rake 0
Player Smok5 Js does not show cards.Bets: 0. Collects: 0. Wins: 0.
Player SenNoSen does not show cards.Bets: 0.25. Collects: 0. Loses: 0.25.
Player Hakuna_Matata777 does not show cards.Bets: 0.50. Collects: 0. Loses: 0.50.
Player IlxxxlI does not show cards.Bets: 0. Collects: 0. Wins: 0.
*Player BoTPuMHeDichBro mucks (does not show cards). Bets: 0.50. Collects: 1.25. Wins: 0.75.
Player eu4ria does not show cards.Bets: 0. Collects: 0. Wins: 0.
Game ended at: 2016/11/28 18:47:1

Game started
Game ID: 786354561 1/2 (PRR) Lakhey - 10 (Hold'em)
Seat 3 is the button
Seat 2: DonCesarGrinder (415.96).
Seat 3: IlxxxlI (80).
Seat 4: KingGuciGuci (212.60).
Seat 5: JJaromir (499.70).
Seat 6: bunchy (361.31).
Player KingGuciGuci has small blind (1)
Player JJaromir has big blind (2)
Player IlxxxlI received card: [Ah]
Player IlxxxlI received card: [Jd]
Player bunchy folds
Player DonCesarGrinder folds
Player IlxxxlI raises (6)
Player KingGuciGuci folds
Player JJaromir folds
Uncalled bet (4) returned to IlxxxlI
Player IlxxxlI mucks cards
------ Summary ------
Pot: 5. Rake 0
Player DonCesarGrinder does not show cards.Bets: 0. Collects: 0. Wins: 0.
*Player IlxxxlI mucks (does not show cards). Bets: 2. Collects: 5. Wins: 3.
Player KingGuciGuci does not show cards.Bets: 1. Collects: 0. Loses: 1.
Player JJaromir does not show cards.Bets: 2. Collects: 0. Loses: 2.
Player bunchy does not show cards.Bets: 0. Collects: 0. Wins: 0.
Game ended at: 2016/11/28 18:46:52

Game started
Game ID: 786354521 0.25/0.50 (PRR) Gorgons - 5 (Hold'em)
Seat 3 is the button
Seat 1: SenNoSen (101.11).
Seat 2: eu4ria (236.21).
Seat 3: IlxxxlI (34.94).
Seat 4: Goomashroom (52.60).
Seat 5: GreinSeint (19.25).
Seat 6: wethco (71.83).
Player Goomashroom has small blind (0.25)
Player GreinSeint has big blind (0.50)
Player IlxxxlI received card: [Kc]
Player IlxxxlI received card: [Qc]
Player wethco folds
Player SenNoSen folds
Player eu4ria folds
Player IlxxxlI raises (1.50)
Player Goomashroom folds
Player GreinSeint raises (4)
Player IlxxxlI calls (3)
*** FLOP ***: [10c 8s Qd]
Player GreinSeint bets (4.39)
Player IlxxxlI calls (4.39)
*** TURN ***: [10c 8s Qd] [7c]
Player GreinSeint allin (10.36)
Player IlxxxlI calls (10.36)
*** RIVER ***: [10c 8s Qd 7c] [10h]
------ Summary ------
Pot: 36.82. Rake 1.69. JP fee 0.24
Board: [10c 8s Qd 7c 10h]
Player SenNoSen does not show cards.Bets: 0. Collects: 0. Wins: 0.
Player eu4ria does not show cards.Bets: 0. Collects: 0. Wins: 0.
Player IlxxxlI shows: Two pairs. Qs and 10s [Kc Qc]. Bets: 19.25. Collects: 0. Loses: 19.25.
Player Goomashroom does not show cards.Bets: 0.25. Collects: 0. Loses: 0.25.
*Player GreinSeint shows: Two pairs. Qs and 10s (kicker A) [Ah Qs]. Bets: 19.25. Collects: 36.82. Wins: 17.57.
Player wethco does not show cards.Bets: 0. Collects: 0. Wins: 0.
Game ended at: 2016/11/28 18:47:10

Game started
Game ID: 786354501 0.25/0.50 (PRR) Gorgons - 17 (Hold'em)
Seat 6 is the button
Seat 1: Smok5 Js (39.46).
Seat 2: SenNoSen (78.81).
Seat 3: Hakuna_Matata777 (63.84).
Seat 4: IlxxxlI (22.08).
Seat 5: BoTPuMHeDichBro (75.11).
Seat 6: eu4ria (53.11).
Player Smok5 Js has small blind (0.25)
Player SenNoSen has big blind (0.50)
Player IlxxxlI received card: [Ad]
Player IlxxxlI received card: [Jc]
Player Hakuna_Matata777 folds
Player IlxxxlI raises (1.75)
Player BoTPuMHeDichBro folds
Player eu4ria folds
Player Smok5 Js folds
Player SenNoSen folds
Uncalled bet (1.25) returned to IlxxxlI
Player IlxxxlI mucks cards
------ Summary ------
Pot: 1.25. Rake 0
Player Smok5 Js does not show cards.Bets: 0.25. Collects: 0. Loses: 0.25.
Player SenNoSen does not show cards.Bets: 0.50. Collects: 0. Loses: 0.50.
Player Hakuna_Matata777 does not show cards.Bets: 0. Collects: 0. Wins: 0.
*Player IlxxxlI mucks (does not show cards). Bets: 0.50. Collects: 1.25. Wins: 0.75.
Player BoTPuMHeDichBro does not show cards.Bets: 0. Collects: 0. Wins: 0.
Player eu4ria does not show cards.Bets: 0. Collects: 0. Wins: 0.
Game ended at: 2016/11/28 18:46:35

Game started
Game ID: 786354463 1/2 (PRR) Lakhey - 10 (Hold'em)
Seat 2 is the button
Seat 2: DonCesarGrinder (415.96).
Seat 3: IlxxxlI (80).
Seat 4: KingGuciGuci (209).
Seat 5: JJaromir (499.70).
Seat 6: bunchy (361.31).
Player IlxxxlI has small blind (1)
Player KingGuciGuci has big blind (2)
Player IlxxxlI received card: [9s]
Player IlxxxlI received card: [4s]
Player JJaromir folds
Player bunchy folds
Player DonCesarGrinder folds
Player IlxxxlI calls (1)
Player KingGuciGuci checks
*** FLOP ***: [5h 5d Jh]
Player IlxxxlI bets (2)
Player KingGuciGuci raises (7.90)
Player IlxxxlI folds
Uncalled bet (5.90) returned to KingGuciGuci
Player KingGuciGuci mucks cards
------ Summary ------
Pot: 7.60. Rake 0.28. JP fee 0.12
Board: [5h 5d Jh]
Player DonCesarGrinder does not show cards.Bets: 0. Collects: 0. Wins: 0.
Player IlxxxlI does not show cards.Bets: 4. Collects: 0. Loses: 4.
*Player KingGuciGuci mucks (does not show cards). Bets: 4. Collects: 7.60. Wins: 3.60.
Player JJaromir does not show cards.Bets: 0. Collects: 0. Wins: 0.
Player bunchy does not show cards.Bets: 0. Collects: 0. Wins: 0.
Game ended at: 2016/11/28 18:46:32

Game started
Game ID: 786354425 0.25/0.50 (PRR) Gorgons - 17 (Hold'em)
Seat 5 is the button
Seat 1: Smok5 Js (39.96).
Seat 2: SenNoSen (78.81).
Seat 3: Hakuna_Matata777 (63.84).
Seat 4: IlxxxlI (22.08).
Seat 5: BoTPuMHeDichBro (75.11).
Seat 6: eu4ria (52.61).
Player eu4ria has small blind (0.25)
Player Smok5 Js has big blind (0.50)
Player IlxxxlI received card: [7s]
Player IlxxxlI received card: [3h]
Player SenNoSen folds
Player Hakuna_Matata777 folds
Player IlxxxlI folds
Player BoTPuMHeDichBro folds
Player eu4ria raises (1.25)
Player Smok5 Js folds
Uncalled bet (1) returned to eu4ria
Player eu4ria mucks cards
------ Summary ------
Pot: 1. Rake 0
Player Smok5 Js does not show cards.Bets: 0.50. Collects: 0. Loses: 0.50.
Player SenNoSen does not show cards.Bets: 0. Collects: 0. Wins: 0.
Player Hakuna_Matata777 does not show cards.Bets: 0. Collects: 0. Wins: 0.
Player IlxxxlI does not show cards.Bets: 0. Collects: 0. Wins: 0.
Player BoTPuMHeDichBro does not show cards.Bets: 0. Collects: 0. Wins: 0.
*Player eu4ria mucks (does not show cards). Bets: 0.50. Collects: 1. Wins: 0.50.
Game ended at: 2016/11/28 18:46:12

Game started
Game ID: 786354362 0.25/0.50 (PRR) Gorgons - 5 (Hold'em)
Seat 2 is the button
Seat 1: SenNoSen (101.11).
Seat 2: eu4ria (235.46).
Seat 3: IlxxxlI (35.19).
Seat 4: Goomashroom (53.10).
Seat 5: GreinSeint (19.25).
Seat 6: wethco (71.83).
Player IlxxxlI has small blind (0.25)
Player Goomashroom has big blind (0.50)
Player IlxxxlI received card: [Jh]
Player IlxxxlI received card: [5h]
Player GreinSeint folds
Player wethco folds
Player SenNoSen folds
Player eu4ria raises (1.25)
Player IlxxxlI folds
Player Goomashroom folds
Uncalled bet (0.75) returned to eu4ria
Player eu4ria mucks cards
------ Summary ------
Pot: 1.25. Rake 0
Player SenNoSen does not show cards.Bets: 0. Collects: 0. Wins: 0.
*Player eu4ria mucks (does not show cards). Bets: 0.50. Collects: 1.25. Wins: 0.75.
Player IlxxxlI does not show cards.Bets: 0.25. Collects: 0. Loses: 0.25.
Player Goomashroom does not show cards.Bets: 0.50. Collects: 0. Loses: 0.50.
Player GreinSeint does not show cards.Bets: 0. Collects: 0. Wins: 0.
Player wethco does not show cards.Bets: 0. Collects: 0. Wins: 0.
Game ended at: 2016/11/28 18:46:16

Game started
Game ID: 786354343 0.25/0.50 (PRR) Gorgons - 17 (Hold'em)
Seat 4 is the button
Seat 1: Smok5 Js (39.96).
Seat 2: SenNoSen (78.81).
Seat 3: Hakuna_Matata777 (63.84).
Seat 4: IlxxxlI (21.33).
Seat 5: BoTPuMHeDichBro (75.36).
Seat 6: eu4ria (53.11).
Player BoTPuMHeDichBro has small blind (0.25)
Player eu4ria has big blind (0.50)
Player IlxxxlI received card: [6s]
Player IlxxxlI received card: [6h]
Player Smok5 Js folds
Player SenNoSen folds
Player Hakuna_Matata777 folds
Player IlxxxlI raises (1.50)
Player BoTPuMHeDichBro folds
Player eu4ria folds
Uncalled bet (1) returned to IlxxxlI
Player IlxxxlI mucks cards
------ Summary ------
Pot: 1.25. Rake 0
Player Smok5 Js does not show cards.Bets: 0. Collects: 0. Wins: 0.
Player SenNoSen does not show cards.Bets: 0. Collects: 0. Wins: 0.
Player Hakuna_Matata777 does not show cards.Bets: 0. Collects: 0. Wins: 0.
*Player IlxxxlI mucks (does not show cards). Bets: 0.50. Collects: 1.25. Wins: 0.75.
Player BoTPuMHeDichBro does not show cards.Bets: 0.25. Collects: 0. Loses: 0.25.
Player eu4ria does not show cards.Bets: 0.50. Collects: 0. Loses: 0.50.
Game ended at: 2016/11/28 18:45:46

Game started
Game ID: 786354232 0.25/0.50 (PRR) Gorgons - 17 (Hold'em)
Seat 3 is the button
Seat 1: Smok5 Js (39.96).
Seat 2: SenNoSen (77.67).
Seat 3: Hakuna_Matata777 (63.84).
Seat 4: IlxxxlI (21.58).
Seat 5: BoTPuMHeDichBro (76.36).
Seat 6: eu4ria (53.11).
Player IlxxxlI has small blind (0.25)
Player BoTPuMHeDichBro has big blind (0.50)
Player IlxxxlI received card: [3c]
Player IlxxxlI received card: [4h]
Player eu4ria folds
Player Smok5 Js folds
Player SenNoSen raises (1)
Player Hakuna_Matata777 folds
Player IlxxxlI folds
Player BoTPuMHeDichBro calls (0.50)
*** FLOP ***: [Ac Qc Ks]
Player BoTPuMHeDichBro checks
Player SenNoSen bets (0.71)
Player BoTPuMHeDichBro folds
Uncalled bet (0.71) returned to SenNoSen
Player SenNoSen mucks cards
------ Summary ------
Pot: 2.14. Rake 0.09. JP fee 0.02
Board: [Ac Qc Ks]
Player Smok5 Js does not show cards.Bets: 0. Collects: 0. Wins: 0.
*Player SenNoSen mucks (does not show cards). Bets: 1. Collects: 2.14. Wins: 1.14.
Player Hakuna_Matata777 does not show cards.Bets: 0. Collects: 0. Wins: 0.
Player IlxxxlI does not show cards.Bets: 0.25. Collects: 0. Loses: 0.25.
Player BoTPuMHeDichBro does not show cards.Bets: 1. Collects: 0. Loses: 1.
Player eu4ria does not show cards.Bets: 0. Collects: 0. Wins: 0.
Game ended at: 2016/11/28 18:45:20

Game started
Game ID: 786354208 0.25/0.50 (PRR) Gorgons - 5 (Hold'em)
Seat 1 is the button
Seat 1: SenNoSen (103.32).
Seat 2: eu4ria (235.71).
Seat 3: IlxxxlI (32.96).
Seat 4: Goomashroom (53.10).
Seat 5: GreinSeint (19.25).
Seat 6: wethco (71.83).
Player eu4ria has small blind (0.25)
Player IlxxxlI has big blind (0.50)
Player IlxxxlI received card: [10h]
Player IlxxxlI received card: [4h]
Player Goomashroom folds
Player GreinSeint folds
Player wethco folds
Player SenNoSen raises (1)
Player eu4ria folds
Player IlxxxlI calls (0.50)
*** FLOP ***: [4s 7c 5c]
Player IlxxxlI checks
Player SenNoSen bets (0.71)
Player IlxxxlI calls (0.71)
*** TURN ***: [4s 7c 5c] [Ac]
Player IlxxxlI checks
Player SenNoSen checks
*** RIVER ***: [4s 7c 5c Ac] [10c]
Player IlxxxlI bets (0.50)
Player SenNoSen calls (0.50)
Player SenNoSen mucks cards
------ Summary ------
Pot: 4.44. Rake 0.17. JP fee 0.06
Board: [4s 7c 5c Ac 10c]
Player SenNoSen mucks (does not show cards). Bets: 2.21. Collects: 0. Loses: 2.21.
Player eu4ria does not show cards.Bets: 0.25. Collects: 0. Loses: 0.25.
*Player IlxxxlI shows: Two pairs. 10s and 4s [10h 4h]. Bets: 2.21. Collects: 4.44. Wins: 2.23.
Player Goomashroom does not show cards.Bets: 0. Collects: 0. Wins: 0.
Player GreinSeint does not show cards.Bets: 0. Collects: 0. Wins: 0.
Player wethco does not show cards.Bets: 0. Collects: 0. Wins: 0.
Game ended at: 2016/11/28 18:45:25

Game started
Game ID: 786354187 0.25/0.50 (PRR) Gorgons - 17 (Hold'em)
Seat 2 is the button
Seat 1: Smok5 Js (39.96).
Seat 2: SenNoSen (76.92).
Seat 3: Hakuna_Matata777 (64.09).
Seat 4: IlxxxlI (22.08).
Seat 5: BoTPuMHeDichBro (76.36).
Seat 6: eu4ria (53.11).
Player Hakuna_Matata777 has small blind (0.25)
Player IlxxxlI has big blind (0.50)
Player IlxxxlI received card: [Qc]
Player IlxxxlI received card: [6s]
Player BoTPuMHeDichBro folds
Player eu4ria folds
Player Smok5 Js folds
Player SenNoSen raises (1)
Player Hakuna_Matata777 folds
Player IlxxxlI folds
Uncalled bet (0.50) returned to SenNoSen
Player SenNoSen mucks cards
------ Summary ------
Pot: 1.25. Rake 0
Player Smok5 Js does not show cards.Bets: 0. Collects: 0. Wins: 0.
*Player SenNoSen mucks (does not show cards). Bets: 0.50. Collects: 1.25. Wins: 0.75.
Player Hakuna_Matata777 does not show cards.Bets: 0.25. Collects: 0. Loses: 0.25.
Player IlxxxlI does not show cards.Bets: 0.50. Collects: 0. Loses: 0.50.
Player BoTPuMHeDichBro does not show cards.Bets: 0. Collects: 0. Wins: 0.
Player eu4ria does not show cards.Bets: 0. Collects: 0. Wins: 0.
Game ended at: 2016/11/28 18:44:39

Game started
Game ID: 786354061 0.25/0.50 (PRR) Gorgons - 5 (Hold'em)
Seat 6 is the button
Seat 1: SenNoSen (112.46).
Seat 2: eu4ria (236.21).
Seat 3: IlxxxlI (24.25).
Seat 4: Goomashroom (53.10).
Seat 5: GreinSeint (19.25).
Seat 6: wethco (71.83).
Player SenNoSen has small blind (0.25)
Player eu4ria has big blind (0.50)
Player IlxxxlI received card: [Ad]
Player IlxxxlI received card: [As]
Player IlxxxlI raises (1.75)
Player Goomashroom folds
Player GreinSeint folds
Player wethco folds
Player SenNoSen raises (5.25)
Player eu4ria folds
Player IlxxxlI calls (3.75)
*** FLOP ***: [5s 3h Kh]
Player SenNoSen bets (3.64)
Player IlxxxlI calls (3.64)
*** TURN ***: [5s 3h Kh] [Qh]
Player SenNoSen checks
Player IlxxxlI bets (5.95)
Player SenNoSen folds
Uncalled bet (5.95) returned to IlxxxlI
Player IlxxxlI mucks cards
------ Summary ------
Pot: 17.85. Rake 0.69. JP fee 0.24
Board: [5s 3h Kh Qh]
Player SenNoSen does not show cards.Bets: 9.14. Collects: 0. Loses: 9.14.
Player eu4ria does not show cards.Bets: 0.50. Collects: 0. Loses: 0.50.
*Player IlxxxlI mucks (does not show cards). Bets: 9.14. Collects: 17.85. Wins: 8.71.
Player Goomashroom does not show cards.Bets: 0. Collects: 0. Wins: 0.
Player GreinSeint does not show cards.Bets: 0. Collects: 0. Wins: 0.
Player wethco does not show cards.Bets: 0. Collects: 0. Wins: 0.
Game ended at: 2016/11/28 18:44:29

Game started
Game ID: 786353988 0.25/0.50 (PRR) Gorgons - 17 (Hold'em)
Seat 1 is the button
Seat 1: Smok5 Js (41.46).
Seat 2: SenNoSen (77.17).
Seat 3: Hakuna_Matata777 (62.50).
Seat 4: IlxxxlI (22.08).
Seat 5: BoTPuMHeDichBro (76.36).
Seat 6: eu4ria (53.11).
Player SenNoSen has small blind (0.25)
Player Hakuna_Matata777 has big blind (0.50)
Player IlxxxlI received card: [Ks]
Player IlxxxlI received card: [7c]
Player IlxxxlI folds
Player BoTPuMHeDichBro folds
Player eu4ria folds
Player Smok5 Js calls (0.50)
Player SenNoSen folds
Player Hakuna_Matata777 checks
*** FLOP ***: [8h 3c 10c]
Player Hakuna_Matata777 checks
Player Smok5 Js checks
*** TURN ***: [8h 3c 10c] [10s]
Player Hakuna_Matata777 checks
Player Smok5 Js checks
*** RIVER ***: [8h 3c 10c 10s] [9c]
Player Hakuna_Matata777 bets (1)
Player Smok5 Js calls (1)
Player Smok5 Js is timed out.
Player Smok5 Js mucks cards
------ Summary ------
Pot: 3.09. Rake 0.12. JP fee 0.04
Board: [8h 3c 10c 10s 9c]
Player Smok5 Js mucks (does not show cards). Bets: 1.50. Collects: 0. Loses: 1.50.
Player SenNoSen does not show cards.Bets: 0.25. Collects: 0. Loses: 0.25.
*Player Hakuna_Matata777 shows: Three Of Kind of 10s [10h 6h]. Bets: 1.50. Collects: 3.09. Wins: 1.59.
Player IlxxxlI does not show cards.Bets: 0. Collects: 0. Wins: 0.
Player BoTPuMHeDichBro does not show cards.Bets: 0. Collects: 0. Wins: 0.
Player eu4ria does not show cards.Bets: 0. Collects: 0. Wins: 0.
Game ended at: 2016/11/28 18:44:21

Game started
Game ID: 786353937 1/2 (PRR) Lakhey - 10 (Hold'em)
Seat 1 is the button
Seat 1: rkoko (108.09).
Seat 2: DonCesarGrinder (308.87).
Seat 3: IlxxxlI (80).
Seat 4: KingGuciGuci (209).
Seat 5: JJaromir (499.70).
Seat 6: bunchy (361.31).
Player DonCesarGrinder has small blind (1)
Player IlxxxlI has big blind (2)
Player IlxxxlI received card: [3c]
Player IlxxxlI received card: [4s]
Player KingGuciGuci folds
Player JJaromir folds
Player bunchy folds
Player rkoko raises (4)
Player DonCesarGrinder raises (12.36)
Player IlxxxlI folds
Player rkoko calls (9.36)
*** FLOP ***: [As 7s Kc]
Player DonCesarGrinder bets (14.19)
Player rkoko calls (14.19)
*** TURN ***: [As 7s Kc] [4c]
Player DonCesarGrinder checks
Player rkoko checks
*** RIVER ***: [As 7s Kc 4c] [Ad]
Player DonCesarGrinder checks
Player rkoko bets (36.16)
Player DonCesarGrinder allin (281.32)
Player rkoko allin (44.38)
Uncalled bet (200.78) returned to DonCesarGrinder
------ Summary ------
Pot: 215.18. Rake 2.76. JP fee 0.24
Board: [As 7s Kc 4c Ad]
Player rkoko shows: One pair of As [Js 2s]. Bets: 108.09. Collects: 0. Loses: 108.09.
*Player DonCesarGrinder shows: One pair of As (kicker 10) [10d Jd]. Bets: 108.09. Collects: 215.18. Wins: 107.09.
Player IlxxxlI does not show cards.Bets: 2. Collects: 0. Loses: 2.
Player KingGuciGuci does not show cards.Bets: 0. Collects: 0. Wins: 0.
Player JJaromir does not show cards.Bets: 0. Collects: 0. Wins: 0.
Player bunchy does not show cards.Bets: 0. Collects: 0. Wins: 0.
Game ended at: 2016/11/28 18:45:58

Game started
Game ID: 786353896 0.25/0.50 (PRR) Gorgons - 5 (Hold'em)
Seat 5 is the button
Seat 1: SenNoSen (114.41).
Seat 2: eu4ria (236.21).
Seat 3: IlxxxlI (24.25).
Seat 4: Goomashroom (53.10).
Seat 5: GreinSeint (19.25).
Seat 6: wethco (70.07).
Player wethco has small blind (0.25)
Player SenNoSen has big blind (0.50)
Player IlxxxlI received card: [2h]
Player IlxxxlI received card: [Qd]
Player eu4ria folds
Player IlxxxlI folds
Player Goomashroom folds
Player GreinSeint folds
Player wethco calls (0.25)
Player SenNoSen checks
*** FLOP ***: [2d 10h 7c]
Player wethco bets (0.50)
Player SenNoSen calls (0.50)
*** TURN ***: [2d 10h 7c] [7s]
Player wethco checks
Player SenNoSen bets (0.95)
Player wethco calls (0.95)
*** RIVER ***: [2d 10h 7c 7s] [Ad]
Player wethco checks
Player SenNoSen checks
------ Summary ------
Pot: 3.71. Rake 0.13. JP fee 0.06
Board: [2d 10h 7c 7s Ad]
Player SenNoSen shows: Two pairs. 7s and 2s [Kc 2c]. Bets: 1.95. Collects: 0. Loses: 1.95.
Player eu4ria does not show cards.Bets: 0. Collects: 0. Wins: 0.
Player IlxxxlI does not show cards.Bets: 0. Collects: 0. Wins: 0.
Player Goomashroom does not show cards.Bets: 0. Collects: 0. Wins: 0.
Player GreinSeint does not show cards.Bets: 0. Collects: 0. Wins: 0.
*Player wethco shows: Two pairs. 7s and 4s [4h 4s]. Bets: 1.95. Collects: 3.71. Wins: 1.76.
Game ended at: 2016/11/28 18:43:40

Game started
Game ID: 786353834 0.25/0.50 (PRR) Gorgons - 17 (Hold'em)
Seat 6 is the button
Seat 1: Smok5 Js (41.96).
Seat 2: SenNoSen (76.72).
Seat 3: Hakuna_Matata777 (62.50).
Seat 4: IlxxxlI (22.08).
Seat 5: BoTPuMHeDichBro (76.36).
Seat 6: eu4ria (53.11).
Player Smok5 Js has small blind (0.25)
Player SenNoSen has big blind (0.50)
Player IlxxxlI received card: [4c]
Player IlxxxlI received card: [Kh]
Player Hakuna_Matata777 folds
Player IlxxxlI folds
Player BoTPuMHeDichBro folds
Player eu4ria folds
Player Smok5 Js calls (0.25)
Player SenNoSen checks
*** FLOP ***: [Jd 2h 10c]
Player Smok5 Js checks
Player SenNoSen bets (0.50)
Player Smok5 Js folds
Uncalled bet (0.50) returned to SenNoSen
Player SenNoSen mucks cards
------ Summary ------
Pot: 0.95. Rake 0.05
Board: [Jd 2h 10c]
Player Smok5 Js does not show cards.Bets: 0.50. Collects: 0. Loses: 0.50.
*Player SenNoSen mucks (does not show cards). Bets: 0.50. Collects: 0.95. Wins: 0.45.
Player Hakuna_Matata777 does not show cards.Bets: 0. Collects: 0. Wins: 0.
Player IlxxxlI does not show cards.Bets: 0. Collects: 0. Wins: 0.
Player BoTPuMHeDichBro does not show cards.Bets: 0. Collects: 0. Wins: 0.
Player eu4ria does not show cards.Bets: 0. Collects: 0. Wins: 0.
Game ended at: 2016/11/28 18:43:15

Game started
Game ID: 786353825 1/2 (PRR) Lakhey - 10 (Hold'em)
Seat 6 is the button
Seat 1: rkoko (114.09).
Seat 2: DonCesarGrinder (310.87).
Seat 3: IlxxxlI (80).
Seat 4: KingGuciGuci (209).
Seat 5: JJaromir (492.40).
Seat 6: bunchy (361.31).
Player rkoko has small blind (1)
Player DonCesarGrinder has big blind (2)
Player IlxxxlI received card: [2h]
Player IlxxxlI received card: [3h]
Player IlxxxlI folds
Player KingGuciGuci folds
Player JJaromir raises (6)
Player bunchy folds
Player rkoko calls (5)
Player DonCesarGrinder folds
*** FLOP ***: [3c Kc 9s]
Player rkoko checks
Player JJaromir bets (12)
Player rkoko folds
Uncalled bet (12) returned to JJaromir
Player JJaromir mucks cards
------ Summary ------
Pot: 13.30. Rake 0.48. JP fee 0.22
Board: [3c Kc 9s]
Player rkoko does not show cards.Bets: 6. Collects: 0. Loses: 6.
Player DonCesarGrinder does not show cards.Bets: 2. Collects: 0. Loses: 2.
Player IlxxxlI does not show cards.Bets: 0. Collects: 0. Wins: 0.
Player KingGuciGuci does not show cards.Bets: 0. Collects: 0. Wins: 0.
*Player JJaromir mucks (does not show cards). Bets: 6. Collects: 13.30. Wins: 7.30.
Player bunchy does not show cards.Bets: 0. Collects: 0. Wins: 0.
Game ended at: 2016/11/28 18:42:58

Game started
Game ID: 786353810 0.25/0.50 (PRR) Gorgons - 5 (Hold'em)
Seat 4 is the button
Seat 1: SenNoSen (114.41).
Seat 2: eu4ria (235.46).
Seat 3: IlxxxlI (24.25).
Seat 4: Goomashroom (53.10).
Seat 5: GreinSeint (19.50).
Seat 6: wethco (70.57).
Player GreinSeint has small blind (0.25)
Player wethco has big blind (0.50)
Player IlxxxlI received card: [2d]
Player IlxxxlI received card: [7h]
Player SenNoSen folds
Player eu4ria raises (1.50)
Player IlxxxlI folds
Player Goomashroom folds
Player GreinSeint folds
Player wethco folds
Uncalled bet (1) returned to eu4ria
Player eu4ria mucks cards
------ Summary ------
Pot: 1.25. Rake 0
Player SenNoSen does not show cards.Bets: 0. Collects: 0. Wins: 0.
*Player eu4ria mucks (does not show cards). Bets: 0.50. Collects: 1.25. Wins: 0.75.
Player IlxxxlI does not show cards.Bets: 0. Collects: 0. Wins: 0.
Player Goomashroom does not show cards.Bets: 0. Collects: 0. Wins: 0.
Player GreinSeint does not show cards.Bets: 0.25. Collects: 0. Loses: 0.25.
Player wethco does not show cards.Bets: 0.50. Collects: 0. Loses: 0.50.
Game ended at: 2016/11/28 18:42:40

Game started
Game ID: 786353762 0.25/0.50 (PRR) Gorgons - 17 (Hold'em)
Seat 5 is the button
Seat 1: Smok5 Js (41.71).
Seat 2: SenNoSen (76.72).
Seat 3: Hakuna_Matata777 (62.50).
Seat 4: IlxxxlI (22.08).
Seat 5: BoTPuMHeDichBro (76.36).
Seat 6: eu4ria (53.36).
Player eu4ria has small blind (0.25)
Player Smok5 Js has big blind (0.50)
Player IlxxxlI received card: [7s]
Player IlxxxlI received card: [Ac]
Player SenNoSen folds
Player Hakuna_Matata777 folds
Player IlxxxlI folds
Player BoTPuMHeDichBro folds
Player eu4ria folds
Uncalled bet (0.25) returned to Smok5 Js
Player Smok5 Js is timed out.
Player Smok5 Js mucks cards
------ Summary ------
Pot: 0.50. Rake 0
*Player Smok5 Js mucks (does not show cards). Bets: 0.25. Collects: 0.50. Wins: 0.25.
Player SenNoSen does not show cards.Bets: 0. Collects: 0. Wins: 0.
Player Hakuna_Matata777 does not show cards.Bets: 0. Collects: 0. Wins: 0.
Player IlxxxlI does not show cards.Bets: 0. Collects: 0. Wins: 0.
Player BoTPuMHeDichBro does not show cards.Bets: 0. Collects: 0. Wins: 0.
Player eu4ria does not show cards.Bets: 0.25. Collects: 0. Loses: 0.25.
Game ended at: 2016/11/28 18:42:20

Game started
Game ID: 786353749 1/2 (PRR) Lakhey - 10 (Hold'em)
Seat 5 is the button
Seat 1: rkoko (116.09).
Seat 2: DonCesarGrinder (310.87).
Seat 3: IlxxxlI (80).
Seat 4: KingGuciGuci (209).
Seat 5: JJaromir (489.40).
Seat 6: bunchy (362.31).
Player bunchy has small blind (1)
Player rkoko has big blind (2)
Player IlxxxlI received card: [2d]
Player IlxxxlI received card: [7c]
Player DonCesarGrinder folds
Player IlxxxlI folds
Player KingGuciGuci folds
Player JJaromir raises (4)
Player bunchy folds
Player rkoko folds
Uncalled bet (2) returned to JJaromir
Player JJaromir mucks cards
------ Summary ------
Pot: 5. Rake 0
Player rkoko does not show cards.Bets: 2. Collects: 0. Loses: 2.
Player DonCesarGrinder does not show cards.Bets: 0. Collects: 0. Wins: 0.
Player IlxxxlI does not show cards.Bets: 0. Collects: 0. Wins: 0.
Player KingGuciGuci does not show cards.Bets: 0. Collects: 0. Wins: 0.
*Player JJaromir mucks (does not show cards). Bets: 2. Collects: 5. Wins: 3.
Player bunchy does not show cards.Bets: 1. Collects: 0. Loses: 1.
Game ended at: 2016/11/28 18:42:17

Game started
Game ID: 786353700 0.25/0.50 (PRR) Gorgons - 5 (Hold'em)
Seat 3 is the button
Seat 1: SenNoSen (115.91).
Seat 2: eu4ria (235.46).
Seat 3: IlxxxlI (24.25).
Seat 4: Goomashroom (51.10).
Seat 5: GreinSeint (20).
Seat 6: wethco (70.57).
Player Goomashroom has small blind (0.25)
Player GreinSeint has big blind (0.50)
Player IlxxxlI received card: [Ad]
Player IlxxxlI received card: [5h]
Player wethco folds
Player SenNoSen raises (1.50)
Player eu4ria folds
Player IlxxxlI folds
Player Goomashroom raises (5)
Player GreinSeint folds
Player SenNoSen folds
Uncalled bet (3.75) returned to Goomashroom
Player Goomashroom mucks cards
------ Summary ------
Pot: 3.50. Rake 0
Player SenNoSen does not show cards.Bets: 1.50. Collects: 0. Loses: 1.50.
Player eu4ria does not show cards.Bets: 0. Collects: 0. Wins: 0.
Player IlxxxlI does not show cards.Bets: 0. Collects: 0. Wins: 0.
*Player Goomashroom mucks (does not show cards). Bets: 1.50. Collects: 3.50. Wins: 2.
Player GreinSeint does not show cards.Bets: 0.50. Collects: 0. Loses: 0.50.
Player wethco does not show cards.Bets: 0. Collects: 0. Wins: 0.
Game ended at: 2016/11/28 18:42:13

Game started
Game ID: 786353643 1/2 (PRR) Lakhey - 10 (Hold'em)
Seat 4 is the button
Seat 1: rkoko (116.09).
Seat 2: DonCesarGrinder (316.87).
Seat 3: IlxxxlI (80).
Seat 4: KingGuciGuci (200).
Seat 5: JJaromir (490.40).
Seat 6: bunchy (364.31).
Player JJaromir has small blind (1)
Player bunchy has big blind (2)
Player IlxxxlI received card: [Jh]
Player IlxxxlI received card: [5c]
Player rkoko folds
Player DonCesarGrinder raises (6)
Player IlxxxlI folds
Player KingGuciGuci raises (17.90)
Player JJaromir folds
Player bunchy folds
Player DonCesarGrinder folds
Uncalled bet (11.90) returned to KingGuciGuci
Player KingGuciGuci mucks cards
------ Summary ------
Pot: 15. Rake 0
Player rkoko does not show cards.Bets: 0. Collects: 0. Wins: 0.
Player DonCesarGrinder does not show cards.Bets: 6. Collects: 0. Loses: 6.
Player IlxxxlI does not show cards.Bets: 0. Collects: 0. Wins: 0.
*Player KingGuciGuci mucks (does not show cards). Bets: 6. Collects: 15. Wins: 9.
Player JJaromir does not show cards.Bets: 1. Collects: 0. Loses: 1.
Player bunchy does not show cards.Bets: 2. Collects: 0. Loses: 2.
Game ended at: 2016/11/28 18:41:55

Game started
Game ID: 786353636 0.25/0.50 (PRR) Gorgons - 5 (Hold'em)
Seat 2 is the button
Seat 1: SenNoSen (115.91).
Seat 2: eu4ria (235.46).
Seat 3: IlxxxlI (24.50).
Seat 4: Goomashroom (51.60).
Seat 5: GreinSeint (19.25).
Seat 6: wethco (70.57).
Player IlxxxlI has small blind (0.25)
Player Goomashroom has big blind (0.50)
Player IlxxxlI received card: [6c]
Player IlxxxlI received card: [Qh]
Player GreinSeint raises (1.50)
Player wethco folds
Player SenNoSen folds
Player eu4ria folds
Player IlxxxlI folds
Player Goomashroom folds
Uncalled bet (1) returned to GreinSeint
Player GreinSeint mucks cards
------ Summary ------
Pot: 1.25. Rake 0
Player SenNoSen does not show cards.Bets: 0. Collects: 0. Wins: 0.
Player eu4ria does not show cards.Bets: 0. Collects: 0. Wins: 0.
Player IlxxxlI does not show cards.Bets: 0.25. Collects: 0. Loses: 0.25.
Player Goomashroom does not show cards.Bets: 0.50. Collects: 0. Loses: 0.50.
*Player GreinSeint mucks (does not show cards). Bets: 0.50. Collects: 1.25. Wins: 0.75.
Player wethco does not show cards.Bets: 0. Collects: 0. Wins: 0.
Game ended at: 2016/11/28 18:41:39

Game started
Game ID: 786353615 0.25/0.50 (PRR) Gorgons - 17 (Hold'em)
Seat 4 is the button
Seat 1: Smok5 Js (41.71).
Seat 2: SenNoSen (76.72).
Seat 3: Hakuna_Matata777 (61.75).
Seat 4: IlxxxlI (22.08).
Seat 5: BoTPuMHeDichBro (76.61).
Seat 6: eu4ria (53.86).
Player BoTPuMHeDichBro has small blind (0.25)
Player eu4ria has big blind (0.50)
Player IlxxxlI received card: [10c]
Player IlxxxlI received card: [2h]
Player Smok5 Js is timed out.
Player Smok5 Js folds
Player SenNoSen folds
Player Hakuna_Matata777 raises (1)
Player IlxxxlI folds
Player BoTPuMHeDichBro folds
Player eu4ria folds
Uncalled bet (0.50) returned to Hakuna_Matata777
Player Hakuna_Matata777 mucks cards
------ Summary ------
Pot: 1.25. Rake 0
Player Smok5 Js does not show cards.Bets: 0. Collects: 0. Wins: 0.
Player SenNoSen does not show cards.Bets: 0. Collects: 0. Wins: 0.
*Player Hakuna_Matata777 mucks (does not show cards). Bets: 0.50. Collects: 1.25. Wins: 0.75.
Player IlxxxlI does not show cards.Bets: 0. Collects: 0. Wins: 0.
Player BoTPuMHeDichBro does not show cards.Bets: 0.25. Collects: 0. Loses: 0.25.
Player eu4ria does not show cards.Bets: 0.50. Collects: 0. Loses: 0.50.
Game ended at: 2016/11/28 18:41:58

Game started
Game ID: 786353546 0.25/0.50 (PRR) Gorgons - 17 (Hold'em)
Seat 3 is the button
Seat 1: Smok5 Js (41.71).
Seat 2: SenNoSen (76.72).
Seat 3: Hakuna_Matata777 (61.75).
Seat 4: IlxxxlI (22.33).
Seat 5: BoTPuMHeDichBro (76.36).
Seat 6: eu4ria (53.86).
Player IlxxxlI has small blind (0.25)
Player BoTPuMHeDichBro has big blind (0.50)
Player IlxxxlI received card: [7s]
Player IlxxxlI received card: [10d]
Player eu4ria folds
Player Smok5 Js folds
Player SenNoSen folds
Player Hakuna_Matata777 folds
Player IlxxxlI folds
Uncalled bet (0.25) returned to BoTPuMHeDichBro
Player BoTPuMHeDichBro mucks cards
------ Summary ------
Pot: 0.50. Rake 0
Player Smok5 Js does not show cards.Bets: 0. Collects: 0. Wins: 0.
Player SenNoSen does not show cards.Bets: 0. Collects: 0. Wins: 0.
Player Hakuna_Matata777 does not show cards.Bets: 0. Collects: 0. Wins: 0.
Player IlxxxlI does not show cards.Bets: 0.25. Collects: 0. Loses: 0.25.
*Player BoTPuMHeDichBro mucks (does not show cards). Bets: 0.25. Collects: 0.50. Wins: 0.25.
Player eu4ria does not show cards.Bets: 0. Collects: 0. Wins: 0.
Game ended at: 2016/11/28 18:41:11

Game started
Game ID: 786353545 0.25/0.50 (PRR) Gorgons - 5 (Hold'em)
Seat 1 is the button
Seat 1: SenNoSen (115.91).
Seat 2: eu4ria (236.96).
Seat 3: IlxxxlI (23).
Seat 4: Goomashroom (51.60).
Seat 5: GreinSeint (19.25).
Seat 6: wethco (70.57).
Player eu4ria has small blind (0.25)
Player IlxxxlI has big blind (0.50)
Player IlxxxlI received card: [Ad]
Player IlxxxlI received card: [Qs]
Player Goomashroom folds
Player GreinSeint folds
Player wethco folds
Player SenNoSen folds
Player eu4ria raises (1.25)
Player IlxxxlI raises (3.14)
Player eu4ria folds
Uncalled bet (2.14) returned to IlxxxlI
Player IlxxxlI mucks cards
------ Summary ------
Pot: 3. Rake 0
Player SenNoSen does not show cards.Bets: 0. Collects: 0. Wins: 0.
Player eu4ria does not show cards.Bets: 1.50. Collects: 0. Loses: 1.50.
*Player IlxxxlI mucks (does not show cards). Bets: 1.50. Collects: 3. Wins: 1.50.
Player Goomashroom does not show cards.Bets: 0. Collects: 0. Wins: 0.
Player GreinSeint does not show cards.Bets: 0. Collects: 0. Wins: 0.
Player wethco does not show cards.Bets: 0. Collects: 0. Wins: 0.
Game ended at: 2016/11/28 18:41:18

Game started
Game ID: 786353527 1/2 (PRR) Lakhey - 10 (Hold'em)
Seat 3 is the button
Seat 1: rkoko (116.09).
Seat 2: DonCesarGrinder (316.87).
Seat 3: IlxxxlI (80).
Seat 4: KingGuciGuci (201).
Seat 5: JJaromir (488.60).
Seat 6: bunchy (364.31).
Player KingGuciGuci has small blind (1)
Player JJaromir has big blind (2)
Player IlxxxlI received card: [5s]
Player IlxxxlI received card: [Kd]
Player bunchy folds
Player rkoko folds
Player DonCesarGrinder folds
Player IlxxxlI folds
Player KingGuciGuci calls (1)
Player JJaromir checks
*** FLOP ***: [4c 2s Jc]
Player KingGuciGuci checks
Player JJaromir bets (4)
Player KingGuciGuci folds
Uncalled bet (4) returned to JJaromir
Player JJaromir mucks cards
------ Summary ------
Pot: 3.80. Rake 0.14. JP fee 0.06
Board: [4c 2s Jc]
Player rkoko does not show cards.Bets: 0. Collects: 0. Wins: 0.
Player DonCesarGrinder does not show cards.Bets: 0. Collects: 0. Wins: 0.
Player IlxxxlI does not show cards.Bets: 0. Collects: 0. Wins: 0.
Player KingGuciGuci does not show cards.Bets: 2. Collects: 0. Loses: 2.
*Player JJaromir mucks (does not show cards). Bets: 2. Collects: 3.80. Wins: 1.80.
Player bunchy does not show cards.Bets: 0. Collects: 0. Wins: 0.
Game ended at: 2016/11/28 18:41:20

Game started
Game ID: 786353504 0.25/0.50 (PRR) Gorgons - 17 (Hold'em)
Seat 2 is the button
Seat 1: Smok5 Js (41.71).
Seat 2: SenNoSen (76.72).
Seat 3: Hakuna_Matata777 (62).
Seat 4: IlxxxlI (22.08).
Seat 5: BoTPuMHeDichBro (76.36).
Seat 6: eu4ria (53.86).
Player Hakuna_Matata777 has small blind (0.25)
Player IlxxxlI has big blind (0.50)
Player IlxxxlI received card: [9c]
Player IlxxxlI received card: [10h]
Player BoTPuMHeDichBro folds
Player eu4ria folds
Player Smok5 Js folds
Player SenNoSen folds
Player Hakuna_Matata777 folds
Uncalled bet (0.25) returned to IlxxxlI
Player IlxxxlI mucks cards
------ Summary ------
Pot: 0.50. Rake 0
Player Smok5 Js does not show cards.Bets: 0. Collects: 0. Wins: 0.
Player SenNoSen does not show cards.Bets: 0. Collects: 0. Wins: 0.
Player Hakuna_Matata777 does not show cards.Bets: 0.25. Collects: 0. Loses: 0.25.
*Player IlxxxlI mucks (does not show cards). Bets: 0.25. Collects: 0.50. Wins: 0.25.
Player BoTPuMHeDichBro does not show cards.Bets: 0. Collects: 0. Wins: 0.
Player eu4ria does not show cards.Bets: 0. Collects: 0. Wins: 0.
Game ended at: 2016/11/28 18:40:52

Game started
Game ID: 786353484 0.25/0.50 (PRR) Gorgons - 5 (Hold'em)
Seat 6 is the button
Seat 1: SenNoSen (116.16).
Seat 2: eu4ria (236.71).
Seat 3: IlxxxlI (23).
Seat 4: Goomashroom (51.60).
Seat 5: GreinSeint (19.25).
Seat 6: wethco (70.57).
Player SenNoSen has small blind (0.25)
Player eu4ria has big blind (0.50)
Player IlxxxlI received card: [9c]
Player IlxxxlI received card: [Jd]
Player IlxxxlI folds
Player Goomashroom folds
Player GreinSeint folds
Player wethco folds
Player SenNoSen folds
Uncalled bet (0.25) returned to eu4ria
Player eu4ria mucks cards
------ Summary ------
Pot: 0.50. Rake 0
Player SenNoSen does not show cards.Bets: 0.25. Collects: 0. Loses: 0.25.
*Player eu4ria mucks (does not show cards). Bets: 0.25. Collects: 0.50. Wins: 0.25.
Player IlxxxlI does not show cards.Bets: 0. Collects: 0. Wins: 0.
Player Goomashroom does not show cards.Bets: 0. Collects: 0. Wins: 0.
Player GreinSeint does not show cards.Bets: 0. Collects: 0. Wins: 0.
Player wethco does not show cards.Bets: 0. Collects: 0. Wins: 0.
Game ended at: 2016/11/28 18:40:51

Game started
Game ID: 786353458 1/2 (PRR) Lakhey - 10 (Hold'em)
Seat 2 is the button
Seat 1: rkoko (116.09).
Seat 2: DonCesarGrinder (313.87).
Seat 3: IlxxxlI (81).
Seat 4: KingGuciGuci (203).
Seat 5: JJaromir (488.60).
Seat 6: bunchy (364.31).
Player IlxxxlI has small blind (1)
Player KingGuciGuci has big blind (2)
Player IlxxxlI received card: [4s]
Player IlxxxlI received card: [6s]
Player JJaromir folds
Player bunchy folds
Player rkoko folds
Player DonCesarGrinder raises (5)
Player IlxxxlI folds
Player KingGuciGuci folds
Uncalled bet (3) returned to DonCesarGrinder
Player DonCesarGrinder mucks cards
------ Summary ------
Pot: 5. Rake 0
Player rkoko does not show cards.Bets: 0. Collects: 0. Wins: 0.
*Player DonCesarGrinder mucks (does not show cards). Bets: 2. Collects: 5. Wins: 3.
Player IlxxxlI does not show cards.Bets: 1. Collects: 0. Loses: 1.
Player KingGuciGuci does not show cards.Bets: 2. Collects: 0. Loses: 2.
Player JJaromir does not show cards.Bets: 0. Collects: 0. Wins: 0.
Player bunchy does not show cards.Bets: 0. Collects: 0. Wins: 0.
Game ended at: 2016/11/28 18:40:46

Game started
Game ID: 786353403 1/2 (PRR) Lakhey - 10 (Hold'em)
Seat 1 is the button
Seat 1: rkoko (116.09).
Seat 2: DonCesarGrinder (314.87).
Seat 3: IlxxxlI (80).
Seat 4: KingGuciGuci (203).
Seat 5: JJaromir (488.60).
Seat 6: bunchy (364.31).
Player DonCesarGrinder has small blind (1)
Player IlxxxlI has big blind (2)
Player IlxxxlI received card: [6h]
Player IlxxxlI received card: [4c]
Player KingGuciGuci folds
Player JJaromir folds
Player bunchy folds
Player rkoko folds
Player DonCesarGrinder folds
Uncalled bet (1) returned to IlxxxlI
Player IlxxxlI mucks cards
------ Summary ------
Pot: 2. Rake 0
Player rkoko does not show cards.Bets: 0. Collects: 0. Wins: 0.
Player DonCesarGrinder does not show cards.Bets: 1. Collects: 0. Loses: 1.
*Player IlxxxlI mucks (does not show cards). Bets: 1. Collects: 2. Wins: 1.
Player KingGuciGuci does not show cards.Bets: 0. Collects: 0. Wins: 0.
Player JJaromir does not show cards.Bets: 0. Collects: 0. Wins: 0.
Player bunchy does not show cards.Bets: 0. Collects: 0. Wins: 0.
Game ended at: 2016/11/28 18:40:26

Game started
Game ID: 786353374 0.25/0.50 (PRR) Gorgons - 5 (Hold'em)
Seat 5 is the button
Seat 1: SenNoSen (116.66).
Seat 2: eu4ria (236.71).
Seat 3: IlxxxlI (23).
Seat 4: Goomashroom (50).
Seat 5: GreinSeint (19.25).
Seat 6: wethco (71.82).
Player wethco has small blind (0.25)
Player SenNoSen has big blind (0.50)
Player IlxxxlI received card: [6h]
Player IlxxxlI received card: [8c]
Player eu4ria folds
Player IlxxxlI folds
Player Goomashroom raises (1.25)
Player GreinSeint folds
Player wethco calls (1)
Player SenNoSen folds
*** FLOP ***: [4h 2c 9s]
Player wethco checks
Player Goomashroom bets (2.25)
Player wethco folds
Uncalled bet (2.25) returned to Goomashroom
Player Goomashroom mucks cards
------ Summary ------
Pot: 2.85. Rake 0.11. JP fee 0.04
Board: [4h 2c 9s]
Player SenNoSen does not show cards.Bets: 0.50. Collects: 0. Loses: 0.50.
Player eu4ria does not show cards.Bets: 0. Collects: 0. Wins: 0.
Player IlxxxlI does not show cards.Bets: 0. Collects: 0. Wins: 0.
*Player Goomashroom mucks (does not show cards). Bets: 1.25. Collects: 2.85. Wins: 1.60.
Player GreinSeint does not show cards.Bets: 0. Collects: 0. Wins: 0.
Player wethco does not show cards.Bets: 1.25. Collects: 0. Loses: 1.25.
Game ended at: 2016/11/28 18:40:32

Game started
Game ID: 786353317 0.25/0.50 (PRR) Gorgons - 17 (Hold'em)
Seat 1 is the button
Seat 1: Smok5 Js (19.45).
Seat 2: SenNoSen (81.22).
Seat 3: Hakuna_Matata777 (62.50).
Seat 4: IlxxxlI (22.08).
Seat 5: BoTPuMHeDichBro (76.36).
Seat 6: eu4ria (73.31).
Player SenNoSen has small blind (0.25)
Player Hakuna_Matata777 has big blind (0.50)
Player IlxxxlI received card: [3s]
Player IlxxxlI received card: [3c]
Player IlxxxlI folds
Player BoTPuMHeDichBro folds
Player eu4ria raises (1.50)
Player Smok5 Js calls (1.50)
Player SenNoSen raises (4.25)
Player Hakuna_Matata777 folds
Player eu4ria raises (15)
Player Smok5 Js allin (17.95)
Player SenNoSen folds
Player eu4ria calls (2.95)
*** FLOP ***: [5d 9h Ah]
*** TURN ***: [5d 9h Ah] [3h]
*** RIVER ***: [5d 9h Ah 3h] [9s]
------ Summary ------
Pot: 41.71. Rake 1.95. JP fee 0.24
Board: [5d 9h Ah 3h 9s]
*Player Smok5 Js shows: Two pairs. Qs and 9s [Qs Qh]. Bets: 19.45. Collects: 41.71. Wins: 22.26.
Player SenNoSen does not show cards.Bets: 4.50. Collects: 0. Loses: 4.50.
Player Hakuna_Matata777 does not show cards.Bets: 0.50. Collects: 0. Loses: 0.50.
Player IlxxxlI does not show cards.Bets: 0. Collects: 0. Wins: 0.
Player BoTPuMHeDichBro does not show cards.Bets: 0. Collects: 0. Wins: 0.
Player eu4ria shows: One pair of 9s [Kh 10c]. Bets: 19.45. Collects: 0. Loses: 19.45.
Game ended at: 2016/11/28 18:40:35

Game started
Game ID: 786353313 0.25/0.50 (PRR) Gorgons - 5 (Hold'em)
Seat 4 is the button
Seat 1: SenNoSen (115.91).
Seat 2: eu4ria (236.71).
Seat 3: IlxxxlI (23).
Seat 4: Goomashroom (50).
Seat 5: GreinSeint (19.50).
Seat 6: wethco (72.32).
Player GreinSeint has small blind (0.25)
Player wethco has big blind (0.50)
Player IlxxxlI received card: [2h]
Player IlxxxlI received card: [10h]
Player SenNoSen raises (1.50)
Player eu4ria folds
Player IlxxxlI folds
Player Goomashroom folds
Player GreinSeint folds
Player wethco folds
Uncalled bet (1) returned to SenNoSen
Player SenNoSen mucks cards
------ Summary ------
Pot: 1.25. Rake 0
*Player SenNoSen mucks (does not show cards). Bets: 0.50. Collects: 1.25. Wins: 0.75.
Player eu4ria does not show cards.Bets: 0. Collects: 0. Wins: 0.
Player IlxxxlI does not show cards.Bets: 0. Collects: 0. Wins: 0.
Player Goomashroom does not show cards.Bets: 0. Collects: 0. Wins: 0.
Player GreinSeint does not show cards.Bets: 0.25. Collects: 0. Loses: 0.25.
Player wethco does not show cards.Bets: 0.50. Collects: 0. Loses: 0.50.
Game ended at: 2016/11/28 18:39:59

Game started
Game ID: 786353228 0.25/0.50 (PRR) Gorgons - 5 (Hold'em)
Seat 3 is the button
Seat 1: SenNoSen (115.91).
Seat 2: eu4ria (235.96).
Seat 3: IlxxxlI (23).
Seat 4: Goomashroom (50).
Seat 5: GreinSeint (20).
Seat 6: wethco (72.32).
Player Goomashroom has small blind (0.25)
Player GreinSeint has big blind (0.50)
Player IlxxxlI received card: [Qh]
Player IlxxxlI received card: [7h]
Player wethco folds
Player SenNoSen folds
Player eu4ria raises (1.50)
Player IlxxxlI folds
Player Goomashroom folds
Player GreinSeint folds
Uncalled bet (1) returned to eu4ria
Player eu4ria mucks cards
------ Summary ------
Pot: 1.25. Rake 0
Player SenNoSen does not show cards.Bets: 0. Collects: 0. Wins: 0.
*Player eu4ria mucks (does not show cards). Bets: 0.50. Collects: 1.25. Wins: 0.75.
Player IlxxxlI does not show cards.Bets: 0. Collects: 0. Wins: 0.
Player Goomashroom does not show cards.Bets: 0.25. Collects: 0. Loses: 0.25.
Player GreinSeint does not show cards.Bets: 0.50. Collects: 0. Loses: 0.50.
Player wethco does not show cards.Bets: 0. Collects: 0. Wins: 0.
Game ended at: 2016/11/28 18:39:39

Game started
Game ID: 786353172 0.25/0.50 (PRR) Gorgons - 17 (Hold'em)
Seat 6 is the button
Seat 1: Smok5 Js (19.70).
Seat 2: SenNoSen (81.72).
Seat 3: Hakuna_Matata777 (62.50).
Seat 4: IlxxxlI (22.08).
Seat 5: BoTPuMHeDichBro (76.36).
Seat 6: eu4ria (72.56).
Player Smok5 Js has small blind (0.25)
Player SenNoSen has big blind (0.50)
Player IlxxxlI received card: [6s]
Player IlxxxlI received card: [10s]
Player Hakuna_Matata777 folds
Player IlxxxlI folds
Player BoTPuMHeDichBro folds
Player eu4ria raises (1.25)
Player Smok5 Js folds
Player SenNoSen folds
Uncalled bet (0.75) returned to eu4ria
Player eu4ria mucks cards
------ Summary ------
Pot: 1.25. Rake 0
Player Smok5 Js does not show cards.Bets: 0.25. Collects: 0. Loses: 0.25.
Player SenNoSen does not show cards.Bets: 0.50. Collects: 0. Loses: 0.50.
Player Hakuna_Matata777 does not show cards.Bets: 0. Collects: 0. Wins: 0.
Player IlxxxlI does not show cards.Bets: 0. Collects: 0. Wins: 0.
Player BoTPuMHeDichBro does not show cards.Bets: 0. Collects: 0. Wins: 0.
*Player eu4ria mucks (does not show cards). Bets: 0.50. Collects: 1.25. Wins: 0.75.
Game ended at: 2016/11/28 18:39:40

Game started
Game ID: 786353146 0.25/0.50 (PRR) Gorgons - 5 (Hold'em)
Seat 2 is the button
Seat 1: SenNoSen (115.91).
Seat 2: eu4ria (235.21).
Seat 3: IlxxxlI (23.25).
Seat 4: Goomashroom (50).
Seat 6: wethco (72.32).
Player IlxxxlI has small blind (0.25)
Player Goomashroom has big blind (0.50)
Player IlxxxlI received card: [Jh]
Player IlxxxlI received card: [Qd]
Player wethco folds
Player SenNoSen folds
Player eu4ria raises (1.25)
Player IlxxxlI folds
Player Goomashroom folds
Uncalled bet (0.75) returned to eu4ria
Player eu4ria mucks cards
------ Summary ------
Pot: 1.25. Rake 0
Player SenNoSen does not show cards.Bets: 0. Collects: 0. Wins: 0.
*Player eu4ria mucks (does not show cards). Bets: 0.50. Collects: 1.25. Wins: 0.75.
Player IlxxxlI does not show cards.Bets: 0.25. Collects: 0. Loses: 0.25.
Player Goomashroom does not show cards.Bets: 0.50. Collects: 0. Loses: 0.50.
Player wethco does not show cards.Bets: 0. Collects: 0. Wins: 0.
Game ended at: 2016/11/28 18:39:9

Game started
Game ID: 786353110 0.25/0.50 (PRR) Gorgons - 17 (Hold'em)
Seat 5 is the button
Seat 1: Smok5 Js (19.45).
Seat 2: SenNoSen (81.72).
Seat 3: Hakuna_Matata777 (62.50).
Seat 4: IlxxxlI (22.08).
Seat 5: BoTPuMHeDichBro (76.36).
Seat 6: eu4ria (72.81).
Player eu4ria has small blind (0.25)
Player Smok5 Js has big blind (0.50)
Player IlxxxlI received card: [8c]
Player IlxxxlI received card: [Qh]
Player SenNoSen folds
Player Hakuna_Matata777 folds
Player IlxxxlI folds
Player BoTPuMHeDichBro folds
Player eu4ria folds
Uncalled bet (0.25) returned to Smok5 Js
Player Smok5 Js is timed out.
Player Smok5 Js mucks cards
------ Summary ------
Pot: 0.50. Rake 0
*Player Smok5 Js mucks (does not show cards). Bets: 0.25. Collects: 0.50. Wins: 0.25.
Player SenNoSen does not show cards.Bets: 0. Collects: 0. Wins: 0.
Player Hakuna_Matata777 does not show cards.Bets: 0. Collects: 0. Wins: 0.
Player IlxxxlI does not show cards.Bets: 0. Collects: 0. Wins: 0.
Player BoTPuMHeDichBro does not show cards.Bets: 0. Collects: 0. Wins: 0.
Player eu4ria does not show cards.Bets: 0.25. Collects: 0. Loses: 0.25.
Game ended at: 2016/11/28 18:38:52

Game started
Game ID: 786353068 0.25/0.50 (PRR) Gorgons - 5 (Hold'em)
Seat 1 is the button
Seat 1: SenNoSen (115.91).
Seat 2: eu4ria (236.71).
Seat 3: IlxxxlI (21.75).
Seat 4: Goomashroom (50).
Seat 6: wethco (72.32).
Player eu4ria has small blind (0.25)
Player IlxxxlI has big blind (0.50)
Player IlxxxlI received card: [Ad]
Player IlxxxlI received card: [Qh]
Player Goomashroom folds
Player wethco folds
Player SenNoSen folds
Player eu4ria raises (1.25)
Player IlxxxlI raises (3.14)
Player eu4ria folds
Uncalled bet (2.14) returned to IlxxxlI
Player IlxxxlI mucks cards
------ Summary ------
Pot: 3. Rake 0
Player SenNoSen does not show cards.Bets: 0. Collects: 0. Wins: 0.
Player eu4ria does not show cards.Bets: 1.50. Collects: 0. Loses: 1.50.
*Player IlxxxlI mucks (does not show cards). Bets: 1.50. Collects: 3. Wins: 1.50.
Player Goomashroom does not show cards.Bets: 0. Collects: 0. Wins: 0.
Player wethco does not show cards.Bets: 0. Collects: 0. Wins: 0.
Game ended at: 2016/11/28 18:38:43

Game started
Game ID: 786353032 0.25/0.50 (PRR) Gorgons - 17 (Hold'em)
Seat 4 is the button
Seat 1: Smok5 Js (19.45).
Seat 2: SenNoSen (81.72).
Seat 3: Hakuna_Matata777 (62.50).
Seat 4: IlxxxlI (21.33).
Seat 5: BoTPuMHeDichBro (76.61).
Seat 6: eu4ria (73.31).
Player BoTPuMHeDichBro has small blind (0.25)
Player eu4ria has big blind (0.50)
Player IlxxxlI received card: [Ac]
Player IlxxxlI received card: [Kh]
Player Smok5 Js folds
Player SenNoSen folds
Player Hakuna_Matata777 folds
Player IlxxxlI raises (1.50)
Player BoTPuMHeDichBro folds
Player eu4ria folds
Uncalled bet (1) returned to IlxxxlI
Player IlxxxlI mucks cards
------ Summary ------
Pot: 1.25. Rake 0
Player Smok5 Js does not show cards.Bets: 0. Collects: 0. Wins: 0.
Player SenNoSen does not show cards.Bets: 0. Collects: 0. Wins: 0.
Player Hakuna_Matata777 does not show cards.Bets: 0. Collects: 0. Wins: 0.
*Player IlxxxlI mucks (does not show cards). Bets: 0.50. Collects: 1.25. Wins: 0.75.
Player BoTPuMHeDichBro does not show cards.Bets: 0.25. Collects: 0. Loses: 0.25.
Player eu4ria does not show cards.Bets: 0.50. Collects: 0. Loses: 0.50.
Game ended at: 2016/11/28 18:38:30

Game started
Game ID: 786352981 0.25/0.50 (PRR) Gorgons - 5 (Hold'em)
Seat 6 is the button
Seat 1: SenNoSen (117.41).
Seat 2: eu4ria (235.21).
Seat 3: IlxxxlI (21.75).
Seat 4: Goomashroom (50).
Seat 6: wethco (72.32).
Player SenNoSen has small blind (0.25)
Player eu4ria has big blind (0.50)
Player IlxxxlI received card: [5c]
Player IlxxxlI received card: [2s]
Player IlxxxlI folds
Player Goomashroom folds
Player wethco folds
Player SenNoSen raises (1.25)
Player eu4ria raises (4)
Player SenNoSen folds
Uncalled bet (3) returned to eu4ria
Player eu4ria mucks cards
------ Summary ------
Pot: 3. Rake 0
Player SenNoSen does not show cards.Bets: 1.50. Collects: 0. Loses: 1.50.
*Player eu4ria mucks (does not show cards). Bets: 1.50. Collects: 3. Wins: 1.50.
Player IlxxxlI does not show cards.Bets: 0. Collects: 0. Wins: 0.
Player Goomashroom does not show cards.Bets: 0. Collects: 0. Wins: 0.
Player wethco does not show cards.Bets: 0. Collects: 0. Wins: 0.
Game ended at: 2016/11/28 18:38:17

Game started
Game ID: 786352902 0.25/0.50 (PRR) Gorgons - 5 (Hold'em)
Seat 4 is the button
Seat 1: SenNoSen (117.91).
Seat 2: eu4ria (234.46).
Seat 3: IlxxxlI (21.75).
Seat 4: Goomashroom (50).
Seat 6: wethco (72.57).
Player wethco has small blind (0.25)
Player SenNoSen has big blind (0.50)
Player IlxxxlI received card: [9c]
Player IlxxxlI received card: [2s]
Player eu4ria raises (1.50)
Player IlxxxlI folds
Player Goomashroom folds
Player wethco folds
Player SenNoSen folds
Uncalled bet (1) returned to eu4ria
Player eu4ria mucks cards
------ Summary ------
Pot: 1.25. Rake 0
Player SenNoSen does not show cards.Bets: 0.50. Collects: 0. Loses: 0.50.
*Player eu4ria mucks (does not show cards). Bets: 0.50. Collects: 1.25. Wins: 0.75.
Player IlxxxlI does not show cards.Bets: 0. Collects: 0. Wins: 0.
Player Goomashroom does not show cards.Bets: 0. Collects: 0. Wins: 0.
Player wethco does not show cards.Bets: 0.25. Collects: 0. Loses: 0.25.
Game ended at: 2016/11/28 18:37:49

Game started
Game ID: 786352900 0.25/0.50 (PRR) Gorgons - 17 (Hold'em)
Seat 3 is the button
Seat 1: Smok5 Js (19.45).
Seat 2: SenNoSen (81.72).
Seat 3: Hakuna_Matata777 (62.50).
Seat 4: IlxxxlI (21.58).
Seat 5: BoTPuMHeDichBro (77.11).
Seat 6: eu4ria (72.56).
Player IlxxxlI has small blind (0.25)
Player BoTPuMHeDichBro has big blind (0.50)
Player IlxxxlI received card: [As]
Player IlxxxlI received card: [6d]
Player eu4ria raises (1.50)
Player Smok5 Js folds
Player SenNoSen folds
Player Hakuna_Matata777 folds
Player IlxxxlI folds
Player BoTPuMHeDichBro folds
Uncalled bet (1) returned to eu4ria
Player eu4ria mucks cards
------ Summary ------
Pot: 1.25. Rake 0
Player Smok5 Js does not show cards.Bets: 0. Collects: 0. Wins: 0.
Player SenNoSen does not show cards.Bets: 0. Collects: 0. Wins: 0.
Player Hakuna_Matata777 does not show cards.Bets: 0. Collects: 0. Wins: 0.
Player IlxxxlI does not show cards.Bets: 0.25. Collects: 0. Loses: 0.25.
Player BoTPuMHeDichBro does not show cards.Bets: 0.50. Collects: 0. Loses: 0.50.
*Player eu4ria mucks (does not show cards). Bets: 0.50. Collects: 1.25. Wins: 0.75.
Game ended at: 2016/11/28 18:38:5

Game started
Game ID: 786352784 0.25/0.50 (PRR) Gorgons - 17 (Hold'em)
Seat 2 is the button
Seat 1: Smok5 Js (19.95).
Seat 2: SenNoSen (80.47).
Seat 3: Hakuna_Matata777 (62.75).
Seat 4: IlxxxlI (22.08).
Seat 5: BoTPuMHeDichBro (77.11).
Seat 6: eu4ria (72.56).
Player Hakuna_Matata777 has small blind (0.25)
Player IlxxxlI has big blind (0.50)
Player IlxxxlI received card: [9h]
Player IlxxxlI received card: [3s]
Player BoTPuMHeDichBro folds
Player eu4ria folds
Player Smok5 Js calls (0.50)
Player SenNoSen raises (2.50)
Player Hakuna_Matata777 folds
Player IlxxxlI folds
Player Smok5 Js folds
Uncalled bet (2) returned to SenNoSen
Player SenNoSen mucks cards
------ Summary ------
Pot: 1.75. Rake 0
Player Smok5 Js does not show cards.Bets: 0.50. Collects: 0. Loses: 0.50.
*Player SenNoSen mucks (does not show cards). Bets: 0.50. Collects: 1.75. Wins: 1.25.
Player Hakuna_Matata777 does not show cards.Bets: 0.25. Collects: 0. Loses: 0.25.
Player IlxxxlI does not show cards.Bets: 0.50. Collects: 0. Loses: 0.50.
Player BoTPuMHeDichBro does not show cards.Bets: 0. Collects: 0. Wins: 0.
Player eu4ria does not show cards.Bets: 0. Collects: 0. Wins: 0.
Game ended at: 2016/11/28 18:37:22

Game started
Game ID: 786352728 0.25/0.50 (PRR) Gorgons - 5 (Hold'em)
Seat 3 is the button
Seat 1: SenNoSen (117.91).
Seat 2: eu4ria (235.96).
Seat 3: IlxxxlI (21.75).
Seat 4: Goomashroom (50).
Seat 5: Hakuna_Matata777 (50.53).
Seat 6: wethco (70.98).
Player Goomashroom has small blind (0.25)
Player Hakuna_Matata777 sitting out
Player wethco has big blind (0.50)
Player IlxxxlI received card: [3c]
Player IlxxxlI received card: [Kc]
Player SenNoSen folds
Player eu4ria raises (1.50)
Player IlxxxlI folds
Player Goomashroom folds
Player wethco calls (1)
*** FLOP ***: [3d 4d Qc]
Player wethco checks
Player eu4ria checks
*** TURN ***: [3d 4d Qc] [5s]
Player wethco checks
Player eu4ria checks
*** RIVER ***: [3d 4d Qc 5s] [5c]
Player wethco checks
Player eu4ria checks
Player eu4ria mucks cards
------ Summary ------
Pot: 3.09. Rake 0.12. JP fee 0.04
Board: [3d 4d Qc 5s 5c]
Player SenNoSen does not show cards.Bets: 0. Collects: 0. Wins: 0.
Player eu4ria mucks (does not show cards). Bets: 1.50. Collects: 0. Loses: 1.50.
Player IlxxxlI does not show cards.Bets: 0. Collects: 0. Wins: 0.
Player Goomashroom does not show cards.Bets: 0.25. Collects: 0. Loses: 0.25.
Player Hakuna_Matata777 does not show cards.Bets: 0. Collects: 0. Wins: 0.
*Player wethco shows: One pair of 5s [6c Ac]. Bets: 1.50. Collects: 3.09. Wins: 1.59.
Game ended at: 2016/11/28 18:37:21

Game started
Game ID: 786352644 0.25/0.50 (PRR) Gorgons - 5 (Hold'em)
Seat 2 is the button
Seat 1: SenNoSen (117.91).
Seat 2: eu4ria (235.21).
Seat 3: IlxxxlI (22).
Seat 4: Goomashroom (50).
Seat 5: Hakuna_Matata777 (50.53).
Seat 6: wethco (70.98).
Player IlxxxlI has small blind (0.25)
Player Goomashroom has big blind (0.50)
Player IlxxxlI received card: [Qc]
Player IlxxxlI received card: [6d]
Player Hakuna_Matata777 folds
Player wethco folds
Player SenNoSen folds
Player eu4ria raises (1.25)
Player IlxxxlI folds
Player Goomashroom folds
Uncalled bet (0.75) returned to eu4ria
Player eu4ria mucks cards
------ Summary ------
Pot: 1.25. Rake 0
Player SenNoSen does not show cards.Bets: 0. Collects: 0. Wins: 0.
*Player eu4ria mucks (does not show cards). Bets: 0.50. Collects: 1.25. Wins: 0.75.
Player IlxxxlI does not show cards.Bets: 0.25. Collects: 0. Loses: 0.25.
Player Goomashroom does not show cards.Bets: 0.50. Collects: 0. Loses: 0.50.
Player Hakuna_Matata777 does not show cards.Bets: 0. Collects: 0. Wins: 0.
Player wethco does not show cards.Bets: 0. Collects: 0. Wins: 0.
Game ended at: 2016/11/28 18:36:20

Game started
Game ID: 786352544 0.25/0.50 (PRR) Gorgons - 5 (Hold'em)
Seat 1 is the button
Seat 1: SenNoSen (118.91).
Seat 2: eu4ria (235.46).
Seat 3: IlxxxlI (20.75).
Seat 5: Hakuna_Matata777 (50.53).
Seat 6: wethco (70.98).
Player eu4ria has small blind (0.25)
Player IlxxxlI has big blind (0.50)
Player IlxxxlI received card: [Ac]
Player IlxxxlI received card: [Js]
Player Hakuna_Matata777 folds
Player wethco folds
Player SenNoSen raises (1)
Player eu4ria folds
Player IlxxxlI raises (2.08)
Player SenNoSen folds
Uncalled bet (1.58) returned to IlxxxlI
Player IlxxxlI mucks cards
------ Summary ------
Pot: 2.25. Rake 0
Player SenNoSen does not show cards.Bets: 1. Collects: 0. Loses: 1.
Player eu4ria does not show cards.Bets: 0.25. Collects: 0. Loses: 0.25.
*Player IlxxxlI mucks (does not show cards). Bets: 1. Collects: 2.25. Wins: 1.25.
Player Hakuna_Matata777 does not show cards.Bets: 0. Collects: 0. Wins: 0.
Player wethco does not show cards.Bets: 0. Collects: 0. Wins: 0.
Game ended at: 2016/11/28 18:35:51

Game started
Game ID: 786352534 0.25/0.50 (PRR) Gorgons - 17 (Hold'em)
Seat 1 is the button
Seat 1: Smok5 Js (21.45).
Seat 2: SenNoSen (80.72).
Seat 3: Hakuna_Matata777 (63.25).
Seat 4: IlxxxlI (22.08).
Seat 5: BoTPuMHeDichBro (75.04).
Seat 6: eu4ria (72.56).
Player SenNoSen has small blind (0.25)
Player Hakuna_Matata777 has big blind (0.50)
Player IlxxxlI received card: [8c]
Player IlxxxlI received card: [Qd]
Player IlxxxlI folds
Player BoTPuMHeDichBro raises (1.50)
Player eu4ria folds
Player Smok5 Js calls (1.50)
Player SenNoSen folds
Player Hakuna_Matata777 folds
*** FLOP ***: [Jc Kd 8s]
Player BoTPuMHeDichBro checks
Player Smok5 Js checks
*** TURN ***: [Jc Kd 8s] [Ac]
Player BoTPuMHeDichBro checks
Player Smok5 Js checks
*** RIVER ***: [Jc Kd 8s Ac] [3h]
Player BoTPuMHeDichBro checks
Player Smok5 Js checks
Player Smok5 Js is timed out.
Player Smok5 Js mucks cards
------ Summary ------
Pot: 3.57. Rake 0.12. JP fee 0.06
Board: [Jc Kd 8s Ac 3h]
Player Smok5 Js mucks (does not show cards). Bets: 1.50. Collects: 0. Loses: 1.50.
Player SenNoSen does not show cards.Bets: 0.25. Collects: 0. Loses: 0.25.
Player Hakuna_Matata777 does not show cards.Bets: 0.50. Collects: 0. Loses: 0.50.
Player IlxxxlI does not show cards.Bets: 0. Collects: 0. Wins: 0.
*Player BoTPuMHeDichBro shows: One pair of 9s [9h 9c]. Bets: 1.50. Collects: 3.57. Wins: 2.07.
Player eu4ria does not show cards.Bets: 0. Collects: 0. Wins: 0.
Game ended at: 2016/11/28 18:36:41

Game started
Game ID: 786352461 0.25/0.50 (PRR) Gorgons - 5 (Hold'em)
Seat 6 is the button
Seat 1: SenNoSen (118.41).
Seat 2: eu4ria (235.96).
Seat 3: IlxxxlI (20.75).
Seat 5: Hakuna_Matata777 (50.53).
Seat 6: wethco (70.98).
Player SenNoSen has small blind (0.25)
Player eu4ria has big blind (0.50)
Player IlxxxlI received card: [9d]
Player IlxxxlI received card: [4c]
Player IlxxxlI folds
Player Hakuna_Matata777 folds
Player wethco folds
Player SenNoSen raises (1.25)
Player eu4ria folds
Uncalled bet (1) returned to SenNoSen
Player SenNoSen mucks cards
------ Summary ------
Pot: 1. Rake 0
*Player SenNoSen mucks (does not show cards). Bets: 0.50. Collects: 1. Wins: 0.50.
Player eu4ria does not show cards.Bets: 0.50. Collects: 0. Loses: 0.50.
Player IlxxxlI does not show cards.Bets: 0. Collects: 0. Wins: 0.
Player Hakuna_Matata777 does not show cards.Bets: 0. Collects: 0. Wins: 0.
Player wethco does not show cards.Bets: 0. Collects: 0. Wins: 0.
Game ended at: 2016/11/28 18:35:16

Game started
Game ID: 786352397 0.25/0.50 (PRR) Gorgons - 5 (Hold'em)
Seat 5 is the button
Seat 1: SenNoSen (118.91).
Seat 2: eu4ria (235.96).
Seat 3: IlxxxlI (20).
Seat 5: Hakuna_Matata777 (50.53).
Seat 6: wethco (71.23).
Player wethco has small blind (0.25)
Player SenNoSen has big blind (0.50)
Player IlxxxlI received card: [Jc]
Player IlxxxlI received card: [Js]
Player eu4ria folds
Player IlxxxlI raises (1.20)
Player Hakuna_Matata777 folds
Player wethco folds
Player SenNoSen folds
Uncalled bet (0.70) returned to IlxxxlI
Player IlxxxlI mucks cards
------ Summary ------
Pot: 1.25. Rake 0
Player SenNoSen does not show cards.Bets: 0.50. Collects: 0. Loses: 0.50.
Player eu4ria does not show cards.Bets: 0. Collects: 0. Wins: 0.
*Player IlxxxlI mucks (does not show cards). Bets: 0.50. Collects: 1.25. Wins: 0.75.
Player Hakuna_Matata777 does not show cards.Bets: 0. Collects: 0. Wins: 0.
Player wethco does not show cards.Bets: 0.25. Collects: 0. Loses: 0.25.
Game ended at: 2016/11/28 18:34:49

Game started
Game ID: 786352383 0.25/0.50 (PRR) Gorgons - 17 (Hold'em)
Seat 6 is the button
Seat 1: Smok5 Js (21.70).
Seat 2: SenNoSen (81.22).
Seat 3: Hakuna_Matata777 (63.25).
Seat 4: IlxxxlI (22.08).
Seat 5: BoTPuMHeDichBro (74.29).
Seat 6: eu4ria (72.56).
Player Smok5 Js has small blind (0.25)
Player SenNoSen has big blind (0.50)
Player IlxxxlI received card: [3d]
Player IlxxxlI received card: [7s]
Player Hakuna_Matata777 folds
Player IlxxxlI folds
Player BoTPuMHeDichBro raises (1.50)
Player eu4ria folds
Player Smok5 Js folds
Player SenNoSen folds
Uncalled bet (1) returned to BoTPuMHeDichBro
Player BoTPuMHeDichBro mucks cards
------ Summary ------
Pot: 1.25. Rake 0
Player Smok5 Js does not show cards.Bets: 0.25. Collects: 0. Loses: 0.25.
Player SenNoSen does not show cards.Bets: 0.50. Collects: 0. Loses: 0.50.
Player Hakuna_Matata777 does not show cards.Bets: 0. Collects: 0. Wins: 0.
Player IlxxxlI does not show cards.Bets: 0. Collects: 0. Wins: 0.
*Player BoTPuMHeDichBro mucks (does not show cards). Bets: 0.50. Collects: 1.25. Wins: 0.75.
Player eu4ria does not show cards.Bets: 0. Collects: 0. Wins: 0.
Game ended at: 2016/11/28 18:35:11

Game started
Game ID: 786352305 0.25/0.50 (PRR) Gorgons - 17 (Hold'em)
Seat 5 is the button
Seat 1: Smok5 Js (21.45).
Seat 2: SenNoSen (81.22).
Seat 3: Hakuna_Matata777 (63.25).
Seat 4: IlxxxlI (22.08).
Seat 5: BoTPuMHeDichBro (74.29).
Seat 6: eu4ria (72.81).
Player eu4ria has small blind (0.25)
Player Smok5 Js has big blind (0.50)
Player IlxxxlI received card: [10h]
Player IlxxxlI received card: [4h]
Player SenNoSen folds
Player Hakuna_Matata777 folds
Player IlxxxlI folds
Player BoTPuMHeDichBro folds
Player eu4ria folds
Uncalled bet (0.25) returned to Smok5 Js
Player Smok5 Js is timed out.
Player Smok5 Js mucks cards
------ Summary ------
Pot: 0.50. Rake 0
*Player Smok5 Js mucks (does not show cards). Bets: 0.25. Collects: 0.50. Wins: 0.25.
Player SenNoSen does not show cards.Bets: 0. Collects: 0. Wins: 0.
Player Hakuna_Matata777 does not show cards.Bets: 0. Collects: 0. Wins: 0.
Player IlxxxlI does not show cards.Bets: 0. Collects: 0. Wins: 0.
Player BoTPuMHeDichBro does not show cards.Bets: 0. Collects: 0. Wins: 0.
Player eu4ria does not show cards.Bets: 0.25. Collects: 0. Loses: 0.25.
Game ended at: 2016/11/28 18:34:24

Game started
Game ID: 786352098 0.25/0.50 (PRR) Gorgons - 5 (Hold'em)
Seat 4 is the button
Seat 1: SenNoSen (118.91).
Seat 2: eu4ria (235.96).
Seat 3: IlxxxlI (20).
Seat 4: dscshift (17.83).
Seat 5: Hakuna_Matata777 (52.53).
Seat 6: wethco (53.28).
Player Hakuna_Matata777 has small blind (0.25)
Player wethco has big blind (0.50)
Player IlxxxlI received card: [10d]
Player IlxxxlI received card: [5s]
Player SenNoSen folds
Player eu4ria folds
Player IlxxxlI folds
Player dscshift calls (0.50)
Player Hakuna_Matata777 raises (1.75)
Player wethco calls (1.50)
Player dscshift calls (1.50)
*** FLOP ***: [6s 10c Js]
Player Hakuna_Matata777 checks
Player wethco bets (3.80)
Player dscshift calls (3.80)
Player Hakuna_Matata777 folds
*** TURN ***: [6s 10c Js] [3h]
Player wethco bets (8.61)
Player dscshift calls (8.61)
*** RIVER ***: [6s 10c Js 3h] [2h]
Player wethco allin (38.87)
Player dscshift allin (3.42)
Uncalled bet (35.45) returned to wethco
------ Summary ------
Pot: 35.78. Rake 1.64. JP fee 0.24
Board: [6s 10c Js 3h 2h]
Player SenNoSen does not show cards.Bets: 0. Collects: 0. Wins: 0.
Player eu4ria does not show cards.Bets: 0. Collects: 0. Wins: 0.
Player IlxxxlI does not show cards.Bets: 0. Collects: 0. Wins: 0.
Player dscshift shows: One pair of 6s [6h Ac]. Bets: 17.83. Collects: 0. Loses: 17.83.
Player Hakuna_Matata777 does not show cards.Bets: 2. Collects: 0. Loses: 2.
*Player wethco shows: One pair of Js [Jd Qh]. Bets: 17.83. Collects: 35.78. Wins: 17.95.
Game ended at: 2016/11/28 18:34:26

Game started
Game ID: 786351971 0.25/0.50 (PRR) Gorgons - 17 (Hold'em)
Seat 4 is the button
Seat 1: Smok5 Js (21.45).
Seat 2: SenNoSen (81.22).
Seat 3: Hakuna_Matata777 (63.25).
Seat 4: IlxxxlI (22.08).
Seat 5: BoTPuMHeDichBro (64.16).
Seat 6: eu4ria (84.06).
Player BoTPuMHeDichBro has small blind (0.25)
Player eu4ria has big blind (0.50)
Player IlxxxlI received card: [Kc]
Player IlxxxlI received card: [10h]
Player Smok5 Js folds
Player SenNoSen folds
Player Hakuna_Matata777 folds
Player IlxxxlI folds
Player BoTPuMHeDichBro raises (1.25)
Player eu4ria raises (4)
Player BoTPuMHeDichBro raises (9.75)
Player eu4ria calls (6.75)
*** FLOP ***: [As 9c 8d]
Player BoTPuMHeDichBro checks
Player eu4ria checks
*** TURN ***: [As 9c 8d] [5c]
Player BoTPuMHeDichBro checks
Player eu4ria checks
*** RIVER ***: [As 9c 8d 5c] [6c]
Player BoTPuMHeDichBro checks
Player eu4ria checks
Player eu4ria mucks cards
------ Summary ------
Pot: 21.38. Rake 0.88. JP fee 0.24
Board: [As 9c 8d 5c 6c]
Player Smok5 Js does not show cards.Bets: 0. Collects: 0. Wins: 0.
Player SenNoSen does not show cards.Bets: 0. Collects: 0. Wins: 0.
Player Hakuna_Matata777 does not show cards.Bets: 0. Collects: 0. Wins: 0.
Player IlxxxlI does not show cards.Bets: 0. Collects: 0. Wins: 0.
*Player BoTPuMHeDichBro shows: One pair of 8s [8s Qs]. Bets: 11.25. Collects: 21.38. Wins: 10.13.
Player eu4ria mucks (does not show cards). Bets: 11.25. Collects: 0. Loses: 11.25.
Game ended at: 2016/11/28 18:33:54

Game started
Game ID: 786351940 0.25/0.50 (PRR) Gorgons - 5 (Hold'em)
Seat 3 is the button
Seat 1: SenNoSen (116.08).
Seat 2: eu4ria (235.96).
Seat 3: IlxxxlI (20).
Seat 4: dscshift (20.44).
Seat 5: Hakuna_Matata777 (53.03).
Seat 6: wethco (53.28).
Player dscshift has small blind (0.25)
Player Hakuna_Matata777 has big blind (0.50)
Player IlxxxlI received card: [2h]
Player IlxxxlI received card: [Jc]
Player wethco folds
Player SenNoSen raises (1.50)
Player eu4ria folds
Player IlxxxlI folds
Player dscshift calls (1.25)
Player Hakuna_Matata777 folds
*** FLOP ***: [9s 4h Jh]
Player dscshift checks
Player SenNoSen bets (1.11)
Player dscshift calls (1.11)
*** TURN ***: [9s 4h Jh] [2s]
Player dscshift checks
Player SenNoSen bets (3.62)
Player dscshift folds
Uncalled bet (3.62) returned to SenNoSen
Player SenNoSen mucks cards
------ Summary ------
Pot: 5.44. Rake 0.20. JP fee 0.08
Board: [9s 4h Jh 2s]
*Player SenNoSen mucks (does not show cards). Bets: 2.61. Collects: 5.44. Wins: 2.83.
Player eu4ria does not show cards.Bets: 0. Collects: 0. Wins: 0.
Player IlxxxlI does not show cards.Bets: 0. Collects: 0. Wins: 0.
Player dscshift does not show cards.Bets: 2.61. Collects: 0. Loses: 2.61.
Player Hakuna_Matata777 does not show cards.Bets: 0.50. Collects: 0. Loses: 0.50.
Player wethco does not show cards.Bets: 0. Collects: 0. Wins: 0.
Game ended at: 2016/11/28 18:32:52

Game started
Game ID: 786351646 0.25/0.50 (PRR) Gorgons - 2 (Hold'em)
Seat 6 is the button
Seat 3: Goomashroom (50).
Seat 4: eu4ria (208.64).
Seat 5: BoTPuMHeDichBro (50).
Seat 6: IlxxxlI (31.63).
Player Goomashroom has small blind (0.25)
Player eu4ria has big blind (0.50)
Player IlxxxlI received card: [2s]
Player IlxxxlI received card: [Js]
Player BoTPuMHeDichBro folds
Player IlxxxlI folds
Player Goomashroom folds
Uncalled bet (0.25) returned to eu4ria
Player eu4ria mucks cards
------ Summary ------
Pot: 0.50. Rake 0
Player Goomashroom does not show cards.Bets: 0.25. Collects: 0. Loses: 0.25.
*Player eu4ria mucks (does not show cards). Bets: 0.25. Collects: 0.50. Wins: 0.25.
Player BoTPuMHeDichBro does not show cards.Bets: 0. Collects: 0. Wins: 0.
Player IlxxxlI does not show cards.Bets: 0. Collects: 0. Wins: 0.
Game ended at: 2016/11/28 18:30:47

Game started
Game ID: 786351623 0.25/0.50 (PRR) Gorgons - 17 (Hold'em)
Seat 3 is the button
Seat 1: Smok5 Js (21.45).
Seat 2: SenNoSen (82.72).
Seat 3: Hakuna_Matata777 (63.25).
Seat 4: IlxxxlI (20.25).
Seat 5: BoTPuMHeDichBro (64.66).
Seat 6: eu4ria (84.06).
Player IlxxxlI has small blind (0.25)
Player BoTPuMHeDichBro has big blind (0.50)
Player IlxxxlI received card: [3s]
Player IlxxxlI received card: [3h]
Player eu4ria folds
Player Smok5 Js folds
Player SenNoSen raises (1)
Player Hakuna_Matata777 folds
Player IlxxxlI raises (1.25)
Player BoTPuMHeDichBro folds
Player SenNoSen calls (0.50)
*** FLOP ***: [Ks 5h 10d]
Player IlxxxlI is timed out.
Player IlxxxlI checks
Player SenNoSen checks
*** TURN ***: [Ks 5h 10d] [6d]
Player IlxxxlI checks
Player SenNoSen checks
*** RIVER ***: [Ks 5h 10d 6d] [8c]
Player IlxxxlI checks
Player SenNoSen checks
Player SenNoSen mucks cards
------ Summary ------
Pot: 3.33. Rake 0.13. JP fee 0.04
Board: [Ks 5h 10d 6d 8c]
Player Smok5 Js does not show cards.Bets: 0. Collects: 0. Wins: 0.
Player SenNoSen mucks (does not show cards). Bets: 1.50. Collects: 0. Loses: 1.50.
Player Hakuna_Matata777 does not show cards.Bets: 0. Collects: 0. Wins: 0.
*Player IlxxxlI shows: One pair of 3s [3s 3h]. Bets: 1.50. Collects: 3.33. Wins: 1.83.
Player BoTPuMHeDichBro does not show cards.Bets: 0.50. Collects: 0. Loses: 0.50.
Player eu4ria does not show cards.Bets: 0. Collects: 0. Wins: 0.
Game ended at: 2016/11/28 18:32:11

Game started
Game ID: 786351613 0.25/0.50 (PRR) Gorgons - 5 (Hold'em)
Seat 2 is the button
Seat 1: SenNoSen (107.29).
Seat 2: eu4ria (235.96).
Seat 3: IlxxxlI (20).
Seat 4: dscshift (29.94).
Seat 5: Hakuna_Matata777 (53.03).
Seat 6: wethco (53.28).
Player IlxxxlI has small blind (0.25)
Player dscshift has big blind (0.50)
Player IlxxxlI received card: [4d]
Player IlxxxlI received card: [Qc]
Player Hakuna_Matata777 folds
Player wethco folds
Player SenNoSen raises (1)
Player eu4ria folds
Player IlxxxlI folds
Player dscshift calls (0.50)
*** FLOP ***: [3h 10d 3s]
Player dscshift bets (2)
Player SenNoSen raises (6)
Player dscshift calls (4)
*** TURN ***: [3h 10d 3s] [8h]
Player dscshift checks
Player SenNoSen checks
*** RIVER ***: [3h 10d 3s 8h] [7c]
Player dscshift bets (2.50)
Player SenNoSen calls (2.50)
------ Summary ------
Pot: 18.29. Rake 0.72. JP fee 0.24
Board: [3h 10d 3s 8h 7c]
*Player SenNoSen shows: Two pairs. 8s and 3s [Ad 8d]. Bets: 9.50. Collects: 18.29. Wins: 8.79.
Player eu4ria does not show cards.Bets: 0. Collects: 0. Wins: 0.
Player IlxxxlI does not show cards.Bets: 0.25. Collects: 0. Loses: 0.25.
Player dscshift shows: One pair of 3s [6h Qh]. Bets: 9.50. Collects: 0. Loses: 9.50.
Player Hakuna_Matata777 does not show cards.Bets: 0. Collects: 0. Wins: 0.
Player wethco does not show cards.Bets: 0. Collects: 0. Wins: 0.
Game ended at: 2016/11/28 18:32:1

Game started
Game ID: 786351552 0.25/0.50 (PRR) Gorgons - 17 (Hold'em)
Seat 2 is the button
Seat 1: Smok5 Js (21.45).
Seat 2: SenNoSen (82.72).
Seat 3: Hakuna_Matata777 (63.50).
Seat 4: IlxxxlI (20.75).
Seat 5: BoTPuMHeDichBro (63.91).
Seat 6: eu4ria (84.06).
Player Hakuna_Matata777 has small blind (0.25)
Player IlxxxlI has big blind (0.50)
Player IlxxxlI received card: [8h]
Player IlxxxlI received card: [6h]
Player BoTPuMHeDichBro raises (1.50)
Player eu4ria folds
Player Smok5 Js folds
Player SenNoSen folds
Player Hakuna_Matata777 folds
Player IlxxxlI folds
Uncalled bet (1) returned to BoTPuMHeDichBro
Player BoTPuMHeDichBro mucks cards
------ Summary ------
Pot: 1.25. Rake 0
Player Smok5 Js does not show cards.Bets: 0. Collects: 0. Wins: 0.
Player SenNoSen does not show cards.Bets: 0. Collects: 0. Wins: 0.
Player Hakuna_Matata777 does not show cards.Bets: 0.25. Collects: 0. Loses: 0.25.
Player IlxxxlI does not show cards.Bets: 0.50. Collects: 0. Loses: 0.50.
*Player BoTPuMHeDichBro mucks (does not show cards). Bets: 0.50. Collects: 1.25. Wins: 0.75.
Player eu4ria does not show cards.Bets: 0. Collects: 0. Wins: 0.
Game ended at: 2016/11/28 18:30:33

Game started
Game ID: 786351520 0.25/0.50 (PRR) Gorgons - 5 (Hold'em)
Seat 1 is the button
Seat 1: SenNoSen (107.29).
Seat 2: eu4ria (236.21).
Seat 3: IlxxxlI (20).
Seat 4: dscshift (29.94).
Seat 5: Hakuna_Matata777 (52.28).
Seat 6: wethco (53.28).
Player eu4ria has small blind (0.25)
Player IlxxxlI has big blind (0.50)
Player IlxxxlI received card: [6c]
Player IlxxxlI received card: [2c]
Player dscshift folds
Player Hakuna_Matata777 raises (1)
Player wethco folds
Player SenNoSen folds
Player eu4ria folds
Player IlxxxlI folds
Uncalled bet (0.50) returned to Hakuna_Matata777
Player Hakuna_Matata777 mucks cards
------ Summary ------
Pot: 1.25. Rake 0
Player SenNoSen does not show cards.Bets: 0. Collects: 0. Wins: 0.
Player eu4ria does not show cards.Bets: 0.25. Collects: 0. Loses: 0.25.
Player IlxxxlI does not show cards.Bets: 0.50. Collects: 0. Loses: 0.50.
Player dscshift does not show cards.Bets: 0. Collects: 0. Wins: 0.
*Player Hakuna_Matata777 mucks (does not show cards). Bets: 0.50. Collects: 1.25. Wins: 0.75.
Player wethco does not show cards.Bets: 0. Collects: 0. Wins: 0.
Game ended at: 2016/11/28 18:30:29

Game started
Game ID: 786351319 0.25/0.50 (PRR) Gorgons - 5 (Hold'em)
Seat 6 is the button
Seat 1: SenNoSen (107.54).
Seat 2: eu4ria (234.07).
Seat 3: IlxxxlI (20).
Seat 4: dscshift (29.94).
Seat 5: Hakuna_Matata777 (52.28).
Seat 6: wethco (53.28).
Player SenNoSen has small blind (0.25)
Player eu4ria has big blind (0.50)
Player IlxxxlI received card: [5d]
Player IlxxxlI received card: [5s]
Player IlxxxlI raises (1)
Player dscshift folds
Player Hakuna_Matata777 folds
Player wethco folds
Player SenNoSen folds
Player eu4ria calls (0.50)
*** FLOP ***: [Jh As 9d]
Player eu4ria checks
Player IlxxxlI bets (1.11)
Player eu4ria calls (1.11)
*** TURN ***: [Jh As 9d] [2c]
Player eu4ria checks
Player IlxxxlI checks
*** RIVER ***: [Jh As 9d 2c] [10h]
Player eu4ria checks
Player IlxxxlI checks
Player IlxxxlI mucks cards
------ Summary ------
Pot: 4.25. Rake 0.16. JP fee 0.06
Board: [Jh As 9d 2c 10h]
Player SenNoSen does not show cards.Bets: 0.25. Collects: 0. Loses: 0.25.
*Player eu4ria shows: One pair of As [Ah Kc]. Bets: 2.11. Collects: 4.25. Wins: 2.14.
Player IlxxxlI mucks (does not show: [5d 5s]). Bets: 2.11. Collects: 0. Loses: 2.11.
Player dscshift does not show cards.Bets: 0. Collects: 0. Wins: 0.
Player Hakuna_Matata777 does not show cards.Bets: 0. Collects: 0. Wins: 0.
Player wethco does not show cards.Bets: 0. Collects: 0. Wins: 0.
Game ended at: 2016/11/28 18:29:55

Game started
Game ID: 786351279 0.25/0.50 (PRR) Gorgons - 17 (Hold'em)
Seat 1 is the button
Seat 1: Smok5 Js (21.95).
Seat 2: SenNoSen (82.97).
Seat 3: Hakuna_Matata777 (62.75).
Seat 4: IlxxxlI (20.75).
Seat 5: BoTPuMHeDichBro (63.91).
Seat 6: eu4ria (84.06).
Player SenNoSen has small blind (0.25)
Player Hakuna_Matata777 has big blind (0.50)
Player IlxxxlI received card: [Kd]
Player IlxxxlI received card: [Jc]
Player IlxxxlI folds
Player BoTPuMHeDichBro folds
Player eu4ria folds
Player Smok5 Js calls (0.50)
Player SenNoSen folds
Player Hakuna_Matata777 raises (1.50)
Player Smok5 Js folds
Uncalled bet (1.50) returned to Hakuna_Matata777
Player Hakuna_Matata777 mucks cards
------ Summary ------
Pot: 1.25. Rake 0
Player Smok5 Js does not show cards.Bets: 0.50. Collects: 0. Loses: 0.50.
Player SenNoSen does not show cards.Bets: 0.25. Collects: 0. Loses: 0.25.
*Player Hakuna_Matata777 mucks (does not show cards). Bets: 0.50. Collects: 1.25. Wins: 0.75.
Player IlxxxlI does not show cards.Bets: 0. Collects: 0. Wins: 0.
Player BoTPuMHeDichBro does not show cards.Bets: 0. Collects: 0. Wins: 0.
Player eu4ria does not show cards.Bets: 0. Collects: 0. Wins: 0.
Game ended at: 2016/11/28 18:30:10

Game started
Game ID: 786351192 0.25/0.50 (PRR) Gorgons - 17 (Hold'em)
Seat 6 is the button
Seat 1: Smok5 Js (22.20).
Seat 2: SenNoSen (83.47).
Seat 3: Hakuna_Matata777 (62.75).
Seat 4: IlxxxlI (20.75).
Seat 5: BoTPuMHeDichBro (63.16).
Seat 6: eu4ria (84.06).
Player Smok5 Js has small blind (0.25)
Player SenNoSen has big blind (0.50)
Player IlxxxlI received card: [10s]
Player IlxxxlI received card: [7s]
Player Hakuna_Matata777 folds
Player IlxxxlI folds
Player BoTPuMHeDichBro raises (1.50)
Player eu4ria folds
Player Smok5 Js folds
Player SenNoSen folds
Uncalled bet (1) returned to BoTPuMHeDichBro
Player BoTPuMHeDichBro mucks cards
------ Summary ------
Pot: 1.25. Rake 0
Player Smok5 Js does not show cards.Bets: 0.25. Collects: 0. Loses: 0.25.
Player SenNoSen does not show cards.Bets: 0.50. Collects: 0. Loses: 0.50.
Player Hakuna_Matata777 does not show cards.Bets: 0. Collects: 0. Wins: 0.
Player IlxxxlI does not show cards.Bets: 0. Collects: 0. Wins: 0.
*Player BoTPuMHeDichBro mucks (does not show cards). Bets: 0.50. Collects: 1.25. Wins: 0.75.
Player eu4ria does not show cards.Bets: 0. Collects: 0. Wins: 0.
Game ended at: 2016/11/28 18:28:45

Game started
Game ID: 786351115 0.25/0.50 (PRR) Gorgons - 17 (Hold'em)
Seat 5 is the button
Seat 1: Smok5 Js (22.70).
Seat 2: SenNoSen (83.47).
Seat 3: Hakuna_Matata777 (62.75).
Seat 4: IlxxxlI (20.75).
Seat 5: BoTPuMHeDichBro (63.16).
Seat 6: eu4ria (83.56).
Player eu4ria has small blind (0.25)
Player Smok5 Js has big blind (0.50)
Player IlxxxlI received card: [5s]
Player IlxxxlI received card: [Kc]
Player SenNoSen folds
Player Hakuna_Matata777 folds
Player IlxxxlI folds
Player BoTPuMHeDichBro folds
Player eu4ria raises (1.25)
Player Smok5 Js folds
Uncalled bet (1) returned to eu4ria
Player eu4ria mucks cards
------ Summary ------
Pot: 1. Rake 0
Player Smok5 Js does not show cards.Bets: 0.50. Collects: 0. Loses: 0.50.
Player SenNoSen does not show cards.Bets: 0. Collects: 0. Wins: 0.
Player Hakuna_Matata777 does not show cards.Bets: 0. Collects: 0. Wins: 0.
Player IlxxxlI does not show cards.Bets: 0. Collects: 0. Wins: 0.
Player BoTPuMHeDichBro does not show cards.Bets: 0. Collects: 0. Wins: 0.
*Player eu4ria mucks (does not show cards). Bets: 0.50. Collects: 1. Wins: 0.50.
Game ended at: 2016/11/28 18:28:20

Game started
Game ID: 786351114 0.25/0.50 (PRR) Gorgons - 5 (Hold'em)
Seat 5 is the button
Seat 1: SenNoSen (106.85).
Seat 2: eu4ria (234.07).
Seat 3: IlxxxlI (20).
Seat 4: dscshift (30.44).
Seat 5: Hakuna_Matata777 (52.28).
Seat 6: wethco (53.53).
Player wethco has small blind (0.25)
Player SenNoSen has big blind (0.50)
Player IlxxxlI received card: [10d]
Player IlxxxlI received card: [9c]
Player eu4ria folds
Player IlxxxlI folds
Player dscshift calls (0.50)
Player Hakuna_Matata777 folds
Player wethco folds
Player SenNoSen checks
*** FLOP ***: [9h Ac 3c]
Player SenNoSen checks
Player dscshift checks
*** TURN ***: [9h Ac 3c] [Kd]
Player SenNoSen checks
Player dscshift checks
*** RIVER ***: [9h Ac 3c Kd] [Qd]
Player SenNoSen bets (0.79)
Player dscshift folds
Uncalled bet (0.79) returned to SenNoSen
Player SenNoSen mucks cards
------ Summary ------
Pot: 1.19. Rake 0.04. JP fee 0.02
Board: [9h Ac 3c Kd Qd]
*Player SenNoSen mucks (does not show cards). Bets: 0.50. Collects: 1.19. Wins: 0.69.
Player eu4ria does not show cards.Bets: 0. Collects: 0. Wins: 0.
Player IlxxxlI does not show cards.Bets: 0. Collects: 0. Wins: 0.
Player dscshift does not show cards.Bets: 0.50. Collects: 0. Loses: 0.50.
Player Hakuna_Matata777 does not show cards.Bets: 0. Collects: 0. Wins: 0.
Player wethco does not show cards.Bets: 0.25. Collects: 0. Loses: 0.25.
Game ended at: 2016/11/28 18:28:55

Game started
Game ID: 786350940 0.25/0.50 (PRR) Gorgons - 17 (Hold'em)
Seat 4 is the button
Seat 1: Smok5 Js (22.70).
Seat 2: SenNoSen (83.47).
Seat 3: Hakuna_Matata777 (62.75).
Seat 4: IlxxxlI (20.75).
Seat 5: BoTPuMHeDichBro (62.26).
Seat 6: eu4ria (84.56).
Player BoTPuMHeDichBro has small blind (0.25)
Player eu4ria has big blind (0.50)
Player IlxxxlI received card: [9h]
Player IlxxxlI received card: [Kc]
Player Smok5 Js folds
Player SenNoSen folds
Player Hakuna_Matata777 folds
Player IlxxxlI folds
Player BoTPuMHeDichBro calls (0.25)
Player eu4ria checks
*** FLOP ***: [7c 10s Ad]
Player BoTPuMHeDichBro checks
Player eu4ria bets (0.50)
Player BoTPuMHeDichBro raises (2)
Player eu4ria folds
Uncalled bet (1.50) returned to BoTPuMHeDichBro
Player BoTPuMHeDichBro mucks cards
------ Summary ------
Pot: 1.90. Rake 0.08. JP fee 0.02
Board: [7c 10s Ad]
Player Smok5 Js does not show cards.Bets: 0. Collects: 0. Wins: 0.
Player SenNoSen does not show cards.Bets: 0. Collects: 0. Wins: 0.
Player Hakuna_Matata777 does not show cards.Bets: 0. Collects: 0. Wins: 0.
Player IlxxxlI does not show cards.Bets: 0. Collects: 0. Wins: 0.
*Player BoTPuMHeDichBro mucks (does not show cards). Bets: 1. Collects: 1.90. Wins: 0.90.
Player eu4ria does not show cards.Bets: 1. Collects: 0. Loses: 1.
Game ended at: 2016/11/28 18:27:56

Game started
Game ID: 786350925 0.25/0.50 (PRR) Gorgons - 5 (Hold'em)
Seat 4 is the button
Seat 1: SenNoSen (106.85).
Seat 2: eu4ria (234.07).
Seat 3: IlxxxlI (20).
Seat 4: dscshift (32.44).
Seat 5: Hakuna_Matata777 (50).
Seat 6: wethco (54.03).
Player Hakuna_Matata777 has small blind (0.25)
Player wethco has big blind (0.50)
Player IlxxxlI received card: [4s]
Player IlxxxlI received card: [Jd]
Player SenNoSen folds
Player eu4ria folds
Player IlxxxlI folds
Player dscshift calls (0.50)
Player Hakuna_Matata777 raises (1.75)
Player wethco folds
Player dscshift calls (1.50)
*** FLOP ***: [5h 4h 5s]
Player Hakuna_Matata777 bets (2.50)
Player dscshift folds
Uncalled bet (2.50) returned to Hakuna_Matata777
Player Hakuna_Matata777 mucks cards
------ Summary ------
Pot: 4.28. Rake 0.16. JP fee 0.06
Board: [5h 4h 5s]
Player SenNoSen does not show cards.Bets: 0. Collects: 0. Wins: 0.
Player eu4ria does not show cards.Bets: 0. Collects: 0. Wins: 0.
Player IlxxxlI does not show cards.Bets: 0. Collects: 0. Wins: 0.
Player dscshift does not show cards.Bets: 2. Collects: 0. Loses: 2.
*Player Hakuna_Matata777 mucks (does not show cards). Bets: 2. Collects: 4.28. Wins: 2.28.
Player wethco does not show cards.Bets: 0.50. Collects: 0. Loses: 0.50.
Game ended at: 2016/11/28 18:27:56

Game started
Game ID: 786350913 0.25/0.50 (PRR) Gorgons - 2 (Hold'em)
Seat 4 is the button
Seat 1: Hakuna_Matata777 (71.22).
Seat 2: SenNoSen (93.35).
Seat 4: eu4ria (211.39).
Seat 5: BoTPuMHeDichBro (57.69).
Seat 6: IlxxxlI (20).
Player BoTPuMHeDichBro has small blind (0.25)
Player IlxxxlI has big blind (0.50)
Player IlxxxlI received card: [2c]
Player IlxxxlI received card: [5c]
Player Hakuna_Matata777 folds
Player SenNoSen folds
Player eu4ria raises (1.25)
Player BoTPuMHeDichBro folds
Player IlxxxlI calls (0.75)
*** FLOP ***: [2h 10d Kc]
Player IlxxxlI checks
Player eu4ria bets (1.50)
Player IlxxxlI calls (1.50)
*** TURN ***: [2h 10d Kc] [8h]
Player IlxxxlI bets (1.50)
Player eu4ria folds
Uncalled bet (1.50) returned to IlxxxlI
Player IlxxxlI mucks cards
------ Summary ------
Pot: 5.47. Rake 0.20. JP fee 0.08
Board: [2h 10d Kc 8h]
Player Hakuna_Matata777 does not show cards.Bets: 0. Collects: 0. Wins: 0.
Player SenNoSen does not show cards.Bets: 0. Collects: 0. Wins: 0.
Player eu4ria does not show cards.Bets: 2.75. Collects: 0. Loses: 2.75.
Player BoTPuMHeDichBro does not show cards.Bets: 0.25. Collects: 0. Loses: 0.25.
*Player IlxxxlI mucks (does not show cards). Bets: 2.75. Collects: 5.47. Wins: 2.72.
Game ended at: 2016/11/28 18:28:8

Game started
Game ID: 786350818 0.25/0.50 (PRR) Gorgons - 17 (Hold'em)
Seat 3 is the button
Seat 1: Smok5 Js (22.70).
Seat 2: SenNoSen (83.47).
Seat 3: Hakuna_Matata777 (62.75).
Seat 4: IlxxxlI (21).
Seat 5: BoTPuMHeDichBro (62.76).
Seat 6: eu4ria (83.81).
Player IlxxxlI has small blind (0.25)
Player BoTPuMHeDichBro has big blind (0.50)
Player IlxxxlI received card: [2c]
Player IlxxxlI received card: [5h]
Player eu4ria raises (1.50)
Player Smok5 Js folds
Player SenNoSen folds
Player Hakuna_Matata777 folds
Player IlxxxlI folds
Player BoTPuMHeDichBro folds
Uncalled bet (1) returned to eu4ria
Player eu4ria mucks cards
------ Summary ------
Pot: 1.25. Rake 0
Player Smok5 Js does not show cards.Bets: 0. Collects: 0. Wins: 0.
Player SenNoSen does not show cards.Bets: 0. Collects: 0. Wins: 0.
Player Hakuna_Matata777 does not show cards.Bets: 0. Collects: 0. Wins: 0.
Player IlxxxlI does not show cards.Bets: 0.25. Collects: 0. Loses: 0.25.
Player BoTPuMHeDichBro does not show cards.Bets: 0.50. Collects: 0. Loses: 0.50.
*Player eu4ria mucks (does not show cards). Bets: 0.50. Collects: 1.25. Wins: 0.75.
Game ended at: 2016/11/28 18:27:4

Game started
Game ID: 786350754 0.25/0.50 (PRR) Gorgons - 17 (Hold'em)
Seat 2 is the button
Seat 1: Smok5 Js (22.70).
Seat 2: SenNoSen (83.47).
Seat 3: Hakuna_Matata777 (63).
Seat 4: IlxxxlI (20.75).
Seat 5: BoTPuMHeDichBro (62.76).
Seat 6: eu4ria (83.81).
Player Hakuna_Matata777 has small blind (0.25)
Player IlxxxlI has big blind (0.50)
Player IlxxxlI received card: [7d]
Player IlxxxlI received card: [7h]
Player BoTPuMHeDichBro folds
Player eu4ria folds
Player Smok5 Js folds
Player SenNoSen folds
Player Hakuna_Matata777 folds
Uncalled bet (0.25) returned to IlxxxlI
Player IlxxxlI mucks cards
------ Summary ------
Pot: 0.50. Rake 0
Player Smok5 Js does not show cards.Bets: 0. Collects: 0. Wins: 0.
Player SenNoSen does not show cards.Bets: 0. Collects: 0. Wins: 0.
Player Hakuna_Matata777 does not show cards.Bets: 0.25. Collects: 0. Loses: 0.25.
*Player IlxxxlI mucks (does not show cards). Bets: 0.25. Collects: 0.50. Wins: 0.25.
Player BoTPuMHeDichBro does not show cards.Bets: 0. Collects: 0. Wins: 0.
Player eu4ria does not show cards.Bets: 0. Collects: 0. Wins: 0.
Game ended at: 2016/11/28 18:26:26

Game started
Game ID: 786350684 0.25/0.50 (PRR) Gorgons - 17 (Hold'em)
Seat 1 is the button
Seat 1: Smok5 Js (22.70).
Seat 2: SenNoSen (83.72).
Seat 3: Hakuna_Matata777 (63.50).
Seat 4: IlxxxlI (20.75).
Seat 5: BoTPuMHeDichBro (62.76).
Seat 6: eu4ria (83.06).
Player SenNoSen has small blind (0.25)
Player Hakuna_Matata777 has big blind (0.50)
Player IlxxxlI received card: [10c]
Player IlxxxlI received card: [9h]
Player IlxxxlI folds
Player BoTPuMHeDichBro folds
Player eu4ria raises (1.50)
Player Smok5 Js folds
Player SenNoSen folds
Player Hakuna_Matata777 folds
Uncalled bet (1) returned to eu4ria
Player eu4ria mucks cards
------ Summary ------
Pot: 1.25. Rake 0
Player Smok5 Js does not show cards.Bets: 0. Collects: 0. Wins: 0.
Player SenNoSen does not show cards.Bets: 0.25. Collects: 0. Loses: 0.25.
Player Hakuna_Matata777 does not show cards.Bets: 0.50. Collects: 0. Loses: 0.50.
Player IlxxxlI does not show cards.Bets: 0. Collects: 0. Wins: 0.
Player BoTPuMHeDichBro does not show cards.Bets: 0. Collects: 0. Wins: 0.
*Player eu4ria mucks (does not show cards). Bets: 0.50. Collects: 1.25. Wins: 0.75.
Game ended at: 2016/11/28 18:26:6

Game started
Game ID: 786350669 0.25/0.50 (PRR) Gorgons - 5 (Hold'em)
Seat 3 is the button
Seat 1: SenNoSen (106.85).
Seat 2: eu4ria (234.07).
Seat 3: IlxxxlI (20.67).
Seat 4: dscshift (32.69).
Seat 5: Hakuna_Matata777 (50).
Seat 6: wethco (49.99).
Player dscshift has small blind (0.25)
Player Hakuna_Matata777 has big blind (0.50)
Player IlxxxlI received card: [Ac]
Player IlxxxlI received card: [7c]
Player wethco calls (0.50)
Player SenNoSen folds
Player eu4ria folds
Player IlxxxlI raises (1.50)
Player dscshift folds
Player Hakuna_Matata777 folds
Player wethco calls (1)
*** FLOP ***: [3c 9h 8d]
Player wethco checks
Player IlxxxlI bets (1.19)
Player wethco calls (1.19)
*** TURN ***: [3c 9h 8d] [9d]
Player wethco checks
Player IlxxxlI checks
*** RIVER ***: [3c 9h 8d 9d] [Ah]
Player wethco checks
Player IlxxxlI bets (1)
Player wethco calls (1)
------ Summary ------
Pot: 7.73. Rake 0.28. JP fee 0.12
Board: [3c 9h 8d 9d Ah]
Player SenNoSen does not show cards.Bets: 0. Collects: 0. Wins: 0.
Player eu4ria does not show cards.Bets: 0. Collects: 0. Wins: 0.
Player IlxxxlI shows: Two pairs. As and 9s [Ac 7c]. Bets: 3.69. Collects: 0. Loses: 3.69.
Player dscshift does not show cards.Bets: 0.25. Collects: 0. Loses: 0.25.
Player Hakuna_Matata777 does not show cards.Bets: 0.50. Collects: 0. Loses: 0.50.
*Player wethco shows: Two pairs. As and 9s (kicker Q) [Qh Ad]. Bets: 3.69. Collects: 7.73. Wins: 4.04.
Game ended at: 2016/11/28 18:26:58

Game started
Game ID: 786350602 0.25/0.50 (PRR) Gorgons - 17 (Hold'em)
Seat 6 is the button
Seat 1: Smok5 Js (22.95).
Seat 2: SenNoSen (84.22).
Seat 4: IlxxxlI (20.75).
Seat 5: BoTPuMHeDichBro (62.01).
Seat 6: eu4ria (83.06).
Player Smok5 Js has small blind (0.25)
Player SenNoSen has big blind (0.50)
Player IlxxxlI received card: [5s]
Player IlxxxlI received card: [10h]
Player IlxxxlI folds
Player BoTPuMHeDichBro raises (1.50)
Player eu4ria folds
Player Smok5 Js folds
Player SenNoSen folds
Uncalled bet (1) returned to BoTPuMHeDichBro
Player BoTPuMHeDichBro mucks cards
------ Summary ------
Pot: 1.25. Rake 0
Player Smok5 Js does not show cards.Bets: 0.25. Collects: 0. Loses: 0.25.
Player SenNoSen does not show cards.Bets: 0.50. Collects: 0. Loses: 0.50.
Player IlxxxlI does not show cards.Bets: 0. Collects: 0. Wins: 0.
*Player BoTPuMHeDichBro mucks (does not show cards). Bets: 0.50. Collects: 1.25. Wins: 0.75.
Player eu4ria does not show cards.Bets: 0. Collects: 0. Wins: 0.
Game ended at: 2016/11/28 18:25:45

Game started
Game ID: 786350535 0.25/0.50 (PRR) Gorgons - 17 (Hold'em)
Seat 5 is the button
Seat 1: Smok5 Js (22.70).
Seat 2: SenNoSen (84.22).
Seat 4: IlxxxlI (20.75).
Seat 5: BoTPuMHeDichBro (62.01).
Seat 6: eu4ria (83.31).
Player eu4ria has small blind (0.25)
Player Smok5 Js has big blind (0.50)
Player IlxxxlI received card: [6s]
Player IlxxxlI received card: [7s]
Player SenNoSen folds
Player IlxxxlI folds
Player BoTPuMHeDichBro folds
Player eu4ria folds
Uncalled bet (0.25) returned to Smok5 Js
Player Smok5 Js is timed out.
Player Smok5 Js mucks cards
------ Summary ------
Pot: 0.50. Rake 0
*Player Smok5 Js mucks (does not show cards). Bets: 0.25. Collects: 0.50. Wins: 0.25.
Player SenNoSen does not show cards.Bets: 0. Collects: 0. Wins: 0.
Player IlxxxlI does not show cards.Bets: 0. Collects: 0. Wins: 0.
Player BoTPuMHeDichBro does not show cards.Bets: 0. Collects: 0. Wins: 0.
Player eu4ria does not show cards.Bets: 0.25. Collects: 0. Loses: 0.25.
Game ended at: 2016/11/28 18:25:22

Game started
Game ID: 786350448 0.25/0.50 (PRR) Gorgons - 17 (Hold'em)
Seat 4 is the button
Seat 1: Smok5 Js (22.70).
Seat 2: SenNoSen (84.22).
Seat 4: IlxxxlI (20).
Seat 5: BoTPuMHeDichBro (62.26).
Seat 6: eu4ria (83.81).
Player BoTPuMHeDichBro has small blind (0.25)
Player eu4ria has big blind (0.50)
Player IlxxxlI received card: [As]
Player IlxxxlI received card: [Qd]
Player Smok5 Js folds
Player SenNoSen folds
Player IlxxxlI raises (1.50)
Player BoTPuMHeDichBro folds
Player eu4ria folds
Uncalled bet (1) returned to IlxxxlI
Player IlxxxlI mucks cards
------ Summary ------
Pot: 1.25. Rake 0
Player Smok5 Js does not show cards.Bets: 0. Collects: 0. Wins: 0.
Player SenNoSen does not show cards.Bets: 0. Collects: 0. Wins: 0.
*Player IlxxxlI mucks (does not show cards). Bets: 0.50. Collects: 1.25. Wins: 0.75.
Player BoTPuMHeDichBro does not show cards.Bets: 0.25. Collects: 0. Loses: 0.25.
Player eu4ria does not show cards.Bets: 0.50. Collects: 0. Loses: 0.50.
Game ended at: 2016/11/28 18:25:1

Game started
Game ID: 786350432 0.25/0.50 (PRR) Gorgons - 5 (Hold'em)
Seat 2 is the button
Seat 1: SenNoSen (109.43).
Seat 2: eu4ria (234.07).
Seat 3: IlxxxlI (23.25).
Seat 4: dscshift (27.91).
Seat 6: wethco (49.99).
Player IlxxxlI has small blind (0.25)
Player dscshift has big blind (0.50)
Player IlxxxlI received card: [9s]
Player IlxxxlI received card: [Qs]
Player wethco folds
Player SenNoSen raises (1)
Player eu4ria folds
Player IlxxxlI raises (2.33)
Player dscshift calls (2.08)
Player SenNoSen calls (1.58)
*** FLOP ***: [5s Kd 2h]
Player IlxxxlI checks
Player dscshift bets (2.50)
Player SenNoSen folds
Player IlxxxlI folds
Uncalled bet (2.50) returned to dscshift
Player dscshift mucks cards
------ Summary ------
Pot: 7.36. Rake 0.26. JP fee 0.12
Board: [5s Kd 2h]
Player SenNoSen does not show cards.Bets: 2.58. Collects: 0. Loses: 2.58.
Player eu4ria does not show cards.Bets: 0. Collects: 0. Wins: 0.
Player IlxxxlI does not show cards.Bets: 2.58. Collects: 0. Loses: 2.58.
*Player dscshift mucks (does not show cards). Bets: 2.58. Collects: 7.36. Wins: 4.78.
Player wethco does not show cards.Bets: 0. Collects: 0. Wins: 0.
Game ended at: 2016/11/28 18:25:38

Game started
Game ID: 786350263 0.25/0.50 (PRR) Gorgons - 5 (Hold'em)
Seat 1 is the button
Seat 1: SenNoSen (109.43).
Seat 2: eu4ria (234.32).
Seat 3: IlxxxlI (23.75).
Seat 4: dscshift (27.22).
Seat 6: wethco (49.99).
Player eu4ria has small blind (0.25)
Player IlxxxlI has big blind (0.50)
Player IlxxxlI received card: [Qs]
Player IlxxxlI received card: [9c]
Player dscshift calls (0.50)
Player wethco folds
Player SenNoSen folds
Player eu4ria folds
Player IlxxxlI checks
*** FLOP ***: [2h 4c 2s]
Player IlxxxlI checks
Player dscshift checks
*** TURN ***: [2h 4c 2s] [Ks]
Player IlxxxlI checks
Player dscshift bets (0.50)
Player IlxxxlI folds
Uncalled bet (0.50) returned to dscshift
Player dscshift mucks cards
------ Summary ------
Pot: 1.19. Rake 0.04. JP fee 0.02
Board: [2h 4c 2s Ks]
Player SenNoSen does not show cards.Bets: 0. Collects: 0. Wins: 0.
Player eu4ria does not show cards.Bets: 0.25. Collects: 0. Loses: 0.25.
Player IlxxxlI does not show cards.Bets: 0.50. Collects: 0. Loses: 0.50.
*Player dscshift mucks (does not show cards). Bets: 0.50. Collects: 1.19. Wins: 0.69.
Player wethco does not show cards.Bets: 0. Collects: 0. Wins: 0.
Game ended at: 2016/11/28 18:24:31

Game started
Game ID: 786350221 0.25/0.50 (PRR) Gorgons - 17 (Hold'em)
Seat 2 is the button
Seat 1: Smok5 Js (23.20).
Seat 2: SenNoSen (84.22).
Seat 4: IlxxxlI (20).
Seat 5: BoTPuMHeDichBro (61.57).
Seat 6: eu4ria (83.81).
Player IlxxxlI has small blind (0.25)
Player BoTPuMHeDichBro has big blind (0.50)
Player IlxxxlI received card: [4h]
Player IlxxxlI received card: [6d]
Player eu4ria folds
Player Smok5 Js calls (0.50)
Player SenNoSen folds
Player IlxxxlI folds
Player BoTPuMHeDichBro checks
*** FLOP ***: [Qc 6s Ks]
Player BoTPuMHeDichBro checks
Player Smok5 Js checks
*** TURN ***: [Qc 6s Ks] [10s]
Player BoTPuMHeDichBro bets (0.79)
Player Smok5 Js folds
Uncalled bet (0.79) returned to BoTPuMHeDichBro
Player BoTPuMHeDichBro mucks cards
------ Summary ------
Pot: 1.19. Rake 0.04. JP fee 0.02
Board: [Qc 6s Ks 10s]
Player Smok5 Js does not show cards.Bets: 0.50. Collects: 0. Loses: 0.50.
Player SenNoSen does not show cards.Bets: 0. Collects: 0. Wins: 0.
Player IlxxxlI does not show cards.Bets: 0.25. Collects: 0. Loses: 0.25.
*Player BoTPuMHeDichBro mucks (does not show cards). Bets: 0.50. Collects: 1.19. Wins: 0.69.
Player eu4ria does not show cards.Bets: 0. Collects: 0. Wins: 0.
Game ended at: 2016/11/28 18:24:36

Game started
Game ID: 786350106 0.25/0.50 (PRR) Gorgons - 5 (Hold'em)
Seat 6 is the button
Seat 1: SenNoSen (109.68).
Seat 2: eu4ria (234.82).
Seat 3: IlxxxlI (23.75).
Seat 4: dscshift (25.60).
Seat 6: wethco (50.99).
Player SenNoSen has small blind (0.25)
Player eu4ria has big blind (0.50)
Player IlxxxlI received card: [Qc]
Player IlxxxlI received card: [7h]
Player IlxxxlI folds
Player dscshift raises (1)
Player wethco calls (1)
Player SenNoSen folds
Player eu4ria folds
*** FLOP ***: [5d 10h 4c]
Player dscshift checks
Player wethco checks
*** TURN ***: [5d 10h 4c] [6s]
Player dscshift bets (2)
Player wethco folds
Uncalled bet (2) returned to dscshift
Player dscshift mucks cards
------ Summary ------
Pot: 2.62. Rake 0.09. JP fee 0.04
Board: [5d 10h 4c 6s]
Player SenNoSen does not show cards.Bets: 0.25. Collects: 0. Loses: 0.25.
Player eu4ria does not show cards.Bets: 0.50. Collects: 0. Loses: 0.50.
Player IlxxxlI does not show cards.Bets: 0. Collects: 0. Wins: 0.
*Player dscshift mucks (does not show cards). Bets: 1. Collects: 2.62. Wins: 1.62.
Player wethco does not show cards.Bets: 1. Collects: 0. Loses: 1.
Game ended at: 2016/11/28 18:23:43

Game started
Game ID: 786349972 0.25/0.50 (PRR) Gorgons - 5 (Hold'em)
Seat 4 is the button
Seat 1: SenNoSen (110.18).
Seat 2: eu4ria (234.82).
Seat 3: IlxxxlI (23.75).
Seat 4: dscshift (24.91).
Seat 6: wethco (51.24).
Player wethco has small blind (0.25)
Player SenNoSen has big blind (0.50)
Player IlxxxlI received card: [Js]
Player IlxxxlI received card: [7h]
Player eu4ria folds
Player IlxxxlI folds
Player dscshift calls (0.50)
Player wethco folds
Player SenNoSen checks
*** FLOP ***: [9h Qh Qd]
Player SenNoSen checks
Player dscshift checks
*** TURN ***: [9h Qh Qd] [7s]
Player SenNoSen checks
Player dscshift checks
*** RIVER ***: [9h Qh Qd 7s] [4s]
Player SenNoSen checks
Player dscshift checks
Player SenNoSen mucks cards
------ Summary ------
Pot: 1.19. Rake 0.04. JP fee 0.02
Board: [9h Qh Qd 7s 4s]
Player SenNoSen mucks (does not show cards). Bets: 0.50. Collects: 0. Loses: 0.50.
Player eu4ria does not show cards.Bets: 0. Collects: 0. Wins: 0.
Player IlxxxlI does not show cards.Bets: 0. Collects: 0. Wins: 0.
*Player dscshift shows: One pair of Qs [Jh 6c]. Bets: 0.50. Collects: 1.19. Wins: 0.69.
Player wethco does not show cards.Bets: 0.25. Collects: 0. Loses: 0.25.
Game ended at: 2016/11/28 18:22:55

Game started
Game ID: 786349919 0.25/0.50 (PRR) Gorgons - 17 (Hold'em)
Seat 1 is the button
Seat 1: Smok5 Js (20.83).
Seat 2: SenNoSen (84.47).
Seat 3: pokanaktus (50).
Seat 4: IlxxxlI (20).
Seat 5: BoTPuMHeDichBro (61.57).
Seat 6: eu4ria (83.81).
Player SenNoSen has small blind (0.25)
Player pokanaktus sitting out
Player IlxxxlI has big blind (0.50)
Player IlxxxlI received card: [Jd]
Player IlxxxlI received card: [Qh]
Player BoTPuMHeDichBro folds
Player eu4ria folds
Player Smok5 Js calls (0.50)
Player SenNoSen folds
Player IlxxxlI checks
*** FLOP ***: [9d 10d Kd]
Player IlxxxlI checks
Player Smok5 Js checks
*** TURN ***: [9d 10d Kd] [6d]
Player IlxxxlI bets (0.65)
Player Smok5 Js calls (0.65)
*** RIVER ***: [9d 10d Kd 6d] [Jh]
Player IlxxxlI bets (1.21)
Player Smok5 Js raises (6.05)
Player IlxxxlI folds
Uncalled bet (4.84) returned to Smok5 Js
Player Smok5 Js is timed out.
Player Smok5 Js mucks cards
------ Summary ------
Pot: 4.73. Rake 0.16. JP fee 0.08
Board: [9d 10d Kd 6d Jh]
*Player Smok5 Js mucks (does not show cards). Bets: 2.36. Collects: 4.73. Wins: 2.37.
Player SenNoSen does not show cards.Bets: 0.25. Collects: 0. Loses: 0.25.
Player pokanaktus does not show cards.Bets: 0. Collects: 0. Wins: 0.
Player IlxxxlI does not show cards.Bets: 2.36. Collects: 0. Loses: 2.36.
Player BoTPuMHeDichBro does not show cards.Bets: 0. Collects: 0. Wins: 0.
Player eu4ria does not show cards.Bets: 0. Collects: 0. Wins: 0.
Game ended at: 2016/11/28 18:23:33

Game started
Game ID: 786349898 0.25/0.50 (PRR) Gorgons - 5 (Hold'em)
Seat 3 is the button
Seat 1: SenNoSen (110.18).
Seat 2: eu4ria (234.07).
Seat 3: IlxxxlI (23.75).
Seat 4: dscshift (25.16).
Seat 5: pokanaktus (54.52).
Seat 6: wethco (51.74).
Player dscshift has small blind (0.25)
Player pokanaktus sitting out
Player wethco has big blind (0.50)
Player IlxxxlI received card: [4d]
Player IlxxxlI received card: [Qs]
Player SenNoSen folds
Player eu4ria raises (1.50)
Player IlxxxlI folds
Player dscshift folds
Player wethco folds
Uncalled bet (1) returned to eu4ria
Player eu4ria mucks cards
------ Summary ------
Pot: 1.25. Rake 0
Player SenNoSen does not show cards.Bets: 0. Collects: 0. Wins: 0.
*Player eu4ria mucks (does not show cards). Bets: 0.50. Collects: 1.25. Wins: 0.75.
Player IlxxxlI does not show cards.Bets: 0. Collects: 0. Wins: 0.
Player dscshift does not show cards.Bets: 0.25. Collects: 0. Loses: 0.25.
Player pokanaktus does not show cards.Bets: 0. Collects: 0. Wins: 0.
Player wethco does not show cards.Bets: 0.50. Collects: 0. Loses: 0.50.
Game ended at: 2016/11/28 18:22:13

Game started
Game ID: 786349847 0.25/0.50 (PRR) Gorgons - 17 (Hold'em)
Seat 6 is the button
Seat 1: Smok5 Js (21.08).
Seat 2: SenNoSen (84.97).
Seat 3: pokanaktus (50).
Seat 4: IlxxxlI (20).
Seat 5: BoTPuMHeDichBro (60.82).
Seat 6: eu4ria (83.81).
Player Smok5 Js has small blind (0.25)
Player SenNoSen has big blind (0.50)
Player IlxxxlI received card: [6s]
Player IlxxxlI received card: [8d]
Player pokanaktus folds
Player IlxxxlI folds
Player BoTPuMHeDichBro raises (1.50)
Player eu4ria folds
Player Smok5 Js folds
Player SenNoSen folds
Uncalled bet (1) returned to BoTPuMHeDichBro
Player BoTPuMHeDichBro mucks cards
------ Summary ------
Pot: 1.25. Rake 0
Player Smok5 Js does not show cards.Bets: 0.25. Collects: 0. Loses: 0.25.
Player SenNoSen does not show cards.Bets: 0.50. Collects: 0. Loses: 0.50.
Player pokanaktus does not show cards.Bets: 0. Collects: 0. Wins: 0.
Player IlxxxlI does not show cards.Bets: 0. Collects: 0. Wins: 0.
*Player BoTPuMHeDichBro mucks (does not show cards). Bets: 0.50. Collects: 1.25. Wins: 0.75.
Player eu4ria does not show cards.Bets: 0. Collects: 0. Wins: 0.
Game ended at: 2016/11/28 18:21:56

Game started
Game ID: 786349647 0.25/0.50 (PRR) Gorgons - 17 (Hold'em)
Seat 5 is the button
Seat 1: Smok5 Js (22.58).
Seat 2: SenNoSen (84.97).
Seat 3: pokanaktus (50).
Seat 4: IlxxxlI (20).
Seat 5: BoTPuMHeDichBro (59.23).
Seat 6: eu4ria (84.06).
Player eu4ria has small blind (0.25)
Player Smok5 Js has big blind (0.50)
Player IlxxxlI received card: [8c]
Player IlxxxlI received card: [10h]
Player SenNoSen folds
Player pokanaktus folds
Player IlxxxlI folds
Player BoTPuMHeDichBro raises (1.50)
Player eu4ria folds
Player Smok5 Js calls (1)
*** FLOP ***: [4h 2d As]
Player Smok5 Js checks
Player BoTPuMHeDichBro bets (1.54)
Player Smok5 Js folds
Uncalled bet (1.54) returned to BoTPuMHeDichBro
Player BoTPuMHeDichBro mucks cards
------ Summary ------
Pot: 3.09. Rake 0.12. JP fee 0.04
Board: [4h 2d As]
Player Smok5 Js does not show cards.Bets: 1.50. Collects: 0. Loses: 1.50.
Player SenNoSen does not show cards.Bets: 0. Collects: 0. Wins: 0.
Player pokanaktus does not show cards.Bets: 0. Collects: 0. Wins: 0.
Player IlxxxlI does not show cards.Bets: 0. Collects: 0. Wins: 0.
*Player BoTPuMHeDichBro mucks (does not show cards). Bets: 1.50. Collects: 3.09. Wins: 1.59.
Player eu4ria does not show cards.Bets: 0.25. Collects: 0. Loses: 0.25.
Game ended at: 2016/11/28 18:21:32

Game started
Game ID: 786349646 0.25/0.50 (PRR) Gorgons - 5 (Hold'em)
Seat 2 is the button
Seat 1: SenNoSen (107.21).
Seat 2: eu4ria (234.07).
Seat 3: IlxxxlI (24).
Seat 4: dscshift (25.66).
Seat 5: pokanaktus (54.52).
Seat 6: wethco (54.24).
Player IlxxxlI has small blind (0.25)
Player dscshift has big blind (0.50)
Player IlxxxlI received card: [4s]
Player IlxxxlI received card: [6c]
Player pokanaktus folds
Player wethco calls (0.50)
Player SenNoSen raises (2.50)
Player eu4ria folds
Player IlxxxlI folds
Player dscshift folds
Player wethco calls (2)
*** FLOP ***: [4d 3s 5d]
Player wethco checks
Player SenNoSen bets (1.82)
Player wethco folds
Uncalled bet (1.82) returned to SenNoSen
Player SenNoSen mucks cards
------ Summary ------
Pot: 5.47. Rake 0.20. JP fee 0.08
Board: [4d 3s 5d]
*Player SenNoSen mucks (does not show cards). Bets: 2.50. Collects: 5.47. Wins: 2.97.
Player eu4ria does not show cards.Bets: 0. Collects: 0. Wins: 0.
Player IlxxxlI does not show cards.Bets: 0.25. Collects: 0. Loses: 0.25.
Player dscshift does not show cards.Bets: 0.50. Collects: 0. Loses: 0.50.
Player pokanaktus does not show cards.Bets: 0. Collects: 0. Wins: 0.
Player wethco does not show cards.Bets: 2.50. Collects: 0. Loses: 2.50.
Game ended at: 2016/11/28 18:21:50

Game started
Game ID: 786349529 0.25/0.50 (PRR) Gorgons - 17 (Hold'em)
Seat 4 is the button
Seat 1: Smok5 Js (22.58).
Seat 2: SenNoSen (84.97).
Seat 3: pokanaktus (50).
Seat 4: IlxxxlI (20).
Seat 5: BoTPuMHeDichBro (59.48).
Seat 6: eu4ria (83.81).
Player BoTPuMHeDichBro has small blind (0.25)
Player eu4ria has big blind (0.50)
Player IlxxxlI received card: [10h]
Player IlxxxlI received card: [7s]
Player Smok5 Js folds
Player SenNoSen folds
Player pokanaktus folds
Player IlxxxlI folds
Player BoTPuMHeDichBro folds
Uncalled bet (0.25) returned to eu4ria
Player eu4ria mucks cards
------ Summary ------
Pot: 0.50. Rake 0
Player Smok5 Js does not show cards.Bets: 0. Collects: 0. Wins: 0.
Player SenNoSen does not show cards.Bets: 0. Collects: 0. Wins: 0.
Player pokanaktus does not show cards.Bets: 0. Collects: 0. Wins: 0.
Player IlxxxlI does not show cards.Bets: 0. Collects: 0. Wins: 0.
Player BoTPuMHeDichBro does not show cards.Bets: 0.25. Collects: 0. Loses: 0.25.
*Player eu4ria mucks (does not show cards). Bets: 0.25. Collects: 0.50. Wins: 0.25.
Game ended at: 2016/11/28 18:20:30

Game started
Game ID: 786349509 0.25/0.50 (PRR) Garuda - 3 (Hold'em)
Seat 1 is the button
Seat 1: Hakuna_Matata777 (92.67).
Seat 2: in_ur_i (48).
Seat 3: Ms.stone (41.04).
Seat 4: smellskindyfishy (17).
Seat 5: IlxxxlI (59.50).
Seat 6: NoizeyCrckt (49.08).
Seat 7: 1jackoff1 (128.40).
Seat 8: haroldbb (86.46).
Seat 9: rpportugal (8.34).
Player in_ur_i has small blind (0.25)
Player Ms.stone has big blind (0.50)
Player IlxxxlI received card: [8s]
Player IlxxxlI received card: [5h]
Player smellskindyfishy raises (2)
Player IlxxxlI folds
Player NoizeyCrckt folds
Player 1jackoff1 calls (2)
Player haroldbb folds
Player rpportugal folds
Player Hakuna_Matata777 folds
Player in_ur_i folds
Player Ms.stone folds
*** FLOP ***: [3c 7d 4d]
Player smellskindyfishy bets (1.50)
Player 1jackoff1 calls (1.50)
*** TURN ***: [3c 7d 4d] [Qd]
Player smellskindyfishy bets (2.50)
Player 1jackoff1 raises (5)
Player smellskindyfishy calls (2.50)
*** RIVER ***: [3c 7d 4d Qd] [10h]
Player smellskindyfishy checks
Player 1jackoff1 bets (5)
Player smellskindyfishy folds
Uncalled bet (5) returned to 1jackoff1
Player 1jackoff1 mucks cards
------ Summary ------
Pot: 16.87. Rake 0.64. JP fee 0.24
Board: [3c 7d 4d Qd 10h]
Player Hakuna_Matata777 does not show cards.Bets: 0. Collects: 0. Wins: 0.
Player in_ur_i does not show cards.Bets: 0.25. Collects: 0. Loses: 0.25.
Player Ms.stone does not show cards.Bets: 0.50. Collects: 0. Loses: 0.50.
Player smellskindyfishy does not show cards.Bets: 8.50. Collects: 0. Loses: 8.50.
Player IlxxxlI does not show cards.Bets: 0. Collects: 0. Wins: 0.
Player NoizeyCrckt does not show cards.Bets: 0. Collects: 0. Wins: 0.
*Player 1jackoff1 mucks (does not show cards). Bets: 8.50. Collects: 16.87. Wins: 8.37.
Player haroldbb does not show cards.Bets: 0. Collects: 0. Wins: 0.
Player rpportugal does not show cards.Bets: 0. Collects: 0. Wins: 0.
Game ended at: 2016/11/28 18:20:55

Game started
Game ID: 786349459 0.25/0.50 (PRR) Gorgons - 5 (Hold'em)
Seat 1 is the button
Seat 1: SenNoSen (110.71).
Seat 2: eu4ria (230.44).
Seat 3: IlxxxlI (24.50).
Seat 4: dscshift (25.66).
Seat 5: pokanaktus (54.52).
Seat 6: wethco (54.24).
Player eu4ria has small blind (0.25)
Player IlxxxlI has big blind (0.50)
Player IlxxxlI received card: [3s]
Player IlxxxlI received card: [10d]
Player dscshift folds
Player pokanaktus folds
Player wethco folds
Player SenNoSen raises (1)
Player eu4ria raises (3.25)
Player IlxxxlI folds
Player SenNoSen calls (2.50)
*** FLOP ***: [6c As Js]
Player eu4ria bets (3)
Player SenNoSen folds
Uncalled bet (3) returned to eu4ria
Player eu4ria mucks cards
------ Summary ------
Pot: 7.13. Rake 0.25. JP fee 0.12
Board: [6c As Js]
Player SenNoSen does not show cards.Bets: 3.50. Collects: 0. Loses: 3.50.
*Player eu4ria mucks (does not show cards). Bets: 3.50. Collects: 7.13. Wins: 3.63.
Player IlxxxlI does not show cards.Bets: 0.50. Collects: 0. Loses: 0.50.
Player dscshift does not show cards.Bets: 0. Collects: 0. Wins: 0.
Player pokanaktus does not show cards.Bets: 0. Collects: 0. Wins: 0.
Player wethco does not show cards.Bets: 0. Collects: 0. Wins: 0.
Game ended at: 2016/11/28 18:20:30

Game started
Game ID: 786349315 0.25/0.50 (PRR) Gorgons - 17 (Hold'em)
Seat 3 is the button
Seat 1: Smok5 Js (21.89).
Seat 2: SenNoSen (84.97).
Seat 3: pokanaktus (50).
Seat 4: IlxxxlI (20).
Seat 5: BoTPuMHeDichBro (59.98).
Seat 6: eu4ria (83.81).
Player IlxxxlI has small blind (0.25)
Player BoTPuMHeDichBro has big blind (0.50)
Player IlxxxlI received card: [2c]
Player IlxxxlI received card: [6s]
Player eu4ria folds
Player Smok5 Js calls (0.50)
Player SenNoSen folds
Player pokanaktus folds
Player IlxxxlI folds
Player BoTPuMHeDichBro checks
*** FLOP ***: [10c Ks 5d]
Player BoTPuMHeDichBro checks
Player Smok5 Js checks
*** TURN ***: [10c Ks 5d] [Kh]
Player BoTPuMHeDichBro checks
Player Smok5 Js checks
*** RIVER ***: [10c Ks 5d Kh] [Jc]
Player BoTPuMHeDichBro checks
Player Smok5 Js bets (1)
Player BoTPuMHeDichBro folds
Uncalled bet (1) returned to Smok5 Js
Player Smok5 Js mucks cards
------ Summary ------
Pot: 1.19. Rake 0.04. JP fee 0.02
Board: [10c Ks 5d Kh Jc]
*Player Smok5 Js mucks (does not show cards). Bets: 0.50. Collects: 1.19. Wins: 0.69.
Player SenNoSen does not show cards.Bets: 0. Collects: 0. Wins: 0.
Player pokanaktus does not show cards.Bets: 0. Collects: 0. Wins: 0.
Player IlxxxlI does not show cards.Bets: 0.25. Collects: 0. Loses: 0.25.
Player BoTPuMHeDichBro does not show cards.Bets: 0.50. Collects: 0. Loses: 0.50.
Player eu4ria does not show cards.Bets: 0. Collects: 0. Wins: 0.
Game ended at: 2016/11/28 18:19:55

Game started
Game ID: 786349267 0.25/0.50 (PRR) Gorgons - 5 (Hold'em)
Seat 6 is the button
Seat 1: SenNoSen (110.96).
Seat 2: eu4ria (230.94).
Seat 3: IlxxxlI (24.50).
Seat 4: dscshift (24).
Seat 5: pokanaktus (54.52).
Seat 6: wethco (55.29).
Player SenNoSen has small blind (0.25)
Player eu4ria has big blind (0.50)
Player IlxxxlI received card: [Jh]
Player IlxxxlI received card: [3s]
Player IlxxxlI folds
Player dscshift calls (0.50)
Player pokanaktus folds
Player wethco calls (0.50)
Player SenNoSen folds
Player eu4ria checks
*** FLOP ***: [Ks 5s 3h]
Player eu4ria checks
Player dscshift checks
Player wethco bets (0.55)
Player eu4ria folds
Player dscshift calls (0.55)
*** TURN ***: [Ks 5s 3h] [3c]
Player dscshift checks
Player wethco checks
*** RIVER ***: [Ks 5s 3h 3c] [Jd]
Player dscshift checks
Player wethco checks
Player wethco mucks cards
------ Summary ------
Pot: 2.71. Rake 0.10. JP fee 0.04
Board: [Ks 5s 3h 3c Jd]
Player SenNoSen does not show cards.Bets: 0.25. Collects: 0. Loses: 0.25.
Player eu4ria does not show cards.Bets: 0.50. Collects: 0. Loses: 0.50.
Player IlxxxlI does not show cards.Bets: 0. Collects: 0. Wins: 0.
*Player dscshift shows: One pair of 3s [2d Ad]. Bets: 1.05. Collects: 2.71. Wins: 1.66.
Player pokanaktus does not show cards.Bets: 0. Collects: 0. Wins: 0.
Player wethco mucks (does not show cards). Bets: 1.05. Collects: 0. Loses: 1.05.
Game ended at: 2016/11/28 18:19:32

Game started
Game ID: 786349225 0.25/0.50 (PRR) Gorgons - 17 (Hold'em)
Seat 2 is the button
Seat 1: Smok5 Js (21.89).
Seat 2: SenNoSen (84.22).
Seat 3: pokanaktus (50).
Seat 4: IlxxxlI (20).
Seat 6: eu4ria (83.81).
Player pokanaktus has small blind (0.25)
Player IlxxxlI has big blind (0.50)
Player IlxxxlI received card: [10s]
Player IlxxxlI received card: [3h]
Player eu4ria folds
Player Smok5 Js folds
Player SenNoSen raises (1)
Player pokanaktus folds
Player IlxxxlI folds
Uncalled bet (0.50) returned to SenNoSen
Player SenNoSen mucks cards
------ Summary ------
Pot: 1.25. Rake 0
Player Smok5 Js does not show cards.Bets: 0. Collects: 0. Wins: 0.
*Player SenNoSen mucks (does not show cards). Bets: 0.50. Collects: 1.25. Wins: 0.75.
Player pokanaktus does not show cards.Bets: 0.25. Collects: 0. Loses: 0.25.
Player IlxxxlI does not show cards.Bets: 0.50. Collects: 0. Loses: 0.50.
Player eu4ria does not show cards.Bets: 0. Collects: 0. Wins: 0.
Game ended at: 2016/11/28 18:18:50

Game started
Game ID: 786349127 0.25/0.50 (PRR) Garuda - 3 (Hold'em)
Seat 9 is the button
Seat 1: Hakuna_Matata777 (92.92).
Seat 2: in_ur_i (50).
Seat 3: Ms.stone (43.04).
Seat 4: smellskindyfishy (17).
Seat 5: IlxxxlI (59.50).
Seat 6: NoizeyCrckt (51.08).
Seat 7: 1jackoff1 (120.66).
Seat 8: haroldbb (86.46).
Seat 9: rpportugal (10.34).
Player Hakuna_Matata777 has small blind (0.25)
Player in_ur_i has big blind (0.50)
Player IlxxxlI received card: [2s]
Player IlxxxlI received card: [Qc]
Player Ms.stone calls (0.50)
Player smellskindyfishy folds
Player IlxxxlI folds
Player NoizeyCrckt raises (2)
Player 1jackoff1 calls (2)
Player haroldbb folds
Player rpportugal calls (2)
Player Hakuna_Matata777 folds
Player in_ur_i calls (1.50)
Player Ms.stone calls (1.50)
*** FLOP ***: [4d 9s 5h]
Player in_ur_i checks
Player Ms.stone checks
Player NoizeyCrckt checks
Player 1jackoff1 bets (5)
Player rpportugal folds
Player in_ur_i folds
Player Ms.stone folds
Player NoizeyCrckt folds
Uncalled bet (5) returned to 1jackoff1
Player 1jackoff1 mucks cards
------ Summary ------
Pot: 9.74. Rake 0.35. JP fee 0.16
Board: [4d 9s 5h]
Player Hakuna_Matata777 does not show cards.Bets: 0.25. Collects: 0. Loses: 0.25.
Player in_ur_i does not show cards.Bets: 2. Collects: 0. Loses: 2.
Player Ms.stone does not show cards.Bets: 2. Collects: 0. Loses: 2.
Player smellskindyfishy does not show cards.Bets: 0. Collects: 0. Wins: 0.
Player IlxxxlI does not show cards.Bets: 0. Collects: 0. Wins: 0.
Player NoizeyCrckt does not show cards.Bets: 2. Collects: 0. Loses: 2.
*Player 1jackoff1 mucks (does not show cards). Bets: 2. Collects: 9.74. Wins: 7.74.
Player haroldbb does not show cards.Bets: 0. Collects: 0. Wins: 0.
Player rpportugal does not show cards.Bets: 2. Collects: 0. Loses: 2.
Game ended at: 2016/11/28 18:19:50

Game started
Game ID: 786349072 0.25/0.50 (PRR) Gorgons - 5 (Hold'em)
Seat 5 is the button
Seat 1: SenNoSen (116.50).
Seat 2: eu4ria (230.94).
Seat 3: IlxxxlI (24.50).
Seat 4: dscshift (24).
Seat 5: pokanaktus (54.52).
Seat 6: wethco (50.30).
Player wethco has small blind (0.25)
Player SenNoSen has big blind (0.50)
Player IlxxxlI received card: [4d]
Player IlxxxlI received card: [5d]
Player eu4ria folds
Player IlxxxlI folds
Player dscshift folds
Player pokanaktus folds
Player wethco calls (0.25)
Player SenNoSen raises (2.34)
Player wethco calls (2.34)
*** FLOP ***: [5c 4c Ac]
Player wethco checks
Player SenNoSen checks
*** TURN ***: [5c 4c Ac] [8s]
Player wethco checks
Player SenNoSen bets (2.70)
Player wethco calls (2.70)
*** RIVER ***: [5c 4c Ac 8s] [Qd]
Player wethco checks
Player SenNoSen checks
------ Summary ------
Pot: 10.53. Rake 0.37. JP fee 0.18
Board: [5c 4c Ac 8s Qd]
Player SenNoSen shows: One pair of Qs [Qs 10d]. Bets: 5.54. Collects: 0. Loses: 5.54.
Player eu4ria does not show cards.Bets: 0. Collects: 0. Wins: 0.
Player IlxxxlI does not show cards.Bets: 0. Collects: 0. Wins: 0.
Player dscshift does not show cards.Bets: 0. Collects: 0. Wins: 0.
Player pokanaktus does not show cards.Bets: 0. Collects: 0. Wins: 0.
*Player wethco shows: One pair of As [Ah 3s]. Bets: 5.54. Collects: 10.53. Wins: 4.99.
Game ended at: 2016/11/28 18:18:34

Game started
Game ID: 786349065 0.25/0.50 (PRR) Garuda - 3 (Hold'em)
Seat 8 is the button
Seat 1: Hakuna_Matata777 (93.42).
Seat 3: Ms.stone (43.04).
Seat 4: smellskindyfishy (16.25).
Seat 5: IlxxxlI (59.50).
Seat 6: NoizeyCrckt (51.08).
Seat 7: 1jackoff1 (120.66).
Seat 8: haroldbb (86.46).
Seat 9: rpportugal (10.59).
Player rpportugal has small blind (0.25)
Player Hakuna_Matata777 has big blind (0.50)
Player IlxxxlI received card: [4h]
Player IlxxxlI received card: [5d]
Player Ms.stone folds
Player smellskindyfishy raises (2.50)
Player IlxxxlI folds
Player NoizeyCrckt folds
Player 1jackoff1 folds
Player haroldbb folds
Player rpportugal folds
Player Hakuna_Matata777 folds
Uncalled bet (2) returned to smellskindyfishy
Player smellskindyfishy mucks cards
------ Summary ------
Pot: 1.25. Rake 0
Player Hakuna_Matata777 does not show cards.Bets: 0.50. Collects: 0. Loses: 0.50.
Player Ms.stone does not show cards.Bets: 0. Collects: 0. Wins: 0.
*Player smellskindyfishy mucks (does not show cards). Bets: 0.50. Collects: 1.25. Wins: 0.75.
Player IlxxxlI does not show cards.Bets: 0. Collects: 0. Wins: 0.
Player NoizeyCrckt does not show cards.Bets: 0. Collects: 0. Wins: 0.
Player 1jackoff1 does not show cards.Bets: 0. Collects: 0. Wins: 0.
Player haroldbb does not show cards.Bets: 0. Collects: 0. Wins: 0.
Player rpportugal does not show cards.Bets: 0.25. Collects: 0. Loses: 0.25.
Game ended at: 2016/11/28 18:17:54

Game started
Game ID: 786348995 0.25/0.50 (PRR) Gorgons - 5 (Hold'em)
Seat 4 is the button
Seat 1: SenNoSen (116.50).
Seat 2: eu4ria (230.19).
Seat 3: IlxxxlI (24.50).
Seat 4: dscshift (24).
Seat 5: pokanaktus (54.77).
Seat 6: wethco (50.80).
Player pokanaktus has small blind (0.25)
Player wethco has big blind (0.50)
Player IlxxxlI received card: [4h]
Player IlxxxlI received card: [4d]
Player SenNoSen folds
Player eu4ria raises (1.50)
Player IlxxxlI folds
Player dscshift folds
Player pokanaktus folds
Player wethco folds
Uncalled bet (1) returned to eu4ria
Player eu4ria mucks cards
------ Summary ------
Pot: 1.25. Rake 0
Player SenNoSen does not show cards.Bets: 0. Collects: 0. Wins: 0.
*Player eu4ria mucks (does not show cards). Bets: 0.50. Collects: 1.25. Wins: 0.75.
Player IlxxxlI does not show cards.Bets: 0. Collects: 0. Wins: 0.
Player dscshift does not show cards.Bets: 0. Collects: 0. Wins: 0.
Player pokanaktus does not show cards.Bets: 0.25. Collects: 0. Loses: 0.25.
Player wethco does not show cards.Bets: 0.50. Collects: 0. Loses: 0.50.
Game ended at: 2016/11/28 18:17:37

Game started
Game ID: 786348939 0.25/0.50 (PRR) Garuda - 3 (Hold'em)
Seat 7 is the button
Seat 1: Hakuna_Matata777 (93.42).
Seat 3: Ms.stone (43.54).
Seat 4: smellskindyfishy (16.25).
Seat 5: IlxxxlI (59.50).
Seat 6: NoizeyCrckt (51.08).
Seat 7: 1jackoff1 (119.49).
Seat 8: haroldbb (86.71).
Seat 9: rpportugal (11.09).
Player haroldbb has small blind (0.25)
Player rpportugal has big blind (0.50)
Player IlxxxlI received card: [Kd]
Player IlxxxlI received card: [9d]
Player Hakuna_Matata777 folds
Player Ms.stone calls (0.50)
Player smellskindyfishy folds
Player IlxxxlI folds
Player NoizeyCrckt folds
Player 1jackoff1 calls (0.50)
Player haroldbb folds
Player rpportugal checks
*** FLOP ***: [Kc 8s Ad]
Player rpportugal checks
Player Ms.stone checks
Player 1jackoff1 bets (2)
Player rpportugal folds
Player Ms.stone folds
Uncalled bet (2) returned to 1jackoff1
Player 1jackoff1 mucks cards
------ Summary ------
Pot: 1.67. Rake 0.06. JP fee 0.02
Board: [Kc 8s Ad]
Player Hakuna_Matata777 does not show cards.Bets: 0. Collects: 0. Wins: 0.
Player Ms.stone does not show cards.Bets: 0.50. Collects: 0. Loses: 0.50.
Player smellskindyfishy does not show cards.Bets: 0. Collects: 0. Wins: 0.
Player IlxxxlI does not show cards.Bets: 0. Collects: 0. Wins: 0.
Player NoizeyCrckt does not show cards.Bets: 0. Collects: 0. Wins: 0.
*Player 1jackoff1 mucks (does not show cards). Bets: 0.50. Collects: 1.67. Wins: 1.17.
Player haroldbb does not show cards.Bets: 0.25. Collects: 0. Loses: 0.25.
Player rpportugal does not show cards.Bets: 0.50. Collects: 0. Loses: 0.50.
Game ended at: 2016/11/28 18:17:36

Game started
Game ID: 786348933 0.25/0.50 (PRR) Gorgons - 17 (Hold'em)
Seat 1 is the button
Seat 1: Smok5 Js (22.39).
Seat 2: SenNoSen (81.49).
Seat 3: pokanaktus (51.59).
Seat 4: IlxxxlI (20).
Seat 6: eu4ria (83.81).
Player SenNoSen has small blind (0.25)
Player pokanaktus has big blind (0.50)
Player IlxxxlI received card: [6h]
Player IlxxxlI received card: [2d]
Player IlxxxlI folds
Player eu4ria folds
Player Smok5 Js calls (0.50)
Player SenNoSen raises (2.25)
Player pokanaktus calls (2)
Player Smok5 Js folds
*** FLOP ***: [Jd Jc 9c]
Player SenNoSen checks
Player pokanaktus checks
*** TURN ***: [Jd Jc 9c] [Ks]
Player SenNoSen bets (3.48)
Player pokanaktus folds
Uncalled bet (3.48) returned to SenNoSen
Player SenNoSen mucks cards
------ Summary ------
Pot: 5.23. Rake 0.19. JP fee 0.08
Board: [Jd Jc 9c Ks]
Player Smok5 Js does not show cards.Bets: 0.50. Collects: 0. Loses: 0.50.
*Player SenNoSen mucks (does not show cards). Bets: 2.50. Collects: 5.23. Wins: 2.73.
Player pokanaktus does not show cards.Bets: 2.50. Collects: 0. Loses: 2.50.
Player IlxxxlI does not show cards.Bets: 0. Collects: 0. Wins: 0.
Player eu4ria does not show cards.Bets: 0. Collects: 0. Wins: 0.
Game ended at: 2016/11/28 18:18:21

Game started
Game ID: 786348915 0.25/0.50 (PRR) Gorgons - 5 (Hold'em)
Seat 3 is the button
Seat 1: SenNoSen (116.50).
Seat 2: eu4ria (230.19).
Seat 3: IlxxxlI (23.75).
Seat 4: dscshift (24.25).
Seat 5: pokanaktus (55.27).
Seat 6: wethco (50.80).
Player dscshift has small blind (0.25)
Player pokanaktus has big blind (0.50)
Player IlxxxlI received card: [Qs]
Player IlxxxlI received card: [9c]
Player wethco folds
Player SenNoSen folds
Player eu4ria folds
Player IlxxxlI raises (1.50)
Player dscshift folds
Player pokanaktus folds
Uncalled bet (1) returned to IlxxxlI
Player IlxxxlI mucks cards
------ Summary ------
Pot: 1.25. Rake 0
Player SenNoSen does not show cards.Bets: 0. Collects: 0. Wins: 0.
Player eu4ria does not show cards.Bets: 0. Collects: 0. Wins: 0.
*Player IlxxxlI mucks (does not show cards). Bets: 0.50. Collects: 1.25. Wins: 0.75.
Player dscshift does not show cards.Bets: 0.25. Collects: 0. Loses: 0.25.
Player pokanaktus does not show cards.Bets: 0.50. Collects: 0. Loses: 0.50.
Player wethco does not show cards.Bets: 0. Collects: 0. Wins: 0.
Game ended at: 2016/11/28 18:17:18

Game started
Game ID: 786348853 0.25/0.50 (PRR) Gorgons - 5 (Hold'em)
Seat 2 is the button
Seat 1: SenNoSen (116.50).
Seat 2: eu4ria (230.19).
Seat 3: IlxxxlI (24).
Seat 4: dscshift (24).
Seat 5: pokanaktus (55.27).
Seat 6: wethco (50.80).
Player IlxxxlI has small blind (0.25)
Player dscshift has big blind (0.50)
Player IlxxxlI received card: [7c]
Player IlxxxlI received card: [Js]
Player pokanaktus folds
Player wethco folds
Player SenNoSen folds
Player eu4ria folds
Player IlxxxlI folds
Uncalled bet (0.25) returned to dscshift
Player dscshift mucks cards
------ Summary ------
Pot: 0.50. Rake 0
Player SenNoSen does not show cards.Bets: 0. Collects: 0. Wins: 0.
Player eu4ria does not show cards.Bets: 0. Collects: 0. Wins: 0.
Player IlxxxlI does not show cards.Bets: 0.25. Collects: 0. Loses: 0.25.
*Player dscshift mucks (does not show cards). Bets: 0.25. Collects: 0.50. Wins: 0.25.
Player pokanaktus does not show cards.Bets: 0. Collects: 0. Wins: 0.
Player wethco does not show cards.Bets: 0. Collects: 0. Wins: 0.
Game ended at: 2016/11/28 18:16:54

Game started
Game ID: 786348807 0.25/0.50 (PRR) Gorgons - 5 (Hold'em)
Seat 1 is the button
Seat 1: SenNoSen (116.50).
Seat 2: eu4ria (230.44).
Seat 3: IlxxxlI (23.75).
Seat 4: dscshift (24).
Seat 5: pokanaktus (55.27).
Seat 6: wethco (50.80).
Player eu4ria has small blind (0.25)
Player IlxxxlI has big blind (0.50)
Player IlxxxlI received card: [Ac]
Player IlxxxlI received card: [Kh]
Player dscshift folds
Player pokanaktus folds
Player wethco folds
Player SenNoSen folds
Player eu4ria folds
Uncalled bet (0.25) returned to IlxxxlI
Player IlxxxlI mucks cards
------ Summary ------
Pot: 0.50. Rake 0
Player SenNoSen does not show cards.Bets: 0. Collects: 0. Wins: 0.
Player eu4ria does not show cards.Bets: 0.25. Collects: 0. Loses: 0.25.
*Player IlxxxlI mucks (does not show cards). Bets: 0.25. Collects: 0.50. Wins: 0.25.
Player dscshift does not show cards.Bets: 0. Collects: 0. Wins: 0.
Player pokanaktus does not show cards.Bets: 0. Collects: 0. Wins: 0.
Player wethco does not show cards.Bets: 0. Collects: 0. Wins: 0.
Game ended at: 2016/11/28 18:16:38

Game started
Game ID: 786348800 0.25/0.50 (PRR) Gorgons - 17 (Hold'em)
Seat 6 is the button
Seat 1: Smok5 Js (22.64).
Seat 2: SenNoSen (82.99).
Seat 3: pokanaktus (50).
Seat 4: IlxxxlI (20).
Seat 6: eu4ria (83.81).
Player Smok5 Js has small blind (0.25)
Player SenNoSen has big blind (0.50)
Player IlxxxlI received card: [3h]
Player IlxxxlI received card: [2s]
Player pokanaktus raises (1.50)
Player IlxxxlI folds
Player eu4ria folds
Player Smok5 Js folds
Player SenNoSen calls (1)
*** FLOP ***: [9d 7d Kc]
Player SenNoSen checks
Player pokanaktus bets (2.06)
Player SenNoSen folds
Uncalled bet (2.06) returned to pokanaktus
Player pokanaktus mucks cards
------ Summary ------
Pot: 3.09. Rake 0.12. JP fee 0.04
Board: [9d 7d Kc]
Player Smok5 Js does not show cards.Bets: 0.25. Collects: 0. Loses: 0.25.
Player SenNoSen does not show cards.Bets: 1.50. Collects: 0. Loses: 1.50.
*Player pokanaktus mucks (does not show cards). Bets: 1.50. Collects: 3.09. Wins: 1.59.
Player IlxxxlI does not show cards.Bets: 0. Collects: 0. Wins: 0.
Player eu4ria does not show cards.Bets: 0. Collects: 0. Wins: 0.
Game ended at: 2016/11/28 18:17:0

Game started
Game ID: 786348798 0.25/0.50 (PRR) Garuda - 3 (Hold'em)
Seat 6 is the button
Seat 1: Hakuna_Matata777 (93.42).
Seat 3: Ms.stone (43.54).
Seat 4: smellskindyfishy (16.25).
Seat 5: IlxxxlI (59.50).
Seat 6: NoizeyCrckt (49.25).
Seat 7: 1jackoff1 (120.99).
Seat 8: haroldbb (87.21).
Seat 9: rpportugal (11.09).
Player 1jackoff1 has small blind (0.25)
Player haroldbb has big blind (0.50)
Player IlxxxlI received card: [Qs]
Player IlxxxlI received card: [8h]
Player rpportugal folds
Player Hakuna_Matata777 folds
Player Ms.stone folds
Player smellskindyfishy folds
Player IlxxxlI folds
Player NoizeyCrckt raises (1.50)
Player 1jackoff1 calls (1.25)
Player haroldbb folds
*** FLOP ***: [10s 2h Kd]
Player 1jackoff1 checks
Player NoizeyCrckt bets (2.75)
Player 1jackoff1 folds
Uncalled bet (2.75) returned to NoizeyCrckt
Player NoizeyCrckt mucks cards
------ Summary ------
Pot: 3.33. Rake 0.13. JP fee 0.04
Board: [10s 2h Kd]
Player Hakuna_Matata777 does not show cards.Bets: 0. Collects: 0. Wins: 0.
Player Ms.stone does not show cards.Bets: 0. Collects: 0. Wins: 0.
Player smellskindyfishy does not show cards.Bets: 0. Collects: 0. Wins: 0.
Player IlxxxlI does not show cards.Bets: 0. Collects: 0. Wins: 0.
*Player NoizeyCrckt mucks (does not show cards). Bets: 1.50. Collects: 3.33. Wins: 1.83.
Player 1jackoff1 does not show cards.Bets: 1.50. Collects: 0. Loses: 1.50.
Player haroldbb does not show cards.Bets: 0.50. Collects: 0. Loses: 0.50.
Player rpportugal does not show cards.Bets: 0. Collects: 0. Wins: 0.
Game ended at: 2016/11/28 18:17:2

Game started
Game ID: 786348751 0.25/0.50 (PRR) Gorgons - 17 (Hold'em)
Seat 4 is the button
Seat 1: Smok5 Js (23.14).
Seat 2: SenNoSen (82.24).
Seat 3: pokanaktus (50).
Seat 4: IlxxxlI (20).
Seat 6: eu4ria (84.06).
Player eu4ria has small blind (0.25)
Player Smok5 Js has big blind (0.50)
Player IlxxxlI received card: [As]
Player IlxxxlI received card: [4h]
Player SenNoSen raises (1.50)
Player pokanaktus folds
Player IlxxxlI folds
Player eu4ria folds
Player Smok5 Js folds
Uncalled bet (1) returned to SenNoSen
Player SenNoSen mucks cards
------ Summary ------
Pot: 1.25. Rake 0
Player Smok5 Js does not show cards.Bets: 0.50. Collects: 0. Loses: 0.50.
*Player SenNoSen mucks (does not show cards). Bets: 0.50. Collects: 1.25. Wins: 0.75.
Player pokanaktus does not show cards.Bets: 0. Collects: 0. Wins: 0.
Player IlxxxlI does not show cards.Bets: 0. Collects: 0. Wins: 0.
Player eu4ria does not show cards.Bets: 0.25. Collects: 0. Loses: 0.25.
Game ended at: 2016/11/28 18:16:22

Game started
Game ID: 786348748 0.25/0.50 (PRR) Gorgons - 5 (Hold'em)
Seat 6 is the button
Seat 1: SenNoSen (116.75).
Seat 2: eu4ria (230.94).
Seat 3: IlxxxlI (23.75).
Seat 4: dscshift (24).
Seat 5: pokanaktus (54.52).
Seat 6: wethco (50.80).
Player SenNoSen has small blind (0.25)
Player eu4ria has big blind (0.50)
Player IlxxxlI received card: [Js]
Player IlxxxlI received card: [3c]
Player IlxxxlI folds
Player dscshift folds
Player pokanaktus raises (1.50)
Player wethco folds
Player SenNoSen folds
Player eu4ria folds
Uncalled bet (1) returned to pokanaktus
Player pokanaktus mucks cards
------ Summary ------
Pot: 1.25. Rake 0
Player SenNoSen does not show cards.Bets: 0.25. Collects: 0. Loses: 0.25.
Player eu4ria does not show cards.Bets: 0.50. Collects: 0. Loses: 0.50.
Player IlxxxlI does not show cards.Bets: 0. Collects: 0. Wins: 0.
Player dscshift does not show cards.Bets: 0. Collects: 0. Wins: 0.
*Player pokanaktus mucks (does not show cards). Bets: 0.50. Collects: 1.25. Wins: 0.75.
Player wethco does not show cards.Bets: 0. Collects: 0. Wins: 0.
Game ended at: 2016/11/28 18:16:24

Game started
Game ID: 786348658 0.25/0.50 (PRR) Gorgons - 5 (Hold'em)
Seat 5 is the button
Seat 1: SenNoSen (117.25).
Seat 2: eu4ria (230.94).
Seat 3: IlxxxlI (23.75).
Seat 4: dscshift (24).
Seat 5: pokanaktus (53.77).
Seat 6: wethco (51.05).
Player wethco has small blind (0.25)
Player SenNoSen has big blind (0.50)
Player IlxxxlI received card: [9s]
Player IlxxxlI received card: [Qs]
Player eu4ria folds
Player IlxxxlI folds
Player dscshift folds
Player pokanaktus raises (1.50)
Player wethco folds
Player SenNoSen folds
Uncalled bet (1) returned to pokanaktus
Player pokanaktus mucks cards
------ Summary ------
Pot: 1.25. Rake 0
Player SenNoSen does not show cards.Bets: 0.50. Collects: 0. Loses: 0.50.
Player eu4ria does not show cards.Bets: 0. Collects: 0. Wins: 0.
Player IlxxxlI does not show cards.Bets: 0. Collects: 0. Wins: 0.
Player dscshift does not show cards.Bets: 0. Collects: 0. Wins: 0.
*Player pokanaktus mucks (does not show cards). Bets: 0.50. Collects: 1.25. Wins: 0.75.
Player wethco does not show cards.Bets: 0.25. Collects: 0. Loses: 0.25.
Game ended at: 2016/11/28 18:16:7

Game started
Game ID: 786348608 0.25/0.50 (PRR) Gorgons - 5 (Hold'em)
Seat 4 is the button
Seat 1: SenNoSen (117.25).
Seat 2: eu4ria (230.94).
Seat 3: IlxxxlI (23.75).
Seat 4: dscshift (24).
Seat 5: pokanaktus (53.27).
Seat 6: wethco (51.55).
Player pokanaktus has small blind (0.25)
Player wethco has big blind (0.50)
Player IlxxxlI received card: [Kd]
Player IlxxxlI received card: [6c]
Player SenNoSen folds
Player eu4ria folds
Player IlxxxlI folds
Player dscshift folds
Player pokanaktus raises (1.25)
Player wethco folds
Uncalled bet (1) returned to pokanaktus
Player pokanaktus mucks cards
------ Summary ------
Pot: 1. Rake 0
Player SenNoSen does not show cards.Bets: 0. Collects: 0. Wins: 0.
Player eu4ria does not show cards.Bets: 0. Collects: 0. Wins: 0.
Player IlxxxlI does not show cards.Bets: 0. Collects: 0. Wins: 0.
Player dscshift does not show cards.Bets: 0. Collects: 0. Wins: 0.
*Player pokanaktus mucks (does not show cards). Bets: 0.50. Collects: 1. Wins: 0.50.
Player wethco does not show cards.Bets: 0.50. Collects: 0. Loses: 0.50.
Game ended at: 2016/11/28 18:15:42

Game started
Game ID: 786348604 0.25/0.50 (PRR) Garuda - 3 (Hold'em)
Seat 5 is the button
Seat 1: Hakuna_Matata777 (93.42).
Seat 3: Ms.stone (43.54).
Seat 4: smellskindyfishy (18.25).
Seat 5: IlxxxlI (59.50).
Seat 6: NoizeyCrckt (49.50).
Seat 7: 1jackoff1 (117.05).
Seat 8: haroldbb (87.21).
Seat 9: rpportugal (13.09).
Player NoizeyCrckt has small blind (0.25)
Player 1jackoff1 has big blind (0.50)
Player IlxxxlI received card: [9h]
Player IlxxxlI received card: [5d]
Player haroldbb folds
Player rpportugal calls (0.50)
Player Hakuna_Matata777 folds
Player Ms.stone folds
Player smellskindyfishy raises (2)
Player IlxxxlI folds
Player NoizeyCrckt folds
Player 1jackoff1 calls (1.50)
Player rpportugal calls (1.50)
*** FLOP ***: [6s 7d 6c]
Player 1jackoff1 checks
Player rpportugal checks
Player smellskindyfishy checks
*** TURN ***: [6s 7d 6c] [Ks]
Player 1jackoff1 bets (3)
Player rpportugal folds
Player smellskindyfishy folds
Uncalled bet (3) returned to 1jackoff1
Player 1jackoff1 mucks cards
------ Summary ------
Pot: 5.94. Rake 0.21. JP fee 0.10
Board: [6s 7d 6c Ks]
Player Hakuna_Matata777 does not show cards.Bets: 0. Collects: 0. Wins: 0.
Player Ms.stone does not show cards.Bets: 0. Collects: 0. Wins: 0.
Player smellskindyfishy does not show cards.Bets: 2. Collects: 0. Loses: 2.
Player IlxxxlI does not show cards.Bets: 0. Collects: 0. Wins: 0.
Player NoizeyCrckt does not show cards.Bets: 0.25. Collects: 0. Loses: 0.25.
*Player 1jackoff1 mucks (does not show cards). Bets: 2. Collects: 5.94. Wins: 3.94.
Player haroldbb does not show cards.Bets: 0. Collects: 0. Wins: 0.
Player rpportugal does not show cards.Bets: 2. Collects: 0. Loses: 2.
Game ended at: 2016/11/28 18:16:22

Game started
Game ID: 786348581 0.25/0.50 (PRR) Gorgons - 17 (Hold'em)
Seat 3 is the button
Seat 1: Smok5 Js (23.14).
Seat 2: SenNoSen (82.24).
Seat 3: pokanaktus (51.50).
Seat 4: IlxxxlI (20).
Seat 5: BoTPuMHeDichBro (59.98).
Seat 6: eu4ria (81.08).
Player IlxxxlI has small blind (0.25)
Player BoTPuMHeDichBro sitting out
Player eu4ria has big blind (0.50)
Player IlxxxlI received card: [10h]
Player IlxxxlI received card: [Kd]
Player Smok5 Js folds
Player SenNoSen folds
Player pokanaktus raises (1.50)
Player IlxxxlI folds
Player eu4ria calls (1)
*** FLOP ***: [Jc Qc 3h]
Player eu4ria checks
Player pokanaktus bets (1.54)
Player eu4ria calls (1.54)
*** TURN ***: [Jc Qc 3h] [5h]
Player eu4ria checks
Player pokanaktus checks
*** RIVER ***: [Jc Qc 3h 5h] [Js]
Player eu4ria checks
Player pokanaktus checks
Player pokanaktus mucks cards
------ Summary ------
Pot: 6.02. Rake 0.21. JP fee 0.10
Board: [Jc Qc 3h 5h Js]
Player Smok5 Js does not show cards.Bets: 0. Collects: 0. Wins: 0.
Player SenNoSen does not show cards.Bets: 0. Collects: 0. Wins: 0.
Player pokanaktus mucks (does not show cards). Bets: 3.04. Collects: 0. Loses: 3.04.
Player IlxxxlI does not show cards.Bets: 0.25. Collects: 0. Loses: 0.25.
Player BoTPuMHeDichBro does not show cards.Bets: 0. Collects: 0. Wins: 0.
*Player eu4ria shows: Two pairs. Js and 4s [4d 4s]. Bets: 3.04. Collects: 6.02. Wins: 2.98.
Game ended at: 2016/11/28 18:16:6

Game started
Game ID: 786348532 0.25/0.50 (PRR) Gorgons - 5 (Hold'em)
Seat 3 is the button
Seat 1: SenNoSen (116.50).
Seat 2: eu4ria (230.94).
Seat 3: IlxxxlI (23.75).
Seat 4: dscshift (24.25).
Seat 5: pokanaktus (53.77).
Seat 6: wethco (51.55).
Player dscshift has small blind (0.25)
Player pokanaktus has big blind (0.50)
Player IlxxxlI received card: [10c]
Player IlxxxlI received card: [Ad]
Player wethco folds
Player SenNoSen raises (1.50)
Player eu4ria folds
Player IlxxxlI folds
Player dscshift folds
Player pokanaktus folds
Uncalled bet (1) returned to SenNoSen
Player SenNoSen mucks cards
------ Summary ------
Pot: 1.25. Rake 0
*Player SenNoSen mucks (does not show cards). Bets: 0.50. Collects: 1.25. Wins: 0.75.
Player eu4ria does not show cards.Bets: 0. Collects: 0. Wins: 0.
Player IlxxxlI does not show cards.Bets: 0. Collects: 0. Wins: 0.
Player dscshift does not show cards.Bets: 0.25. Collects: 0. Loses: 0.25.
Player pokanaktus does not show cards.Bets: 0.50. Collects: 0. Loses: 0.50.
Player wethco does not show cards.Bets: 0. Collects: 0. Wins: 0.
Game ended at: 2016/11/28 18:15:23

Game started
Game ID: 786348424 0.25/0.50 (PRR) Gorgons - 17 (Hold'em)
Seat 2 is the button
Seat 1: Smok5 Js (22.45).
Seat 2: SenNoSen (82.24).
Seat 3: pokanaktus (51.75).
Seat 4: IlxxxlI (20).
Seat 5: BoTPuMHeDichBro (59.98).
Seat 6: eu4ria (81.08).
Player pokanaktus has small blind (0.25)
Player IlxxxlI has big blind (0.50)
Player IlxxxlI received card: [8c]
Player IlxxxlI received card: [2c]
Player BoTPuMHeDichBro folds
Player eu4ria folds
Player Smok5 Js calls (0.50)
Player SenNoSen folds
Player pokanaktus folds
Player IlxxxlI checks
*** FLOP ***: [6d 8d Ah]
Player IlxxxlI checks
Player Smok5 Js bets (0.50)
Player IlxxxlI folds
Uncalled bet (0.50) returned to Smok5 Js
Player Smok5 Js mucks cards
------ Summary ------
Pot: 1.19. Rake 0.04. JP fee 0.02
Board: [6d 8d Ah]
*Player Smok5 Js mucks (does not show cards). Bets: 0.50. Collects: 1.19. Wins: 0.69.
Player SenNoSen does not show cards.Bets: 0. Collects: 0. Wins: 0.
Player pokanaktus does not show cards.Bets: 0.25. Collects: 0. Loses: 0.25.
Player IlxxxlI does not show cards.Bets: 0.50. Collects: 0. Loses: 0.50.
Player BoTPuMHeDichBro does not show cards.Bets: 0. Collects: 0. Wins: 0.
Player eu4ria does not show cards.Bets: 0. Collects: 0. Wins: 0.
Game ended at: 2016/11/28 18:15:15

Game started
Game ID: 786348399 0.25/0.50 (PRR) Gorgons - 5 (Hold'em)
Seat 2 is the button
Seat 1: SenNoSen (115.36).
Seat 2: eu4ria (230.94).
Seat 3: IlxxxlI (24).
Seat 4: dscshift (25.25).
Seat 5: pokanaktus (53.77).
Seat 6: wethco (51.55).
Player IlxxxlI has small blind (0.25)
Player dscshift has big blind (0.50)
Player IlxxxlI received card: [8h]
Player IlxxxlI received card: [6s]
Player pokanaktus folds
Player wethco folds
Player SenNoSen raises (1)
Player eu4ria folds
Player IlxxxlI folds
Player dscshift calls (0.50)
*** FLOP ***: [3c 2d Kc]
Player dscshift checks
Player SenNoSen bets (0.71)
Player dscshift folds
Uncalled bet (0.71) returned to SenNoSen
Player SenNoSen mucks cards
------ Summary ------
Pot: 2.14. Rake 0.09. JP fee 0.02
Board: [3c 2d Kc]
*Player SenNoSen mucks (does not show cards). Bets: 1. Collects: 2.14. Wins: 1.14.
Player eu4ria does not show cards.Bets: 0. Collects: 0. Wins: 0.
Player IlxxxlI does not show cards.Bets: 0.25. Collects: 0. Loses: 0.25.
Player dscshift does not show cards.Bets: 1. Collects: 0. Loses: 1.
Player pokanaktus does not show cards.Bets: 0. Collects: 0. Wins: 0.
Player wethco does not show cards.Bets: 0. Collects: 0. Wins: 0.
Game ended at: 2016/11/28 18:15:5

Game started
Game ID: 786348327 0.25/0.50 (PRR) Gorgons - 17 (Hold'em)
Seat 1 is the button
Seat 1: Smok5 Js (22.45).
Seat 2: SenNoSen (82.49).
Seat 3: pokanaktus (52.25).
Seat 4: IlxxxlI (20).
Seat 5: BoTPuMHeDichBro (59.98).
Seat 6: eu4ria (80.33).
Player SenNoSen has small blind (0.25)
Player pokanaktus has big blind (0.50)
Player IlxxxlI received card: [3h]
Player IlxxxlI received card: [6c]
Player IlxxxlI folds
Player BoTPuMHeDichBro folds
Player eu4ria raises (1.50)
Player Smok5 Js folds
Player SenNoSen folds
Player pokanaktus folds
Uncalled bet (1) returned to eu4ria
Player eu4ria mucks cards
------ Summary ------
Pot: 1.25. Rake 0
Player Smok5 Js does not show cards.Bets: 0. Collects: 0. Wins: 0.
Player SenNoSen does not show cards.Bets: 0.25. Collects: 0. Loses: 0.25.
Player pokanaktus does not show cards.Bets: 0.50. Collects: 0. Loses: 0.50.
Player IlxxxlI does not show cards.Bets: 0. Collects: 0. Wins: 0.
Player BoTPuMHeDichBro does not show cards.Bets: 0. Collects: 0. Wins: 0.
*Player eu4ria mucks (does not show cards). Bets: 0.50. Collects: 1.25. Wins: 0.75.
Game ended at: 2016/11/28 18:14:37

Game started
Game ID: 786348322 0.25/0.50 (PRR) Garuda - 3 (Hold'em)
Seat 4 is the button
Seat 1: Hakuna_Matata777 (93.42).
Seat 2: Ease E Game (37.63).
Seat 3: Ms.stone (45.91).
Seat 4: smellskindyfishy (18.25).
Seat 5: IlxxxlI (20).
Seat 6: NoizeyCrckt (50).
Seat 7: 1jackoff1 (117.55).
Seat 8: haroldbb (87.21).
Seat 9: rpportugal (14.59).
Player IlxxxlI has small blind (0.25)
Player NoizeyCrckt has big blind (0.50)
Player IlxxxlI received card: [10c]
Player IlxxxlI received card: [10d]
Player 1jackoff1 calls (0.50)
Player haroldbb folds
Player rpportugal raises (1.50)
Player Hakuna_Matata777 folds
Player Ease E Game calls (1.50)
Player Ms.stone calls (1.50)
Player smellskindyfishy folds
Player IlxxxlI allin (19.75)
Player NoizeyCrckt folds
Player 1jackoff1 folds
Player rpportugal folds
Player Ease E Game allin (36.13)
Player Ms.stone calls (36.13)
*** FLOP ***: [Kd Jd 10s]
*** TURN ***: [Kd Jd 10s] [5s]
*** RIVER ***: [Kd Jd 10s 5s] [3s]
------ Summary ------
Pot: 94.76. Rake 2.76. JP fee 0.24
Board: [Kd Jd 10s 5s 3s]
Player Hakuna_Matata777 does not show cards.Bets: 0. Collects: 0. Wins: 0.
Player Ease E Game shows: High card K [7h 8h]. Bets: 37.63. Collects: 0. Loses: 37.63.
*Player Ms.stone shows: One pair of Ks [Ah Ks]. Bets: 37.63. Collects: 35.26. Loses: 2.37.
Player smellskindyfishy does not show cards.Bets: 0. Collects: 0. Wins: 0.
*Player IlxxxlI shows: Three Of Kind of 10s [10c 10d]. Bets: 20. Collects: 59.50. Wins: 39.50.
Player NoizeyCrckt does not show cards.Bets: 0.50. Collects: 0. Loses: 0.50.
Player 1jackoff1 does not show cards.Bets: 0.50. Collects: 0. Loses: 0.50.
Player haroldbb does not show cards.Bets: 0. Collects: 0. Wins: 0.
Player rpportugal does not show cards.Bets: 1.50. Collects: 0. Loses: 1.50.
Game ended at: 2016/11/28 18:15:21

Game started
Game ID: 786348162 0.25/0.50 (PRR) Gorgons - 5 (Hold'em)
Seat 1 is the button
Seat 1: SenNoSen (115.36).
Seat 2: eu4ria (231.19).
Seat 3: IlxxxlI (24.50).
Seat 4: dscshift (21.38).
Seat 5: pokanaktus (57.27).
Seat 6: wethco (51.55).
Player eu4ria has small blind (0.25)
Player IlxxxlI has big blind (0.50)
Player IlxxxlI received card: [8h]
Player IlxxxlI received card: [Js]
Player dscshift calls (0.50)
Player pokanaktus raises (2.50)
Player wethco folds
Player SenNoSen folds
Player eu4ria folds
Player IlxxxlI folds
Player dscshift calls (2)
*** FLOP ***: [5s 2c 4s]
Player dscshift checks
Player pokanaktus checks
*** TURN ***: [5s 2c 4s] [As]
Player dscshift bets (1)
Player pokanaktus calls (1)
*** RIVER ***: [5s 2c 4s As] [3c]
Player dscshift checks
Player pokanaktus checks
Player pokanaktus mucks cards
------ Summary ------
Pot: 7.37. Rake 0.26. JP fee 0.12
Board: [5s 2c 4s As 3c]
Player SenNoSen does not show cards.Bets: 0. Collects: 0. Wins: 0.
Player eu4ria does not show cards.Bets: 0.25. Collects: 0. Loses: 0.25.
Player IlxxxlI does not show cards.Bets: 0.50. Collects: 0. Loses: 0.50.
*Player dscshift shows: Straight to 6 [6s 8c]. Bets: 3.50. Collects: 7.37. Wins: 3.87.
Player pokanaktus mucks (does not show cards). Bets: 3.50. Collects: 0. Loses: 3.50.
Player wethco does not show cards.Bets: 0. Collects: 0. Wins: 0.
Game ended at: 2016/11/28 18:14:26

Game started
Game ID: 786348066 0.25/0.50 (PRR) Gorgons - 17 (Hold'em)
Seat 6 is the button
Seat 1: Smok5 Js (19.50).
Seat 2: SenNoSen (82.99).
Seat 3: pokanaktus (52.25).
Seat 4: IlxxxlI (20).
Seat 5: BoTPuMHeDichBro (59.98).
Seat 6: eu4ria (83.08).
Player Smok5 Js has small blind (0.25)
Player SenNoSen has big blind (0.50)
Player IlxxxlI received card: [9s]
Player IlxxxlI received card: [Kd]
Player pokanaktus folds
Player IlxxxlI folds
Player BoTPuMHeDichBro folds
Player eu4ria raises (1.25)
Player Smok5 Js calls (1)
Player SenNoSen folds
*** FLOP ***: [2d 6h 6d]
Player Smok5 Js checks
Player eu4ria checks
*** TURN ***: [2d 6h 6d] [6s]
Player Smok5 Js bets (1.50)
Player eu4ria calls (1.50)
*** RIVER ***: [2d 6h 6d 6s] [9d]
Player Smok5 Js checks
Player eu4ria checks
Player eu4ria mucks cards
------ Summary ------
Pot: 5.70. Rake 0.20. JP fee 0.10
Board: [2d 6h 6d 6s 9d]
*Player Smok5 Js shows: Full House (6/7) [7c 7s]. Bets: 2.75. Collects: 5.70. Wins: 2.95.
Player SenNoSen does not show cards.Bets: 0.50. Collects: 0. Loses: 0.50.
Player pokanaktus does not show cards.Bets: 0. Collects: 0. Wins: 0.
Player IlxxxlI does not show cards.Bets: 0. Collects: 0. Wins: 0.
Player BoTPuMHeDichBro does not show cards.Bets: 0. Collects: 0. Wins: 0.
Player eu4ria mucks (does not show cards). Bets: 2.75. Collects: 0. Loses: 2.75.
Game ended at: 2016/11/28 18:14:4

Game started
Game ID: 786347992 0.25/0.50 (PRR) Gorgons - 5 (Hold'em)
Seat 6 is the button
Seat 1: SenNoSen (115.61).
Seat 2: eu4ria (228.22).
Seat 3: IlxxxlI (24.50).
Seat 4: dscshift (21.88).
Seat 5: pokanaktus (59.77).
Seat 6: wethco (51.55).
Player SenNoSen has small blind (0.25)
Player eu4ria has big blind (0.50)
Player IlxxxlI received card: [6h]
Player IlxxxlI received card: [5d]
Player IlxxxlI folds
Player dscshift calls (0.50)
Player pokanaktus raises (2.50)
Player wethco folds
Player SenNoSen folds
Player eu4ria calls (2)
Player dscshift folds
*** FLOP ***: [4c 4h 6s]
Player eu4ria checks
Player pokanaktus checks
*** TURN ***: [4c 4h 6s] [7h]
Player eu4ria bets (4.50)
Player pokanaktus folds
Uncalled bet (4.50) returned to eu4ria
Player eu4ria mucks cards
------ Summary ------
Pot: 5.47. Rake 0.20. JP fee 0.08
Board: [4c 4h 6s 7h]
Player SenNoSen does not show cards.Bets: 0.25. Collects: 0. Loses: 0.25.
*Player eu4ria mucks (does not show cards). Bets: 2.50. Collects: 5.47. Wins: 2.97.
Player IlxxxlI does not show cards.Bets: 0. Collects: 0. Wins: 0.
Player dscshift does not show cards.Bets: 0.50. Collects: 0. Loses: 0.50.
Player pokanaktus does not show cards.Bets: 2.50. Collects: 0. Loses: 2.50.
Player wethco does not show cards.Bets: 0. Collects: 0. Wins: 0.
Game ended at: 2016/11/28 18:13:20

Game started
Game ID: 786347951 0.25/0.50 (PRR) Gorgons - 5 (Hold'em)
Seat 5 is the button
Seat 1: SenNoSen (115.36).
Seat 2: eu4ria (228.22).
Seat 3: IlxxxlI (24.50).
Seat 4: dscshift (21.88).
Seat 5: pokanaktus (59.77).
Seat 6: wethco (51.80).
Player wethco has small blind (0.25)
Player SenNoSen has big blind (0.50)
Player IlxxxlI received card: [Qh]
Player IlxxxlI received card: [5d]
Player eu4ria folds
Player IlxxxlI folds
Player dscshift folds
Player pokanaktus folds
Player wethco folds
Uncalled bet (0.25) returned to SenNoSen
Player SenNoSen mucks cards
------ Summary ------
Pot: 0.50. Rake 0
*Player SenNoSen mucks (does not show cards). Bets: 0.25. Collects: 0.50. Wins: 0.25.
Player eu4ria does not show cards.Bets: 0. Collects: 0. Wins: 0.
Player IlxxxlI does not show cards.Bets: 0. Collects: 0. Wins: 0.
Player dscshift does not show cards.Bets: 0. Collects: 0. Wins: 0.
Player pokanaktus does not show cards.Bets: 0. Collects: 0. Wins: 0.
Player wethco does not show cards.Bets: 0.25. Collects: 0. Loses: 0.25.
Game ended at: 2016/11/28 18:12:34

Game started
Game ID: 786347934 0.25/0.50 (PRR) Gorgons - 17 (Hold'em)
Seat 5 is the button
Seat 1: Smok5 Js (20).
Seat 2: SenNoSen (84.49).
Seat 3: pokanaktus (50).
Seat 4: IlxxxlI (20).
Seat 5: BoTPuMHeDichBro (59.98).
Seat 6: eu4ria (83.33).
Player eu4ria has small blind (0.25)
Player Smok5 Js has big blind (0.50)
Player IlxxxlI received card: [As]
Player IlxxxlI received card: [5d]
Player SenNoSen raises (1.50)
Player pokanaktus raises (5)
Player IlxxxlI folds
Player BoTPuMHeDichBro folds
Player eu4ria folds
Player Smok5 Js folds
Player SenNoSen folds
Uncalled bet (3.50) returned to pokanaktus
Player pokanaktus mucks cards
------ Summary ------
Pot: 3.75. Rake 0
Player Smok5 Js does not show cards.Bets: 0.50. Collects: 0. Loses: 0.50.
Player SenNoSen does not show cards.Bets: 1.50. Collects: 0. Loses: 1.50.
*Player pokanaktus mucks (does not show cards). Bets: 1.50. Collects: 3.75. Wins: 2.25.
Player IlxxxlI does not show cards.Bets: 0. Collects: 0. Wins: 0.
Player BoTPuMHeDichBro does not show cards.Bets: 0. Collects: 0. Wins: 0.
Player eu4ria does not show cards.Bets: 0.25. Collects: 0. Loses: 0.25.
Game ended at: 2016/11/28 18:12:54

Game started
Game ID: 786347931 0.25/0.50 (PRR) Garuda - 3 (Hold'em)
Seat 3 is the button
Seat 1: Hakuna_Matata777 (93.42).
Seat 2: Ease E Game (52.26).
Seat 3: Ms.stone (28.23).
Seat 4: smellskindyfishy (18.50).
Seat 5: IlxxxlI (20).
Seat 6: NoizeyCrckt (50).
Seat 7: 1jackoff1 (118.05).
Seat 8: haroldbb (87.21).
Seat 9: rpportugal (14.59).
Player smellskindyfishy has small blind (0.25)
Player IlxxxlI has big blind (0.50)
Player IlxxxlI received card: [Kd]
Player IlxxxlI received card: [Qh]
Player NoizeyCrckt folds
Player 1jackoff1 calls (0.50)
Player haroldbb folds
Player rpportugal folds
Player Hakuna_Matata777 folds
Player Ease E Game calls (0.50)
Player Ms.stone calls (0.50)
Player smellskindyfishy folds
Player IlxxxlI raises (3)
Player 1jackoff1 folds
Player Ease E Game calls (3)
Player Ms.stone calls (3)
*** FLOP ***: [8s 4d 3d]
Player IlxxxlI bets (0.50)
Player Ease E Game calls (0.50)
Player Ms.stone calls (0.50)
*** TURN ***: [8s 4d 3d] [4h]
Player IlxxxlI checks
Player Ease E Game checks
Player Ms.stone bets (4.04)
Player IlxxxlI folds
Player Ease E Game calls (4.04)
*** RIVER ***: [8s 4d 3d 4h] [3s]
Player Ease E Game checks
Player Ms.stone bets (6.59)
Player Ease E Game calls (6.59)
Player Ease E Game mucks cards
------ Summary ------
Pot: 32.31. Rake 1.46. JP fee 0.24
Board: [8s 4d 3d 4h 3s]
Player Hakuna_Matata777 does not show cards.Bets: 0. Collects: 0. Wins: 0.
Player Ease E Game mucks (does not show cards). Bets: 14.63. Collects: 0. Loses: 14.63.
*Player Ms.stone shows: Full House (4/3) [4s 6s]. Bets: 14.63. Collects: 32.31. Wins: 17.68.
Player smellskindyfishy does not show cards.Bets: 0.25. Collects: 0. Loses: 0.25.
Player IlxxxlI does not show cards.Bets: 4. Collects: 0. Loses: 4.
Player NoizeyCrckt does not show cards.Bets: 0. Collects: 0. Wins: 0.
Player 1jackoff1 does not show cards.Bets: 0.50. Collects: 0. Loses: 0.50.
Player haroldbb does not show cards.Bets: 0. Collects: 0. Wins: 0.
Player rpportugal does not show cards.Bets: 0. Collects: 0. Wins: 0.
Game ended at: 2016/11/28 18:14:4

Game started
Game ID: 786347864 0.25/0.50 (PRR) Gorgons - 5 (Hold'em)
Seat 4 is the button
Seat 1: SenNoSen (115.36).
Seat 2: eu4ria (228.22).
Seat 3: IlxxxlI (23.75).
Seat 4: dscshift (21.88).
Seat 5: pokanaktus (60.02).
Seat 6: wethco (52.30).
Player pokanaktus has small blind (0.25)
Player wethco has big blind (0.50)
Player IlxxxlI received card: [Qs]
Player IlxxxlI received card: [Ad]
Player SenNoSen folds
Player eu4ria folds
Player IlxxxlI raises (1.20)
Player dscshift folds
Player pokanaktus folds
Player wethco folds
Uncalled bet (0.70) returned to IlxxxlI
Player IlxxxlI mucks cards
------ Summary ------
Pot: 1.25. Rake 0
Player SenNoSen does not show cards.Bets: 0. Collects: 0. Wins: 0.
Player eu4ria does not show cards.Bets: 0. Collects: 0. Wins: 0.
*Player IlxxxlI mucks (does not show cards). Bets: 0.50. Collects: 1.25. Wins: 0.75.
Player dscshift does not show cards.Bets: 0. Collects: 0. Wins: 0.
Player pokanaktus does not show cards.Bets: 0.25. Collects: 0. Loses: 0.25.
Player wethco does not show cards.Bets: 0.50. Collects: 0. Loses: 0.50.
Game ended at: 2016/11/28 18:12:21

Game started
Game ID: 786347842 0.25/0.50 (PRR) Gorgons - 17 (Hold'em)
Seat 4 is the button
Seat 1: Smok5 Js (20).
Seat 2: SenNoSen (84.49).
Seat 3: pokanaktus (50).
Seat 4: IlxxxlI (20).
Seat 5: BoTPuMHeDichBro (60.23).
Seat 6: eu4ria (83.08).
Player BoTPuMHeDichBro has small blind (0.25)
Player eu4ria has big blind (0.50)
Player Smok5 Js is timed out.
Player Smok5 Js wait BB
Player IlxxxlI received card: [6d]
Player IlxxxlI received card: [9h]
Player SenNoSen folds
Player pokanaktus folds
Player IlxxxlI folds
Player BoTPuMHeDichBro folds
Uncalled bet (0.25) returned to eu4ria
Player eu4ria mucks cards
------ Summary ------
Pot: 0.50. Rake 0
Player Smok5 Js does not show cards.Bets: 0. Collects: 0. Wins: 0.
Player SenNoSen does not show cards.Bets: 0. Collects: 0. Wins: 0.
Player pokanaktus does not show cards.Bets: 0. Collects: 0. Wins: 0.
Player IlxxxlI does not show cards.Bets: 0. Collects: 0. Wins: 0.
Player BoTPuMHeDichBro does not show cards.Bets: 0.25. Collects: 0. Loses: 0.25.
*Player eu4ria mucks (does not show cards). Bets: 0.25. Collects: 0.50. Wins: 0.25.
Game ended at: 2016/11/28 18:12:17

Game started
Game ID: 786347757 0.25/0.50 (PRR) Gorgons - 5 (Hold'em)
Seat 3 is the button
Seat 1: SenNoSen (115.36).
Seat 2: eu4ria (228.22).
Seat 3: IlxxxlI (23.75).
Seat 4: dscshift (21.43).
Seat 5: pokanaktus (60.52).
Seat 6: wethco (52.30).
Player dscshift has small blind (0.25)
Player pokanaktus has big blind (0.50)
Player IlxxxlI received card: [8c]
Player IlxxxlI received card: [2s]
Player wethco folds
Player SenNoSen folds
Player eu4ria folds
Player IlxxxlI folds
Player dscshift calls (0.25)
Player pokanaktus checks
*** FLOP ***: [10d Jh Kh]
Player dscshift bets (0.50)
Player pokanaktus folds
Uncalled bet (0.50) returned to dscshift
Player dscshift mucks cards
------ Summary ------
Pot: 0.95. Rake 0.05
Board: [10d Jh Kh]
Player SenNoSen does not show cards.Bets: 0. Collects: 0. Wins: 0.
Player eu4ria does not show cards.Bets: 0. Collects: 0. Wins: 0.
Player IlxxxlI does not show cards.Bets: 0. Collects: 0. Wins: 0.
*Player dscshift mucks (does not show cards). Bets: 0.50. Collects: 0.95. Wins: 0.45.
Player pokanaktus does not show cards.Bets: 0.50. Collects: 0. Loses: 0.50.
Player wethco does not show cards.Bets: 0. Collects: 0. Wins: 0.
Game ended at: 2016/11/28 18:12:0

Game started
Game ID: 786347648 0.25/0.50 (PRR) Gorgons - 5 (Hold'em)
Seat 2 is the button
Seat 1: SenNoSen (115.36).
Seat 2: eu4ria (228.22).
Seat 3: IlxxxlI (22.62).
Seat 4: dscshift (22.68).
Seat 5: pokanaktus (60.52).
Seat 6: wethco (52.30).
Player IlxxxlI has small blind (0.25)
Player dscshift has big blind (0.50)
Player IlxxxlI received card: [Ad]
Player IlxxxlI received card: [Qc]
Player pokanaktus folds
Player wethco folds
Player SenNoSen folds
Player eu4ria folds
Player IlxxxlI raises (1)
Player dscshift calls (0.75)
*** FLOP ***: [8h 2s Jd]
Player IlxxxlI bets (1.24)
Player dscshift folds
Uncalled bet (1.24) returned to IlxxxlI
Player IlxxxlI mucks cards
------ Summary ------
Pot: 2.38. Rake 0.08. JP fee 0.04
Board: [8h 2s Jd]
Player SenNoSen does not show cards.Bets: 0. Collects: 0. Wins: 0.
Player eu4ria does not show cards.Bets: 0. Collects: 0. Wins: 0.
*Player IlxxxlI mucks (does not show cards). Bets: 1.25. Collects: 2.38. Wins: 1.13.
Player dscshift does not show cards.Bets: 1.25. Collects: 0. Loses: 1.25.
Player pokanaktus does not show cards.Bets: 0. Collects: 0. Wins: 0.
Player wethco does not show cards.Bets: 0. Collects: 0. Wins: 0.
Game ended at: 2016/11/28 18:11:31

Game started
Game ID: 786347596 0.25/0.50 (PRR) Gorgons - 17 (Hold'em)
Seat 3 is the button
Seat 2: SenNoSen (84.49).
Seat 3: pokanaktus (50).
Seat 4: IlxxxlI (20).
Seat 5: BoTPuMHeDichBro (58.64).
Seat 6: eu4ria (83.08).
Player IlxxxlI has small blind (0.25)
Player BoTPuMHeDichBro has big blind (0.50)
Player IlxxxlI received card: [Ah]
Player IlxxxlI received card: [6c]
Player eu4ria folds
Player SenNoSen folds
Player pokanaktus raises (1.50)
Player IlxxxlI folds
Player BoTPuMHeDichBro calls (1)
*** FLOP ***: [10c 3h Jd]
Player BoTPuMHeDichBro checks
Player pokanaktus checks
*** TURN ***: [10c 3h Jd] [Jh]
Player BoTPuMHeDichBro bets (2.06)
Player pokanaktus folds
Uncalled bet (2.06) returned to BoTPuMHeDichBro
Player BoTPuMHeDichBro mucks cards
------ Summary ------
Pot: 3.09. Rake 0.12. JP fee 0.04
Board: [10c 3h Jd Jh]
Player SenNoSen does not show cards.Bets: 0. Collects: 0. Wins: 0.
Player pokanaktus does not show cards.Bets: 1.50. Collects: 0. Loses: 1.50.
Player IlxxxlI does not show cards.Bets: 0.25. Collects: 0. Loses: 0.25.
*Player BoTPuMHeDichBro mucks (does not show cards). Bets: 1.50. Collects: 3.09. Wins: 1.59.
Player eu4ria does not show cards.Bets: 0. Collects: 0. Wins: 0.
Game ended at: 2016/11/28 18:11:52

Game started
Game ID: 786347569 0.25/0.50 (PRR) Garuda - 3 (Hold'em)
Seat 2 is the button
Seat 1: Hakuna_Matata777 (93.42).
Seat 2: Ease E Game (52.26).
Seat 3: Ms.stone (29.73).
Seat 4: smellskindyfishy (20).
Seat 5: IlxxxlI (20).
Seat 6: NoizeyCrckt (50).
Seat 7: 1jackoff1 (115.27).
Seat 8: haroldbb (87.21).
Seat 9: rpportugal (14.59).
Player Ms.stone has small blind (0.25)
Player smellskindyfishy has big blind (0.50)
Player IlxxxlI received card: [10c]
Player IlxxxlI received card: [Jd]
Player IlxxxlI folds
Player NoizeyCrckt folds
Player 1jackoff1 calls (0.50)
Player haroldbb folds
Player rpportugal folds
Player Hakuna_Matata777 folds
Player Ease E Game folds
Player Ms.stone calls (0.25)
Player smellskindyfishy checks
*** FLOP ***: [6c 3h Qd]
Player Ms.stone checks
Player smellskindyfishy checks
Player 1jackoff1 bets (1)
Player Ms.stone calls (1)
Player smellskindyfishy calls (1)
*** TURN ***: [6c 3h Qd] [7d]
Player Ms.stone checks
Player smellskindyfishy checks
Player 1jackoff1 bets (3)
Player Ms.stone folds
Player smellskindyfishy folds
Uncalled bet (3) returned to 1jackoff1
Player 1jackoff1 mucks cards
------ Summary ------
Pot: 4.28. Rake 0.16. JP fee 0.06
Board: [6c 3h Qd 7d]
Player Hakuna_Matata777 does not show cards.Bets: 0. Collects: 0. Wins: 0.
Player Ease E Game does not show cards.Bets: 0. Collects: 0. Wins: 0.
Player Ms.stone does not show cards.Bets: 1.50. Collects: 0. Loses: 1.50.
Player smellskindyfishy does not show cards.Bets: 1.50. Collects: 0. Loses: 1.50.
Player IlxxxlI does not show cards.Bets: 0. Collects: 0. Wins: 0.
Player NoizeyCrckt does not show cards.Bets: 0. Collects: 0. Wins: 0.
*Player 1jackoff1 mucks (does not show cards). Bets: 1.50. Collects: 4.28. Wins: 2.78.
Player haroldbb does not show cards.Bets: 0. Collects: 0. Wins: 0.
Player rpportugal does not show cards.Bets: 0. Collects: 0. Wins: 0.
Game ended at: 2016/11/28 18:12:16

Game started
Game ID: 786347522 0.25/0.50 (PRR) Gorgons - 5 (Hold'em)
Seat 1 is the button
Seat 1: SenNoSen (114.22).
Seat 2: eu4ria (228.47).
Seat 3: IlxxxlI (23.62).
Seat 4: dscshift (22.68).
Seat 5: pokanaktus (60.52).
Seat 6: wethco (52.30).
Player eu4ria has small blind (0.25)
Player IlxxxlI has big blind (0.50)
Player IlxxxlI received card: [10c]
Player IlxxxlI received card: [8c]
Player dscshift folds
Player pokanaktus folds
Player wethco folds
Player SenNoSen raises (1)
Player eu4ria folds
Player IlxxxlI calls (0.50)
*** FLOP ***: [4h Qh 3d]
Player IlxxxlI checks
Player SenNoSen bets (0.71)
Player IlxxxlI folds
Uncalled bet (0.71) returned to SenNoSen
Player SenNoSen mucks cards
------ Summary ------
Pot: 2.14. Rake 0.09. JP fee 0.02
Board: [4h Qh 3d]
*Player SenNoSen mucks (does not show cards). Bets: 1. Collects: 2.14. Wins: 1.14.
Player eu4ria does not show cards.Bets: 0.25. Collects: 0. Loses: 0.25.
Player IlxxxlI does not show cards.Bets: 1. Collects: 0. Loses: 1.
Player dscshift does not show cards.Bets: 0. Collects: 0. Wins: 0.
Player pokanaktus does not show cards.Bets: 0. Collects: 0. Wins: 0.
Player wethco does not show cards.Bets: 0. Collects: 0. Wins: 0.
Game ended at: 2016/11/28 18:10:58

Game started
Game ID: 786347394 0.25/0.50 (PRR) Gorgons - 5 (Hold'em)
Seat 6 is the button
Seat 1: SenNoSen (114.47).
Seat 2: eu4ria (230.47).
Seat 3: IlxxxlI (23.62).
Seat 4: dscshift (20.64).
Seat 5: pokanaktus (60.52).
Seat 6: wethco (52.30).
Player SenNoSen has small blind (0.25)
Player eu4ria has big blind (0.50)
Player IlxxxlI received card: [Kd]
Player IlxxxlI received card: [6s]
Player IlxxxlI folds
Player dscshift calls (0.50)
Player pokanaktus folds
Player wethco folds
Player SenNoSen folds
Player eu4ria checks
*** FLOP ***: [5d 10c Qc]
Player eu4ria checks
Player dscshift checks
*** TURN ***: [5d 10c Qc] [9s]
Player eu4ria bets (1.50)
Player dscshift raises (3)
Player eu4ria folds
Uncalled bet (1.50) returned to dscshift
Player dscshift mucks cards
------ Summary ------
Pot: 4.04. Rake 0.15. JP fee 0.06
Board: [5d 10c Qc 9s]
Player SenNoSen does not show cards.Bets: 0.25. Collects: 0. Loses: 0.25.
Player eu4ria does not show cards.Bets: 2. Collects: 0. Loses: 2.
Player IlxxxlI does not show cards.Bets: 0. Collects: 0. Wins: 0.
*Player dscshift mucks (does not show cards). Bets: 2. Collects: 4.04. Wins: 2.04.
Player pokanaktus does not show cards.Bets: 0. Collects: 0. Wins: 0.
Player wethco does not show cards.Bets: 0. Collects: 0. Wins: 0.
Game ended at: 2016/11/28 18:10:25

Game started
Game ID: 786347359 0.25/0.50 (PRR) Garuda - 3 (Hold'em)
Seat 1 is the button
Seat 1: Hakuna_Matata777 (93.42).
Seat 2: Ease E Game (52.51).
Seat 3: Ms.stone (30.23).
Seat 4: smellskindyfishy (20).
Seat 5: IlxxxlI (20).
Seat 6: NoizeyCrckt (22.49).
Seat 7: 1jackoff1 (114.88).
Seat 8: haroldbb (86.81).
Seat 9: rpportugal (16.09).
Player Ease E Game has small blind (0.25)
Player Ms.stone has big blind (0.50)
Player IlxxxlI received card: [6s]
Player IlxxxlI received card: [2c]
Player smellskindyfishy folds
Player IlxxxlI folds
Player NoizeyCrckt folds
Player 1jackoff1 calls (0.50)
Player haroldbb raises (1.50)
Player rpportugal calls (1.50)
Player Hakuna_Matata777 folds
Player Ease E Game folds
Player Ms.stone folds
Player 1jackoff1 calls (1)
*** FLOP ***: [Ac 3c Jd]
Player 1jackoff1 bets (3)
Player haroldbb calls (3)
Player rpportugal folds
*** TURN ***: [Ac 3c Jd] [2h]
Player 1jackoff1 bets (3)
Player haroldbb calls (3)
*** RIVER ***: [Ac 3c Jd 2h] [5c]
Player 1jackoff1 bets (6)
Player haroldbb calls (6)
------ Summary ------
Pot: 27.79. Rake 1.22. JP fee 0.24
Board: [Ac 3c Jd 2h 5c]
Player Hakuna_Matata777 does not show cards.Bets: 0. Collects: 0. Wins: 0.
Player Ease E Game does not show cards.Bets: 0.25. Collects: 0. Loses: 0.25.
Player Ms.stone does not show cards.Bets: 0.50. Collects: 0. Loses: 0.50.
Player smellskindyfishy does not show cards.Bets: 0. Collects: 0. Wins: 0.
Player IlxxxlI does not show cards.Bets: 0. Collects: 0. Wins: 0.
Player NoizeyCrckt does not show cards.Bets: 0. Collects: 0. Wins: 0.
*Player 1jackoff1 shows: One pair of Js [Jh 10c]. Bets: 13.50. Collects: 13.89. Wins: 0.39.
*Player haroldbb shows: One pair of Js [10s Jc]. Bets: 13.50. Collects: 13.90. Wins: 0.40.
Player rpportugal does not show cards.Bets: 1.50. Collects: 0. Loses: 1.50.
Game ended at: 2016/11/28 18:10:34

Game started
Game ID: 786347294 0.25/0.50 (PRR) Gorgons - 5 (Hold'em)
Seat 5 is the button
Seat 1: SenNoSen (114.97).
Seat 2: eu4ria (230.47).
Seat 3: IlxxxlI (22.87).
Seat 4: dscshift (20.64).
Seat 5: pokanaktus (60.52).
Seat 6: wethco (52.55).
Player wethco has small blind (0.25)
Player SenNoSen has big blind (0.50)
Player IlxxxlI received card: [10c]
Player IlxxxlI received card: [Ac]
Player eu4ria folds
Player IlxxxlI raises (1.75)
Player dscshift folds
Player pokanaktus folds
Player wethco folds
Player SenNoSen folds
Uncalled bet (1.25) returned to IlxxxlI
Player IlxxxlI mucks cards
------ Summary ------
Pot: 1.25. Rake 0
Player SenNoSen does not show cards.Bets: 0.50. Collects: 0. Loses: 0.50.
Player eu4ria does not show cards.Bets: 0. Collects: 0. Wins: 0.
*Player IlxxxlI mucks (does not show cards). Bets: 0.50. Collects: 1.25. Wins: 0.75.
Player dscshift does not show cards.Bets: 0. Collects: 0. Wins: 0.
Player pokanaktus does not show cards.Bets: 0. Collects: 0. Wins: 0.
Player wethco does not show cards.Bets: 0.25. Collects: 0. Loses: 0.25.
Game ended at: 2016/11/28 18:9:49

Game started
Game ID: 786347174 0.25/0.50 (PRR) Gorgons - 5 (Hold'em)
Seat 4 is the button
Seat 1: SenNoSen (114.97).
Seat 2: eu4ria (229.72).
Seat 3: IlxxxlI (22.87).
Seat 4: dscshift (20.64).
Seat 5: pokanaktus (60.77).
Seat 6: wethco (53.05).
Player pokanaktus has small blind (0.25)
Player wethco has big blind (0.50)
Player IlxxxlI received card: [9s]
Player IlxxxlI received card: [10c]
Player SenNoSen folds
Player eu4ria raises (1.50)
Player IlxxxlI folds
Player dscshift folds
Player pokanaktus folds
Player wethco folds
Uncalled bet (1) returned to eu4ria
Player eu4ria mucks cards
------ Summary ------
Pot: 1.25. Rake 0
Player SenNoSen does not show cards.Bets: 0. Collects: 0. Wins: 0.
*Player eu4ria mucks (does not show cards). Bets: 0.50. Collects: 1.25. Wins: 0.75.
Player IlxxxlI does not show cards.Bets: 0. Collects: 0. Wins: 0.
Player dscshift does not show cards.Bets: 0. Collects: 0. Wins: 0.
Player pokanaktus does not show cards.Bets: 0.25. Collects: 0. Loses: 0.25.
Player wethco does not show cards.Bets: 0.50. Collects: 0. Loses: 0.50.
Game ended at: 2016/11/28 18:9:21

Game started
Game ID: 786347138 0.25/0.50 (PRR) Gorgons - 17 (Hold'em)
Seat 2 is the button
Seat 2: SenNoSen (81.78).
Seat 3: pokanaktus (50).
Seat 4: IlxxxlI (20).
Seat 5: BoTPuMHeDichBro (58.64).
Seat 6: eu4ria (83.08).
Player pokanaktus has small blind (0.25)
Player IlxxxlI has big blind (0.50)
Player IlxxxlI received card: [7h]
Player IlxxxlI received card: [8d]
Player BoTPuMHeDichBro folds
Player eu4ria folds
Player SenNoSen raises (1)
Player pokanaktus calls (0.75)
Player IlxxxlI calls (0.50)
*** FLOP ***: [4h 8c Ac]
Player pokanaktus checks
Player IlxxxlI checks
Player SenNoSen checks
*** TURN ***: [4h 8c Ac] [6c]
Player pokanaktus checks
Player IlxxxlI checks
Player SenNoSen checks
*** RIVER ***: [4h 8c Ac 6c] [10d]
Player pokanaktus checks
Player IlxxxlI checks
Player SenNoSen bets (0.95)
Player pokanaktus folds
Player IlxxxlI calls (0.95)
Player IlxxxlI mucks cards
------ Summary ------
Pot: 4.66. Rake 0.16. JP fee 0.08
Board: [4h 8c Ac 6c 10d]
*Player SenNoSen shows: Two pairs. As and 4s [Ah 4c]. Bets: 1.95. Collects: 4.66. Wins: 2.71.
Player pokanaktus does not show cards.Bets: 1. Collects: 0. Loses: 1.
Player IlxxxlI mucks (does not show: [7h 8d]). Bets: 1.95. Collects: 0. Loses: 1.95.
Player BoTPuMHeDichBro does not show cards.Bets: 0. Collects: 0. Wins: 0.
Player eu4ria does not show cards.Bets: 0. Collects: 0. Wins: 0.
Game ended at: 2016/11/28 18:10:41

Game started
Game ID: 786347086 0.25/0.50 (PRR) Gorgons - 5 (Hold'em)
Seat 3 is the button
Seat 1: SenNoSen (114.97).
Seat 2: eu4ria (229.72).
Seat 3: IlxxxlI (22.87).
Seat 4: dscshift (21.14).
Seat 5: pokanaktus (60.27).
Seat 6: wethco (53.05).
Player dscshift has small blind (0.25)
Player pokanaktus has big blind (0.50)
Player IlxxxlI received card: [4s]
Player IlxxxlI received card: [7h]
Player wethco folds
Player SenNoSen folds
Player eu4ria folds
Player IlxxxlI folds
Player dscshift calls (0.25)
Player pokanaktus raises (1)
Player dscshift folds
Uncalled bet (1) returned to pokanaktus
Player pokanaktus mucks cards
------ Summary ------
Pot: 1. Rake 0
Player SenNoSen does not show cards.Bets: 0. Collects: 0. Wins: 0.
Player eu4ria does not show cards.Bets: 0. Collects: 0. Wins: 0.
Player IlxxxlI does not show cards.Bets: 0. Collects: 0. Wins: 0.
Player dscshift does not show cards.Bets: 0.50. Collects: 0. Loses: 0.50.
*Player pokanaktus mucks (does not show cards). Bets: 0.50. Collects: 1. Wins: 0.50.
Player wethco does not show cards.Bets: 0. Collects: 0. Wins: 0.
Game ended at: 2016/11/28 18:8:48

Game started
Game ID: 786347068 0.25/0.50 (PRR) Garuda - 3 (Hold'em)
Seat 9 is the button
Seat 1: Hakuna_Matata777 (93.67).
Seat 2: Ease E Game (26.01).
Seat 3: Ms.stone (30.23).
Seat 4: smellskindyfishy (20).
Seat 5: IlxxxlI (20).
Seat 6: NoizeyCrckt (48.50).
Seat 7: 1jackoff1 (116.38).
Seat 8: haroldbb (86.81).
Seat 9: rpportugal (17.59).
Player Hakuna_Matata777 has small blind (0.25)
Player Ease E Game has big blind (0.50)
Player IlxxxlI received card: [2d]
Player IlxxxlI received card: [2s]
Player Ms.stone folds
Player smellskindyfishy folds
Player IlxxxlI folds
Player NoizeyCrckt raises (1.50)
Player 1jackoff1 calls (1.50)
Player haroldbb folds
Player rpportugal calls (1.50)
Player Hakuna_Matata777 folds
Player Ease E Game calls (1)
*** FLOP ***: [Ah Qc 9c]
Player Ease E Game checks
Player NoizeyCrckt bets (3.75)
Player 1jackoff1 folds
Player rpportugal folds
Player Ease E Game allin (24.51)
Player NoizeyCrckt calls (20.76)
*** TURN ***: [Ah Qc 9c] [5h]
*** RIVER ***: [Ah Qc 9c 5h] [6d]
------ Summary ------
Pot: 52.51. Rake 2.52. JP fee 0.24
Board: [Ah Qc 9c 5h 6d]
Player Hakuna_Matata777 does not show cards.Bets: 0.25. Collects: 0. Loses: 0.25.
*Player Ease E Game shows: One pair of As [Ac 10c]. Bets: 26.01. Collects: 52.51. Wins: 26.50.
Player Ms.stone does not show cards.Bets: 0. Collects: 0. Wins: 0.
Player smellskindyfishy does not show cards.Bets: 0. Collects: 0. Wins: 0.
Player IlxxxlI does not show cards.Bets: 0. Collects: 0. Wins: 0.
Player NoizeyCrckt shows: High card A [Jh 10h]. Bets: 26.01. Collects: 0. Loses: 26.01.
Player 1jackoff1 does not show cards.Bets: 1.50. Collects: 0. Loses: 1.50.
Player haroldbb does not show cards.Bets: 0. Collects: 0. Wins: 0.
Player rpportugal does not show cards.Bets: 1.50. Collects: 0. Loses: 1.50.
Game ended at: 2016/11/28 18:9:37

Game started
Game ID: 786347041 0.25/0.50 (PRR) Gorgons - 17 (Hold'em)
Seat 6 is the button
Seat 2: SenNoSen (82.03).
Seat 3: pokanaktus (50).
Seat 4: IlxxxlI (20).
Seat 5: BoTPuMHeDichBro (58.64).
Seat 6: eu4ria (82.33).
Player SenNoSen has small blind (0.25)
Player pokanaktus has big blind (0.50)
Player IlxxxlI received card: [3h]
Player IlxxxlI received card: [Ac]
Player IlxxxlI folds
Player BoTPuMHeDichBro folds
Player eu4ria raises (1.25)
Player SenNoSen folds
Player pokanaktus folds
Uncalled bet (0.75) returned to eu4ria
Player eu4ria mucks cards
------ Summary ------
Pot: 1.25. Rake 0
Player SenNoSen does not show cards.Bets: 0.25. Collects: 0. Loses: 0.25.
Player pokanaktus does not show cards.Bets: 0.50. Collects: 0. Loses: 0.50.
Player IlxxxlI does not show cards.Bets: 0. Collects: 0. Wins: 0.
Player BoTPuMHeDichBro does not show cards.Bets: 0. Collects: 0. Wins: 0.
*Player eu4ria mucks (does not show cards). Bets: 0.50. Collects: 1.25. Wins: 0.75.
Game ended at: 2016/11/28 18:8:38

Game started
Game ID: 786346911 0.25/0.50 (PRR) Gorgons - 5 (Hold'em)
Seat 2 is the button
Seat 1: SenNoSen (114.97).
Seat 2: eu4ria (229.72).
Seat 3: IlxxxlI (23.12).
Seat 4: dscshift (20).
Seat 5: pokanaktus (60.27).
Seat 6: wethco (54.05).
Player IlxxxlI has small blind (0.25)
Player dscshift has big blind (0.50)
Player IlxxxlI received card: [Qs]
Player IlxxxlI received card: [2h]
Player pokanaktus folds
Player wethco calls (0.50)
Player SenNoSen folds
Player eu4ria folds
Player IlxxxlI folds
Player dscshift checks
*** FLOP ***: [2c 8s Qc]
Player dscshift checks
Player wethco bets (0.50)
Player dscshift calls (0.50)
*** TURN ***: [2c 8s Qc] [Jh]
Player dscshift checks
Player wethco checks
*** RIVER ***: [2c 8s Qc Jh] [7c]
Player dscshift bets (0.50)
Player wethco folds
Uncalled bet (0.50) returned to dscshift
Player dscshift mucks cards
------ Summary ------
Pot: 2.14. Rake 0.09. JP fee 0.02
Board: [2c 8s Qc Jh 7c]
Player SenNoSen does not show cards.Bets: 0. Collects: 0. Wins: 0.
Player eu4ria does not show cards.Bets: 0. Collects: 0. Wins: 0.
Player IlxxxlI does not show cards.Bets: 0.25. Collects: 0. Loses: 0.25.
*Player dscshift mucks (does not show cards). Bets: 1. Collects: 2.14. Wins: 1.14.
Player pokanaktus does not show cards.Bets: 0. Collects: 0. Wins: 0.
Player wethco does not show cards.Bets: 1. Collects: 0. Loses: 1.
Game ended at: 2016/11/28 18:8:24

Game started
Game ID: 786346848 0.25/0.50 (PRR) Garuda - 3 (Hold'em)
Seat 8 is the button
Seat 1: Hakuna_Matata777 (89.17).
Seat 3: Ms.stone (30.23).
Seat 4: smellskindyfishy (7).
Seat 5: IlxxxlI (20).
Seat 6: NoizeyCrckt (50).
Seat 7: 1jackoff1 (117.88).
Seat 8: haroldbb (86.81).
Seat 9: rpportugal (19.09).
Player rpportugal has small blind (0.25)
Player Hakuna_Matata777 has big blind (0.50)
Player IlxxxlI received card: [As]
Player IlxxxlI received card: [4s]
Player Ms.stone folds
Player smellskindyfishy folds
Player IlxxxlI folds
Player NoizeyCrckt raises (1.50)
Player 1jackoff1 calls (1.50)
Player haroldbb folds
Player rpportugal calls (1.25)
Player Hakuna_Matata777 raises (7)
Player NoizeyCrckt folds
Player 1jackoff1 folds
Player rpportugal folds
Uncalled bet (6) returned to Hakuna_Matata777
Player Hakuna_Matata777 mucks cards
------ Summary ------
Pot: 6. Rake 0
*Player Hakuna_Matata777 mucks (does not show cards). Bets: 1.50. Collects: 6. Wins: 4.50.
Player Ms.stone does not show cards.Bets: 0. Collects: 0. Wins: 0.
Player smellskindyfishy does not show cards.Bets: 0. Collects: 0. Wins: 0.
Player IlxxxlI does not show cards.Bets: 0. Collects: 0. Wins: 0.
Player NoizeyCrckt does not show cards.Bets: 1.50. Collects: 0. Loses: 1.50.
Player 1jackoff1 does not show cards.Bets: 1.50. Collects: 0. Loses: 1.50.
Player haroldbb does not show cards.Bets: 0. Collects: 0. Wins: 0.
Player rpportugal does not show cards.Bets: 1.50. Collects: 0. Loses: 1.50.
Game ended at: 2016/11/28 18:8:18

Game started
Game ID: 786346773 0.25/0.50 (PRR) Gorgons - 17 (Hold'em)
Seat 5 is the button
Seat 1: Hakuna_Matata777 (63.50).
Seat 2: SenNoSen (79.54).
Seat 3: pokanaktus (50.75).
Seat 4: IlxxxlI (20).
Seat 5: BoTPuMHeDichBro (58.64).
Seat 6: eu4ria (82.58).
Player eu4ria has small blind (0.25)
Player Hakuna_Matata777 sitting out
Player SenNoSen has big blind (0.50)
Player IlxxxlI received card: [3d]
Player IlxxxlI received card: [10d]
Player pokanaktus raises (1)
Player IlxxxlI folds
Player BoTPuMHeDichBro folds
Player eu4ria folds
Player SenNoSen calls (0.50)
*** FLOP ***: [Js 2c 3s]
Player SenNoSen checks
Player pokanaktus bets (1.50)
Player SenNoSen calls (1.50)
*** TURN ***: [Js 2c 3s] [8s]
Player SenNoSen checks
Player pokanaktus is timed out.
Player pokanaktus checks
*** RIVER ***: [Js 2c 3s 8s] [10s]
Player SenNoSen checks
Player pokanaktus checks
Player pokanaktus mucks cards
------ Summary ------
Pot: 4.99. Rake 0.18. JP fee 0.08
Board: [Js 2c 3s 8s 10s]
Player Hakuna_Matata777 does not show cards.Bets: 0. Collects: 0. Wins: 0.
*Player SenNoSen shows: Flush, J high [5s 6s]. Bets: 2.50. Collects: 4.99. Wins: 2.49.
Player pokanaktus mucks (does not show cards). Bets: 2.50. Collects: 0. Loses: 2.50.
Player IlxxxlI does not show cards.Bets: 0. Collects: 0. Wins: 0.
Player BoTPuMHeDichBro does not show cards.Bets: 0. Collects: 0. Wins: 0.
Player eu4ria does not show cards.Bets: 0.25. Collects: 0. Loses: 0.25.
Game ended at: 2016/11/28 18:8:5

Game started
Game ID: 786346766 0.25/0.50 (PRR) Gorgons - 5 (Hold'em)
Seat 1 is the button
Seat 1: SenNoSen (114.97).
Seat 2: eu4ria (228.34).
Seat 3: IlxxxlI (23.62).
Seat 5: pokanaktus (61.27).
Seat 6: wethco (54.05).
Player eu4ria has small blind (0.25)
Player IlxxxlI has big blind (0.50)
Player IlxxxlI received card: [10d]
Player IlxxxlI received card: [5c]
Player pokanaktus raises (1)
Player wethco folds
Player SenNoSen folds
Player eu4ria calls (0.75)
Player IlxxxlI folds
*** FLOP ***: [Jd 4h Jc]
Player eu4ria checks
Player pokanaktus checks
*** TURN ***: [Jd 4h Jc] [8d]
Player eu4ria bets (1.50)
Player pokanaktus folds
Uncalled bet (1.50) returned to eu4ria
Player eu4ria mucks cards
------ Summary ------
Pot: 2.38. Rake 0.08. JP fee 0.04
Board: [Jd 4h Jc 8d]
Player SenNoSen does not show cards.Bets: 0. Collects: 0. Wins: 0.
*Player eu4ria mucks (does not show cards). Bets: 1. Collects: 2.38. Wins: 1.38.
Player IlxxxlI does not show cards.Bets: 0.50. Collects: 0. Loses: 0.50.
Player pokanaktus does not show cards.Bets: 1. Collects: 0. Loses: 1.
Player wethco does not show cards.Bets: 0. Collects: 0. Wins: 0.
Game ended at: 2016/11/28 18:7:36

Game started
Game ID: 786346729 0.25/0.50 (PRR) Gorgons - 8 (Hold'em)
Seat 2 is the button
Seat 1: sucazappa (65.48).
Seat 2: IlxxxlI (38.69).
Seat 4: SenNoSen (101.05).
Seat 5: eu4ria (90.52).
Seat 6: DonkReaper (89.31).
Player SenNoSen has small blind (0.25)
Player eu4ria has big blind (0.50)
Player IlxxxlI received card: [Ad]
Player IlxxxlI received card: [Js]
Player DonkReaper folds
Player sucazappa folds
Player IlxxxlI raises (1.50)
Player SenNoSen folds
Player eu4ria folds
Uncalled bet (1) returned to IlxxxlI
Player IlxxxlI mucks cards
------ Summary ------
Pot: 1.25. Rake 0
Player sucazappa does not show cards.Bets: 0. Collects: 0. Wins: 0.
*Player IlxxxlI mucks (does not show cards). Bets: 0.50. Collects: 1.25. Wins: 0.75.
Player SenNoSen does not show cards.Bets: 0.25. Collects: 0. Loses: 0.25.
Player eu4ria does not show cards.Bets: 0.50. Collects: 0. Loses: 0.50.
Player DonkReaper does not show cards.Bets: 0. Collects: 0. Wins: 0.
Game ended at: 2016/11/28 18:6:59

Game started
Game ID: 786346690 0.25/0.50 (PRR) Gorgons - 5 (Hold'em)
Seat 6 is the button
Seat 1: SenNoSen (114.47).
Seat 2: eu4ria (228.84).
Seat 3: IlxxxlI (23.62).
Seat 5: pokanaktus (61.27).
Seat 6: wethco (54.05).
Player SenNoSen has small blind (0.25)
Player eu4ria has big blind (0.50)
Player IlxxxlI received card: [8h]
Player IlxxxlI received card: [3d]
Player IlxxxlI folds
Player pokanaktus folds
Player wethco folds
Player SenNoSen raises (1.25)
Player eu4ria folds
Uncalled bet (1) returned to SenNoSen
Player SenNoSen mucks cards
------ Summary ------
Pot: 1. Rake 0
*Player SenNoSen mucks (does not show cards). Bets: 0.50. Collects: 1. Wins: 0.50.
Player eu4ria does not show cards.Bets: 0.50. Collects: 0. Loses: 0.50.
Player IlxxxlI does not show cards.Bets: 0. Collects: 0. Wins: 0.
Player pokanaktus does not show cards.Bets: 0. Collects: 0. Wins: 0.
Player wethco does not show cards.Bets: 0. Collects: 0. Wins: 0.
Game ended at: 2016/11/28 18:6:51

Game started
Game ID: 786346665 0.25/0.50 (PRR) Gorgons - 17 (Hold'em)
Seat 4 is the button
Seat 1: Hakuna_Matata777 (63.50).
Seat 2: SenNoSen (79.54).
Seat 3: pokanaktus (50.75).
Seat 4: IlxxxlI (20).
Seat 5: BoTPuMHeDichBro (57.64).
Seat 6: eu4ria (83.08).
Player BoTPuMHeDichBro has small blind (0.25)
Player eu4ria has big blind (0.50)
Player IlxxxlI received card: [6c]
Player IlxxxlI received card: [Ad]
Player Hakuna_Matata777 folds
Player SenNoSen folds
Player pokanaktus folds
Player IlxxxlI calls (0.50)
Player BoTPuMHeDichBro raises (2.25)
Player eu4ria folds
Player IlxxxlI folds
Uncalled bet (2) returned to BoTPuMHeDichBro
Player BoTPuMHeDichBro mucks cards
------ Summary ------
Pot: 1.50. Rake 0
Player Hakuna_Matata777 does not show cards.Bets: 0. Collects: 0. Wins: 0.
Player SenNoSen does not show cards.Bets: 0. Collects: 0. Wins: 0.
Player pokanaktus does not show cards.Bets: 0. Collects: 0. Wins: 0.
Player IlxxxlI does not show cards.Bets: 0.50. Collects: 0. Loses: 0.50.
*Player BoTPuMHeDichBro mucks (does not show cards). Bets: 0.50. Collects: 1.50. Wins: 1.
Player eu4ria does not show cards.Bets: 0.50. Collects: 0. Loses: 0.50.
Game ended at: 2016/11/28 18:6:52

Game started
Game ID: 786346599 0.25/0.50 (PRR) Garuda - 3 (Hold'em)
Seat 7 is the button
Seat 1: Hakuna_Matata777 (89.17).
Seat 3: Ms.stone (30.23).
Seat 4: smellskindyfishy (19.50).
Seat 5: IlxxxlI (20).
Seat 6: NoizeyCrckt (45.25).
Seat 7: 1jackoff1 (104.96).
Seat 8: haroldbb (87.06).
Seat 9: rpportugal (20.59).
Player haroldbb has small blind (0.25)
Player rpportugal has big blind (0.50)
Player IlxxxlI received card: [Ac]
Player IlxxxlI received card: [7c]
Player Hakuna_Matata777 folds
Player Ms.stone folds
Player smellskindyfishy raises (1.50)
Player IlxxxlI folds
Player NoizeyCrckt folds
Player 1jackoff1 calls (1.50)
Player haroldbb folds
Player rpportugal calls (1)
*** FLOP ***: [9h Qs 6h]
Player rpportugal checks
Player smellskindyfishy bets (2)
Player 1jackoff1 raises (6)
Player rpportugal folds
Player smellskindyfishy calls (4)
*** TURN ***: [9h Qs 6h] [4d]
Player smellskindyfishy checks
Player 1jackoff1 bets (5)
Player smellskindyfishy calls (5)
*** RIVER ***: [9h Qs 6h 4d] [3c]
Player smellskindyfishy checks
Player 1jackoff1 checks
Player smellskindyfishy mucks cards
------ Summary ------
Pot: 25.42. Rake 1.09. JP fee 0.24
Board: [9h Qs 6h 4d 3c]
Player Hakuna_Matata777 does not show cards.Bets: 0. Collects: 0. Wins: 0.
Player Ms.stone does not show cards.Bets: 0. Collects: 0. Wins: 0.
Player smellskindyfishy mucks (does not show cards). Bets: 12.50. Collects: 0. Loses: 12.50.
Player IlxxxlI does not show cards.Bets: 0. Collects: 0. Wins: 0.
Player NoizeyCrckt does not show cards.Bets: 0. Collects: 0. Wins: 0.
*Player 1jackoff1 shows: One pair of Qs [Kd Qc]. Bets: 12.50. Collects: 25.42. Wins: 12.92.
Player haroldbb does not show cards.Bets: 0.25. Collects: 0. Loses: 0.25.
Player rpportugal does not show cards.Bets: 1.50. Collects: 0. Loses: 1.50.
Game ended at: 2016/11/28 18:7:16

Game started
Game ID: 786346566 0.25/0.50 (PRR) Gorgons - 17 (Hold'em)
Seat 3 is the button
Seat 1: Hakuna_Matata777 (63.50).
Seat 2: SenNoSen (79.54).
Seat 3: pokanaktus (50).
Seat 4: IlxxxlI (20).
Seat 5: BoTPuMHeDichBro (58.14).
Seat 6: eu4ria (83.08).
Player IlxxxlI has small blind (0.25)
Player BoTPuMHeDichBro has big blind (0.50)
Player IlxxxlI received card: [Qc]
Player IlxxxlI received card: [7c]
Player eu4ria folds
Player Hakuna_Matata777 folds
Player SenNoSen folds
Player pokanaktus raises (1.50)
Player IlxxxlI folds
Player BoTPuMHeDichBro folds
Uncalled bet (1) returned to pokanaktus
Player pokanaktus mucks cards
------ Summary ------
Pot: 1.25. Rake 0
Player Hakuna_Matata777 does not show cards.Bets: 0. Collects: 0. Wins: 0.
Player SenNoSen does not show cards.Bets: 0. Collects: 0. Wins: 0.
*Player pokanaktus mucks (does not show cards). Bets: 0.50. Collects: 1.25. Wins: 0.75.
Player IlxxxlI does not show cards.Bets: 0.25. Collects: 0. Loses: 0.25.
Player BoTPuMHeDichBro does not show cards.Bets: 0.50. Collects: 0. Loses: 0.50.
Player eu4ria does not show cards.Bets: 0. Collects: 0. Wins: 0.
Game ended at: 2016/11/28 18:6:22

Game started
Game ID: 786346502 0.25/0.50 (PRR) Gorgons - 5 (Hold'em)
Seat 5 is the button
Seat 1: SenNoSen (115.97).
Seat 2: eu4ria (228.84).
Seat 3: IlxxxlI (23.62).
Seat 5: pokanaktus (59.68).
Seat 6: wethco (54.30).
Player wethco has small blind (0.25)
Player SenNoSen has big blind (0.50)
Player IlxxxlI received card: [4s]
Player IlxxxlI received card: [Kd]
Player eu4ria folds
Player IlxxxlI folds
Player pokanaktus raises (1.50)
Player wethco folds
Player SenNoSen calls (1)
*** FLOP ***: [7s Qs 9h]
Player SenNoSen checks
Player pokanaktus checks
*** TURN ***: [7s Qs 9h] [Qh]
Player SenNoSen checks
Player pokanaktus bets (2.06)
Player SenNoSen folds
Uncalled bet (2.06) returned to pokanaktus
Player pokanaktus mucks cards
------ Summary ------
Pot: 3.09. Rake 0.12. JP fee 0.04
Board: [7s Qs 9h Qh]
Player SenNoSen does not show cards.Bets: 1.50. Collects: 0. Loses: 1.50.
Player eu4ria does not show cards.Bets: 0. Collects: 0. Wins: 0.
Player IlxxxlI does not show cards.Bets: 0. Collects: 0. Wins: 0.
*Player pokanaktus mucks (does not show cards). Bets: 1.50. Collects: 3.09. Wins: 1.59.
Player wethco does not show cards.Bets: 0.25. Collects: 0. Loses: 0.25.
Game ended at: 2016/11/28 18:6:29

Game started
Game ID: 786346445 0.25/0.50 (PRR) Gorgons - 17 (Hold'em)
Seat 2 is the button
Seat 1: Hakuna_Matata777 (63.50).
Seat 2: SenNoSen (79.54).
Seat 3: pokanaktus (50).
Seat 4: IlxxxlI (20).
Seat 5: BoTPuMHeDichBro (58.14).
Seat 6: eu4ria (82.33).
Player pokanaktus has small blind (0.25)
Player IlxxxlI has big blind (0.50)
Player IlxxxlI received card: [7c]
Player IlxxxlI received card: [3s]
Player BoTPuMHeDichBro folds
Player eu4ria raises (1.50)
Player Hakuna_Matata777 folds
Player SenNoSen folds
Player pokanaktus folds
Player IlxxxlI folds
Uncalled bet (1) returned to eu4ria
Player eu4ria mucks cards
------ Summary ------
Pot: 1.25. Rake 0
Player Hakuna_Matata777 does not show cards.Bets: 0. Collects: 0. Wins: 0.
Player SenNoSen does not show cards.Bets: 0. Collects: 0. Wins: 0.
Player pokanaktus does not show cards.Bets: 0.25. Collects: 0. Loses: 0.25.
Player IlxxxlI does not show cards.Bets: 0.50. Collects: 0. Loses: 0.50.
Player BoTPuMHeDichBro does not show cards.Bets: 0. Collects: 0. Wins: 0.
*Player eu4ria mucks (does not show cards). Bets: 0.50. Collects: 1.25. Wins: 0.75.
Game ended at: 2016/11/28 18:5:50

Game started
Game ID: 786346441 0.25/0.50 (PRR) Garuda - 3 (Hold'em)
Seat 6 is the button
Seat 1: Hakuna_Matata777 (91.67).
Seat 3: Ms.stone (30.23).
Seat 4: smellskindyfishy (19.50).
Seat 5: IlxxxlI (20).
Seat 6: NoizeyCrckt (47.75).
Seat 7: 1jackoff1 (99.38).
Seat 8: haroldbb (87.56).
Seat 9: rpportugal (21.09).
Player 1jackoff1 has small blind (0.25)
Player haroldbb has big blind (0.50)
Player IlxxxlI received card: [4h]
Player IlxxxlI received card: [7s]
Player rpportugal calls (0.50)
Player Hakuna_Matata777 raises (2.50)
Player Ms.stone folds
Player smellskindyfishy folds
Player IlxxxlI folds
Player NoizeyCrckt calls (2.50)
Player 1jackoff1 calls (2.25)
Player haroldbb folds
Player rpportugal folds
*** FLOP ***: [Qc 9d 2d]
Player 1jackoff1 bets (5)
Player Hakuna_Matata777 folds
Player NoizeyCrckt folds
Uncalled bet (5) returned to 1jackoff1
Player 1jackoff1 mucks cards
------ Summary ------
Pot: 8.08. Rake 0.28. JP fee 0.14
Board: [Qc 9d 2d]
Player Hakuna_Matata777 does not show cards.Bets: 2.50. Collects: 0. Loses: 2.50.
Player Ms.stone does not show cards.Bets: 0. Collects: 0. Wins: 0.
Player smellskindyfishy does not show cards.Bets: 0. Collects: 0. Wins: 0.
Player IlxxxlI does not show cards.Bets: 0. Collects: 0. Wins: 0.
Player NoizeyCrckt does not show cards.Bets: 2.50. Collects: 0. Loses: 2.50.
*Player 1jackoff1 mucks (does not show cards). Bets: 2.50. Collects: 8.08. Wins: 5.58.
Player haroldbb does not show cards.Bets: 0.50. Collects: 0. Loses: 0.50.
Player rpportugal does not show cards.Bets: 0.50. Collects: 0. Loses: 0.50.
Game ended at: 2016/11/28 18:6:2

Game started
Game ID: 786346398 0.25/0.50 (PRR) Gorgons - 5 (Hold'em)
Seat 3 is the button
Seat 1: SenNoSen (115.97).
Seat 2: eu4ria (228.84).
Seat 3: IlxxxlI (23.62).
Seat 5: pokanaktus (59.18).
Seat 6: wethco (54.80).
Player pokanaktus has small blind (0.25)
Player wethco has big blind (0.50)
Player IlxxxlI received card: [7c]
Player IlxxxlI received card: [Js]
Player SenNoSen folds
Player eu4ria folds
Player IlxxxlI folds
Player pokanaktus raises (1.25)
Player wethco folds
Uncalled bet (1) returned to pokanaktus
Player pokanaktus mucks cards
------ Summary ------
Pot: 1. Rake 0
Player SenNoSen does not show cards.Bets: 0. Collects: 0. Wins: 0.
Player eu4ria does not show cards.Bets: 0. Collects: 0. Wins: 0.
Player IlxxxlI does not show cards.Bets: 0. Collects: 0. Wins: 0.
*Player pokanaktus mucks (does not show cards). Bets: 0.50. Collects: 1. Wins: 0.50.
Player wethco does not show cards.Bets: 0.50. Collects: 0. Loses: 0.50.
Game ended at: 2016/11/28 18:5:32

Game started
Game ID: 786346381 0.25/0.50 (PRR) Gorgons - 8 (Hold'em)
Seat 6 is the button
Seat 1: sucazappa (65.73).
Seat 2: IlxxxlI (20).
Seat 3: BoTPuMHeDichBro (50).
Seat 5: eu4ria (90.52).
Seat 6: DonkReaper (109.31).
Player sucazappa has small blind (0.25)
Player IlxxxlI has big blind (0.50)
Player IlxxxlI received card: [Ad]
Player IlxxxlI received card: [Ah]
Player BoTPuMHeDichBro folds
Player eu4ria folds
Player DonkReaper raises (1.50)
Player sucazappa folds
Player IlxxxlI raises (3.30)
Player DonkReaper calls (2.30)
*** FLOP ***: [7h 6s 6c]
Player IlxxxlI bets (2.48)
Player DonkReaper allin (105.51)
Player IlxxxlI allin (13.72)
Uncalled bet (89.31) returned to DonkReaper
*** TURN ***: [7h 6s 6c] [5h]
*** RIVER ***: [7h 6s 6c 5h] [Kc]
------ Summary ------
Pot: 38.24. Rake 1.77. JP fee 0.24
Board: [7h 6s 6c 5h Kc]
Player sucazappa does not show cards.Bets: 0.25. Collects: 0. Loses: 0.25.
*Player IlxxxlI shows: Two pairs. As and 6s [Ad Ah]. Bets: 20. Collects: 38.24. Wins: 18.24.
Player BoTPuMHeDichBro does not show cards.Bets: 0. Collects: 0. Wins: 0.
Player eu4ria does not show cards.Bets: 0. Collects: 0. Wins: 0.
Player DonkReaper shows: Two pairs. 9s and 6s [9s 9d]. Bets: 20. Collects: 0. Loses: 20.
Game ended at: 2016/11/28 18:6:16

Game started
Game ID: 786346309 0.25/0.50 (PRR) Gorgons (Hold'em)
Seat 2 is the button
Seat 1: eu4ria (50).
Seat 2: JoJoLoring (58.12).
Seat 3: BoTPuMHeDichBro (51.37).
Seat 4: pokanaktus (63.18).
Seat 5: pingpong420 (50).
Seat 6: IlxxxlI (26.64).
Player BoTPuMHeDichBro has small blind (0.25)
Player pokanaktus has big blind (0.50)
Player IlxxxlI received card: [Jc]
Player IlxxxlI received card: [9h]
Player pingpong420 folds
Player IlxxxlI folds
Player eu4ria folds
Player JoJoLoring folds
Player BoTPuMHeDichBro calls (0.25)
Player pokanaktus checks
*** FLOP ***: [2d 3d 4s]
Player BoTPuMHeDichBro bets (1)
Player pokanaktus folds
Uncalled bet (1) returned to BoTPuMHeDichBro
Player BoTPuMHeDichBro mucks cards
------ Summary ------
Pot: 0.95. Rake 0.05
Board: [2d 3d 4s]
Player eu4ria does not show cards.Bets: 0. Collects: 0. Wins: 0.
Player JoJoLoring does not show cards.Bets: 0. Collects: 0. Wins: 0.
*Player BoTPuMHeDichBro mucks (does not show cards). Bets: 0.50. Collects: 0.95. Wins: 0.45.
Player pokanaktus does not show cards.Bets: 0.50. Collects: 0. Loses: 0.50.
Player pingpong420 does not show cards.Bets: 0. Collects: 0. Wins: 0.
Player IlxxxlI does not show cards.Bets: 0. Collects: 0. Wins: 0.
Game ended at: 2016/11/28 18:5:20

Game started
Game ID: 786346310 0.25/0.50 (PRR) Gorgons - 5 (Hold'em)
Seat 2 is the button
Seat 1: SenNoSen (115.97).
Seat 2: eu4ria (228.09).
Seat 3: IlxxxlI (23.87).
Seat 4: BoTPuMHeDichBro (51.07).
Seat 5: pokanaktus (59.68).
Seat 6: wethco (54.80).
Player IlxxxlI has small blind (0.25)
Player BoTPuMHeDichBro sitting out
Player pokanaktus has big blind (0.50)
Player IlxxxlI received card: [6h]
Player IlxxxlI received card: [Jd]
Player wethco folds
Player SenNoSen folds
Player eu4ria raises (1.25)
Player IlxxxlI folds
Player pokanaktus folds
Uncalled bet (0.75) returned to eu4ria
Player eu4ria mucks cards
------ Summary ------
Pot: 1.25. Rake 0
Player SenNoSen does not show cards.Bets: 0. Collects: 0. Wins: 0.
*Player eu4ria mucks (does not show cards). Bets: 0.50. Collects: 1.25. Wins: 0.75.
Player IlxxxlI does not show cards.Bets: 0.25. Collects: 0. Loses: 0.25.
Player BoTPuMHeDichBro does not show cards.Bets: 0. Collects: 0. Wins: 0.
Player pokanaktus does not show cards.Bets: 0.50. Collects: 0. Loses: 0.50.
Player wethco does not show cards.Bets: 0. Collects: 0. Wins: 0.
Game ended at: 2016/11/28 18:5:7

Game started
Game ID: 786346234 0.25/0.50 (PRR) Gorgons (Hold'em)
Seat 1 is the button
Seat 1: eu4ria (50).
Seat 2: JoJoLoring (58.37).
Seat 3: BoTPuMHeDichBro (51.87).
Seat 4: pokanaktus (63.18).
Seat 5: pingpong420 (49.25).
Seat 6: IlxxxlI (26.64).
Player JoJoLoring has small blind (0.25)
Player BoTPuMHeDichBro has big blind (0.50)
Player IlxxxlI received card: [Ac]
Player IlxxxlI received card: [3c]
Player pokanaktus folds
Player pingpong420 raises (2)
Player IlxxxlI folds
Player eu4ria folds
Player JoJoLoring folds
Player BoTPuMHeDichBro folds
Uncalled bet (1.50) returned to pingpong420
Player pingpong420 mucks cards
------ Summary ------
Pot: 1.25. Rake 0
Player eu4ria does not show cards.Bets: 0. Collects: 0. Wins: 0.
Player JoJoLoring does not show cards.Bets: 0.25. Collects: 0. Loses: 0.25.
Player BoTPuMHeDichBro does not show cards.Bets: 0.50. Collects: 0. Loses: 0.50.
Player pokanaktus does not show cards.Bets: 0. Collects: 0. Wins: 0.
*Player pingpong420 mucks (does not show cards). Bets: 0.50. Collects: 1.25. Wins: 0.75.
Player IlxxxlI does not show cards.Bets: 0. Collects: 0. Wins: 0.
Game ended at: 2016/11/28 18:4:44

Game started
Game ID: 786346208 0.25/0.50 (PRR) Gorgons - 8 (Hold'em)
Seat 5 is the button
Seat 1: sucazappa (66.23).
Seat 2: IlxxxlI (20).
Seat 3: BoTPuMHeDichBro (50).
Seat 5: eu4ria (89.77).
Seat 6: DonkReaper (109.56).
Player DonkReaper has small blind (0.25)
Player sucazappa has big blind (0.50)
Player IlxxxlI received card: [9h]
Player IlxxxlI received card: [4h]
Player IlxxxlI folds
Player BoTPuMHeDichBro folds
Player eu4ria raises (1.25)
Player DonkReaper folds
Player sucazappa folds
Uncalled bet (0.75) returned to eu4ria
Player eu4ria mucks cards
------ Summary ------
Pot: 1.25. Rake 0
Player sucazappa does not show cards.Bets: 0.50. Collects: 0. Loses: 0.50.
Player IlxxxlI does not show cards.Bets: 0. Collects: 0. Wins: 0.
Player BoTPuMHeDichBro does not show cards.Bets: 0. Collects: 0. Wins: 0.
*Player eu4ria mucks (does not show cards). Bets: 0.50. Collects: 1.25. Wins: 0.75.
Player DonkReaper does not show cards.Bets: 0.25. Collects: 0. Loses: 0.25.
Game ended at: 2016/11/28 18:5:3

Game started
Game ID: 786346171 0.25/0.50 (PRR) Gorgons - 5 (Hold'em)
Seat 1 is the button
Seat 1: SenNoSen (115.97).
Seat 2: eu4ria (228.34).
Seat 3: IlxxxlI (24.37).
Seat 4: BoTPuMHeDichBro (51.07).
Seat 5: pokanaktus (58.93).
Seat 6: wethco (54.80).
Player eu4ria has small blind (0.25)
Player IlxxxlI has big blind (0.50)
Player IlxxxlI received card: [Js]
Player IlxxxlI received card: [10d]
Player BoTPuMHeDichBro folds
Player pokanaktus raises (1.50)
Player wethco folds
Player SenNoSen folds
Player eu4ria folds
Player IlxxxlI folds
Uncalled bet (1) returned to pokanaktus
Player pokanaktus mucks cards
------ Summary ------
Pot: 1.25. Rake 0
Player SenNoSen does not show cards.Bets: 0. Collects: 0. Wins: 0.
Player eu4ria does not show cards.Bets: 0.25. Collects: 0. Loses: 0.25.
Player IlxxxlI does not show cards.Bets: 0.50. Collects: 0. Loses: 0.50.
Player BoTPuMHeDichBro does not show cards.Bets: 0. Collects: 0. Wins: 0.
*Player pokanaktus mucks (does not show cards). Bets: 0.50. Collects: 1.25. Wins: 0.75.
Player wethco does not show cards.Bets: 0. Collects: 0. Wins: 0.
Game ended at: 2016/11/28 18:4:44

Game started
Game ID: 786346169 0.25/0.50 (PRR) Garuda - 3 (Hold'em)
Seat 5 is the button
Seat 1: Hakuna_Matata777 (91.67).
Seat 3: Ms.stone (30.23).
Seat 4: smellskindyfishy (20).
Seat 5: IlxxxlI (20).
Seat 6: NoizeyCrckt (48).
Seat 7: 1jackoff1 (95.96).
Seat 8: haroldbb (87.56).
Seat 9: rpportugal (24.09).
Player NoizeyCrckt has small blind (0.25)
Player 1jackoff1 has big blind (0.50)
Player smellskindyfishy posts (0.50)
Player IlxxxlI received card: [3d]
Player IlxxxlI received card: [Jc]
Player haroldbb folds
Player rpportugal raises (1)
Player Hakuna_Matata777 folds
Player Ms.stone folds
Player smellskindyfishy folds
Player IlxxxlI folds
Player NoizeyCrckt folds
Player 1jackoff1 calls (0.50)
*** FLOP ***: [Qd 7h 8h]
Player 1jackoff1 bets (2)
Player rpportugal calls (2)
*** TURN ***: [Qd 7h 8h] [Kh]
Player 1jackoff1 bets (2)
Player rpportugal folds
Uncalled bet (2) returned to 1jackoff1
Player 1jackoff1 mucks cards
------ Summary ------
Pot: 6.42. Rake 0.23. JP fee 0.10
Board: [Qd 7h 8h Kh]
Player Hakuna_Matata777 does not show cards.Bets: 0. Collects: 0. Wins: 0.
Player Ms.stone does not show cards.Bets: 0. Collects: 0. Wins: 0.
Player smellskindyfishy does not show cards.Bets: 0.50. Collects: 0. Loses: 0.50.
Player IlxxxlI does not show cards.Bets: 0. Collects: 0. Wins: 0.
Player NoizeyCrckt does not show cards.Bets: 0.25. Collects: 0. Loses: 0.25.
*Player 1jackoff1 mucks (does not show cards). Bets: 3. Collects: 6.42. Wins: 3.42.
Player haroldbb does not show cards.Bets: 0. Collects: 0. Wins: 0.
Player rpportugal does not show cards.Bets: 3. Collects: 0. Loses: 3.
Game ended at: 2016/11/28 18:5:20

Game started
Game ID: 786346119 0.25/0.50 (PRR) Gorgons (Hold'em)
Seat 6 is the button
Seat 1: eu4ria (50).
Seat 2: JoJoLoring (58.87).
Seat 3: BoTPuMHeDichBro (53.37).
Seat 4: pokanaktus (60.93).
Seat 5: pingpong420 (49.25).
Seat 6: IlxxxlI (26.64).
Player eu4ria has small blind (0.25)
Player JoJoLoring has big blind (0.50)
Player IlxxxlI received card: [10h]
Player IlxxxlI received card: [4h]
Player BoTPuMHeDichBro raises (1.50)
Player pokanaktus raises (4.50)
Player pingpong420 folds
Player IlxxxlI folds
Player eu4ria folds
Player JoJoLoring folds
Player BoTPuMHeDichBro folds
Uncalled bet (3) returned to pokanaktus
Player pokanaktus mucks cards
------ Summary ------
Pot: 3.75. Rake 0
Player eu4ria does not show cards.Bets: 0.25. Collects: 0. Loses: 0.25.
Player JoJoLoring does not show cards.Bets: 0.50. Collects: 0. Loses: 0.50.
Player BoTPuMHeDichBro does not show cards.Bets: 1.50. Collects: 0. Loses: 1.50.
*Player pokanaktus mucks (does not show cards). Bets: 1.50. Collects: 3.75. Wins: 2.25.
Player pingpong420 does not show cards.Bets: 0. Collects: 0. Wins: 0.
Player IlxxxlI does not show cards.Bets: 0. Collects: 0. Wins: 0.
Game ended at: 2016/11/28 18:4:22

Game started
Game ID: 786346093 0.25/0.50 (PRR) Gorgons - 5 (Hold'em)
Seat 6 is the button
Seat 1: SenNoSen (116.22).
Seat 2: eu4ria (228.09).
Seat 3: IlxxxlI (24.37).
Seat 4: BoTPuMHeDichBro (51.07).
Seat 5: pokanaktus (58.93).
Seat 6: wethco (54.80).
Player SenNoSen has small blind (0.25)
Player eu4ria has big blind (0.50)
Player IlxxxlI received card: [3d]
Player IlxxxlI received card: [7h]
Player IlxxxlI folds
Player BoTPuMHeDichBro folds
Player pokanaktus folds
Player wethco folds
Player SenNoSen folds
Uncalled bet (0.25) returned to eu4ria
Player eu4ria mucks cards
------ Summary ------
Pot: 0.50. Rake 0
Player SenNoSen does not show cards.Bets: 0.25. Collects: 0. Loses: 0.25.
*Player eu4ria mucks (does not show cards). Bets: 0.25. Collects: 0.50. Wins: 0.25.
Player IlxxxlI does not show cards.Bets: 0. Collects: 0. Wins: 0.
Player BoTPuMHeDichBro does not show cards.Bets: 0. Collects: 0. Wins: 0.
Player pokanaktus does not show cards.Bets: 0. Collects: 0. Wins: 0.
Player wethco does not show cards.Bets: 0. Collects: 0. Wins: 0.
Game ended at: 2016/11/28 18:4:9

Game started
Game ID: 786345975 0.50/1 (PRR) Kraken - 16 (Hold'em)
Seat 2 is the button
Seat 2: SenNoSen (100).
Seat 4: IlxxxlI (43.30).
Player SenNoSen has small blind (0.50)
Player IlxxxlI has big blind (1)
Player IlxxxlI received card: [10s]
Player IlxxxlI received card: [6d]
Player SenNoSen raises (2.50)
Player IlxxxlI folds
Uncalled bet (2) returned to SenNoSen
Player SenNoSen mucks cards
------ Summary ------
Pot: 2. Rake 0
*Player SenNoSen mucks (does not show cards). Bets: 1. Collects: 2. Wins: 1.
Player IlxxxlI does not show cards.Bets: 1. Collects: 0. Loses: 1.
Game ended at: 2016/11/28 18:3:33

Game started
Game ID: 786345959 0.25/0.50 (PRR) Garuda - 3 (Hold'em)
Seat 3 is the button
Seat 1: Hakuna_Matata777 (91.67).
Seat 3: Ms.stone (30.23).
Seat 5: IlxxxlI (20).
Seat 6: NoizeyCrckt (48.50).
Seat 7: 1jackoff1 (96.46).
Seat 8: haroldbb (87.56).
Seat 9: rpportugal (22.69).
Player IlxxxlI has small blind (0.25)
Player NoizeyCrckt has big blind (0.50)
Player IlxxxlI received card: [Kd]
Player IlxxxlI received card: [3d]
Player 1jackoff1 calls (0.50)
Player haroldbb folds
Player rpportugal calls (0.50)
Player Hakuna_Matata777 folds
Player Ms.stone folds
Player IlxxxlI calls (0.25)
Player NoizeyCrckt checks
*** FLOP ***: [5c 7s As]
Player IlxxxlI checks
Player NoizeyCrckt checks
Player 1jackoff1 checks
Player rpportugal bets (0.50)
Player IlxxxlI folds
Player NoizeyCrckt folds
Player 1jackoff1 folds
Uncalled bet (0.50) returned to rpportugal
Player rpportugal mucks cards
------ Summary ------
Pot: 1.90. Rake 0.08. JP fee 0.02
Board: [5c 7s As]
Player Hakuna_Matata777 does not show cards.Bets: 0. Collects: 0. Wins: 0.
Player Ms.stone does not show cards.Bets: 0. Collects: 0. Wins: 0.
Player IlxxxlI does not show cards.Bets: 0.50. Collects: 0. Loses: 0.50.
Player NoizeyCrckt does not show cards.Bets: 0.50. Collects: 0. Loses: 0.50.
Player 1jackoff1 does not show cards.Bets: 0.50. Collects: 0. Loses: 0.50.
Player haroldbb does not show cards.Bets: 0. Collects: 0. Wins: 0.
*Player rpportugal mucks (does not show cards). Bets: 0.50. Collects: 1.90. Wins: 1.40.
Game ended at: 2016/11/28 18:4:8

Game started
Game ID: 786345923 0.25/0.50 (PRR) Gorgons - 8 (Hold'em)
Seat 3 is the button
Seat 1: sucazappa (66.23).
Seat 2: IlxxxlI (20).
Seat 3: BoTPuMHeDichBro (50).
Seat 5: eu4ria (113.27).
Seat 6: DonkReaper (88.41).
Player eu4ria has small blind (0.25)
Player DonkReaper has big blind (0.50)
Player IlxxxlI received card: [3s]
Player IlxxxlI received card: [2s]
Player sucazappa folds
Player IlxxxlI folds
Player BoTPuMHeDichBro folds
Player eu4ria raises (1.25)
Player DonkReaper raises (4)
Player eu4ria raises (9)
Player DonkReaper calls (6)
*** FLOP ***: [10h 8h 5c]
Player eu4ria bets (13)
Player DonkReaper calls (13)
*** TURN ***: [10h 8h 5c] [7h]
Player eu4ria checks
Player DonkReaper allin (64.91)
Player eu4ria folds
Uncalled bet (64.91) returned to DonkReaper
Player DonkReaper mucks cards
------ Summary ------
Pot: 44.65. Rake 2.11. JP fee 0.24
Board: [10h 8h 5c 7h]
Player sucazappa does not show cards.Bets: 0. Collects: 0. Wins: 0.
Player IlxxxlI does not show cards.Bets: 0. Collects: 0. Wins: 0.
Player BoTPuMHeDichBro does not show cards.Bets: 0. Collects: 0. Wins: 0.
Player eu4ria does not show cards.Bets: 23.50. Collects: 0. Loses: 23.50.
*Player DonkReaper mucks (does not show cards). Bets: 23.50. Collects: 44.65. Wins: 21.15.
Game ended at: 2016/11/28 18:4:16

Game started
Game ID: 786345828 0.25/0.50 (PRR) Garuda - 3 (Hold'em)
Seat 1 is the button
Seat 1: Hakuna_Matata777 (91.67).
Seat 3: Ms.stone (30.48).
Seat 5: IlxxxlI (20).
Seat 6: NoizeyCrckt (48.50).
Seat 7: 1jackoff1 (95.29).
Seat 8: haroldbb (87.56).
Seat 9: rpportugal (23.19).
Player Ms.stone has small blind (0.25)
Player IlxxxlI has big blind (0.50)
Player rpportugal posts (0.25)
Player IlxxxlI received card: [5s]
Player IlxxxlI received card: [3d]
Player NoizeyCrckt folds
Player 1jackoff1 calls (0.50)
Player haroldbb folds
Player rpportugal calls (0.25)
Player Hakuna_Matata777 folds
Player Ms.stone folds
Player IlxxxlI checks
*** FLOP ***: [As 6c 6s]
Player IlxxxlI checks
Player 1jackoff1 bets (2)
Player rpportugal folds
Player IlxxxlI folds
Uncalled bet (2) returned to 1jackoff1
Player 1jackoff1 mucks cards
------ Summary ------
Pot: 1.67. Rake 0.06. JP fee 0.02
Board: [As 6c 6s]
Player Hakuna_Matata777 does not show cards.Bets: 0. Collects: 0. Wins: 0.
Player Ms.stone does not show cards.Bets: 0.25. Collects: 0. Loses: 0.25.
Player IlxxxlI does not show cards.Bets: 0.50. Collects: 0. Loses: 0.50.
Player NoizeyCrckt does not show cards.Bets: 0. Collects: 0. Wins: 0.
*Player 1jackoff1 mucks (does not show cards). Bets: 0.50. Collects: 1.67. Wins: 1.17.
Player haroldbb does not show cards.Bets: 0. Collects: 0. Wins: 0.
Player rpportugal does not show cards.Bets: 0.50. Collects: 0. Loses: 0.50.
Game ended at: 2016/11/28 18:3:6

Game started
Game ID: 786345809 0.25/0.50 (PRR) Gorgons - 8 (Hold'em)
Seat 2 is the button
Seat 1: sucazappa (66.23).
Seat 2: IlxxxlI (20).
Seat 3: BoTPuMHeDichBro (50).
Seat 4: SenNoSen (101.55).
Seat 5: eu4ria (111.52).
Seat 6: DonkReaper (88.41).
Player BoTPuMHeDichBro has small blind (0.25)
Player SenNoSen sitting out
Player eu4ria has big blind (0.50)
Player IlxxxlI received card: [10c]
Player IlxxxlI received card: [8c]
Player DonkReaper folds
Player sucazappa folds
Player IlxxxlI raises (1.50)
Player BoTPuMHeDichBro folds
Player eu4ria raises (4.50)
Player IlxxxlI folds
Uncalled bet (3.50) returned to eu4ria
Player eu4ria mucks cards
------ Summary ------
Pot: 3.25. Rake 0
Player sucazappa does not show cards.Bets: 0. Collects: 0. Wins: 0.
Player IlxxxlI does not show cards.Bets: 1.50. Collects: 0. Loses: 1.50.
Player BoTPuMHeDichBro does not show cards.Bets: 0.25. Collects: 0. Loses: 0.25.
Player SenNoSen does not show cards.Bets: 0. Collects: 0. Wins: 0.
*Player eu4ria mucks (does not show cards). Bets: 1.50. Collects: 3.25. Wins: 1.75.
Player DonkReaper does not show cards.Bets: 0. Collects: 0. Wins: 0.
Game ended at: 2016/11/28 18:2:55

Game started
Game ID: 786345799 0.25/0.50 (PRR) Gorgons (Hold'em)
Seat 5 is the button
Seat 1: eu4ria (50).
Seat 2: JoJoLoring (60.62).
Seat 3: BoTPuMHeDichBro (53.37).
Seat 4: pokanaktus (60.93).
Seat 5: pingpong420 (49.25).
Seat 6: IlxxxlI (20.25).
Player IlxxxlI has small blind (0.25)
Player eu4ria has big blind (0.50)
Player IlxxxlI received card: [Qd]
Player IlxxxlI received card: [Qs]
Player JoJoLoring calls (0.50)
Player BoTPuMHeDichBro folds
Player pokanaktus folds
Player pingpong420 folds
Player IlxxxlI raises (1.50)
Player eu4ria calls (1.25)
Player JoJoLoring calls (1.25)
*** FLOP ***: [10d Ac 6c]
Player IlxxxlI checks
Player eu4ria bets (3.50)
Player JoJoLoring folds
Player IlxxxlI calls (3.50)
*** TURN ***: [10d Ac 6c] [5s]
Player IlxxxlI checks
Player eu4ria checks
*** RIVER ***: [10d Ac 6c 5s] [Ks]
Player IlxxxlI checks
Player eu4ria checks
Player eu4ria mucks cards
------ Summary ------
Pot: 11.64. Rake 0.41. JP fee 0.20
Board: [10d Ac 6c 5s Ks]
Player eu4ria mucks (does not show cards). Bets: 5.25. Collects: 0. Loses: 5.25.
Player JoJoLoring does not show cards.Bets: 1.75. Collects: 0. Loses: 1.75.
Player BoTPuMHeDichBro does not show cards.Bets: 0. Collects: 0. Wins: 0.
Player pokanaktus does not show cards.Bets: 0. Collects: 0. Wins: 0.
Player pingpong420 does not show cards.Bets: 0. Collects: 0. Wins: 0.
*Player IlxxxlI shows: One pair of Qs [Qd Qs]. Bets: 5.25. Collects: 11.64. Wins: 6.39.
Game ended at: 2016/11/28 18:3:50

Game started
Game ID: 786345735 0.25/0.50 (PRR) Gorgons - 5 (Hold'em)
Seat 5 is the button
Seat 1: SenNoSen (119.72).
Seat 2: eu4ria (224.70).
Seat 3: IlxxxlI (24.37).
Seat 4: BoTPuMHeDichBro (51.07).
Seat 5: pokanaktus (58.93).
Seat 6: wethco (55.05).
Player wethco has small blind (0.25)
Player SenNoSen has big blind (0.50)
Player IlxxxlI received card: [3s]
Player IlxxxlI received card: [6c]
Player eu4ria raises (1.50)
Player IlxxxlI folds
Player BoTPuMHeDichBro folds
Player pokanaktus folds
Player wethco folds
Player SenNoSen calls (1)
*** FLOP ***: [Kc 8s 5h]
Player SenNoSen checks
Player eu4ria bets (2)
Player SenNoSen calls (2)
*** TURN ***: [Kc 8s 5h] [Jc]
Player SenNoSen checks
Player eu4ria checks
*** RIVER ***: [Kc 8s 5h Jc] [5c]
Player SenNoSen checks
Player eu4ria bets (6.50)
Player SenNoSen folds
Uncalled bet (6.50) returned to eu4ria
Player eu4ria mucks cards
------ Summary ------
Pot: 6.89. Rake 0.24. JP fee 0.12
Board: [Kc 8s 5h Jc 5c]
Player SenNoSen does not show cards.Bets: 3.50. Collects: 0. Loses: 3.50.
*Player eu4ria mucks (does not show cards). Bets: 3.50. Collects: 6.89. Wins: 3.39.
Player IlxxxlI does not show cards.Bets: 0. Collects: 0. Wins: 0.
Player BoTPuMHeDichBro does not show cards.Bets: 0. Collects: 0. Wins: 0.
Player pokanaktus does not show cards.Bets: 0. Collects: 0. Wins: 0.
Player wethco does not show cards.Bets: 0.25. Collects: 0. Loses: 0.25.
Game ended at: 2016/11/28 18:3:43

Game started
Game ID: 786345723 0.50/1 (PRR) Kraken - 16 (Hold'em)
Seat 6 is the button
Seat 2: SenNoSen (100.13).
Seat 4: IlxxxlI (41.50).
Seat 6: CrimZnole (99.67).
Player SenNoSen has small blind (0.50)
Player IlxxxlI has big blind (1)
Player IlxxxlI received card: [9c]
Player IlxxxlI received card: [8s]
Player CrimZnole folds
Player SenNoSen raises (1.50)
Player IlxxxlI calls (1)
*** FLOP ***: [7s 7h 6h]
Player SenNoSen checks
Player IlxxxlI bets (1.98)
Player SenNoSen folds
Uncalled bet (1.98) returned to IlxxxlI
Player IlxxxlI mucks cards
------ Summary ------
Pot: 3.80. Rake 0.14. JP fee 0.06
Board: [7s 7h 6h]
Player SenNoSen does not show cards.Bets: 2. Collects: 0. Loses: 2.
*Player IlxxxlI mucks (does not show cards). Bets: 2. Collects: 3.80. Wins: 1.80.
Player CrimZnole does not show cards.Bets: 0. Collects: 0. Wins: 0.
Game ended at: 2016/11/28 18:3:8

Game started
Game ID: 786345691 0.25/0.50 (PRR) Gorgons - 8 (Hold'em)
Seat 1 is the button
Seat 1: sucazappa (65.48).
Seat 2: IlxxxlI (20).
Seat 3: BoTPuMHeDichBro (50).
Seat 4: SenNoSen (101.55).
Seat 5: eu4ria (111.52).
Seat 6: DonkReaper (88.41).
Player IlxxxlI has small blind (0.25)
Player BoTPuMHeDichBro has big blind (0.50)
Player IlxxxlI received card: [8c]
Player IlxxxlI received card: [As]
Player SenNoSen folds
Player eu4ria folds
Player DonkReaper folds
Player sucazappa raises (1.50)
Player IlxxxlI folds
Player BoTPuMHeDichBro folds
Uncalled bet (1) returned to sucazappa
Player sucazappa mucks cards
------ Summary ------
Pot: 1.25. Rake 0
*Player sucazappa mucks (does not show cards). Bets: 0.50. Collects: 1.25. Wins: 0.75.
Player IlxxxlI does not show cards.Bets: 0.25. Collects: 0. Loses: 0.25.
Player BoTPuMHeDichBro does not show cards.Bets: 0.50. Collects: 0. Loses: 0.50.
Player SenNoSen does not show cards.Bets: 0. Collects: 0. Wins: 0.
Player eu4ria does not show cards.Bets: 0. Collects: 0. Wins: 0.
Player DonkReaper does not show cards.Bets: 0. Collects: 0. Wins: 0.
Game ended at: 2016/11/28 18:2:23

Game started
Game ID: 786345621 0.25/0.50 (PRR) Gorgons - 5 (Hold'em)
Seat 4 is the button
Seat 1: SenNoSen (119.72).
Seat 2: eu4ria (224.70).
Seat 3: IlxxxlI (24.37).
Seat 4: BoTPuMHeDichBro (51.07).
Seat 5: pokanaktus (59.18).
Seat 6: wethco (54.80).
Player pokanaktus has small blind (0.25)
Player wethco has big blind (0.50)
Player IlxxxlI received card: [3h]
Player IlxxxlI received card: [Jh]
Player SenNoSen folds
Player eu4ria folds
Player IlxxxlI folds
Player BoTPuMHeDichBro folds
Player pokanaktus folds
Uncalled bet (0.25) returned to wethco
Player wethco mucks cards
------ Summary ------
Pot: 0.50. Rake 0
Player SenNoSen does not show cards.Bets: 0. Collects: 0. Wins: 0.
Player eu4ria does not show cards.Bets: 0. Collects: 0. Wins: 0.
Player IlxxxlI does not show cards.Bets: 0. Collects: 0. Wins: 0.
Player BoTPuMHeDichBro does not show cards.Bets: 0. Collects: 0. Wins: 0.
Player pokanaktus does not show cards.Bets: 0.25. Collects: 0. Loses: 0.25.
*Player wethco mucks (does not show cards). Bets: 0.25. Collects: 0.50. Wins: 0.25.
Game ended at: 2016/11/28 18:1:55

Game started
Game ID: 786345576 0.25/0.50 (PRR) Gorgons (Hold'em)
Seat 4 is the button
Seat 1: eu4ria (50.75).
Seat 2: JoJoLoring (50).
Seat 3: BoTPuMHeDichBro (53.37).
Seat 4: pokanaktus (60.93).
Seat 5: pingpong420 (49.50).
Seat 6: IlxxxlI (20.75).
Player pingpong420 has small blind (0.25)
Player IlxxxlI has big blind (0.50)
Player JoJoLoring posts (0.50)
Player IlxxxlI received card: [2h]
Player IlxxxlI received card: [3d]
Player eu4ria raises (1.50)
Player JoJoLoring calls (1)
Player BoTPuMHeDichBro folds
Player pokanaktus folds
Player pingpong420 folds
Player IlxxxlI folds
*** FLOP ***: [6h 8c 5h]
Player eu4ria bets (2.50)
Player JoJoLoring calls (2.50)
*** TURN ***: [6h 8c 5h] [Kc]
Player eu4ria bets (7)
Player JoJoLoring calls (7)
*** RIVER ***: [6h 8c 5h Kc] [2c]
Player eu4ria checks
Player JoJoLoring checks
------ Summary ------
Pot: 21.62. Rake 0.89. JP fee 0.24
Board: [6h 8c 5h Kc 2c]
Player eu4ria shows: High card K [Qd Jh]. Bets: 11. Collects: 0. Loses: 11.
*Player JoJoLoring shows: One pair of Ks [Ks 4d]. Bets: 11. Collects: 21.62. Wins: 10.62.
Player BoTPuMHeDichBro does not show cards.Bets: 0. Collects: 0. Wins: 0.
Player pokanaktus does not show cards.Bets: 0. Collects: 0. Wins: 0.
Player pingpong420 does not show cards.Bets: 0.25. Collects: 0. Loses: 0.25.
Player IlxxxlI does not show cards.Bets: 0.50. Collects: 0. Loses: 0.50.
Game ended at: 2016/11/28 18:2:16

Game started
Game ID: 786345573 0.50/1 (PRR) Kraken - 16 (Hold'em)
Seat 4 is the button
Seat 2: SenNoSen (101.13).
Seat 4: IlxxxlI (40).
Seat 6: CrimZnole (100.17).
Player CrimZnole has small blind (0.50)
Player SenNoSen has big blind (1)
Player IlxxxlI received card: [Kh]
Player IlxxxlI received card: [Qd]
Player IlxxxlI raises (3)
Player CrimZnole folds
Player SenNoSen folds
Uncalled bet (2) returned to IlxxxlI
Player IlxxxlI mucks cards
------ Summary ------
Pot: 2.50. Rake 0
Player SenNoSen does not show cards.Bets: 1. Collects: 0. Loses: 1.
*Player IlxxxlI mucks (does not show cards). Bets: 1. Collects: 2.50. Wins: 1.50.
Player CrimZnole does not show cards.Bets: 0.50. Collects: 0. Loses: 0.50.
Game ended at: 2016/11/28 18:1:50

Game started
Game ID: 786345545 0.25/0.50 (PRR) Gorgons - 5 (Hold'em)
Seat 3 is the button
Seat 1: SenNoSen (119.72).
Seat 2: eu4ria (224.70).
Seat 3: IlxxxlI (23.62).
Seat 4: BoTPuMHeDichBro (51.32).
Seat 5: pokanaktus (59.68).
Seat 6: wethco (54.80).
Player BoTPuMHeDichBro has small blind (0.25)
Player pokanaktus has big blind (0.50)
Player IlxxxlI received card: [Kc]
Player IlxxxlI received card: [Jh]
Player wethco folds
Player SenNoSen folds
Player eu4ria folds
Player IlxxxlI raises (1.50)
Player BoTPuMHeDichBro folds
Player pokanaktus folds
Uncalled bet (1) returned to IlxxxlI
Player IlxxxlI mucks cards
------ Summary ------
Pot: 1.25. Rake 0
Player SenNoSen does not show cards.Bets: 0. Collects: 0. Wins: 0.
Player eu4ria does not show cards.Bets: 0. Collects: 0. Wins: 0.
*Player IlxxxlI mucks (does not show cards). Bets: 0.50. Collects: 1.25. Wins: 0.75.
Player BoTPuMHeDichBro does not show cards.Bets: 0.25. Collects: 0. Loses: 0.25.
Player pokanaktus does not show cards.Bets: 0.50. Collects: 0. Loses: 0.50.
Player wethco does not show cards.Bets: 0. Collects: 0. Wins: 0.
Game ended at: 2016/11/28 18:1:28

Game started
Game ID: 786345508 0.25/0.50 (PRR) Garuda - 3 (Hold'em)
Seat 7 is the button
Seat 1: Hakuna_Matata777 (91.92).
Seat 2: frenzybarb (50).
Seat 5: IlxxxlI (20).
Seat 6: NoizeyCrckt (48.50).
Seat 7: 1jackoff1 (97.79).
Seat 8: haroldbb (86.19).
Seat 9: rpportugal (6.13).
Player haroldbb has small blind (0.25)
Player rpportugal has big blind (0.50)
Player IlxxxlI received card: [3d]
Player IlxxxlI received card: [Js]
Player Hakuna_Matata777 folds
Player frenzybarb raises (1.50)
Player IlxxxlI folds
Player NoizeyCrckt folds
Player 1jackoff1 calls (1.50)
Player haroldbb folds
Player rpportugal calls (1)
*** FLOP ***: [Jd Qd 7c]
Player rpportugal checks
Player frenzybarb bets (3.50)
Player 1jackoff1 folds
Player rpportugal allin (4.63)
Player frenzybarb calls (1.13)
*** TURN ***: [Jd Qd 7c] [Ah]
*** RIVER ***: [Jd Qd 7c Ah] [5h]
------ Summary ------
Pot: 13.31. Rake 0.48. JP fee 0.22
Board: [Jd Qd 7c Ah 5h]
Player Hakuna_Matata777 does not show cards.Bets: 0. Collects: 0. Wins: 0.
*Player frenzybarb shows: One pair of Qs [Qh Ks]. Bets: 6.13. Collects: 13.31. Wins: 7.18.
Player IlxxxlI does not show cards.Bets: 0. Collects: 0. Wins: 0.
Player NoizeyCrckt does not show cards.Bets: 0. Collects: 0. Wins: 0.
Player 1jackoff1 does not show cards.Bets: 1.50. Collects: 0. Loses: 1.50.
Player haroldbb does not show cards.Bets: 0.25. Collects: 0. Loses: 0.25.
Player rpportugal shows: High card A [9h Kd]. Bets: 6.13. Collects: 0. Loses: 6.13.
Game ended at: 2016/11/28 18:1:41

Game started
Game ID: 786345503 0.25/0.50 (PRR) Gorgons - 8 (Hold'em)
Seat 6 is the button
Seat 1: sucazappa (63.48).
Seat 2: IlxxxlI (20).
Seat 3: BoTPuMHeDichBro (50).
Seat 4: SenNoSen (101.55).
Seat 5: eu4ria (111.52).
Seat 6: DonkReaper (89.91).
Player sucazappa has small blind (0.25)
Player IlxxxlI has big blind (0.50)
Player IlxxxlI received card: [5c]
Player IlxxxlI received card: [8h]
Player BoTPuMHeDichBro folds
Player SenNoSen folds
Player eu4ria folds
Player DonkReaper raises (1.50)
Player sucazappa raises (5.25)
Player IlxxxlI folds
Player DonkReaper folds
Uncalled bet (4) returned to sucazappa
Player sucazappa mucks cards
------ Summary ------
Pot: 3.50. Rake 0
*Player sucazappa mucks (does not show cards). Bets: 1.50. Collects: 3.50. Wins: 2.
Player IlxxxlI does not show cards.Bets: 0.50. Collects: 0. Loses: 0.50.
Player BoTPuMHeDichBro does not show cards.Bets: 0. Collects: 0. Wins: 0.
Player SenNoSen does not show cards.Bets: 0. Collects: 0. Wins: 0.
Player eu4ria does not show cards.Bets: 0. Collects: 0. Wins: 0.
Player DonkReaper does not show cards.Bets: 1.50. Collects: 0. Loses: 1.50.
Game ended at: 2016/11/28 18:1:40

Game started
Game ID: 786345475 0.25/0.50 (PRR) Gorgons (Hold'em)
Seat 3 is the button
Seat 1: eu4ria (50.75).
Seat 3: BoTPuMHeDichBro (53.37).
Seat 4: pokanaktus (61.18).
Seat 5: pingpong420 (50).
Seat 6: IlxxxlI (20).
Player pokanaktus has small blind (0.25)
Player pingpong420 has big blind (0.50)
Player IlxxxlI received card: [10h]
Player IlxxxlI received card: [Jh]
Player IlxxxlI raises (1.75)
Player eu4ria folds
Player BoTPuMHeDichBro folds
Player pokanaktus folds
Player pingpong420 folds
Uncalled bet (1.25) returned to IlxxxlI
Player IlxxxlI mucks cards
------ Summary ------
Pot: 1.25. Rake 0
Player eu4ria does not show cards.Bets: 0. Collects: 0. Wins: 0.
Player BoTPuMHeDichBro does not show cards.Bets: 0. Collects: 0. Wins: 0.
Player pokanaktus does not show cards.Bets: 0.25. Collects: 0. Loses: 0.25.
Player pingpong420 does not show cards.Bets: 0.50. Collects: 0. Loses: 0.50.
*Player IlxxxlI mucks (does not show cards). Bets: 0.50. Collects: 1.25. Wins: 0.75.
Game ended at: 2016/11/28 18:1:14

Game started
Game ID: 786345468 0.50/1 (PRR) Kraken - 16 (Hold'em)
Seat 2 is the button
Seat 2: SenNoSen (101.13).
Seat 4: IlxxxlI (40).
Seat 5: plin777 (50.54).
Seat 6: CrimZnole (97.47).
Player IlxxxlI has small blind (0.50)
Player plin777 sitting out
Player CrimZnole has big blind (1)
Player IlxxxlI received card: [9s]
Player IlxxxlI received card: [6s]
Player SenNoSen folds
Player IlxxxlI calls (0.50)
Player CrimZnole checks
*** FLOP ***: [9c Kh Ad]
Player IlxxxlI bets (1)
Player CrimZnole calls (1)
*** TURN ***: [9c Kh Ad] [8d]
Player IlxxxlI bets (1)
Player CrimZnole raises (4)
Player IlxxxlI folds
Uncalled bet (3) returned to CrimZnole
Player CrimZnole mucks cards
------ Summary ------
Pot: 5.70. Rake 0.22. JP fee 0.08
Board: [9c Kh Ad 8d]
Player SenNoSen does not show cards.Bets: 0. Collects: 0. Wins: 0.
Player IlxxxlI does not show cards.Bets: 3. Collects: 0. Loses: 3.
Player plin777 does not show cards.Bets: 0. Collects: 0. Wins: 0.
*Player CrimZnole mucks (does not show cards). Bets: 3. Collects: 5.70. Wins: 2.70.
Game ended at: 2016/11/28 18:1:13

Game started
Game ID: 786345459 0.25/0.50 (PRR) Gorgons - 5 (Hold'em)
Seat 2 is the button
Seat 1: SenNoSen (119.72).
Seat 2: eu4ria (224.70).
Seat 3: IlxxxlI (23.87).
Seat 4: BoTPuMHeDichBro (51.82).
Seat 5: pokanaktus (58.93).
Seat 6: wethco (54.80).
Player IlxxxlI has small blind (0.25)
Player BoTPuMHeDichBro has big blind (0.50)
Player IlxxxlI received card: [6h]
Player IlxxxlI received card: [5h]
Player pokanaktus raises (1.50)
Player wethco folds
Player SenNoSen folds
Player eu4ria folds
Player IlxxxlI folds
Player BoTPuMHeDichBro folds
Uncalled bet (1) returned to pokanaktus
Player pokanaktus mucks cards
------ Summary ------
Pot: 1.25. Rake 0
Player SenNoSen does not show cards.Bets: 0. Collects: 0. Wins: 0.
Player eu4ria does not show cards.Bets: 0. Collects: 0. Wins: 0.
Player IlxxxlI does not show cards.Bets: 0.25. Collects: 0. Loses: 0.25.
Player BoTPuMHeDichBro does not show cards.Bets: 0.50. Collects: 0. Loses: 0.50.
*Player pokanaktus mucks (does not show cards). Bets: 0.50. Collects: 1.25. Wins: 0.75.
Player wethco does not show cards.Bets: 0. Collects: 0. Wins: 0.
Game ended at: 2016/11/28 18:1:2

Game started
Game ID: 786345418 0.50/1 (PRR) Kraken - 16 (Hold'em)
Seat 6 is the button
Seat 2: SenNoSen (101.63).
Seat 4: IlxxxlI (40).
Seat 5: plin777 (49.04).
Seat 6: CrimZnole (97.47).
Player SenNoSen has small blind (0.50)
Player IlxxxlI has big blind (1)
Player IlxxxlI received card: [Kd]
Player IlxxxlI received card: [4d]
Player plin777 raises (3)
Player CrimZnole folds
Player SenNoSen folds
Player IlxxxlI folds
Uncalled bet (2) returned to plin777
Player plin777 mucks cards
------ Summary ------
Pot: 2.50. Rake 0
Player SenNoSen does not show cards.Bets: 0.50. Collects: 0. Loses: 0.50.
Player IlxxxlI does not show cards.Bets: 1. Collects: 0. Loses: 1.
*Player plin777 mucks (does not show cards). Bets: 1. Collects: 2.50. Wins: 1.50.
Player CrimZnole does not show cards.Bets: 0. Collects: 0. Wins: 0.
Game ended at: 2016/11/28 18:0:38

Game started
Game ID: 786345378 0.50/1 (PRR) Kraken - 16 (Hold'em)
Seat 5 is the button
Seat 1: Hakuna_Matata777 (130.81).
Seat 2: SenNoSen (101.13).
Seat 4: IlxxxlI (40).
Seat 5: plin777 (49.04).
Seat 6: CrimZnole (97.97).
Player CrimZnole has small blind (0.50)
Player Hakuna_Matata777 sitting out
Player SenNoSen has big blind (1)
Player IlxxxlI received card: [Qd]
Player IlxxxlI received card: [9h]
Player IlxxxlI folds
Player plin777 folds
Player CrimZnole folds
Uncalled bet (0.50) returned to SenNoSen
Player SenNoSen mucks cards
------ Summary ------
Pot: 1. Rake 0
Player Hakuna_Matata777 does not show cards.Bets: 0. Collects: 0. Wins: 0.
*Player SenNoSen mucks (does not show cards). Bets: 0.50. Collects: 1. Wins: 0.50.
Player IlxxxlI does not show cards.Bets: 0. Collects: 0. Wins: 0.
Player plin777 does not show cards.Bets: 0. Collects: 0. Wins: 0.
Player CrimZnole does not show cards.Bets: 0.50. Collects: 0. Loses: 0.50.
Game ended at: 2016/11/28 18:0:21

Game started
Game ID: 786345306 0.25/0.50 (PRR) Garuda - 3 (Hold'em)
Seat 6 is the button
Seat 1: Hakuna_Matata777 (91.92).
Seat 2: frenzybarb (50).
Seat 5: IlxxxlI (20).
Seat 6: NoizeyCrckt (48.50).
Seat 7: 1jackoff1 (89.61).
Seat 8: haroldbb (93.69).
Seat 9: rpportugal (6.13).
Player 1jackoff1 has small blind (0.25)
Player haroldbb has big blind (0.50)
Player IlxxxlI received card: [Ac]
Player IlxxxlI received card: [2d]
Player rpportugal folds
Player Hakuna_Matata777 folds
Player frenzybarb raises (1.50)
Player IlxxxlI folds
Player NoizeyCrckt folds
Player 1jackoff1 calls (1.25)
Player haroldbb calls (1)
*** FLOP ***: [8s 5c 6h]
Player 1jackoff1 bets (2)
Player haroldbb calls (2)
Player frenzybarb folds
*** TURN ***: [8s 5c 6h] [7d]
Player 1jackoff1 bets (2)
Player haroldbb calls (2)
*** RIVER ***: [8s 5c 6h 7d] [6d]
Player 1jackoff1 bets (2)
Player haroldbb calls (2)
Player haroldbb mucks cards
------ Summary ------
Pot: 15.68. Rake 0.58. JP fee 0.24
Board: [8s 5c 6h 7d 6d]
Player Hakuna_Matata777 does not show cards.Bets: 0. Collects: 0. Wins: 0.
Player frenzybarb does not show cards.Bets: 1.50. Collects: 0. Loses: 1.50.
Player IlxxxlI does not show cards.Bets: 0. Collects: 0. Wins: 0.
Player NoizeyCrckt does not show cards.Bets: 0. Collects: 0. Wins: 0.
*Player 1jackoff1 shows: Straight to 8 [4s 3c]. Bets: 7.50. Collects: 15.68. Wins: 8.18.
Player haroldbb mucks (does not show cards). Bets: 7.50. Collects: 0. Loses: 7.50.
Player rpportugal does not show cards.Bets: 0. Collects: 0. Wins: 0.
Game ended at: 2016/11/28 18:0:49

Game started
Game ID: 786345304 0.25/0.50 (PRR) Gorgons (Hold'em)
Seat 1 is the button
Seat 1: eu4ria (50.75).
Seat 3: BoTPuMHeDichBro (52.02).
Seat 4: pokanaktus (62.68).
Seat 6: IlxxxlI (20).
Player BoTPuMHeDichBro has small blind (0.25)
Player pokanaktus has big blind (0.50)
Player IlxxxlI received card: [2s]
Player IlxxxlI received card: [10d]
Player IlxxxlI folds
Player eu4ria folds
Player BoTPuMHeDichBro raises (1.25)
Player pokanaktus calls (1)
*** FLOP ***: [3d 7s Jh]
Player BoTPuMHeDichBro bets (0.95)
Player pokanaktus folds
Uncalled bet (0.95) returned to BoTPuMHeDichBro
Player BoTPuMHeDichBro mucks cards
------ Summary ------
Pot: 2.85. Rake 0.11. JP fee 0.04
Board: [3d 7s Jh]
Player eu4ria does not show cards.Bets: 0. Collects: 0. Wins: 0.
*Player BoTPuMHeDichBro mucks (does not show cards). Bets: 1.50. Collects: 2.85. Wins: 1.35.
Player pokanaktus does not show cards.Bets: 1.50. Collects: 0. Loses: 1.50.
Player IlxxxlI does not show cards.Bets: 0. Collects: 0. Wins: 0.
Game ended at: 2016/11/28 18:0:40

Game started
Game ID: 786345247 0.25/0.50 (PRR) Gorgons - 5 (Hold'em)
Seat 1 is the button
Seat 1: SenNoSen (123.75).
Seat 2: eu4ria (224.95).
Seat 3: IlxxxlI (20).
Seat 4: BoTPuMHeDichBro (51.82).
Seat 5: pokanaktus (58.93).
Seat 6: wethco (54.80).
Player eu4ria has small blind (0.25)
Player IlxxxlI has big blind (0.50)
Player IlxxxlI received card: [5s]
Player IlxxxlI received card: [Ad]
Player BoTPuMHeDichBro folds
Player pokanaktus folds
Player wethco folds
Player SenNoSen raises (1)
Player eu4ria folds
Player IlxxxlI calls (0.50)
*** FLOP ***: [7h 3s 5c]
Player IlxxxlI checks
Player SenNoSen bets (0.71)
Player IlxxxlI calls (0.71)
*** TURN ***: [7h 3s 5c] [7c]
Player IlxxxlI checks
Player SenNoSen bets (2.32)
Player IlxxxlI calls (2.32)
*** RIVER ***: [7h 3s 5c 7c] [10c]
Player IlxxxlI checks
Player SenNoSen checks
------ Summary ------
Pot: 7.90. Rake 0.29. JP fee 0.12
Board: [7h 3s 5c 7c 10c]
Player SenNoSen shows: One pair of 7s [Jh Kh]. Bets: 4.03. Collects: 0. Loses: 4.03.
Player eu4ria does not show cards.Bets: 0.25. Collects: 0. Loses: 0.25.
*Player IlxxxlI shows: Two pairs. 7s and 5s [5s Ad]. Bets: 4.03. Collects: 7.90. Wins: 3.87.
Player BoTPuMHeDichBro does not show cards.Bets: 0. Collects: 0. Wins: 0.
Player pokanaktus does not show cards.Bets: 0. Collects: 0. Wins: 0.
Player wethco does not show cards.Bets: 0. Collects: 0. Wins: 0.
Game ended at: 2016/11/28 18:0:34

Game started
Game ID: 786345179 0.25/0.50 (PRR) Gorgons (Hold'em)
Seat 6 is the button
Seat 1: eu4ria (50.25).
Seat 3: BoTPuMHeDichBro (52.52).
Seat 4: pokanaktus (62.68).
Seat 6: IlxxxlI (20).
Player eu4ria has small blind (0.25)
Player BoTPuMHeDichBro has big blind (0.50)
Player IlxxxlI received card: [3h]
Player IlxxxlI received card: [10h]
Player pokanaktus is timed out.
Player pokanaktus folds
Player IlxxxlI folds
Player eu4ria raises (1.25)
Player BoTPuMHeDichBro folds
Uncalled bet (1) returned to eu4ria
Player eu4ria mucks cards
------ Summary ------
Pot: 1. Rake 0
*Player eu4ria mucks (does not show cards). Bets: 0.50. Collects: 1. Wins: 0.50.
Player BoTPuMHeDichBro does not show cards.Bets: 0.50. Collects: 0. Loses: 0.50.
Player pokanaktus does not show cards.Bets: 0. Collects: 0. Wins: 0.
Player IlxxxlI does not show cards.Bets: 0. Collects: 0. Wins: 0.
Game ended at: 2016/11/28 17:59:41

Game started
Game ID: 786345150 0.50/1 (PRR) Kraken - 16 (Hold'em)
Seat 4 is the button
Seat 1: Hakuna_Matata777 (130.81).
Seat 2: SenNoSen (101.13).
Seat 4: IlxxxlI (40.90).
Seat 5: plin777 (49.54).
Seat 6: CrimZnole (94.16).
Player plin777 has small blind (0.50)
Player CrimZnole has big blind (1)
Player IlxxxlI received card: [10c]
Player IlxxxlI received card: [Qh]
Player Hakuna_Matata777 folds
Player SenNoSen folds
Player IlxxxlI raises (2)
Player plin777 folds
Player CrimZnole calls (1)
*** FLOP ***: [7c 3h 6d]
Player CrimZnole checks
Player IlxxxlI checks
*** TURN ***: [7c 3h 6d] [10s]
Player CrimZnole bets (1.70)
Player IlxxxlI calls (1.70)
*** RIVER ***: [7c 3h 6d 10s] [4s]
Player CrimZnole bets (6.20)
Player IlxxxlI folds
Uncalled bet (6.20) returned to CrimZnole
Player CrimZnole mucks cards
------ Summary ------
Pot: 7.51. Rake 0.27. JP fee 0.12
Board: [7c 3h 6d 10s 4s]
Player Hakuna_Matata777 does not show cards.Bets: 0. Collects: 0. Wins: 0.
Player SenNoSen does not show cards.Bets: 0. Collects: 0. Wins: 0.
Player IlxxxlI does not show cards.Bets: 3.70. Collects: 0. Loses: 3.70.
Player plin777 does not show cards.Bets: 0.50. Collects: 0. Loses: 0.50.
*Player CrimZnole mucks (does not show cards). Bets: 3.70. Collects: 7.51. Wins: 3.81.
Game ended at: 2016/11/28 18:0:8

Game started
Game ID: 786345107 0.25/0.50 (PRR) Gorgons (Hold'em)
Seat 4 is the button
Seat 1: eu4ria (50.75).
Seat 3: BoTPuMHeDichBro (52.52).
Seat 4: pokanaktus (61.93).
Seat 6: IlxxxlI (20).
Player IlxxxlI has small blind (0.25)
Player eu4ria has big blind (0.50)
Player IlxxxlI received card: [4d]
Player IlxxxlI received card: [Jc]
Player BoTPuMHeDichBro folds
Player pokanaktus raises (1.50)
Player IlxxxlI folds
Player eu4ria folds
Uncalled bet (1) returned to pokanaktus
Player pokanaktus mucks cards
------ Summary ------
Pot: 1.25. Rake 0
Player eu4ria does not show cards.Bets: 0.50. Collects: 0. Loses: 0.50.
Player BoTPuMHeDichBro does not show cards.Bets: 0. Collects: 0. Wins: 0.
*Player pokanaktus mucks (does not show cards). Bets: 0.50. Collects: 1.25. Wins: 0.75.
Player IlxxxlI does not show cards.Bets: 0.25. Collects: 0. Loses: 0.25.
Game ended at: 2016/11/28 17:58:54

Game started
Game ID: 786345074 0.25/0.50 (PRR) Garuda - 3 (Hold'em)
Seat 5 is the button
Seat 1: Hakuna_Matata777 (91.92).
Seat 2: frenzybarb (50).
Seat 4: JoJoLoring (16.51).
Seat 5: IlxxxlI (20).
Seat 6: NoizeyCrckt (49).
Seat 7: 1jackoff1 (88.21).
Seat 8: haroldbb (93.69).
Seat 9: rpportugal (6.63).
Player NoizeyCrckt has small blind (0.25)
Player 1jackoff1 has big blind (0.50)
Player IlxxxlI received card: [6d]
Player IlxxxlI received card: [6c]
Player haroldbb folds
Player rpportugal calls (0.50)
Player Hakuna_Matata777 folds
Player frenzybarb folds
Player JoJoLoring folds
Player IlxxxlI calls (0.50)
Player NoizeyCrckt calls (0.25)
Player 1jackoff1 checks
*** FLOP ***: [Qd Ac 10d]
Player NoizeyCrckt checks
Player 1jackoff1 checks
Player rpportugal checks
Player IlxxxlI checks
*** TURN ***: [Qd Ac 10d] [Ad]
Player NoizeyCrckt checks
Player 1jackoff1 bets (2)
Player rpportugal folds
Player IlxxxlI folds
Player NoizeyCrckt folds
Uncalled bet (2) returned to 1jackoff1
Player 1jackoff1 mucks cards
------ Summary ------
Pot: 1.90. Rake 0.08. JP fee 0.02
Board: [Qd Ac 10d Ad]
Player Hakuna_Matata777 does not show cards.Bets: 0. Collects: 0. Wins: 0.
Player frenzybarb does not show cards.Bets: 0. Collects: 0. Wins: 0.
Player JoJoLoring does not show cards.Bets: 0. Collects: 0. Wins: 0.
Player IlxxxlI does not show cards.Bets: 0.50. Collects: 0. Loses: 0.50.
Player NoizeyCrckt does not show cards.Bets: 0.50. Collects: 0. Loses: 0.50.
*Player 1jackoff1 mucks (does not show cards). Bets: 0.50. Collects: 1.90. Wins: 1.40.
Player haroldbb does not show cards.Bets: 0. Collects: 0. Wins: 0.
Player rpportugal does not show cards.Bets: 0.50. Collects: 0. Loses: 0.50.
Game ended at: 2016/11/28 17:59:42

Game started
Game ID: 786345073 0.50/1 (PRR) Kraken - 16 (Hold'em)
Seat 2 is the button
Seat 1: Hakuna_Matata777 (130.81).
Seat 2: SenNoSen (101.13).
Seat 4: IlxxxlI (40).
Seat 5: plin777 (50.54).
Seat 6: CrimZnole (94.16).
Player IlxxxlI has small blind (0.50)
Player plin777 has big blind (1)
Player IlxxxlI received card: [Kh]
Player IlxxxlI received card: [7s]
Player CrimZnole folds
Player Hakuna_Matata777 folds
Player SenNoSen folds
Player IlxxxlI calls (0.50)
Player plin777 checks
*** FLOP ***: [2d 9s 8c]
Player IlxxxlI bets (1)
Player plin777 folds
Uncalled bet (1) returned to IlxxxlI
Player IlxxxlI mucks cards
------ Summary ------
Pot: 1.90. Rake 0.08. JP fee 0.02
Board: [2d 9s 8c]
Player Hakuna_Matata777 does not show cards.Bets: 0. Collects: 0. Wins: 0.
Player SenNoSen does not show cards.Bets: 0. Collects: 0. Wins: 0.
*Player IlxxxlI mucks (does not show cards). Bets: 1. Collects: 1.90. Wins: 0.90.
Player plin777 does not show cards.Bets: 1. Collects: 0. Loses: 1.
Player CrimZnole does not show cards.Bets: 0. Collects: 0. Wins: 0.
Game ended at: 2016/11/28 17:58:44

Game started
Game ID: 786344842 0.25/0.50 (PRR) Garuda - 3 (Hold'em)
Seat 4 is the button
Seat 1: Hakuna_Matata777 (91.92).
Seat 2: frenzybarb (50).
Seat 4: JoJoLoring (21.80).
Seat 5: IlxxxlI (20).
Seat 6: NoizeyCrckt (50).
Seat 7: 1jackoff1 (82.26).
Seat 8: haroldbb (93.69).
Seat 9: rpportugal (6.63).
Player IlxxxlI has small blind (0.25)
Player NoizeyCrckt has big blind (0.50)
Player IlxxxlI received card: [Js]
Player IlxxxlI received card: [10d]
Player 1jackoff1 calls (0.50)
Player haroldbb folds
Player rpportugal folds
Player Hakuna_Matata777 folds
Player frenzybarb folds
Player JoJoLoring raises (1)
Player IlxxxlI folds
Player NoizeyCrckt calls (0.50)
Player 1jackoff1 calls (0.50)
*** FLOP ***: [5h 8c 6h]
Player NoizeyCrckt checks
Player 1jackoff1 bets (2)
Player JoJoLoring calls (2)
Player NoizeyCrckt folds
*** TURN ***: [5h 8c 6h] [7c]
Player 1jackoff1 checks
Player JoJoLoring bets (2.29)
Player 1jackoff1 calls (2.29)
*** RIVER ***: [5h 8c 6h 7c] [3c]
Player 1jackoff1 checks
Player JoJoLoring checks
------ Summary ------
Pot: 11.24. Rake 0.41. JP fee 0.18
Board: [5h 8c 6h 7c 3c]
Player Hakuna_Matata777 does not show cards.Bets: 0. Collects: 0. Wins: 0.
Player frenzybarb does not show cards.Bets: 0. Collects: 0. Wins: 0.
Player JoJoLoring shows: One pair of 7s [As 7s]. Bets: 5.29. Collects: 0. Loses: 5.29.
Player IlxxxlI does not show cards.Bets: 0.25. Collects: 0. Loses: 0.25.
Player NoizeyCrckt does not show cards.Bets: 1. Collects: 0. Loses: 1.
*Player 1jackoff1 shows: One pair of 8s [8d 2c]. Bets: 5.29. Collects: 11.24. Wins: 5.95.
Player haroldbb does not show cards.Bets: 0. Collects: 0. Wins: 0.
Player rpportugal does not show cards.Bets: 0. Collects: 0. Wins: 0.
Game ended at: 2016/11/28 17:58:9

Game started
Game ID: 786344620 0.25/0.50 (PRR) Garuda - 3 (Hold'em)
Seat 2 is the button
Seat 1: Hakuna_Matata777 (91.92).
Seat 2: frenzybarb (50).
Seat 4: JoJoLoring (44.40).
Seat 5: IlxxxlI (20).
Seat 7: 1jackoff1 (88.38).
Seat 8: haroldbb (67.06).
Seat 9: rpportugal (6.63).
Player JoJoLoring has small blind (0.25)
Player IlxxxlI has big blind (0.50)
Player IlxxxlI received card: [As]
Player IlxxxlI received card: [5s]
Player 1jackoff1 calls (0.50)
Player haroldbb raises (2)
Player rpportugal folds
Player Hakuna_Matata777 folds
Player frenzybarb folds
Player JoJoLoring calls (1.75)
Player IlxxxlI folds
Player 1jackoff1 calls (1.50)
*** FLOP ***: [3h Kh 2s]
Player JoJoLoring bets (4.12)
Player 1jackoff1 calls (4.12)
Player haroldbb raises (20.60)
Player JoJoLoring calls (16.48)
Player 1jackoff1 folds
*** TURN ***: [3h Kh 2s] [Ad]
Player JoJoLoring checks
Player haroldbb allin (44.46)
Player JoJoLoring folds
Uncalled bet (44.46) returned to haroldbb
Player haroldbb mucks cards
------ Summary ------
Pot: 49.23. Rake 2.35. JP fee 0.24
Board: [3h Kh 2s Ad]
Player Hakuna_Matata777 does not show cards.Bets: 0. Collects: 0. Wins: 0.
Player frenzybarb does not show cards.Bets: 0. Collects: 0. Wins: 0.
Player JoJoLoring does not show cards.Bets: 22.60. Collects: 0. Loses: 22.60.
Player IlxxxlI does not show cards.Bets: 0.50. Collects: 0. Loses: 0.50.
Player 1jackoff1 does not show cards.Bets: 6.12. Collects: 0. Loses: 6.12.
*Player haroldbb mucks (does not show cards). Bets: 22.60. Collects: 49.23. Wins: 26.63.
Player rpportugal does not show cards.Bets: 0. Collects: 0. Wins: 0.
Game ended at: 2016/11/28 17:56:50

Game started
Game ID: 786344489 0.25/0.50 (PRR) Garuda - 3 (Hold'em)
Seat 1 is the button
Seat 1: Hakuna_Matata777 (91.92).
Seat 2: frenzybarb (50).
Seat 4: JoJoLoring (44.90).
Seat 5: IlxxxlI (20).
Seat 7: 1jackoff1 (96.38).
Seat 8: haroldbb (59.14).
Seat 9: rpportugal (6.63).
Player frenzybarb has small blind (0.25)
Player JoJoLoring has big blind (0.50)
Player IlxxxlI received card: [2d]
Player IlxxxlI received card: [Ks]
Player IlxxxlI folds
Player 1jackoff1 calls (0.50)
Player haroldbb raises (2)
Player rpportugal folds
Player Hakuna_Matata777 folds
Player frenzybarb folds
Player JoJoLoring folds
Player 1jackoff1 calls (1.50)
*** FLOP ***: [Qs Jc 9c]
Player 1jackoff1 bets (2)
Player haroldbb calls (2)
*** TURN ***: [Qs Jc 9c] [5c]
Player 1jackoff1 bets (2)
Player haroldbb calls (2)
*** RIVER ***: [Qs Jc 9c 5c] [7h]
Player 1jackoff1 bets (2)
Player haroldbb calls (2)
------ Summary ------
Pot: 15.92. Rake 0.59. JP fee 0.24
Board: [Qs Jc 9c 5c 7h]
Player Hakuna_Matata777 does not show cards.Bets: 0. Collects: 0. Wins: 0.
Player frenzybarb does not show cards.Bets: 0.25. Collects: 0. Loses: 0.25.
Player JoJoLoring does not show cards.Bets: 0.50. Collects: 0. Loses: 0.50.
Player IlxxxlI does not show cards.Bets: 0. Collects: 0. Wins: 0.
Player 1jackoff1 shows: One pair of Js [Js 6h]. Bets: 8. Collects: 0. Loses: 8.
*Player haroldbb shows: One pair of Qs [Qh Kc]. Bets: 8. Collects: 15.92. Wins: 7.92.
Player rpportugal does not show cards.Bets: 0. Collects: 0. Wins: 0.
Game ended at: 2016/11/28 17:55:30

Game started
Game ID: 786344269 0.25/0.50 (PRR) Garuda - 3 (Hold'em)
Seat 9 is the button
Seat 1: Hakuna_Matata777 (92.17).
Seat 2: frenzybarb (50).
Seat 4: JoJoLoring (44.90).
Seat 5: IlxxxlI (20).
Seat 6: NoizeyCrckt (50).
Seat 7: 1jackoff1 (95.69).
Seat 8: haroldbb (59.14).
Seat 9: rpportugal (6.63).
Player Hakuna_Matata777 has small blind (0.25)
Player frenzybarb has big blind (0.50)
Player NoizeyCrckt is timed out.
Player NoizeyCrckt wait BB
Player IlxxxlI received card: [Js]
Player IlxxxlI received card: [8s]
Player JoJoLoring folds
Player IlxxxlI folds
Player 1jackoff1 calls (0.50)
Player haroldbb folds
Player rpportugal folds
Player Hakuna_Matata777 folds
Player frenzybarb checks
*** FLOP ***: [10s Kd 3h]
Player frenzybarb checks
Player 1jackoff1 checks
*** TURN ***: [10s Kd 3h] [3c]
Player frenzybarb checks
Player 1jackoff1 bets (1)
Player frenzybarb folds
Uncalled bet (1) returned to 1jackoff1
Player 1jackoff1 mucks cards
------ Summary ------
Pot: 1.19. Rake 0.04. JP fee 0.02
Board: [10s Kd 3h 3c]
Player Hakuna_Matata777 does not show cards.Bets: 0.25. Collects: 0. Loses: 0.25.
Player frenzybarb does not show cards.Bets: 0.50. Collects: 0. Loses: 0.50.
Player JoJoLoring does not show cards.Bets: 0. Collects: 0. Wins: 0.
Player IlxxxlI does not show cards.Bets: 0. Collects: 0. Wins: 0.
Player NoizeyCrckt does not show cards.Bets: 0. Collects: 0. Wins: 0.
*Player 1jackoff1 mucks (does not show cards). Bets: 0.50. Collects: 1.19. Wins: 0.69.
Player haroldbb does not show cards.Bets: 0. Collects: 0. Wins: 0.
Player rpportugal does not show cards.Bets: 0. Collects: 0. Wins: 0.
Game ended at: 2016/11/28 17:54:46

Game started
Game ID: 786344089 0.25/0.50 (PRR) Garuda - 3 (Hold'em)
Seat 8 is the button
Seat 1: Hakuna_Matata777 (92.67).
Seat 2: frenzybarb (50).
Seat 4: JoJoLoring (45.40).
Seat 5: IlxxxlI (20).
Seat 7: 1jackoff1 (94.05).
Seat 8: haroldbb (59.64).
Seat 9: rpportugal (6.88).
Player rpportugal has small blind (0.25)
Player Hakuna_Matata777 has big blind (0.50)
Player IlxxxlI received card: [Qh]
Player IlxxxlI received card: [9s]
Player frenzybarb folds
Player JoJoLoring calls (0.50)
Player IlxxxlI folds
Player 1jackoff1 calls (0.50)
Player haroldbb calls (0.50)
Player rpportugal folds
Player Hakuna_Matata777 checks
*** FLOP ***: [Kd 8s 10d]
Player Hakuna_Matata777 checks
Player JoJoLoring checks
Player 1jackoff1 bets (2)
Player haroldbb folds
Player Hakuna_Matata777 folds
Player JoJoLoring folds
Uncalled bet (2) returned to 1jackoff1
Player 1jackoff1 mucks cards
------ Summary ------
Pot: 2.14. Rake 0.09. JP fee 0.02
Board: [Kd 8s 10d]
Player Hakuna_Matata777 does not show cards.Bets: 0.50. Collects: 0. Loses: 0.50.
Player frenzybarb does not show cards.Bets: 0. Collects: 0. Wins: 0.
Player JoJoLoring does not show cards.Bets: 0.50. Collects: 0. Loses: 0.50.
Player IlxxxlI does not show cards.Bets: 0. Collects: 0. Wins: 0.
*Player 1jackoff1 mucks (does not show cards). Bets: 0.50. Collects: 2.14. Wins: 1.64.
Player haroldbb does not show cards.Bets: 0.50. Collects: 0. Loses: 0.50.
Player rpportugal does not show cards.Bets: 0.25. Collects: 0. Loses: 0.25.
Game ended at: 2016/11/28 17:53:45

Game started
Game ID: 786343846 0.25/0.50 (PRR) Garuda - 3 (Hold'em)
Seat 7 is the button
Seat 1: Hakuna_Matata777 (92.67).
Seat 2: frenzybarb (50).
Seat 4: JoJoLoring (44.23).
Seat 5: IlxxxlI (20).
Seat 7: 1jackoff1 (94.55).
Seat 8: haroldbb (59.89).
Seat 9: rpportugal (7.38).
Player haroldbb has small blind (0.25)
Player rpportugal has big blind (0.50)
Player IlxxxlI received card: [As]
Player IlxxxlI received card: [4h]
Player Hakuna_Matata777 folds
Player frenzybarb folds
Player JoJoLoring calls (0.50)
Player IlxxxlI folds
Player 1jackoff1 calls (0.50)
Player haroldbb folds
Player rpportugal checks
*** FLOP ***: [Kc 8h Qd]
Player rpportugal checks
Player JoJoLoring checks
Player 1jackoff1 checks
*** TURN ***: [Kc 8h Qd] [9h]
Player rpportugal checks
Player JoJoLoring checks
Player 1jackoff1 checks
*** RIVER ***: [Kc 8h Qd 9h] [Kd]
Player rpportugal checks
Player JoJoLoring checks
Player 1jackoff1 checks
Player rpportugal mucks cards
Player 1jackoff1 mucks cards
------ Summary ------
Pot: 1.67. Rake 0.06. JP fee 0.02
Board: [Kc 8h Qd 9h Kd]
Player Hakuna_Matata777 does not show cards.Bets: 0. Collects: 0. Wins: 0.
Player frenzybarb does not show cards.Bets: 0. Collects: 0. Wins: 0.
*Player JoJoLoring shows: One pair of Ks [Ac 7d]. Bets: 0.50. Collects: 1.67. Wins: 1.17.
Player IlxxxlI does not show cards.Bets: 0. Collects: 0. Wins: 0.
Player 1jackoff1 mucks (does not show cards). Bets: 0.50. Collects: 0. Loses: 0.50.
Player haroldbb does not show cards.Bets: 0.25. Collects: 0. Loses: 0.25.
Player rpportugal mucks (does not show cards). Bets: 0.50. Collects: 0. Loses: 0.50.
Game ended at: 2016/11/28 17:52:53

Game started
Game ID: 786343689 0.25/0.50 (PRR) Garuda - 3 (Hold'em)
Seat 5 is the button
Seat 1: Hakuna_Matata777 (92.67).
Seat 2: frenzybarb (50).
Seat 4: JoJoLoring (44.23).
Seat 5: IlxxxlI (20).
Seat 7: 1jackoff1 (94.80).
Seat 8: haroldbb (60.39).
Seat 9: rpportugal (6.63).
Player 1jackoff1 has small blind (0.25)
Player haroldbb has big blind (0.50)
Player IlxxxlI received card: [9c]
Player IlxxxlI received card: [4d]
Player rpportugal allin (6.63)
Player Hakuna_Matata777 folds
Player frenzybarb folds
Player JoJoLoring folds
Player IlxxxlI folds
Player 1jackoff1 folds
Player haroldbb folds
Uncalled bet (6.13) returned to rpportugal
Player rpportugal mucks cards
------ Summary ------
Pot: 1.25. Rake 0
Player Hakuna_Matata777 does not show cards.Bets: 0. Collects: 0. Wins: 0.
Player frenzybarb does not show cards.Bets: 0. Collects: 0. Wins: 0.
Player JoJoLoring does not show cards.Bets: 0. Collects: 0. Wins: 0.
Player IlxxxlI does not show cards.Bets: 0. Collects: 0. Wins: 0.
Player 1jackoff1 does not show cards.Bets: 0.25. Collects: 0. Loses: 0.25.
Player haroldbb does not show cards.Bets: 0.50. Collects: 0. Loses: 0.50.
*Player rpportugal mucks (does not show cards). Bets: 0.50. Collects: 1.25. Wins: 0.75.
Game ended at: 2016/11/28 17:51:43

Game started
Game ID: 786343522 0.25/0.50 (PRR) Garuda - 3 (Hold'em)
Seat 4 is the button
Seat 1: Hakuna_Matata777 (92.67).
Seat 2: frenzybarb (50).
Seat 4: JoJoLoring (44.23).
Seat 5: IlxxxlI (20).
Seat 7: 1jackoff1 (93).
Seat 8: haroldbb (60.39).
Seat 9: rpportugal (6.63).
Player IlxxxlI has small blind (0.25)
Player 1jackoff1 has big blind (0.50)
Player IlxxxlI received card: [8d]
Player IlxxxlI received card: [Ad]
Player haroldbb folds
Player rpportugal folds
Player Hakuna_Matata777 folds
Player frenzybarb folds
Player JoJoLoring folds
Player IlxxxlI raises (0.75)
Player 1jackoff1 calls (0.50)
*** FLOP ***: [5c Jh 7c]
Player IlxxxlI bets (0.50)
Player 1jackoff1 calls (0.50)
*** TURN ***: [5c Jh 7c] [6h]
Player IlxxxlI bets (0.50)
Player 1jackoff1 calls (0.50)
*** RIVER ***: [5c Jh 7c 6h] [5s]
Player IlxxxlI checks
Player 1jackoff1 bets (2)
Player IlxxxlI folds
Uncalled bet (2) returned to 1jackoff1
Player 1jackoff1 mucks cards
------ Summary ------
Pot: 3.80. Rake 0.14. JP fee 0.06
Board: [5c Jh 7c 6h 5s]
Player Hakuna_Matata777 does not show cards.Bets: 0. Collects: 0. Wins: 0.
Player frenzybarb does not show cards.Bets: 0. Collects: 0. Wins: 0.
Player JoJoLoring does not show cards.Bets: 0. Collects: 0. Wins: 0.
Player IlxxxlI does not show cards.Bets: 2. Collects: 0. Loses: 2.
*Player 1jackoff1 mucks (does not show cards). Bets: 2. Collects: 3.80. Wins: 1.80.
Player haroldbb does not show cards.Bets: 0. Collects: 0. Wins: 0.
Player rpportugal does not show cards.Bets: 0. Collects: 0. Wins: 0.
Game ended at: 2016/11/28 17:51:7

Game started
Game ID: 786343242 0.25/0.50 (PRR) Garuda - 3 (Hold'em)
Seat 2 is the button
Seat 1: Hakuna_Matata777 (92.67).
Seat 2: frenzybarb (50).
Seat 4: JoJoLoring (48.29).
Seat 5: IlxxxlI (20).
Seat 7: 1jackoff1 (86.97).
Seat 8: haroldbb (60.39).
Seat 9: rpportugal (8.63).
Player JoJoLoring has small blind (0.25)
Player IlxxxlI has big blind (0.50)
Player IlxxxlI received card: [Ad]
Player IlxxxlI received card: [4d]
Player 1jackoff1 calls (0.50)
Player haroldbb folds
Player rpportugal calls (0.50)
Player Hakuna_Matata777 folds
Player frenzybarb folds
Player JoJoLoring raises (1.75)
Player IlxxxlI folds
Player 1jackoff1 calls (1.50)
Player rpportugal calls (1.50)
*** FLOP ***: [3c 2c 8d]
Player JoJoLoring bets (2.06)
Player 1jackoff1 raises (4.12)
Player rpportugal folds
Player JoJoLoring folds
Uncalled bet (2.06) returned to 1jackoff1
Player 1jackoff1 mucks cards
------ Summary ------
Pot: 10.09. Rake 0.37. JP fee 0.16
Board: [3c 2c 8d]
Player Hakuna_Matata777 does not show cards.Bets: 0. Collects: 0. Wins: 0.
Player frenzybarb does not show cards.Bets: 0. Collects: 0. Wins: 0.
Player JoJoLoring does not show cards.Bets: 4.06. Collects: 0. Loses: 4.06.
Player IlxxxlI does not show cards.Bets: 0.50. Collects: 0. Loses: 0.50.
*Player 1jackoff1 mucks (does not show cards). Bets: 4.06. Collects: 10.09. Wins: 6.03.
Player haroldbb does not show cards.Bets: 0. Collects: 0. Wins: 0.
Player rpportugal does not show cards.Bets: 2. Collects: 0. Loses: 2.
Game ended at: 2016/11/28 17:50:15

Game started
Game ID: 781111876 0.25/0.50 (PRR) Garuda (Hold'em)
Seat 6 is the button
Seat 1: GagaPoker (67.09).
Seat 3: FirstClan (50).
Seat 4: texaswarthog (48.04).
Seat 5: Chipburnner (33.06).
Seat 6: Parcker (50).
Seat 7: sobrr (19.50).
Seat 8: HorsePussy (31.47).
Seat 9: IlxxxlI (25.82).
Player sobrr has small blind (0.25)
Player HorsePussy has big blind (0.50)
Player IlxxxlI received card: [Qc]
Player IlxxxlI received card: [2s]
Player IlxxxlI folds
Player GagaPoker folds
Player FirstClan folds
Player texaswarthog folds
Player Chipburnner folds
Player Parcker folds
Player sobrr folds
Uncalled bet (0.25) returned to HorsePussy
Player HorsePussy mucks cards
------ Summary ------
Pot: 0.50. Rake 0
Player GagaPoker does not show cards.Bets: 0. Collects: 0. Wins: 0.
Player FirstClan does not show cards.Bets: 0. Collects: 0. Wins: 0.
Player texaswarthog does not show cards.Bets: 0. Collects: 0. Wins: 0.
Player Chipburnner does not show cards.Bets: 0. Collects: 0. Wins: 0.
Player Parcker does not show cards.Bets: 0. Collects: 0. Wins: 0.
Player sobrr does not show cards.Bets: 0.25. Collects: 0. Loses: 0.25.
*Player HorsePussy mucks (does not show cards). Bets: 0.25. Collects: 0.50. Wins: 0.25.
Player IlxxxlI does not show cards.Bets: 0. Collects: 0. Wins: 0.
Game ended at: 2016/11/21 15:9:52

Game started
Game ID: 781111301 0.25/0.50 (PRR) Garuda (Hold'em)
Seat 5 is the button
Seat 1: GagaPoker (67.09).
Seat 3: FirstClan (50).
Seat 4: texaswarthog (44.37).
Seat 5: Chipburnner (33.06).
Seat 6: Parcker (50).
Seat 7: sobrr (20).
Seat 8: HorsePussy (31.47).
Seat 9: IlxxxlI (25.82).
Player Parcker has small blind (0.25)
Player sobrr has big blind (0.50)
Player IlxxxlI received card: [8s]
Player IlxxxlI received card: [2h]
Player HorsePussy folds
Player IlxxxlI folds
Player GagaPoker folds
Player FirstClan raises (1.50)
Player texaswarthog calls (1.50)
Player Chipburnner folds
Player Parcker folds
Player sobrr folds
*** FLOP ***: [5h Jh Qh]
Player FirstClan checks
Player texaswarthog bets (1.78)
Player FirstClan calls (1.78)
*** TURN ***: [5h Jh Qh] [Ac]
Player FirstClan checks
Player texaswarthog checks
*** RIVER ***: [5h Jh Qh Ac] [2s]
Player FirstClan checks
Player texaswarthog checks
Player FirstClan mucks cards
------ Summary ------
Pot: 6.95. Rake 0.24. JP fee 0.12
Board: [5h Jh Qh Ac 2s]
Player GagaPoker does not show cards.Bets: 0. Collects: 0. Wins: 0.
Player FirstClan mucks (does not show cards). Bets: 3.28. Collects: 0. Loses: 3.28.
*Player texaswarthog shows: One pair of As [As 3s]. Bets: 3.28. Collects: 6.95. Wins: 3.67.
Player Chipburnner does not show cards.Bets: 0. Collects: 0. Wins: 0.
Player Parcker does not show cards.Bets: 0.25. Collects: 0. Loses: 0.25.
Player sobrr does not show cards.Bets: 0.50. Collects: 0. Loses: 0.50.
Player HorsePussy does not show cards.Bets: 0. Collects: 0. Wins: 0.
Player IlxxxlI does not show cards.Bets: 0. Collects: 0. Wins: 0.
Game ended at: 2016/11/21 15:9:11

Game started
Game ID: 781110707 0.25/0.50 (PRR) Garuda (Hold'em)
Seat 4 is the button
Seat 1: GagaPoker (67.09).
Seat 3: FirstClan (50).
Seat 4: texaswarthog (45.87).
Seat 5: Chipburnner (33.31).
Seat 6: Parcker (50).
Seat 8: HorsePussy (31.47).
Seat 9: IlxxxlI (23.75).
Player Chipburnner has small blind (0.25)
Player Parcker has big blind (0.50)
Player IlxxxlI received card: [Ac]
Player IlxxxlI received card: [Ah]
Player HorsePussy folds
Player IlxxxlI raises (1.50)
Player GagaPoker folds
Player FirstClan folds
Player texaswarthog calls (1.50)
Player Chipburnner folds
Player Parcker folds
*** FLOP ***: [Ks Jh 10h]
Player IlxxxlI bets (3.50)
Player texaswarthog folds
Uncalled bet (3.50) returned to IlxxxlI
Player IlxxxlI mucks cards
------ Summary ------
Pot: 3.57. Rake 0.12. JP fee 0.06
Board: [Ks Jh 10h]
Player GagaPoker does not show cards.Bets: 0. Collects: 0. Wins: 0.
Player FirstClan does not show cards.Bets: 0. Collects: 0. Wins: 0.
Player texaswarthog does not show cards.Bets: 1.50. Collects: 0. Loses: 1.50.
Player Chipburnner does not show cards.Bets: 0.25. Collects: 0. Loses: 0.25.
Player Parcker does not show cards.Bets: 0.50. Collects: 0. Loses: 0.50.
Player HorsePussy does not show cards.Bets: 0. Collects: 0. Wins: 0.
*Player IlxxxlI mucks (does not show cards). Bets: 1.50. Collects: 3.57. Wins: 2.07.
Game ended at: 2016/11/21 15:7:44

Game started
Game ID: 781110231 0.25/0.50 (PRR) Garuda (Hold'em)
Seat 3 is the button
Seat 1: GagaPoker (67.09).
Seat 3: FirstClan (53.50).
Seat 4: texaswarthog (37.63).
Seat 5: Chipburnner (34.81).
Seat 6: Parcker (50).
Seat 8: HorsePussy (31.47).
Seat 9: IlxxxlI (23.75).
Player texaswarthog has small blind (0.25)
Player Chipburnner has big blind (0.50)
Player IlxxxlI received card: [10c]
Player IlxxxlI received card: [Jd]
Player Parcker folds
Player HorsePussy folds
Player IlxxxlI folds
Player GagaPoker folds
Player FirstClan raises (1.50)
Player texaswarthog calls (1.25)
Player Chipburnner calls (1)
*** FLOP ***: [5s 5d 4s]
Player texaswarthog checks
Player Chipburnner checks
Player FirstClan bets (1.42)
Player texaswarthog calls (1.42)
Player Chipburnner folds
*** TURN ***: [5s 5d 4s] [3h]
Player texaswarthog checks
Player FirstClan checks
*** RIVER ***: [5s 5d 4s 3h] [7h]
Player texaswarthog bets (4.65)
Player FirstClan calls (4.65)
Player FirstClan mucks cards
------ Summary ------
Pot: 15.81. Rake 0.59. JP fee 0.24
Board: [5s 5d 4s 3h 7h]
Player GagaPoker does not show cards.Bets: 0. Collects: 0. Wins: 0.
Player FirstClan mucks (does not show cards). Bets: 7.57. Collects: 0. Loses: 7.57.
*Player texaswarthog shows: Two pairs. 7s and 5s [7s 10h]. Bets: 7.57. Collects: 15.81. Wins: 8.24.
Player Chipburnner does not show cards.Bets: 1.50. Collects: 0. Loses: 1.50.
Player Parcker does not show cards.Bets: 0. Collects: 0. Wins: 0.
Player HorsePussy does not show cards.Bets: 0. Collects: 0. Wins: 0.
Player IlxxxlI does not show cards.Bets: 0. Collects: 0. Wins: 0.
Game ended at: 2016/11/21 15:6:13

Game started
Game ID: 781109815 0.25/0.50 (PRR) Garuda (Hold'em)
Seat 1 is the button
Seat 1: GagaPoker (67.09).
Seat 3: FirstClan (53.75).
Seat 4: texaswarthog (38.13).
Seat 5: Chipburnner (34.81).
Seat 6: Parcker (50).
Seat 7: ACESOVAKINGZ (65.32).
Seat 8: HorsePussy (32.97).
Seat 9: IlxxxlI (20).
Player FirstClan has small blind (0.25)
Player texaswarthog has big blind (0.50)
Player IlxxxlI received card: [Kc]
Player IlxxxlI received card: [Ks]
Player Chipburnner folds
Player Parcker raises (1.50)
Player ACESOVAKINGZ folds
Player HorsePussy calls (1.50)
Player IlxxxlI raises (5.14)
Player GagaPoker folds
Player FirstClan folds
Player texaswarthog folds
Player Parcker folds
Player HorsePussy folds
Uncalled bet (3.64) returned to IlxxxlI
Player IlxxxlI mucks cards
------ Summary ------
Pot: 5.25. Rake 0
Player GagaPoker does not show cards.Bets: 0. Collects: 0. Wins: 0.
Player FirstClan does not show cards.Bets: 0.25. Collects: 0. Loses: 0.25.
Player texaswarthog does not show cards.Bets: 0.50. Collects: 0. Loses: 0.50.
Player Chipburnner does not show cards.Bets: 0. Collects: 0. Wins: 0.
Player Parcker does not show cards.Bets: 1.50. Collects: 0. Loses: 1.50.
Player ACESOVAKINGZ does not show cards.Bets: 0. Collects: 0. Wins: 0.
Player HorsePussy does not show cards.Bets: 1.50. Collects: 0. Loses: 1.50.
*Player IlxxxlI mucks (does not show cards). Bets: 1.50. Collects: 5.25. Wins: 3.75.
Game ended at: 2016/11/21 15:4:57

Game started
Game ID: 781108853 0.25/0.50 (PRR) Garuda (Hold'em)
Seat 9 is the button
Seat 1: GagaPoker (67.59).
Seat 2: imperceptible (20).
Seat 3: FirstClan (54.25).
Seat 4: texaswarthog (38.13).
Seat 5: Chipburnner (30.01).
Seat 6: Parcker (50).
Seat 7: ACESOVAKINGZ (69.06).
Seat 8: HorsePussy (33.47).
Seat 9: IlxxxlI (20).
Player GagaPoker has small blind (0.25)
Player imperceptible is timed out.
Player imperceptible sitting out
Player FirstClan has big blind (0.50)
Player IlxxxlI received card: [Jc]
Player IlxxxlI received card: [9d]
Player texaswarthog folds
Player Chipburnner calls (0.50)
Player Parcker folds
Player ACESOVAKINGZ calls (0.50)
Player HorsePussy calls (0.50)
Player IlxxxlI folds
Player GagaPoker calls (0.25)
Player FirstClan checks
*** FLOP ***: [6d Qh 10h]
Player GagaPoker checks
Player FirstClan checks
Player Chipburnner checks
Player ACESOVAKINGZ bets (1.50)
Player HorsePussy folds
Player GagaPoker folds
Player FirstClan folds
Player Chipburnner calls (1.50)
*** TURN ***: [6d Qh 10h] [Ks]
Player Chipburnner checks
Player ACESOVAKINGZ checks
*** RIVER ***: [6d Qh 10h Ks] [6s]
Player Chipburnner bets (1.74)
Player ACESOVAKINGZ calls (1.74)
Player ACESOVAKINGZ mucks cards
------ Summary ------
Pot: 8.54. Rake 0.30. JP fee 0.14
Board: [6d Qh 10h Ks 6s]
Player GagaPoker does not show cards.Bets: 0.50. Collects: 0. Loses: 0.50.
Player imperceptible does not show cards.Bets: 0. Collects: 0. Wins: 0.
Player FirstClan does not show cards.Bets: 0.50. Collects: 0. Loses: 0.50.
Player texaswarthog does not show cards.Bets: 0. Collects: 0. Wins: 0.
*Player Chipburnner shows: Two pairs. Qs and 10s [10d Qc]. Bets: 3.74. Collects: 8.54. Wins: 4.80.
Player Parcker does not show cards.Bets: 0. Collects: 0. Wins: 0.
Player ACESOVAKINGZ mucks (does not show cards). Bets: 3.74. Collects: 0. Loses: 3.74.
Player HorsePussy does not show cards.Bets: 0.50. Collects: 0. Loses: 0.50.
Player IlxxxlI does not show cards.Bets: 0. Collects: 0. Wins: 0.
Game ended at: 2016/11/21 15:3:50

Game started
Game ID: 781108258 0.25/0.50 (PRR) Garuda (Hold'em)
Seat 8 is the button
Seat 1: GagaPoker (70.59).
Seat 2: imperceptible (20).
Seat 3: FirstClan (54.25).
Seat 4: texaswarthog (38.13).
Seat 5: Chipburnner (24.22).
Seat 6: Parcker (50).
Seat 7: ACESOVAKINGZ (69.06).
Seat 8: HorsePussy (36.47).
Seat 9: IlxxxlI (20.25).
Player IlxxxlI has small blind (0.25)
Player GagaPoker has big blind (0.50)
Player IlxxxlI received card: [4d]
Player IlxxxlI received card: [10s]
Player imperceptible folds
Player FirstClan folds
Player texaswarthog folds
Player Chipburnner raises (1.50)
Player Parcker folds
Player ACESOVAKINGZ folds
Player HorsePussy calls (1.50)
Player IlxxxlI folds
Player GagaPoker calls (1)
*** FLOP ***: [10c 7c 9d]
Player GagaPoker checks
Player Chipburnner bets (1.50)
Player HorsePussy calls (1.50)
Player GagaPoker calls (1.50)
*** TURN ***: [10c 7c 9d] [As]
Player GagaPoker checks
Player Chipburnner allin (21.22)
Player HorsePussy folds
Player GagaPoker folds
Uncalled bet (21.22) returned to Chipburnner
Player Chipburnner is timed out.
Player Chipburnner mucks cards
------ Summary ------
Pot: 8.79. Rake 0.32. JP fee 0.14
Board: [10c 7c 9d As]
Player GagaPoker does not show cards.Bets: 3. Collects: 0. Loses: 3.
Player imperceptible does not show cards.Bets: 0. Collects: 0. Wins: 0.
Player FirstClan does not show cards.Bets: 0. Collects: 0. Wins: 0.
Player texaswarthog does not show cards.Bets: 0. Collects: 0. Wins: 0.
*Player Chipburnner mucks (does not show cards). Bets: 3. Collects: 8.79. Wins: 5.79.
Player Parcker does not show cards.Bets: 0. Collects: 0. Wins: 0.
Player ACESOVAKINGZ does not show cards.Bets: 0. Collects: 0. Wins: 0.
Player HorsePussy does not show cards.Bets: 3. Collects: 0. Loses: 3.
Player IlxxxlI does not show cards.Bets: 0.25. Collects: 0. Loses: 0.25.
Game ended at: 2016/11/21 15:1:11

Game started
Game ID: 781107650 0.25/0.50 (PRR) Garuda (Hold'em)
Seat 7 is the button
Seat 1: GagaPoker (50).
Seat 2: imperceptible (15.75).
Seat 3: FirstClan (54.25).
Seat 4: texaswarthog (38.13).
Seat 5: Chipburnner (25.22).
Seat 6: Parcker (50).
Seat 7: ACESOVAKINGZ (69.06).
Seat 8: HorsePussy (36.72).
Seat 9: IlxxxlI (20.75).
Player HorsePussy has small blind (0.25)
Player IlxxxlI has big blind (0.50)
Player IlxxxlI received card: [5c]
Player IlxxxlI received card: [Kd]
Player GagaPoker raises (1)
Player imperceptible calls (1)
Player FirstClan folds
Player texaswarthog folds
Player Chipburnner calls (1)
Player Parcker raises (5)
Player ACESOVAKINGZ folds
Player HorsePussy folds
Player IlxxxlI folds
Player GagaPoker calls (4)
Player imperceptible allin (14.75)
Player Chipburnner folds
Player Parcker folds
Player GagaPoker calls (10.75)
*** FLOP ***: [4c 7d 8d]
*** TURN ***: [4c 7d 8d] [2d]
*** RIVER ***: [4c 7d 8d 2d] [6s]
------ Summary ------
Pot: 36.34. Rake 1.67. JP fee 0.24
Board: [4c 7d 8d 2d 6s]
*Player GagaPoker shows: High card A (kicker K) [Ah Kh]. Bets: 15.75. Collects: 36.34. Wins: 20.59.
Player imperceptible shows: High card A [Qc Ad]. Bets: 15.75. Collects: 0. Loses: 15.75.
Player FirstClan does not show cards.Bets: 0. Collects: 0. Wins: 0.
Player texaswarthog does not show cards.Bets: 0. Collects: 0. Wins: 0.
Player Chipburnner does not show cards.Bets: 1. Collects: 0. Loses: 1.
Player Parcker does not show cards.Bets: 5. Collects: 0. Loses: 5.
Player ACESOVAKINGZ does not show cards.Bets: 0. Collects: 0. Wins: 0.
Player HorsePussy does not show cards.Bets: 0.25. Collects: 0. Loses: 0.25.
Player IlxxxlI does not show cards.Bets: 0.50. Collects: 0. Loses: 0.50.
Game ended at: 2016/11/21 14:59:34

Game started
Game ID: 781107058 0.25/0.50 (PRR) Garuda (Hold'em)
Seat 6 is the button
Seat 1: GagaPoker (50).
Seat 2: imperceptible (15.75).
Seat 3: FirstClan (54.25).
Seat 4: texaswarthog (38.45).
Seat 5: Chipburnner (25.55).
Seat 6: Parcker (50).
Seat 7: ACESOVAKINGZ (70.56).
Seat 8: HorsePussy (37.22).
Seat 9: IlxxxlI (20.75).
Player ACESOVAKINGZ has small blind (0.25)
Player HorsePussy has big blind (0.50)
Player IlxxxlI received card: [7s]
Player IlxxxlI received card: [2c]
Player IlxxxlI folds
Player GagaPoker folds
Player imperceptible folds
Player FirstClan folds
Player texaswarthog raises (1.50)
Player Chipburnner calls (1.50)
Player Parcker folds
Player ACESOVAKINGZ calls (1.25)
Player HorsePussy folds
*** FLOP ***: [Qs Js 4s]
Player ACESOVAKINGZ checks
Player texaswarthog bets (2.37)
Player Chipburnner calls (2.37)
Player ACESOVAKINGZ folds
*** TURN ***: [Qs Js 4s] [4c]
Player texaswarthog bets (6.17)
Player Chipburnner calls (6.17)
*** RIVER ***: [Qs Js 4s 4c] [10s]
Player texaswarthog checks
Player Chipburnner allin (15.51)
Player texaswarthog calls (15.51)
------ Summary ------
Pot: 50.45. Rake 2.41. JP fee 0.24
Board: [Qs Js 4s 4c 10s]
Player GagaPoker does not show cards.Bets: 0. Collects: 0. Wins: 0.
Player imperceptible does not show cards.Bets: 0. Collects: 0. Wins: 0.
Player FirstClan does not show cards.Bets: 0. Collects: 0. Wins: 0.
*Player texaswarthog shows: Two pairs. Qs and 10s [Qc 10h]. Bets: 25.55. Collects: 25.23. Loses: 0.32.
*Player Chipburnner shows: Two pairs. Qs and 10s [Qh 10d]. Bets: 25.55. Collects: 25.22. Loses: 0.33.
Player Parcker does not show cards.Bets: 0. Collects: 0. Wins: 0.
Player ACESOVAKINGZ does not show cards.Bets: 1.50. Collects: 0. Loses: 1.50.
Player HorsePussy does not show cards.Bets: 0.50. Collects: 0. Loses: 0.50.
Player IlxxxlI does not show cards.Bets: 0. Collects: 0. Wins: 0.
Game ended at: 2016/11/21 14:57:46

Game started
Game ID: 781106735 0.25/0.50 (PRR) Garuda (Hold'em)
Seat 5 is the button
Seat 1: GagaPoker (50).
Seat 2: imperceptible (15.75).
Seat 3: FirstClan (50).
Seat 4: texaswarthog (38.45).
Seat 5: Chipburnner (25.55).
Seat 6: Parcker (50).
Seat 7: ACESOVAKINGZ (71.06).
Seat 9: IlxxxlI (22.50).
Player Parcker has small blind (0.25)
Player ACESOVAKINGZ has big blind (0.50)
Player IlxxxlI received card: [Qd]
Player IlxxxlI received card: [Kh]
Player IlxxxlI raises (1.75)
Player GagaPoker calls (1.75)
Player imperceptible folds
Player FirstClan raises (6)
Player texaswarthog folds
Player Chipburnner folds
Player Parcker folds
Player ACESOVAKINGZ folds
Player IlxxxlI folds
Player GagaPoker folds
Uncalled bet (4.25) returned to FirstClan
Player FirstClan mucks cards
------ Summary ------
Pot: 6. Rake 0
Player GagaPoker does not show cards.Bets: 1.75. Collects: 0. Loses: 1.75.
Player imperceptible does not show cards.Bets: 0. Collects: 0. Wins: 0.
*Player FirstClan mucks (does not show cards). Bets: 1.75. Collects: 6. Wins: 4.25.
Player texaswarthog does not show cards.Bets: 0. Collects: 0. Wins: 0.
Player Chipburnner does not show cards.Bets: 0. Collects: 0. Wins: 0.
Player Parcker does not show cards.Bets: 0.25. Collects: 0. Loses: 0.25.
Player ACESOVAKINGZ does not show cards.Bets: 0.50. Collects: 0. Loses: 0.50.
Player IlxxxlI does not show cards.Bets: 1.75. Collects: 0. Loses: 1.75.
Game ended at: 2016/11/21 14:56:3

Game started
Game ID: 781106525 0.25/0.50 (PRR) Garuda (Hold'em)
Seat 4 is the button
Seat 1: GagaPoker (50).
Seat 2: imperceptible (15.75).
Seat 3: FirstClan (50).
Seat 4: texaswarthog (38.45).
Seat 5: Chipburnner (25.80).
Seat 6: Parcker (50).
Seat 7: ACESOVAKINGZ (71.06).
Seat 9: IlxxxlI (21.75).
Player Chipburnner has small blind (0.25)
Player Parcker has big blind (0.50)
Player IlxxxlI received card: [Ad]
Player IlxxxlI received card: [Qh]
Player ACESOVAKINGZ folds
Player IlxxxlI raises (1.75)
Player GagaPoker folds
Player imperceptible folds
Player FirstClan folds
Player texaswarthog folds
Player Chipburnner folds
Player Parcker folds
Uncalled bet (1.25) returned to IlxxxlI
Player IlxxxlI mucks cards
------ Summary ------
Pot: 1.25. Rake 0
Player GagaPoker does not show cards.Bets: 0. Collects: 0. Wins: 0.
Player imperceptible does not show cards.Bets: 0. Collects: 0. Wins: 0.
Player FirstClan does not show cards.Bets: 0. Collects: 0. Wins: 0.
Player texaswarthog does not show cards.Bets: 0. Collects: 0. Wins: 0.
Player Chipburnner does not show cards.Bets: 0.25. Collects: 0. Loses: 0.25.
Player Parcker does not show cards.Bets: 0.50. Collects: 0. Loses: 0.50.
Player ACESOVAKINGZ does not show cards.Bets: 0. Collects: 0. Wins: 0.
*Player IlxxxlI mucks (does not show cards). Bets: 0.50. Collects: 1.25. Wins: 0.75.
Game ended at: 2016/11/21 14:55:9

Game started
Game ID: 781105821 0.25/0.50 (PRR) Garuda (Hold'em)
Seat 3 is the button
Seat 1: GagaPoker (50).
Seat 2: imperceptible (15.75).
Seat 3: FirstClan (50).
Seat 4: texaswarthog (36.62).
Seat 5: Chipburnner (26.30).
Seat 6: Parcker (50).
Seat 7: ACESOVAKINGZ (72.56).
Seat 9: IlxxxlI (21.75).
Player texaswarthog has small blind (0.25)
Player Chipburnner has big blind (0.50)
Player IlxxxlI received card: [4d]
Player IlxxxlI received card: [2c]
Player Parcker folds
Player ACESOVAKINGZ calls (0.50)
Player IlxxxlI folds
Player GagaPoker folds
Player imperceptible folds
Player FirstClan folds
Player texaswarthog calls (0.25)
Player Chipburnner checks
*** FLOP ***: [2h 10d 7h]
Player texaswarthog checks
Player Chipburnner checks
Player ACESOVAKINGZ checks
*** TURN ***: [2h 10d 7h] [Jc]
Player texaswarthog checks
Player Chipburnner checks
Player ACESOVAKINGZ bets (1)
Player texaswarthog calls (1)
Player Chipburnner folds
*** RIVER ***: [2h 10d 7h Jc] [4c]
Player texaswarthog checks
Player ACESOVAKINGZ checks
------ Summary ------
Pot: 3.33. Rake 0.13. JP fee 0.04
Board: [2h 10d 7h Jc 4c]
Player GagaPoker does not show cards.Bets: 0. Collects: 0. Wins: 0.
Player imperceptible does not show cards.Bets: 0. Collects: 0. Wins: 0.
Player FirstClan does not show cards.Bets: 0. Collects: 0. Wins: 0.
*Player texaswarthog shows: One pair of 2s [2d Kc]. Bets: 1.50. Collects: 3.33. Wins: 1.83.
Player Chipburnner does not show cards.Bets: 0.50. Collects: 0. Loses: 0.50.
Player Parcker does not show cards.Bets: 0. Collects: 0. Wins: 0.
Player ACESOVAKINGZ shows: High card A [9h Ac]. Bets: 1.50. Collects: 0. Loses: 1.50.
Player IlxxxlI does not show cards.Bets: 0. Collects: 0. Wins: 0.
Game ended at: 2016/11/21 14:54:29

Game started
Game ID: 781105213 0.25/0.50 (PRR) Garuda (Hold'em)
Seat 2 is the button
Seat 1: GagaPoker (50).
Seat 2: imperceptible (15.75).
Seat 3: FirstClan (50).
Seat 4: texaswarthog (42.80).
Seat 5: Chipburnner (18.12).
Seat 6: Parcker (50.25).
Seat 7: ACESOVAKINGZ (72.56).
Seat 9: IlxxxlI (21.75).
Player FirstClan has small blind (0.25)
Player texaswarthog has big blind (0.50)
Player IlxxxlI received card: [Kd]
Player IlxxxlI received card: [9c]
Player Chipburnner calls (0.50)
Player Parcker raises (2.50)
Player ACESOVAKINGZ folds
Player IlxxxlI folds
Player GagaPoker folds
Player imperceptible folds
Player FirstClan folds
Player texaswarthog calls (2)
Player Chipburnner calls (2)
*** FLOP ***: [9d 10s 6h]
Player texaswarthog checks
Player Chipburnner checks
Player Parcker checks
*** TURN ***: [9d 10s 6h] [6s]
Player texaswarthog checks
Player Chipburnner bets (3.68)
Player Parcker folds
Player texaswarthog calls (3.68)
*** RIVER ***: [9d 10s 6h 6s] [4d]
Player texaswarthog checks
Player Chipburnner checks
Player texaswarthog mucks cards
------ Summary ------
Pot: 14.36. Rake 0.51. JP fee 0.24
Board: [9d 10s 6h 6s 4d]
Player GagaPoker does not show cards.Bets: 0. Collects: 0. Wins: 0.
Player imperceptible does not show cards.Bets: 0. Collects: 0. Wins: 0.
Player FirstClan does not show cards.Bets: 0.25. Collects: 0. Loses: 0.25.
Player texaswarthog mucks (does not show cards). Bets: 6.18. Collects: 0. Loses: 6.18.
*Player Chipburnner shows: Two pairs. 9s and 6s [8s 9s]. Bets: 6.18. Collects: 14.36. Wins: 8.18.
Player Parcker does not show cards.Bets: 2.50. Collects: 0. Loses: 2.50.
Player ACESOVAKINGZ does not show cards.Bets: 0. Collects: 0. Wins: 0.
Player IlxxxlI does not show cards.Bets: 0. Collects: 0. Wins: 0.
Game ended at: 2016/11/21 14:52:46

Game started
Game ID: 781104509 0.25/0.50 (PRR) Garuda (Hold'em)
Seat 1 is the button
Seat 1: GagaPoker (50).
Seat 2: imperceptible (17.25).
Seat 3: FirstClan (50).
Seat 4: texaswarthog (42.80).
Seat 5: Chipburnner (14.44).
Seat 6: Parcker (50.25).
Seat 7: ACESOVAKINGZ (72.56).
Seat 9: IlxxxlI (21.75).
Player imperceptible has small blind (0.25)
Player FirstClan has big blind (0.50)
Player IlxxxlI received card: [9s]
Player IlxxxlI received card: [Ad]
Player texaswarthog folds
Player Chipburnner calls (0.50)
Player Parcker folds
Player ACESOVAKINGZ folds
Player IlxxxlI folds
Player GagaPoker folds
Player imperceptible calls (0.25)
Player FirstClan checks
*** FLOP ***: [10s 8d 6h]
Player imperceptible bets (1)
Player FirstClan calls (1)
Player Chipburnner raises (2)
Player imperceptible folds
Player FirstClan calls (1)
*** TURN ***: [10s 8d 6h] [10c]
Player FirstClan checks
Player Chipburnner bets (3.09)
Player FirstClan folds
Uncalled bet (3.09) returned to Chipburnner
Player Chipburnner mucks cards
------ Summary ------
Pot: 6.18. Rake 0.22. JP fee 0.10
Board: [10s 8d 6h 10c]
Player GagaPoker does not show cards.Bets: 0. Collects: 0. Wins: 0.
Player imperceptible does not show cards.Bets: 1.50. Collects: 0. Loses: 1.50.
Player FirstClan does not show cards.Bets: 2.50. Collects: 0. Loses: 2.50.
Player texaswarthog does not show cards.Bets: 0. Collects: 0. Wins: 0.
*Player Chipburnner mucks (does not show cards). Bets: 2.50. Collects: 6.18. Wins: 3.68.
Player Parcker does not show cards.Bets: 0. Collects: 0. Wins: 0.
Player ACESOVAKINGZ does not show cards.Bets: 0. Collects: 0. Wins: 0.
Player IlxxxlI does not show cards.Bets: 0. Collects: 0. Wins: 0.
Game ended at: 2016/11/21 14:51:16

Game started
Game ID: 781103656 0.25/0.50 (PRR) Garuda (Hold'em)
Seat 9 is the button
Seat 1: GagaPoker (65.82).
Seat 2: imperceptible (17.75).
Seat 4: texaswarthog (42.80).
Seat 5: Chipburnner (14.44).
Seat 6: Parcker (50.25).
Seat 7: ACESOVAKINGZ (56.65).
Seat 9: IlxxxlI (21.75).
Player GagaPoker has small blind (0.25)
Player imperceptible has big blind (0.50)
Player IlxxxlI received card: [9d]
Player IlxxxlI received card: [4s]
Player texaswarthog folds
Player Chipburnner folds
Player Parcker folds
Player ACESOVAKINGZ calls (0.50)
Player IlxxxlI folds
Player GagaPoker raises (1.75)
Player imperceptible folds
Player ACESOVAKINGZ calls (1.50)
*** FLOP ***: [3d 5c 6s]
Player GagaPoker bets (1.42)
Player ACESOVAKINGZ calls (1.42)
*** TURN ***: [3d 5c 6s] [Ks]
Player GagaPoker bets (4)
Player ACESOVAKINGZ calls (4)
*** RIVER ***: [3d 5c 6s Ks] [9h]
Player GagaPoker bets (9.72)
Player ACESOVAKINGZ allin (49.23)
Player GagaPoker folds
Uncalled bet (39.51) returned to ACESOVAKINGZ
Player ACESOVAKINGZ mucks cards
------ Summary ------
Pot: 33.05. Rake 1.49. JP fee 0.24
Board: [3d 5c 6s Ks 9h]
Player GagaPoker does not show cards.Bets: 17.14. Collects: 0. Loses: 17.14.
Player imperceptible does not show cards.Bets: 0.50. Collects: 0. Loses: 0.50.
Player texaswarthog does not show cards.Bets: 0. Collects: 0. Wins: 0.
Player Chipburnner does not show cards.Bets: 0. Collects: 0. Wins: 0.
Player Parcker does not show cards.Bets: 0. Collects: 0. Wins: 0.
*Player ACESOVAKINGZ mucks (does not show cards). Bets: 17.14. Collects: 33.05. Wins: 15.91.
Player IlxxxlI does not show cards.Bets: 0. Collects: 0. Wins: 0.
Game ended at: 2016/11/21 14:49:32

Game started
Game ID: 781103449 0.25/0.50 (PRR) Garuda (Hold'em)
Seat 7 is the button
Seat 1: GagaPoker (66.32).
Seat 2: imperceptible (17.75).
Seat 4: texaswarthog (42.80).
Seat 5: Chipburnner (14.44).
Seat 6: Parcker (51.50).
Seat 7: ACESOVAKINGZ (56.65).
Seat 9: IlxxxlI (20).
Player IlxxxlI has small blind (0.25)
Player GagaPoker has big blind (0.50)
Player IlxxxlI received card: [4s]
Player IlxxxlI received card: [4c]
Player imperceptible folds
Player texaswarthog folds
Player Chipburnner folds
Player Parcker raises (1.25)
Player ACESOVAKINGZ folds
Player IlxxxlI raises (2.94)
Player GagaPoker folds
Player Parcker folds
Uncalled bet (1.94) returned to IlxxxlI
Player IlxxxlI mucks cards
------ Summary ------
Pot: 3. Rake 0
Player GagaPoker does not show cards.Bets: 0.50. Collects: 0. Loses: 0.50.
Player imperceptible does not show cards.Bets: 0. Collects: 0. Wins: 0.
Player texaswarthog does not show cards.Bets: 0. Collects: 0. Wins: 0.
Player Chipburnner does not show cards.Bets: 0. Collects: 0. Wins: 0.
Player Parcker does not show cards.Bets: 1.25. Collects: 0. Loses: 1.25.
Player ACESOVAKINGZ does not show cards.Bets: 0. Collects: 0. Wins: 0.
*Player IlxxxlI mucks (does not show cards). Bets: 1.25. Collects: 3. Wins: 1.75.
Game ended at: 2016/11/21 14:47:30

Game started
Game ID: 781102925 0.25/0.50 (PRR) Garuda (Hold'em)
Seat 6 is the button
Seat 1: GagaPoker (68.19).
Seat 2: imperceptible (17.75).
Seat 4: texaswarthog (40.40).
Seat 5: Chipburnner (14.44).
Seat 6: Parcker (51.50).
Seat 7: ACESOVAKINGZ (56.90).
Seat 8: Spagetti1 (95.14).
Seat 9: IlxxxlI (20).
Player ACESOVAKINGZ has small blind (0.25)
Player Spagetti1 sitting out
Player IlxxxlI has big blind (0.50)
Player IlxxxlI received card: [5d]
Player IlxxxlI received card: [4s]
Player GagaPoker raises (1)
Player imperceptible folds
Player texaswarthog calls (1)
Player Chipburnner folds
Player Parcker folds
Player ACESOVAKINGZ folds
Player IlxxxlI folds
*** FLOP ***: [As Jc 9h]
Player GagaPoker bets (0.87)
Player texaswarthog calls (0.87)
*** TURN ***: [As Jc 9h] [7h]
Player GagaPoker checks
Player texaswarthog bets (2.84)
Player GagaPoker folds
Uncalled bet (2.84) returned to texaswarthog
Player texaswarthog mucks cards
------ Summary ------
Pot: 4.27. Rake 0.16. JP fee 0.06
Board: [As Jc 9h 7h]
Player GagaPoker does not show cards.Bets: 1.87. Collects: 0. Loses: 1.87.
Player imperceptible does not show cards.Bets: 0. Collects: 0. Wins: 0.
*Player texaswarthog mucks (does not show cards). Bets: 1.87. Collects: 4.27. Wins: 2.40.
Player Chipburnner does not show cards.Bets: 0. Collects: 0. Wins: 0.
Player Parcker does not show cards.Bets: 0. Collects: 0. Wins: 0.
Player ACESOVAKINGZ does not show cards.Bets: 0.25. Collects: 0. Loses: 0.25.
Player Spagetti1 does not show cards.Bets: 0. Collects: 0. Wins: 0.
Player IlxxxlI does not show cards.Bets: 0.50. Collects: 0. Loses: 0.50.
Game ended at: 2016/11/21 14:47:2

Game started
Game ID: 781102405 0.25/0.50 (PRR) Garuda (Hold'em)
Seat 5 is the button
Seat 1: GagaPoker (68.19).
Seat 2: imperceptible (18.75).
Seat 4: texaswarthog (40.40).
Seat 5: Chipburnner (14.44).
Seat 6: Parcker (50).
Seat 7: ACESOVAKINGZ (57.40).
Seat 8: Spagetti1 (95.14).
Seat 9: IlxxxlI (20).
Player Parcker has small blind (0.25)
Player ACESOVAKINGZ has big blind (0.50)
Player IlxxxlI received card: [7c]
Player IlxxxlI received card: [6s]
Player Spagetti1 folds
Player IlxxxlI folds
Player GagaPoker folds
Player imperceptible raises (1)
Player texaswarthog folds
Player Chipburnner folds
Player Parcker raises (3.25)
Player ACESOVAKINGZ folds
Player imperceptible folds
Uncalled bet (2.50) returned to Parcker
Player Parcker mucks cards
------ Summary ------
Pot: 2.50. Rake 0
Player GagaPoker does not show cards.Bets: 0. Collects: 0. Wins: 0.
Player imperceptible does not show cards.Bets: 1. Collects: 0. Loses: 1.
Player texaswarthog does not show cards.Bets: 0. Collects: 0. Wins: 0.
Player Chipburnner does not show cards.Bets: 0. Collects: 0. Wins: 0.
*Player Parcker mucks (does not show cards). Bets: 1. Collects: 2.50. Wins: 1.50.
Player ACESOVAKINGZ does not show cards.Bets: 0.50. Collects: 0. Loses: 0.50.
Player Spagetti1 does not show cards.Bets: 0. Collects: 0. Wins: 0.
Player IlxxxlI does not show cards.Bets: 0. Collects: 0. Wins: 0.
Game ended at: 2016/11/21 14:45:49

Game started
Game ID: 781101552 0.25/0.50 (PRR) Garuda (Hold'em)
Seat 4 is the button
Seat 1: GagaPoker (68.19).
Seat 2: imperceptible (16.42).
Seat 4: texaswarthog (41.40).
Seat 5: Chipburnner (15.44).
Seat 6: Parcker (50).
Seat 7: ACESOVAKINGZ (57.40).
Seat 8: Spagetti1 (95.14).
Seat 9: IlxxxlI (20).
Player Chipburnner has small blind (0.25)
Player Parcker has big blind (0.50)
Player IlxxxlI received card: [Jc]
Player IlxxxlI received card: [7h]
Player ACESOVAKINGZ folds
Player Spagetti1 folds
Player IlxxxlI folds
Player GagaPoker folds
Player imperceptible raises (1)
Player texaswarthog calls (1)
Player Chipburnner calls (0.75)
Player Parcker folds
*** FLOP ***: [Kc 5c 10c]
Player Chipburnner checks
Player imperceptible checks
Player texaswarthog checks
*** TURN ***: [Kc 5c 10c] [5s]
Player Chipburnner checks
Player imperceptible bets (2)
Player texaswarthog folds
Player Chipburnner folds
Uncalled bet (2) returned to imperceptible
Player imperceptible mucks cards
------ Summary ------
Pot: 3.33. Rake 0.13. JP fee 0.04
Board: [Kc 5c 10c 5s]
Player GagaPoker does not show cards.Bets: 0. Collects: 0. Wins: 0.
*Player imperceptible mucks (does not show cards). Bets: 1. Collects: 3.33. Wins: 2.33.
Player texaswarthog does not show cards.Bets: 1. Collects: 0. Loses: 1.
Player Chipburnner does not show cards.Bets: 1. Collects: 0. Loses: 1.
Player Parcker does not show cards.Bets: 0.50. Collects: 0. Loses: 0.50.
Player ACESOVAKINGZ does not show cards.Bets: 0. Collects: 0. Wins: 0.
Player Spagetti1 does not show cards.Bets: 0. Collects: 0. Wins: 0.
Player IlxxxlI does not show cards.Bets: 0. Collects: 0. Wins: 0.
Game ended at: 2016/11/21 14:44:36

Game started
Game ID: 781101001 0.25/0.50 (PRR) Garuda (Hold'em)
Seat 2 is the button
Seat 1: GagaPoker (68.19).
Seat 2: imperceptible (16.42).
Seat 4: texaswarthog (41.90).
Seat 5: Chipburnner (15.94).
Seat 6: Parcker (50).
Seat 7: ACESOVAKINGZ (56.47).
Seat 8: Spagetti1 (95.14).
Seat 9: IlxxxlI (20).
Player texaswarthog has small blind (0.25)
Player Chipburnner has big blind (0.50)
Player IlxxxlI received card: [Qc]
Player IlxxxlI received card: [7c]
Player Parcker folds
Player ACESOVAKINGZ calls (0.50)
Player Spagetti1 folds
Player IlxxxlI folds
Player GagaPoker folds
Player imperceptible folds
Player texaswarthog calls (0.25)
Player Chipburnner checks
*** FLOP ***: [Jd Ah 6h]
Player texaswarthog checks
Player Chipburnner checks
Player ACESOVAKINGZ bets (0.95)
Player texaswarthog folds
Player Chipburnner folds
Uncalled bet (0.95) returned to ACESOVAKINGZ
Player ACESOVAKINGZ mucks cards
------ Summary ------
Pot: 1.43. Rake 0.05. JP fee 0.02
Board: [Jd Ah 6h]
Player GagaPoker does not show cards.Bets: 0. Collects: 0. Wins: 0.
Player imperceptible does not show cards.Bets: 0. Collects: 0. Wins: 0.
Player texaswarthog does not show cards.Bets: 0.50. Collects: 0. Loses: 0.50.
Player Chipburnner does not show cards.Bets: 0.50. Collects: 0. Loses: 0.50.
Player Parcker does not show cards.Bets: 0. Collects: 0. Wins: 0.
*Player ACESOVAKINGZ mucks (does not show cards). Bets: 0.50. Collects: 1.43. Wins: 0.93.
Player Spagetti1 does not show cards.Bets: 0. Collects: 0. Wins: 0.
Player IlxxxlI does not show cards.Bets: 0. Collects: 0. Wins: 0.
Game ended at: 2016/11/21 14:42:38

Game started
Game ID: 781100596 0.25/0.50 (PRR) Garuda (Hold'em)
Seat 1 is the button
Seat 1: GagaPoker (68.19).
Seat 2: imperceptible (16.92).
Seat 4: texaswarthog (40.97).
Seat 5: Chipburnner (16.44).
Seat 6: Parcker (50).
Seat 7: ACESOVAKINGZ (56.47).
Seat 8: Spagetti1 (95.14).
Seat 9: IlxxxlI (20).
Player imperceptible has small blind (0.25)
Player texaswarthog has big blind (0.50)
Player IlxxxlI received card: [8h]
Player IlxxxlI received card: [Ac]
Player Chipburnner calls (0.50)
Player Parcker folds
Player ACESOVAKINGZ folds
Player Spagetti1 folds
Player IlxxxlI folds
Player GagaPoker folds
Player imperceptible calls (0.25)
Player texaswarthog checks
*** FLOP ***: [6d 10h 3d]
Player imperceptible checks
Player texaswarthog bets (1.43)
Player Chipburnner folds
Player imperceptible folds
Uncalled bet (1.43) returned to texaswarthog
Player texaswarthog mucks cards
------ Summary ------
Pot: 1.43. Rake 0.05. JP fee 0.02
Board: [6d 10h 3d]
Player GagaPoker does not show cards.Bets: 0. Collects: 0. Wins: 0.
Player imperceptible does not show cards.Bets: 0.50. Collects: 0. Loses: 0.50.
*Player texaswarthog mucks (does not show cards). Bets: 0.50. Collects: 1.43. Wins: 0.93.
Player Chipburnner does not show cards.Bets: 0.50. Collects: 0. Loses: 0.50.
Player Parcker does not show cards.Bets: 0. Collects: 0. Wins: 0.
Player ACESOVAKINGZ does not show cards.Bets: 0. Collects: 0. Wins: 0.
Player Spagetti1 does not show cards.Bets: 0. Collects: 0. Wins: 0.
Player IlxxxlI does not show cards.Bets: 0. Collects: 0. Wins: 0.
Game ended at: 2016/11/21 14:41:27

Game started
Game ID: 781100138 0.25/0.50 (PRR) Garuda (Hold'em)
Seat 9 is the button
Seat 1: GagaPoker (67.26).
Seat 2: imperceptible (17.42).
Seat 3: MaxWoof (38.59).
Seat 4: texaswarthog (40.97).
Seat 5: Chipburnner (16.94).
Seat 6: Parcker (50).
Seat 7: ACESOVAKINGZ (56.47).
Seat 8: Spagetti1 (95.14).
Seat 9: IlxxxlI (20).
Player GagaPoker has small blind (0.25)
Player imperceptible has big blind (0.50)
Player IlxxxlI received card: [8d]
Player IlxxxlI received card: [2h]
Player MaxWoof folds
Player texaswarthog folds
Player Chipburnner calls (0.50)
Player Parcker folds
Player ACESOVAKINGZ folds
Player Spagetti1 folds
Player IlxxxlI folds
Player GagaPoker calls (0.25)
Player imperceptible checks
*** FLOP ***: [Ah Kh 7d]
Player GagaPoker bets (0.95)
Player imperceptible folds
Player Chipburnner folds
Uncalled bet (0.95) returned to GagaPoker
Player GagaPoker mucks cards
------ Summary ------
Pot: 1.43. Rake 0.05. JP fee 0.02
Board: [Ah Kh 7d]
*Player GagaPoker mucks (does not show cards). Bets: 0.50. Collects: 1.43. Wins: 0.93.
Player imperceptible does not show cards.Bets: 0.50. Collects: 0. Loses: 0.50.
Player MaxWoof does not show cards.Bets: 0. Collects: 0. Wins: 0.
Player texaswarthog does not show cards.Bets: 0. Collects: 0. Wins: 0.
Player Chipburnner does not show cards.Bets: 0.50. Collects: 0. Loses: 0.50.
Player Parcker does not show cards.Bets: 0. Collects: 0. Wins: 0.
Player ACESOVAKINGZ does not show cards.Bets: 0. Collects: 0. Wins: 0.
Player Spagetti1 does not show cards.Bets: 0. Collects: 0. Wins: 0.
Player IlxxxlI does not show cards.Bets: 0. Collects: 0. Wins: 0.
Game ended at: 2016/11/21 14:40:32

Game started
Game ID: 781099851 0.25/0.50 (PRR) Garuda (Hold'em)
Seat 8 is the button
Seat 1: GagaPoker (67.76).
Seat 2: imperceptible (17.42).
Seat 3: MaxWoof (38.59).
Seat 4: texaswarthog (40.97).
Seat 5: Chipburnner (16.94).
Seat 6: Parcker (50).
Seat 7: ACESOVAKINGZ (56.47).
Seat 8: Spagetti1 (90.84).
Seat 9: IlxxxlI (20).
Player IlxxxlI has small blind (0.25)
Player GagaPoker has big blind (0.50)
Player IlxxxlI received card: [Qc]
Player IlxxxlI received card: [Kc]
Player imperceptible folds
Player MaxWoof folds
Player texaswarthog folds
Player Chipburnner folds
Player Parcker folds
Player ACESOVAKINGZ folds
Player Spagetti1 raises (1.50)
Player IlxxxlI raises (3.55)
Player GagaPoker folds
Player Spagetti1 allin (89.34)
Player IlxxxlI folds
Uncalled bet (87.04) returned to Spagetti1
Player Spagetti1 mucks cards
------ Summary ------
Pot: 8.10. Rake 0
Player GagaPoker does not show cards.Bets: 0.50. Collects: 0. Loses: 0.50.
Player imperceptible does not show cards.Bets: 0. Collects: 0. Wins: 0.
Player MaxWoof does not show cards.Bets: 0. Collects: 0. Wins: 0.
Player texaswarthog does not show cards.Bets: 0. Collects: 0. Wins: 0.
Player Chipburnner does not show cards.Bets: 0. Collects: 0. Wins: 0.
Player Parcker does not show cards.Bets: 0. Collects: 0. Wins: 0.
Player ACESOVAKINGZ does not show cards.Bets: 0. Collects: 0. Wins: 0.
*Player Spagetti1 mucks (does not show cards). Bets: 3.80. Collects: 8.10. Wins: 4.30.
Player IlxxxlI does not show cards.Bets: 3.80. Collects: 0. Loses: 3.80.
Game ended at: 2016/11/21 14:39:33

Game started
Game ID: 781099481 0.25/0.50 (PRR) Garuda (Hold'em)
Seat 7 is the button
Seat 1: GagaPoker (67.76).
Seat 2: imperceptible (17.42).
Seat 3: MaxWoof (37.84).
Seat 4: texaswarthog (40.97).
Seat 5: Chipburnner (16.94).
Seat 6: Parcker (50).
Seat 7: ACESOVAKINGZ (56.47).
Seat 8: Spagetti1 (91.09).
Seat 9: IlxxxlI (20).
Player Spagetti1 has small blind (0.25)
Player IlxxxlI has big blind (0.50)
Player IlxxxlI received card: [2c]
Player IlxxxlI received card: [Kc]
Player GagaPoker is timed out.
Player GagaPoker folds
Player imperceptible folds
Player MaxWoof raises (2)
Player texaswarthog folds
Player Chipburnner folds
Player Parcker folds
Player ACESOVAKINGZ folds
Player Spagetti1 folds
Player IlxxxlI folds
Uncalled bet (1.50) returned to MaxWoof
Player MaxWoof mucks cards
------ Summary ------
Pot: 1.25. Rake 0
Player GagaPoker does not show cards.Bets: 0. Collects: 0. Wins: 0.
Player imperceptible does not show cards.Bets: 0. Collects: 0. Wins: 0.
*Player MaxWoof mucks (does not show cards). Bets: 0.50. Collects: 1.25. Wins: 0.75.
Player texaswarthog does not show cards.Bets: 0. Collects: 0. Wins: 0.
Player Chipburnner does not show cards.Bets: 0. Collects: 0. Wins: 0.
Player Parcker does not show cards.Bets: 0. Collects: 0. Wins: 0.
Player ACESOVAKINGZ does not show cards.Bets: 0. Collects: 0. Wins: 0.
Player Spagetti1 does not show cards.Bets: 0.25. Collects: 0. Loses: 0.25.
Player IlxxxlI does not show cards.Bets: 0.50. Collects: 0. Loses: 0.50.
Game ended at: 2016/11/21 14:38:54

Game started
Game ID: 781098742 0.25/0.50 (PRR) Garuda (Hold'em)
Seat 6 is the button
Seat 1: GagaPoker (67.76).
Seat 2: imperceptible (17.42).
Seat 3: MaxWoof (37.84).
Seat 4: texaswarthog (20.31).
Seat 5: Chipburnner (37.25).
Seat 6: Parcker (50).
Seat 7: ACESOVAKINGZ (58.47).
Seat 8: Spagetti1 (91.59).
Seat 9: IlxxxlI (20).
Player ACESOVAKINGZ has small blind (0.25)
Player Spagetti1 has big blind (0.50)
Player IlxxxlI received card: [3c]
Player IlxxxlI received card: [Qh]
Player IlxxxlI folds
Player GagaPoker folds
Player imperceptible folds
Player MaxWoof folds
Player texaswarthog raises (2)
Player Chipburnner calls (2)
Player Parcker folds
Player ACESOVAKINGZ calls (1.75)
Player Spagetti1 folds
*** FLOP ***: [2c 5s 8s]
Player ACESOVAKINGZ checks
Player texaswarthog checks
Player Chipburnner bets (1.50)
Player ACESOVAKINGZ folds
Player texaswarthog calls (1.50)
*** TURN ***: [2c 5s 8s] [6s]
Player texaswarthog checks
Player Chipburnner bets (3.01)
Player texaswarthog raises (6.02)
Player Chipburnner raises (15.05)
Player texaswarthog allin (10.79)
Uncalled bet (1.25) returned to Chipburnner
*** RIVER ***: [2c 5s 8s 6s] [As]
------ Summary ------
Pot: 40.97. Rake 1.91. JP fee 0.24
Board: [2c 5s 8s 6s As]
Player GagaPoker does not show cards.Bets: 0. Collects: 0. Wins: 0.
Player imperceptible does not show cards.Bets: 0. Collects: 0. Wins: 0.
Player MaxWoof does not show cards.Bets: 0. Collects: 0. Wins: 0.
*Player texaswarthog shows: Flush, A high [Js Ks]. Bets: 20.31. Collects: 40.97. Wins: 20.66.
Player Chipburnner shows: Three Of Kind of 5s [5d 5c]. Bets: 20.31. Collects: 0. Loses: 20.31.
Player Parcker does not show cards.Bets: 0. Collects: 0. Wins: 0.
Player ACESOVAKINGZ does not show cards.Bets: 2. Collects: 0. Loses: 2.
Player Spagetti1 does not show cards.Bets: 0.50. Collects: 0. Loses: 0.50.
Player IlxxxlI does not show cards.Bets: 0. Collects: 0. Wins: 0.
Game ended at: 2016/11/21 14:38:2

Game started
Game ID: 781098416 0.25/0.50 (PRR) Garuda (Hold'em)
Seat 5 is the button
Seat 1: GagaPoker (67.76).
Seat 2: imperceptible (17.42).
Seat 3: MaxWoof (37.84).
Seat 4: texaswarthog (20.31).
Seat 5: Chipburnner (34.75).
Seat 6: Parcker (50).
Seat 7: ACESOVAKINGZ (58.97).
Seat 8: Spagetti1 (91.59).
Seat 9: IlxxxlI (20).
Player Parcker has small blind (0.25)
Player ACESOVAKINGZ has big blind (0.50)
Player IlxxxlI received card: [10h]
Player IlxxxlI received card: [10c]
Player Spagetti1 folds
Player IlxxxlI raises (1.75)
Player GagaPoker folds
Player imperceptible folds
Player MaxWoof folds
Player texaswarthog folds
Player Chipburnner raises (8)
Player Parcker folds
Player ACESOVAKINGZ folds
Player IlxxxlI folds
Uncalled bet (6.25) returned to Chipburnner
Player Chipburnner is timed out.
Player Chipburnner mucks cards
------ Summary ------
Pot: 4.25. Rake 0
Player GagaPoker does not show cards.Bets: 0. Collects: 0. Wins: 0.
Player imperceptible does not show cards.Bets: 0. Collects: 0. Wins: 0.
Player MaxWoof does not show cards.Bets: 0. Collects: 0. Wins: 0.
Player texaswarthog does not show cards.Bets: 0. Collects: 0. Wins: 0.
*Player Chipburnner mucks (does not show cards). Bets: 1.75. Collects: 4.25. Wins: 2.50.
Player Parcker does not show cards.Bets: 0.25. Collects: 0. Loses: 0.25.
Player ACESOVAKINGZ does not show cards.Bets: 0.50. Collects: 0. Loses: 0.50.
Player Spagetti1 does not show cards.Bets: 0. Collects: 0. Wins: 0.
Player IlxxxlI does not show cards.Bets: 1.75. Collects: 0. Loses: 1.75.
Game ended at: 2016/11/21 14:36:23

Game started
Game ID: 781097923 0.25/0.50 (PRR) Garuda (Hold'em)
Seat 4 is the button
Seat 1: GagaPoker (67.76).
Seat 2: imperceptible (17.42).
Seat 3: MaxWoof (37.84).
Seat 4: texaswarthog (20.81).
Seat 5: Chipburnner (33.25).
Seat 6: Parcker (50).
Seat 7: ACESOVAKINGZ (59.47).
Seat 8: Spagetti1 (91.59).
Seat 9: IlxxxlI (20).
Player Chipburnner has small blind (0.25)
Player Parcker has big blind (0.50)
Player IlxxxlI received card: [As]
Player IlxxxlI received card: [2c]
Player ACESOVAKINGZ calls (0.50)
Player Spagetti1 folds
Player IlxxxlI folds
Player GagaPoker folds
Player imperceptible folds
Player MaxWoof folds
Player texaswarthog calls (0.50)
Player Chipburnner raises (2.75)
Player Parcker folds
Player ACESOVAKINGZ folds
Player texaswarthog folds
Uncalled bet (2.50) returned to Chipburnner
Player Chipburnner is timed out.
Player Chipburnner mucks cards
------ Summary ------
Pot: 2. Rake 0
Player GagaPoker does not show cards.Bets: 0. Collects: 0. Wins: 0.
Player imperceptible does not show cards.Bets: 0. Collects: 0. Wins: 0.
Player MaxWoof does not show cards.Bets: 0. Collects: 0. Wins: 0.
Player texaswarthog does not show cards.Bets: 0.50. Collects: 0. Loses: 0.50.
*Player Chipburnner mucks (does not show cards). Bets: 0.50. Collects: 2. Wins: 1.50.
Player Parcker does not show cards.Bets: 0.50. Collects: 0. Loses: 0.50.
Player ACESOVAKINGZ does not show cards.Bets: 0.50. Collects: 0. Loses: 0.50.
Player Spagetti1 does not show cards.Bets: 0. Collects: 0. Wins: 0.
Player IlxxxlI does not show cards.Bets: 0. Collects: 0. Wins: 0.
Game ended at: 2016/11/21 14:35:38

Game started
Game ID: 781096803 0.25/0.50 (PRR) Garuda (Hold'em)
Seat 3 is the button
Seat 1: GagaPoker (52.07).
Seat 2: imperceptible (17.42).
Seat 3: MaxWoof (37.84).
Seat 4: texaswarthog (37.71).
Seat 5: Chipburnner (33.75).
Seat 7: ACESOVAKINGZ (59.47).
Seat 8: Spagetti1 (91.59).
Seat 9: IlxxxlI (20).
Player texaswarthog has small blind (0.25)
Player Chipburnner has big blind (0.50)
Player IlxxxlI received card: [Jd]
Player IlxxxlI received card: [7c]
Player ACESOVAKINGZ folds
Player Spagetti1 folds
Player IlxxxlI folds
Player GagaPoker raises (1)
Player imperceptible folds
Player MaxWoof folds
Player texaswarthog calls (0.75)
Player Chipburnner folds
*** FLOP ***: [As 5d 4h]
Player texaswarthog bets (1.58)
Player GagaPoker calls (1.58)
*** TURN ***: [As 5d 4h] [3c]
Player texaswarthog bets (3.58)
Player GagaPoker raises (14.32)
Player texaswarthog calls (10.74)
*** RIVER ***: [As 5d 4h 3c] [10c]
Player texaswarthog checks
Player GagaPoker bets (21.72)
Player texaswarthog folds
Uncalled bet (21.72) returned to GagaPoker
Player GagaPoker mucks cards
------ Summary ------
Pot: 32.59. Rake 1.47. JP fee 0.24
Board: [As 5d 4h 3c 10c]
*Player GagaPoker mucks (does not show cards). Bets: 16.90. Collects: 32.59. Wins: 15.69.
Player imperceptible does not show cards.Bets: 0. Collects: 0. Wins: 0.
Player MaxWoof does not show cards.Bets: 0. Collects: 0. Wins: 0.
Player texaswarthog does not show cards.Bets: 16.90. Collects: 0. Loses: 16.90.
Player Chipburnner does not show cards.Bets: 0.50. Collects: 0. Loses: 0.50.
Player ACESOVAKINGZ does not show cards.Bets: 0. Collects: 0. Wins: 0.
Player Spagetti1 does not show cards.Bets: 0. Collects: 0. Wins: 0.
Player IlxxxlI does not show cards.Bets: 0. Collects: 0. Wins: 0.
Game ended at: 2016/11/21 14:34:28

Game started
Game ID: 781096248 0.25/0.50 (PRR) Garuda (Hold'em)
Seat 2 is the button
Seat 1: GagaPoker (52.07).
Seat 2: imperceptible (17.42).
Seat 3: MaxWoof (38.09).
Seat 4: texaswarthog (38.71).
Seat 5: Chipburnner (31.66).
Seat 7: ACESOVAKINGZ (60.47).
Seat 8: Spagetti1 (91.59).
Seat 9: IlxxxlI (20).
Player MaxWoof has small blind (0.25)
Player texaswarthog has big blind (0.50)
Player IlxxxlI received card: [Ad]
Player IlxxxlI received card: [Jc]
Player Chipburnner raises (1)
Player ACESOVAKINGZ calls (1)
Player Spagetti1 folds
Player IlxxxlI folds
Player GagaPoker folds
Player imperceptible folds
Player MaxWoof folds
Player texaswarthog calls (0.50)
*** FLOP ***: [Js 4h Kc]
Player texaswarthog checks
Player Chipburnner checks
Player ACESOVAKINGZ checks
*** TURN ***: [Js 4h Kc] [8d]
Player texaswarthog checks
Player Chipburnner checks
Player ACESOVAKINGZ checks
*** RIVER ***: [Js 4h Kc 8d] [Qd]
Player texaswarthog checks
Player Chipburnner bets (2.06)
Player ACESOVAKINGZ folds
Player texaswarthog folds
Uncalled bet (2.06) returned to Chipburnner
Player Chipburnner mucks cards
------ Summary ------
Pot: 3.09. Rake 0.12. JP fee 0.04
Board: [Js 4h Kc 8d Qd]
Player GagaPoker does not show cards.Bets: 0. Collects: 0. Wins: 0.
Player imperceptible does not show cards.Bets: 0. Collects: 0. Wins: 0.
Player MaxWoof does not show cards.Bets: 0.25. Collects: 0. Loses: 0.25.
Player texaswarthog does not show cards.Bets: 1. Collects: 0. Loses: 1.
*Player Chipburnner mucks (does not show cards). Bets: 1. Collects: 3.09. Wins: 2.09.
Player ACESOVAKINGZ does not show cards.Bets: 1. Collects: 0. Loses: 1.
Player Spagetti1 does not show cards.Bets: 0. Collects: 0. Wins: 0.
Player IlxxxlI does not show cards.Bets: 0. Collects: 0. Wins: 0.
Game ended at: 2016/11/21 14:31:47

Game started
Game ID: 781095677 0.25/0.50 (PRR) Garuda (Hold'em)
Seat 1 is the button
Seat 1: GagaPoker (52.07).
Seat 2: imperceptible (27.11).
Seat 3: MaxWoof (38.59).
Seat 4: texaswarthog (38.71).
Seat 5: Chipburnner (31.66).
Seat 7: ACESOVAKINGZ (51.27).
Seat 8: Spagetti1 (91.59).
Seat 9: IlxxxlI (20).
Player imperceptible has small blind (0.25)
Player MaxWoof has big blind (0.50)
Player IlxxxlI received card: [7c]
Player IlxxxlI received card: [2d]
Player texaswarthog folds
Player Chipburnner folds
Player ACESOVAKINGZ calls (0.50)
Player Spagetti1 folds
Player IlxxxlI folds
Player GagaPoker folds
Player imperceptible raises (1.75)
Player MaxWoof folds
Player ACESOVAKINGZ calls (1.50)
*** FLOP ***: [Ad 9s 6s]
Player imperceptible bets (2.85)
Player ACESOVAKINGZ calls (2.85)
*** TURN ***: [Ad 9s 6s] [8s]
Player imperceptible bets (4.84)
Player ACESOVAKINGZ calls (4.84)
*** RIVER ***: [Ad 9s 6s 8s] [10s]
Player imperceptible checks
Player ACESOVAKINGZ bets (12.59)
Player imperceptible folds
Uncalled bet (12.59) returned to ACESOVAKINGZ
Player ACESOVAKINGZ mucks cards
------ Summary ------
Pot: 18.89. Rake 0.75. JP fee 0.24
Board: [Ad 9s 6s 8s 10s]
Player GagaPoker does not show cards.Bets: 0. Collects: 0. Wins: 0.
Player imperceptible does not show cards.Bets: 9.69. Collects: 0. Loses: 9.69.
Player MaxWoof does not show cards.Bets: 0.50. Collects: 0. Loses: 0.50.
Player texaswarthog does not show cards.Bets: 0. Collects: 0. Wins: 0.
Player Chipburnner does not show cards.Bets: 0. Collects: 0. Wins: 0.
*Player ACESOVAKINGZ mucks (does not show cards). Bets: 9.69. Collects: 18.89. Wins: 9.20.
Player Spagetti1 does not show cards.Bets: 0. Collects: 0. Wins: 0.
Player IlxxxlI does not show cards.Bets: 0. Collects: 0. Wins: 0.
Game ended at: 2016/11/21 14:30:32

Game started
Game ID: 781095312 0.25/0.50 (PRR) Garuda (Hold'em)
Seat 9 is the button
Seat 1: GagaPoker (51.57).
Seat 2: imperceptible (27.61).
Seat 3: MaxWoof (38.59).
Seat 4: texaswarthog (38.71).
Seat 5: Chipburnner (31.66).
Seat 7: ACESOVAKINGZ (51.27).
Seat 8: Spagetti1 (91.59).
Seat 9: IlxxxlI (20).
Player GagaPoker has small blind (0.25)
Player imperceptible has big blind (0.50)
Player IlxxxlI received card: [3s]
Player IlxxxlI received card: [9d]
Player MaxWoof folds
Player texaswarthog folds
Player Chipburnner folds
Player ACESOVAKINGZ folds
Player Spagetti1 folds
Player IlxxxlI folds
Player GagaPoker raises (1.25)
Player imperceptible folds
Uncalled bet (1) returned to GagaPoker
Player GagaPoker mucks cards
------ Summary ------
Pot: 1. Rake 0
*Player GagaPoker mucks (does not show cards). Bets: 0.50. Collects: 1. Wins: 0.50.
Player imperceptible does not show cards.Bets: 0.50. Collects: 0. Loses: 0.50.
Player MaxWoof does not show cards.Bets: 0. Collects: 0. Wins: 0.
Player texaswarthog does not show cards.Bets: 0. Collects: 0. Wins: 0.
Player Chipburnner does not show cards.Bets: 0. Collects: 0. Wins: 0.
Player ACESOVAKINGZ does not show cards.Bets: 0. Collects: 0. Wins: 0.
Player Spagetti1 does not show cards.Bets: 0. Collects: 0. Wins: 0.
Player IlxxxlI does not show cards.Bets: 0. Collects: 0. Wins: 0.
Game ended at: 2016/11/21 14:29:12

Game started
Game ID: 781094641 0.25/0.50 (PRR) Garuda (Hold'em)
Seat 8 is the button
Seat 1: GagaPoker (52.07).
Seat 2: imperceptible (23.29).
Seat 3: MaxWoof (38.59).
Seat 4: texaswarthog (38.71).
Seat 5: Chipburnner (35.66).
Seat 7: ACESOVAKINGZ (51.27).
Seat 8: Spagetti1 (91.59).
Seat 9: IlxxxlI (20).
Player IlxxxlI has small blind (0.25)
Player GagaPoker has big blind (0.50)
Player IlxxxlI received card: [Kd]
Player IlxxxlI received card: [7c]
Player imperceptible raises (1.50)
Player MaxWoof folds
Player texaswarthog folds
Player Chipburnner calls (1.50)
Player ACESOVAKINGZ folds
Player Spagetti1 folds
Player IlxxxlI folds
Player GagaPoker folds
*** FLOP ***: [6s 9s 3d]
Player imperceptible bets (2.50)
Player Chipburnner calls (2.50)
*** TURN ***: [6s 9s 3d] [Kc]
Player imperceptible checks
Player Chipburnner checks
*** RIVER ***: [6s 9s 3d Kc] [9h]
Player imperceptible bets (6)
Player Chipburnner folds
Uncalled bet (6) returned to imperceptible
Player imperceptible mucks cards
------ Summary ------
Pot: 8.32. Rake 0.29. JP fee 0.14
Board: [6s 9s 3d Kc 9h]
Player GagaPoker does not show cards.Bets: 0.50. Collects: 0. Loses: 0.50.
*Player imperceptible mucks (does not show cards). Bets: 4. Collects: 8.32. Wins: 4.32.
Player MaxWoof does not show cards.Bets: 0. Collects: 0. Wins: 0.
Player texaswarthog does not show cards.Bets: 0. Collects: 0. Wins: 0.
Player Chipburnner does not show cards.Bets: 4. Collects: 0. Loses: 4.
Player ACESOVAKINGZ does not show cards.Bets: 0. Collects: 0. Wins: 0.
Player Spagetti1 does not show cards.Bets: 0. Collects: 0. Wins: 0.
Player IlxxxlI does not show cards.Bets: 0.25. Collects: 0. Loses: 0.25.
Game ended at: 2016/11/21 14:28:23

Game started
Game ID: 781094527 0.25/0.50 (PRR) Garuda (Hold'em)
Seat 7 is the button
Seat 2: imperceptible (23.29).
Seat 3: MaxWoof (38.59).
Seat 4: texaswarthog (38.71).
Seat 5: Chipburnner (35.66).
Seat 7: ACESOVAKINGZ (51.27).
Seat 8: Spagetti1 (91.09).
Seat 9: IlxxxlI (20).
Player Spagetti1 has small blind (0.25)
Player IlxxxlI has big blind (0.50)
Player IlxxxlI received card: [4h]
Player IlxxxlI received card: [Jd]
Player imperceptible folds
Player MaxWoof folds
Player texaswarthog folds
Player Chipburnner folds
Player ACESOVAKINGZ folds
Player Spagetti1 raises (0.75)
Player IlxxxlI folds
Uncalled bet (0.50) returned to Spagetti1
Player Spagetti1 mucks cards
------ Summary ------
Pot: 1. Rake 0
Player imperceptible does not show cards.Bets: 0. Collects: 0. Wins: 0.
Player MaxWoof does not show cards.Bets: 0. Collects: 0. Wins: 0.
Player texaswarthog does not show cards.Bets: 0. Collects: 0. Wins: 0.
Player Chipburnner does not show cards.Bets: 0. Collects: 0. Wins: 0.
Player ACESOVAKINGZ does not show cards.Bets: 0. Collects: 0. Wins: 0.
*Player Spagetti1 mucks (does not show cards). Bets: 0.50. Collects: 1. Wins: 0.50.
Player IlxxxlI does not show cards.Bets: 0.50. Collects: 0. Loses: 0.50.
Game ended at: 2016/11/21 14:26:52

Game started
Game ID: 781030542 0.25/0.50 (PRR) Garuda (Short) (Hold'em)
Seat 8 is the button
Seat 1: kidsquid (16).
Seat 2: sr86 (47.15).
Seat 3: IlxxxlI (26.39).
Seat 4: hotshothotgg (20.97).
Seat 5: Spagetti1 (24.84).
Seat 6: parmele (18.97).
Seat 7: ChrisNola (60.95).
Seat 8: Parcker (25).
Seat 9: FirstClan (49.66).
Player FirstClan has small blind (0.25)
Player kidsquid has big blind (0.50)
Player IlxxxlI received card: [2c]
Player IlxxxlI received card: [Qc]
Player sr86 folds
Player IlxxxlI folds
Player hotshothotgg folds
Player Spagetti1 folds
Player parmele folds
Player ChrisNola folds
Player Parcker raises (1.20)
Player FirstClan folds
Player kidsquid is timed out.
Player kidsquid folds
Uncalled bet (0.70) returned to Parcker
Player Parcker mucks cards
------ Summary ------
Pot: 1.25. Rake 0
Player kidsquid does not show cards.Bets: 0.50. Collects: 0. Loses: 0.50.
Player sr86 does not show cards.Bets: 0. Collects: 0. Wins: 0.
Player IlxxxlI does not show cards.Bets: 0. Collects: 0. Wins: 0.
Player hotshothotgg does not show cards.Bets: 0. Collects: 0. Wins: 0.
Player Spagetti1 does not show cards.Bets: 0. Collects: 0. Wins: 0.
Player parmele does not show cards.Bets: 0. Collects: 0. Wins: 0.
Player ChrisNola does not show cards.Bets: 0. Collects: 0. Wins: 0.
*Player Parcker mucks (does not show cards). Bets: 0.50. Collects: 1.25. Wins: 0.75.
Player FirstClan does not show cards.Bets: 0.25. Collects: 0. Loses: 0.25.
Game ended at: 2016/11/21 12:34:4

Game started
Game ID: 781028918 0.25/0.50 (PRR) Garuda (Short) (Hold'em)
Seat 7 is the button
Seat 1: kidsquid (31.88).
Seat 2: sr86 (47.15).
Seat 3: IlxxxlI (26.39).
Seat 4: hotshothotgg (27.47).
Seat 5: Spagetti1 (24.84).
Seat 6: parmele (18.97).
Seat 7: ChrisNola (60.95).
Seat 8: Parcker (25).
Seat 9: FirstClan (28.95).
Player Parcker has small blind (0.25)
Player FirstClan has big blind (0.50)
Player IlxxxlI received card: [3c]
Player IlxxxlI received card: [3d]
Player kidsquid raises (1.50)
Player sr86 folds
Player IlxxxlI folds
Player hotshothotgg calls (1.50)
Player Spagetti1 folds
Player parmele folds
Player ChrisNola folds
Player Parcker folds
Player FirstClan raises (6)
Player kidsquid calls (5)
Player hotshothotgg calls (5)
*** FLOP ***: [8h Ks 2d]
Player FirstClan checks
Player kidsquid bets (9.38)
Player hotshothotgg folds
Player FirstClan calls (9.38)
*** TURN ***: [8h Ks 2d] [5d]
Player FirstClan checks
Player kidsquid checks
*** RIVER ***: [8h Ks 2d 5d] [Ah]
Player FirstClan allin (13.07)
Player kidsquid folds
Uncalled bet (13.07) returned to FirstClan
Player FirstClan mucks cards
------ Summary ------
Pot: 36.59. Rake 1.68. JP fee 0.24
Board: [8h Ks 2d 5d Ah]
Player kidsquid does not show cards.Bets: 15.88. Collects: 0. Loses: 15.88.
Player sr86 does not show cards.Bets: 0. Collects: 0. Wins: 0.
Player IlxxxlI does not show cards.Bets: 0. Collects: 0. Wins: 0.
Player hotshothotgg does not show cards.Bets: 6.50. Collects: 0. Loses: 6.50.
Player Spagetti1 does not show cards.Bets: 0. Collects: 0. Wins: 0.
Player parmele does not show cards.Bets: 0. Collects: 0. Wins: 0.
Player ChrisNola does not show cards.Bets: 0. Collects: 0. Wins: 0.
Player Parcker does not show cards.Bets: 0.25. Collects: 0. Loses: 0.25.
*Player FirstClan mucks (does not show cards). Bets: 15.88. Collects: 36.59. Wins: 20.71.
Game ended at: 2016/11/21 12:32:50

Game started
Game ID: 781027648 0.25/0.50 (PRR) Garuda (Short) (Hold'em)
Seat 6 is the button
Seat 1: kidsquid (31.88).
Seat 2: sr86 (47.65).
Seat 3: IlxxxlI (26.39).
Seat 4: hotshothotgg (27.97).
Seat 5: Spagetti1 (24.84).
Seat 6: parmele (18.97).
Seat 7: ChrisNola (36.82).
Seat 8: Parcker (25.75).
Seat 9: FirstClan (28.95).
Player ChrisNola has small blind (0.25)
Player Parcker has big blind (0.50)
Player IlxxxlI received card: [2s]
Player IlxxxlI received card: [Kh]
Player FirstClan folds
Player kidsquid folds
Player sr86 calls (0.50)
Player IlxxxlI folds
Player hotshothotgg calls (0.50)
Player Spagetti1 folds
Player parmele folds
Player ChrisNola calls (0.25)
Player Parcker raises (4)
Player sr86 folds
Player hotshothotgg folds
Player ChrisNola calls (4)
*** FLOP ***: [2c 10d 3d]
Player ChrisNola checks
Player Parcker bets (6.65)
Player ChrisNola raises (13.30)
Player Parcker allin (14.60)
Player ChrisNola calls (7.95)
*** TURN ***: [2c 10d 3d] [As]
*** RIVER ***: [2c 10d 3d As] [10c]
------ Summary ------
Pot: 49.88. Rake 2.38. JP fee 0.24
Board: [2c 10d 3d As 10c]
Player kidsquid does not show cards.Bets: 0. Collects: 0. Wins: 0.
Player sr86 does not show cards.Bets: 0.50. Collects: 0. Loses: 0.50.
Player IlxxxlI does not show cards.Bets: 0. Collects: 0. Wins: 0.
Player hotshothotgg does not show cards.Bets: 0.50. Collects: 0. Loses: 0.50.
Player Spagetti1 does not show cards.Bets: 0. Collects: 0. Wins: 0.
Player parmele does not show cards.Bets: 0. Collects: 0. Wins: 0.
*Player ChrisNola shows: Three Of Kind of 10s [10s Qh]. Bets: 25.75. Collects: 49.88. Wins: 24.13.
Player Parcker shows: Two pairs. Js and 10s [Jd Js]. Bets: 25.75. Collects: 0. Loses: 25.75.
Player FirstClan does not show cards.Bets: 0. Collects: 0. Wins: 0.
Game ended at: 2016/11/21 12:30:33

Game started
Game ID: 781027085 0.25/0.50 (PRR) Garuda (Short) (Hold'em)
Seat 5 is the button
Seat 1: kidsquid (31.13).
Seat 2: sr86 (47.65).
Seat 3: IlxxxlI (26.39).
Seat 4: hotshothotgg (27.97).
Seat 5: Spagetti1 (24.84).
Seat 6: parmele (19.22).
Seat 7: ChrisNola (37.32).
Seat 8: Parcker (25.75).
Seat 9: FirstClan (28.95).
Player parmele has small blind (0.25)
Player ChrisNola has big blind (0.50)
Player IlxxxlI received card: [Kh]
Player IlxxxlI received card: [8c]
Player Parcker folds
Player FirstClan folds
Player kidsquid raises (1.50)
Player sr86 folds
Player IlxxxlI folds
Player hotshothotgg folds
Player Spagetti1 folds
Player parmele folds
Player ChrisNola folds
Uncalled bet (1) returned to kidsquid
Player kidsquid mucks cards
------ Summary ------
Pot: 1.25. Rake 0
*Player kidsquid mucks (does not show cards). Bets: 0.50. Collects: 1.25. Wins: 0.75.
Player sr86 does not show cards.Bets: 0. Collects: 0. Wins: 0.
Player IlxxxlI does not show cards.Bets: 0. Collects: 0. Wins: 0.
Player hotshothotgg does not show cards.Bets: 0. Collects: 0. Wins: 0.
Player Spagetti1 does not show cards.Bets: 0. Collects: 0. Wins: 0.
Player parmele does not show cards.Bets: 0.25. Collects: 0. Loses: 0.25.
Player ChrisNola does not show cards.Bets: 0.50. Collects: 0. Loses: 0.50.
Player Parcker does not show cards.Bets: 0. Collects: 0. Wins: 0.
Player FirstClan does not show cards.Bets: 0. Collects: 0. Wins: 0.
Game ended at: 2016/11/21 12:28:49

Game started
Game ID: 781024608 0.25/0.50 (PRR) Garuda (Short) (Hold'em)
Seat 4 is the button
Seat 1: kidsquid (32.63).
Seat 2: sr86 (42.97).
Seat 3: IlxxxlI (26.39).
Seat 4: hotshothotgg (27.97).
Seat 5: Spagetti1 (25.34).
Seat 6: parmele (20.72).
Seat 7: ChrisNola (38.82).
Seat 8: Parcker (25.75).
Seat 9: FirstClan (28.95).
Player Spagetti1 has small blind (0.25)
Player parmele has big blind (0.50)
Player IlxxxlI received card: [As]
Player IlxxxlI received card: [2c]
Player ChrisNola calls (0.50)
Player Parcker folds
Player FirstClan folds
Player kidsquid calls (0.50)
Player sr86 calls (0.50)
Player IlxxxlI folds
Player hotshothotgg folds
Player Spagetti1 calls (0.25)
Player parmele raises (1)
Player ChrisNola calls (1)
Player kidsquid calls (1)
Player sr86 calls (1)
Player Spagetti1 folds
*** FLOP ***: [7d 6d Ad]
Player parmele checks
Player ChrisNola checks
Player kidsquid checks
Player sr86 checks
*** TURN ***: [7d 6d Ad] [2d]
Player parmele checks
Player ChrisNola checks
Player kidsquid checks
Player sr86 is timed out.
Player sr86 checks
*** RIVER ***: [7d 6d Ad 2d] [7s]
Player parmele checks
Player ChrisNola checks
Player kidsquid checks
Player sr86 checks
Player parmele mucks cards
Player ChrisNola mucks cards
Player kidsquid mucks cards
------ Summary ------
Pot: 6.18. Rake 0.22. JP fee 0.10
Board: [7d 6d Ad 2d 7s]
Player kidsquid mucks (does not show cards). Bets: 1.50. Collects: 0. Loses: 1.50.
*Player sr86 shows: Two pairs. As and 7s [Ac 8c]. Bets: 1.50. Collects: 6.18. Wins: 4.68.
Player IlxxxlI does not show cards.Bets: 0. Collects: 0. Wins: 0.
Player hotshothotgg does not show cards.Bets: 0. Collects: 0. Wins: 0.
Player Spagetti1 does not show cards.Bets: 0.50. Collects: 0. Loses: 0.50.
Player parmele mucks (does not show cards). Bets: 1.50. Collects: 0. Loses: 1.50.
Player ChrisNola mucks (does not show cards). Bets: 1.50. Collects: 0. Loses: 1.50.
Player Parcker does not show cards.Bets: 0. Collects: 0. Wins: 0.
Player FirstClan does not show cards.Bets: 0. Collects: 0. Wins: 0.
Game ended at: 2016/11/21 12:28:2

Game started
Game ID: 781023863 0.25/0.50 (PRR) Garuda (Short) (Hold'em)
Seat 3 is the button
Seat 1: kidsquid (32.63).
Seat 2: sr86 (42.97).
Seat 3: IlxxxlI (26.39).
Seat 4: hotshothotgg (28.22).
Seat 5: Spagetti1 (25.84).
Seat 6: parmele (20.72).
Seat 7: ChrisNola (38.82).
Seat 8: Parcker (25).
Seat 9: FirstClan (28.95).
Player hotshothotgg has small blind (0.25)
Player Spagetti1 has big blind (0.50)
Player IlxxxlI received card: [5s]
Player IlxxxlI received card: [9d]
Player parmele folds
Player ChrisNola folds
Player Parcker raises (1.50)
Player FirstClan folds
Player kidsquid folds
Player sr86 folds
Player IlxxxlI folds
Player hotshothotgg folds
Player Spagetti1 folds
Uncalled bet (1) returned to Parcker
Player Parcker mucks cards
------ Summary ------
Pot: 1.25. Rake 0
Player kidsquid does not show cards.Bets: 0. Collects: 0. Wins: 0.
Player sr86 does not show cards.Bets: 0. Collects: 0. Wins: 0.
Player IlxxxlI does not show cards.Bets: 0. Collects: 0. Wins: 0.
Player hotshothotgg does not show cards.Bets: 0.25. Collects: 0. Loses: 0.25.
Player Spagetti1 does not show cards.Bets: 0.50. Collects: 0. Loses: 0.50.
Player parmele does not show cards.Bets: 0. Collects: 0. Wins: 0.
Player ChrisNola does not show cards.Bets: 0. Collects: 0. Wins: 0.
*Player Parcker mucks (does not show cards). Bets: 0.50. Collects: 1.25. Wins: 0.75.
Player FirstClan does not show cards.Bets: 0. Collects: 0. Wins: 0.
Game ended at: 2016/11/21 12:24:46

Game started
Game ID: 781023243 0.25/0.50 (PRR) Garuda (Short) (Hold'em)
Seat 2 is the button
Seat 1: kidsquid (32.63).
Seat 2: sr86 (42.97).
Seat 3: IlxxxlI (26.64).
Seat 4: hotshothotgg (28.72).
Seat 5: Spagetti1 (25.84).
Seat 6: parmele (20.72).
Seat 7: ChrisNola (38.82).
Seat 8: Parcker (25.20).
Seat 9: FirstClan (26.70).
Player IlxxxlI has small blind (0.25)
Player hotshothotgg has big blind (0.50)
Player IlxxxlI received card: [Kc]
Player IlxxxlI received card: [3c]
Player Spagetti1 folds
Player parmele folds
Player ChrisNola folds
Player Parcker raises (1.50)
Player FirstClan raises (4)
Player kidsquid folds
Player sr86 folds
Player IlxxxlI folds
Player hotshothotgg folds
Player Parcker folds
Uncalled bet (2.50) returned to FirstClan
Player FirstClan mucks cards
------ Summary ------
Pot: 3.75. Rake 0
Player kidsquid does not show cards.Bets: 0. Collects: 0. Wins: 0.
Player sr86 does not show cards.Bets: 0. Collects: 0. Wins: 0.
Player IlxxxlI does not show cards.Bets: 0.25. Collects: 0. Loses: 0.25.
Player hotshothotgg does not show cards.Bets: 0.50. Collects: 0. Loses: 0.50.
Player Spagetti1 does not show cards.Bets: 0. Collects: 0. Wins: 0.
Player parmele does not show cards.Bets: 0. Collects: 0. Wins: 0.
Player ChrisNola does not show cards.Bets: 0. Collects: 0. Wins: 0.
Player Parcker does not show cards.Bets: 1.50. Collects: 0. Loses: 1.50.
*Player FirstClan mucks (does not show cards). Bets: 1.50. Collects: 3.75. Wins: 2.25.
Game ended at: 2016/11/21 12:23:42

Game started
Game ID: 781022238 0.25/0.50 (PRR) Garuda (Short) (Hold'em)
Seat 1 is the button
Seat 1: kidsquid (25.84).
Seat 2: sr86 (43.22).
Seat 3: IlxxxlI (27.14).
Seat 4: hotshothotgg (28.72).
Seat 5: Spagetti1 (25.84).
Seat 6: parmele (27.47).
Seat 7: ChrisNola (38.82).
Seat 8: Parcker (25.20).
Seat 9: FirstClan (26.70).
Player sr86 has small blind (0.25)
Player IlxxxlI has big blind (0.50)
Player IlxxxlI received card: [10d]
Player IlxxxlI received card: [4d]
Player hotshothotgg folds
Player Spagetti1 folds
Player parmele raises (1.50)
Player ChrisNola folds
Player Parcker folds
Player FirstClan folds
Player kidsquid calls (1.50)
Player sr86 folds
Player IlxxxlI folds
*** FLOP ***: [9c 8s Jh]
Player parmele checks
Player kidsquid bets (1.78)
Player parmele calls (1.78)
*** TURN ***: [9c 8s Jh] [Qc]
Player parmele checks
Player kidsquid bets (3.47)
Player parmele calls (3.47)
*** RIVER ***: [9c 8s Jh Qc] [Jd]
Player parmele checks
Player kidsquid checks
Player parmele mucks cards
------ Summary ------
Pot: 13.54. Rake 0.49. JP fee 0.22
Board: [9c 8s Jh Qc Jd]
*Player kidsquid shows: Two pairs. Js and 9s [9s Ks]. Bets: 6.75. Collects: 13.54. Wins: 6.79.
Player sr86 does not show cards.Bets: 0.25. Collects: 0. Loses: 0.25.
Player IlxxxlI does not show cards.Bets: 0.50. Collects: 0. Loses: 0.50.
Player hotshothotgg does not show cards.Bets: 0. Collects: 0. Wins: 0.
Player Spagetti1 does not show cards.Bets: 0. Collects: 0. Wins: 0.
Player parmele mucks (does not show cards). Bets: 6.75. Collects: 0. Loses: 6.75.
Player ChrisNola does not show cards.Bets: 0. Collects: 0. Wins: 0.
Player Parcker does not show cards.Bets: 0. Collects: 0. Wins: 0.
Player FirstClan does not show cards.Bets: 0. Collects: 0. Wins: 0.
Game ended at: 2016/11/21 12:22:52

Game started
Game ID: 781013978 0.25/0.50 (PRR) Garuda (Short) (Hold'em)
Seat 9 is the button
Seat 1: kidsquid (26.09).
Seat 2: sr86 (43.97).
Seat 3: IlxxxlI (27.14).
Seat 4: hotshothotgg (22.64).
Seat 5: Spagetti1 (25.84).
Seat 6: parmele (27.47).
Seat 7: ChrisNola (39.14).
Seat 8: Parcker (27.22).
Seat 9: FirstClan (29.94).
Player kidsquid has small blind (0.25)
Player sr86 has big blind (0.50)
Player IlxxxlI received card: [10c]
Player IlxxxlI received card: [Kc]
Player IlxxxlI folds
Player hotshothotgg folds
Player Spagetti1 raises (1.50)
Player parmele folds
Player ChrisNola folds
Player Parcker folds
Player FirstClan folds
Player kidsquid folds
Player sr86 folds
Uncalled bet (1) returned to Spagetti1
Player Spagetti1 mucks cards
------ Summary ------
Pot: 1.25. Rake 0
Player kidsquid does not show cards.Bets: 0.25. Collects: 0. Loses: 0.25.
Player sr86 does not show cards.Bets: 0.50. Collects: 0. Loses: 0.50.
Player IlxxxlI does not show cards.Bets: 0. Collects: 0. Wins: 0.
Player hotshothotgg does not show cards.Bets: 0. Collects: 0. Wins: 0.
*Player Spagetti1 mucks (does not show cards). Bets: 0.50. Collects: 1.25. Wins: 0.75.
Player parmele does not show cards.Bets: 0. Collects: 0. Wins: 0.
Player ChrisNola does not show cards.Bets: 0. Collects: 0. Wins: 0.
Player Parcker does not show cards.Bets: 0. Collects: 0. Wins: 0.
Player FirstClan does not show cards.Bets: 0. Collects: 0. Wins: 0.
Game ended at: 2016/11/21 12:11:41

Game started
Game ID: 781012681 0.25/0.50 (PRR) Garuda (Short) (Hold'em)
Seat 8 is the button
Seat 1: kidsquid (24.50).
Seat 2: sr86 (45.47).
Seat 3: IlxxxlI (27.14).
Seat 4: hotshothotgg (22.64).
Seat 5: Spagetti1 (25.84).
Seat 6: parmele (27.47).
Seat 7: ChrisNola (39.14).
Seat 8: Parcker (27.22).
Seat 9: FirstClan (30.19).
Player FirstClan has small blind (0.25)
Player kidsquid has big blind (0.50)
Player IlxxxlI received card: [4c]
Player IlxxxlI received card: [Jh]
Player sr86 calls (0.50)
Player IlxxxlI folds
Player hotshothotgg folds
Player Spagetti1 folds
Player parmele folds
Player ChrisNola folds
Player Parcker folds
Player FirstClan folds
Player kidsquid checks
*** FLOP ***: [7h 6s 9h]
Player kidsquid checks
Player sr86 bets (1)
Player kidsquid calls (1)
*** TURN ***: [7h 6s 9h] [10h]
Player kidsquid checks
Player sr86 checks
*** RIVER ***: [7h 6s 9h 10h] [4d]
Player kidsquid checks
Player sr86 checks
Player sr86 mucks cards
------ Summary ------
Pot: 3.09. Rake 0.12. JP fee 0.04
Board: [7h 6s 9h 10h 4d]
*Player kidsquid shows: One pair of 7s [Qd 7d]. Bets: 1.50. Collects: 3.09. Wins: 1.59.
Player sr86 mucks (does not show cards). Bets: 1.50. Collects: 0. Loses: 1.50.
Player IlxxxlI does not show cards.Bets: 0. Collects: 0. Wins: 0.
Player hotshothotgg does not show cards.Bets: 0. Collects: 0. Wins: 0.
Player Spagetti1 does not show cards.Bets: 0. Collects: 0. Wins: 0.
Player parmele does not show cards.Bets: 0. Collects: 0. Wins: 0.
Player ChrisNola does not show cards.Bets: 0. Collects: 0. Wins: 0.
Player Parcker does not show cards.Bets: 0. Collects: 0. Wins: 0.
Player FirstClan does not show cards.Bets: 0.25. Collects: 0. Loses: 0.25.
Game ended at: 2016/11/21 12:11:4

Game started
Game ID: 781011559 0.25/0.50 (PRR) Garuda (Short) (Hold'em)
Seat 7 is the button
Seat 1: kidsquid (24.50).
Seat 2: sr86 (45.47).
Seat 3: IlxxxlI (22.43).
Seat 4: hotshothotgg (22.64).
Seat 5: Spagetti1 (25.84).
Seat 6: parmele (27.47).
Seat 7: ChrisNola (43.58).
Seat 8: Parcker (27.47).
Seat 9: FirstClan (30.69).
Player Parcker has small blind (0.25)
Player FirstClan has big blind (0.50)
Player IlxxxlI received card: [10h]
Player IlxxxlI received card: [10s]
Player kidsquid folds
Player sr86 folds
Player IlxxxlI raises (1.75)
Player hotshothotgg folds
Player Spagetti1 folds
Player parmele folds
Player ChrisNola calls (1.75)
Player Parcker folds
Player FirstClan folds
*** FLOP ***: [6c 10d 6s]
Player IlxxxlI checks
Player ChrisNola bets (2.69)
Player IlxxxlI calls (2.69)
*** TURN ***: [6c 10d 6s] [4d]
Player IlxxxlI checks
Player ChrisNola checks
*** RIVER ***: [6c 10d 6s 4d] [Qs]
Player IlxxxlI bets (14.50)
Player ChrisNola folds
Uncalled bet (14.50) returned to IlxxxlI
Player IlxxxlI mucks cards
------ Summary ------
Pot: 9.15. Rake 0.32. JP fee 0.16
Board: [6c 10d 6s 4d Qs]
Player kidsquid does not show cards.Bets: 0. Collects: 0. Wins: 0.
Player sr86 does not show cards.Bets: 0. Collects: 0. Wins: 0.
*Player IlxxxlI mucks (does not show cards). Bets: 4.44. Collects: 9.15. Wins: 4.71.
Player hotshothotgg does not show cards.Bets: 0. Collects: 0. Wins: 0.
Player Spagetti1 does not show cards.Bets: 0. Collects: 0. Wins: 0.
Player parmele does not show cards.Bets: 0. Collects: 0. Wins: 0.
Player ChrisNola does not show cards.Bets: 4.44. Collects: 0. Loses: 4.44.
Player Parcker does not show cards.Bets: 0.25. Collects: 0. Loses: 0.25.
Player FirstClan does not show cards.Bets: 0.50. Collects: 0. Loses: 0.50.
Game ended at: 2016/11/21 12:9:28

Game started
Game ID: 781011061 0.25/0.50 (PRR) Garuda (Short) (Hold'em)
Seat 6 is the button
Seat 1: kidsquid (24.50).
Seat 2: sr86 (45.47).
Seat 3: IlxxxlI (22.43).
Seat 4: hotshothotgg (22.64).
Seat 5: Spagetti1 (25.84).
Seat 6: parmele (27.47).
Seat 7: ChrisNola (43.13).
Seat 8: Parcker (27.97).
Seat 9: FirstClan (30.69).
Player ChrisNola has small blind (0.25)
Player Parcker has big blind (0.50)
Player IlxxxlI received card: [Jh]
Player IlxxxlI received card: [5h]
Player FirstClan folds
Player kidsquid folds
Player sr86 folds
Player IlxxxlI folds
Player hotshothotgg folds
Player Spagetti1 folds
Player parmele folds
Player ChrisNola calls (0.25)
Player Parcker checks
*** FLOP ***: [Jc 7d 4s]
Player ChrisNola checks
Player Parcker checks
*** TURN ***: [Jc 7d 4s] [5s]
Player ChrisNola bets (0.50)
Player Parcker folds
Uncalled bet (0.50) returned to ChrisNola
Player ChrisNola mucks cards
------ Summary ------
Pot: 0.95. Rake 0.05
Board: [Jc 7d 4s 5s]
Player kidsquid does not show cards.Bets: 0. Collects: 0. Wins: 0.
Player sr86 does not show cards.Bets: 0. Collects: 0. Wins: 0.
Player IlxxxlI does not show cards.Bets: 0. Collects: 0. Wins: 0.
Player hotshothotgg does not show cards.Bets: 0. Collects: 0. Wins: 0.
Player Spagetti1 does not show cards.Bets: 0. Collects: 0. Wins: 0.
Player parmele does not show cards.Bets: 0. Collects: 0. Wins: 0.
*Player ChrisNola mucks (does not show cards). Bets: 0.50. Collects: 0.95. Wins: 0.45.
Player Parcker does not show cards.Bets: 0.50. Collects: 0. Loses: 0.50.
Player FirstClan does not show cards.Bets: 0. Collects: 0. Wins: 0.
Game ended at: 2016/11/21 12:8:2

Game started
Game ID: 781009930 0.25/0.50 (PRR) Garuda (Short) (Hold'em)
Seat 5 is the button
Seat 1: kidsquid (24.50).
Seat 2: sr86 (45.47).
Seat 3: IlxxxlI (22.43).
Seat 4: hotshothotgg (22.64).
Seat 5: Spagetti1 (25.84).
Seat 6: parmele (26.45).
Seat 7: ChrisNola (44.26).
Seat 8: Parcker (27.97).
Seat 9: FirstClan (30.69).
Player parmele has small blind (0.25)
Player ChrisNola has big blind (0.50)
Player IlxxxlI received card: [8d]
Player IlxxxlI received card: [Ah]
Player Parcker folds
Player FirstClan folds
Player kidsquid folds
Player sr86 folds
Player IlxxxlI folds
Player hotshothotgg folds
Player Spagetti1 folds
Player parmele calls (0.25)
Player ChrisNola checks
*** FLOP ***: [8c 5s 6h]
Player parmele checks
Player ChrisNola bets (0.63)
Player parmele calls (0.63)
*** TURN ***: [8c 5s 6h] [Ac]
Player parmele bets (2)
Player ChrisNola folds
Uncalled bet (2) returned to parmele
Player parmele mucks cards
------ Summary ------
Pot: 2.15. Rake 0.09. JP fee 0.02
Board: [8c 5s 6h Ac]
Player kidsquid does not show cards.Bets: 0. Collects: 0. Wins: 0.
Player sr86 does not show cards.Bets: 0. Collects: 0. Wins: 0.
Player IlxxxlI does not show cards.Bets: 0. Collects: 0. Wins: 0.
Player hotshothotgg does not show cards.Bets: 0. Collects: 0. Wins: 0.
Player Spagetti1 does not show cards.Bets: 0. Collects: 0. Wins: 0.
*Player parmele mucks (does not show cards). Bets: 1.13. Collects: 2.15. Wins: 1.02.
Player ChrisNola does not show cards.Bets: 1.13. Collects: 0. Loses: 1.13.
Player Parcker does not show cards.Bets: 0. Collects: 0. Wins: 0.
Player FirstClan does not show cards.Bets: 0. Collects: 0. Wins: 0.
Game ended at: 2016/11/21 12:7:26

Game started
Game ID: 781009504 0.25/0.50 (PRR) Garuda (Short) (Hold'em)
Seat 4 is the button
Seat 1: kidsquid (24.50).
Seat 2: sr86 (45.47).
Seat 3: IlxxxlI (22.43).
Seat 4: hotshothotgg (22.64).
Seat 5: Spagetti1 (25.34).
Seat 6: parmele (26.95).
Seat 7: ChrisNola (44.26).
Seat 8: Parcker (27.97).
Seat 9: FirstClan (30.69).
Player Spagetti1 has small blind (0.25)
Player parmele has big blind (0.50)
Player IlxxxlI received card: [5c]
Player IlxxxlI received card: [8d]
Player ChrisNola folds
Player Parcker folds
Player FirstClan folds
Player kidsquid folds
Player sr86 folds
Player IlxxxlI folds
Player hotshothotgg folds
Player Spagetti1 raises (0.75)
Player parmele folds
Uncalled bet (0.50) returned to Spagetti1
Player Spagetti1 mucks cards
------ Summary ------
Pot: 1. Rake 0
Player kidsquid does not show cards.Bets: 0. Collects: 0. Wins: 0.
Player sr86 does not show cards.Bets: 0. Collects: 0. Wins: 0.
Player IlxxxlI does not show cards.Bets: 0. Collects: 0. Wins: 0.
Player hotshothotgg does not show cards.Bets: 0. Collects: 0. Wins: 0.
*Player Spagetti1 mucks (does not show cards). Bets: 0.50. Collects: 1. Wins: 0.50.
Player parmele does not show cards.Bets: 0.50. Collects: 0. Loses: 0.50.
Player ChrisNola does not show cards.Bets: 0. Collects: 0. Wins: 0.
Player Parcker does not show cards.Bets: 0. Collects: 0. Wins: 0.
Player FirstClan does not show cards.Bets: 0. Collects: 0. Wins: 0.
Game ended at: 2016/11/21 12:5:59

Game started
Game ID: 781008353 0.25/0.50 (PRR) Garuda (Short) (Hold'em)
Seat 3 is the button
Seat 1: kidsquid (24.50).
Seat 2: sr86 (45.47).
Seat 3: IlxxxlI (22.43).
Seat 4: hotshothotgg (22.89).
Seat 5: Spagetti1 (25.84).
Seat 6: parmele (26.95).
Seat 7: ChrisNola (44.76).
Seat 8: Parcker (27.97).
Seat 9: FirstClan (29.52).
Player hotshothotgg has small blind (0.25)
Player Spagetti1 has big blind (0.50)
Player IlxxxlI received card: [5h]
Player IlxxxlI received card: [Jd]
Player parmele folds
Player ChrisNola calls (0.50)
Player Parcker folds
Player FirstClan calls (0.50)
Player kidsquid folds
Player sr86 folds
Player IlxxxlI folds
Player hotshothotgg folds
Player Spagetti1 checks
*** FLOP ***: [Qs 7h Kd]
Player Spagetti1 checks
Player ChrisNola checks
Player FirstClan checks
*** TURN ***: [Qs 7h Kd] [3h]
Player Spagetti1 checks
Player ChrisNola checks
Player FirstClan bets (1.11)
Player Spagetti1 folds
Player ChrisNola folds
Uncalled bet (1.11) returned to FirstClan
Player FirstClan mucks cards
------ Summary ------
Pot: 1.67. Rake 0.06. JP fee 0.02
Board: [Qs 7h Kd 3h]
Player kidsquid does not show cards.Bets: 0. Collects: 0. Wins: 0.
Player sr86 does not show cards.Bets: 0. Collects: 0. Wins: 0.
Player IlxxxlI does not show cards.Bets: 0. Collects: 0. Wins: 0.
Player hotshothotgg does not show cards.Bets: 0.25. Collects: 0. Loses: 0.25.
Player Spagetti1 does not show cards.Bets: 0.50. Collects: 0. Loses: 0.50.
Player parmele does not show cards.Bets: 0. Collects: 0. Wins: 0.
Player ChrisNola does not show cards.Bets: 0.50. Collects: 0. Loses: 0.50.
Player Parcker does not show cards.Bets: 0. Collects: 0. Wins: 0.
*Player FirstClan mucks (does not show cards). Bets: 0.50. Collects: 1.67. Wins: 1.17.
Game ended at: 2016/11/21 12:5:26

Game started
Game ID: 781007267 0.25/0.50 (PRR) Garuda (Short) (Hold'em)
Seat 2 is the button
Seat 1: kidsquid (25).
Seat 2: sr86 (45.47).
Seat 3: IlxxxlI (22.68).
Seat 4: hotshothotgg (25.39).
Seat 5: Spagetti1 (25.84).
Seat 6: parmele (26.95).
Seat 7: ChrisNola (44.76).
Seat 8: Parcker (25).
Seat 9: FirstClan (29.52).
Player IlxxxlI has small blind (0.25)
Player hotshothotgg has big blind (0.50)
Player kidsquid posts (0.50)
Player IlxxxlI received card: [Qd]
Player IlxxxlI received card: [9h]
Player Spagetti1 folds
Player parmele folds
Player ChrisNola folds
Player Parcker raises (2.50)
Player FirstClan folds
Player kidsquid folds
Player sr86 folds
Player IlxxxlI folds
Player hotshothotgg calls (2)
*** FLOP ***: [Jd 7c 10c]
Player hotshothotgg checks
Player Parcker checks
*** TURN ***: [Jd 7c 10c] [8d]
Player hotshothotgg checks
Player Parcker checks
*** RIVER ***: [Jd 7c 10c 8d] [5c]
Player hotshothotgg checks
Player Parcker checks
Player hotshothotgg mucks cards
------ Summary ------
Pot: 5.47. Rake 0.20. JP fee 0.08
Board: [Jd 7c 10c 8d 5c]
Player kidsquid does not show cards.Bets: 0.50. Collects: 0. Loses: 0.50.
Player sr86 does not show cards.Bets: 0. Collects: 0. Wins: 0.
Player IlxxxlI does not show cards.Bets: 0.25. Collects: 0. Loses: 0.25.
Player hotshothotgg mucks (does not show cards). Bets: 2.50. Collects: 0. Loses: 2.50.
Player Spagetti1 does not show cards.Bets: 0. Collects: 0. Wins: 0.
Player parmele does not show cards.Bets: 0. Collects: 0. Wins: 0.
Player ChrisNola does not show cards.Bets: 0. Collects: 0. Wins: 0.
*Player Parcker shows: One pair of 10s [As 10h]. Bets: 2.50. Collects: 5.47. Wins: 2.97.
Player FirstClan does not show cards.Bets: 0. Collects: 0. Wins: 0.
Game ended at: 2016/11/21 12:3:54

Game started
Game ID: 781006111 0.25/0.50 (PRR) Garuda (Short) (Hold'em)
Seat 9 is the button
Seat 2: sr86 (45.72).
Seat 3: IlxxxlI (23.18).
Seat 4: hotshothotgg (25.39).
Seat 5: Spagetti1 (25.84).
Seat 6: parmele (26.95).
Seat 7: ChrisNola (42.02).
Seat 8: Parcker (25).
Seat 9: FirstClan (29.52).
Player sr86 has small blind (0.25)
Player IlxxxlI has big blind (0.50)
Player IlxxxlI received card: [Qh]
Player IlxxxlI received card: [7c]
Player hotshothotgg folds
Player Spagetti1 folds
Player parmele folds
Player ChrisNola calls (0.50)
Player Parcker raises (2.25)
Player FirstClan folds
Player sr86 folds
Player IlxxxlI folds
Player ChrisNola calls (1.75)
*** FLOP ***: [3s Ah 2h]
Player ChrisNola checks
Player Parcker checks
*** TURN ***: [3s Ah 2h] [10h]
Player ChrisNola checks
Player Parcker checks
*** RIVER ***: [3s Ah 2h 10h] [6c]
Player ChrisNola bets (4)
Player Parcker folds
Uncalled bet (4) returned to ChrisNola
Player ChrisNola mucks cards
------ Summary ------
Pot: 4.99. Rake 0.18. JP fee 0.08
Board: [3s Ah 2h 10h 6c]
Player sr86 does not show cards.Bets: 0.25. Collects: 0. Loses: 0.25.
Player IlxxxlI does not show cards.Bets: 0.50. Collects: 0. Loses: 0.50.
Player hotshothotgg does not show cards.Bets: 0. Collects: 0. Wins: 0.
Player Spagetti1 does not show cards.Bets: 0. Collects: 0. Wins: 0.
Player parmele does not show cards.Bets: 0. Collects: 0. Wins: 0.
*Player ChrisNola mucks (does not show cards). Bets: 2.25. Collects: 4.99. Wins: 2.74.
Player Parcker does not show cards.Bets: 2.25. Collects: 0. Loses: 2.25.
Player FirstClan does not show cards.Bets: 0. Collects: 0. Wins: 0.
Game ended at: 2016/11/21 12:2:29

Game started
Game ID: 781005018 0.25/0.50 (PRR) Garuda (Short) (Hold'em)
Seat 8 is the button
Seat 2: sr86 (48.09).
Seat 3: IlxxxlI (23.18).
Seat 4: hotshothotgg (22.06).
Seat 5: Spagetti1 (25.84).
Seat 6: parmele (26.95).
Seat 7: ChrisNola (42.77).
Seat 8: Parcker (25).
Seat 9: FirstClan (30.02).
Player FirstClan has small blind (0.25)
Player sr86 has big blind (0.50)
Player ChrisNola posts (0.25) as a dead bet
Player ChrisNola posts (0.50)
Player IlxxxlI received card: [Ac]
Player IlxxxlI received card: [10d]
Player IlxxxlI folds
Player hotshothotgg calls (0.50)
Player Spagetti1 folds
Player parmele folds
Player ChrisNola checks
Player Parcker folds
Player FirstClan calls (0.25)
Player sr86 checks
*** FLOP ***: [8h Qc 8s]
Player FirstClan checks
Player sr86 checks
Player hotshothotgg bets (0.71)
Player ChrisNola folds
Player FirstClan folds
Player sr86 calls (0.71)
*** TURN ***: [8h Qc 8s] [5c]
Player sr86 checks
Player hotshothotgg checks
*** RIVER ***: [8h Qc 8s 5c] [3c]
Player sr86 checks
Player hotshothotgg bets (1.16)
Player sr86 calls (1.16)
Player sr86 mucks cards
------ Summary ------
Pot: 5.70. Rake 0.21. JP fee 0.08
Board: [8h Qc 8s 5c 3c]
Player sr86 mucks (does not show cards). Bets: 2.37. Collects: 0. Loses: 2.37.
Player IlxxxlI does not show cards.Bets: 0. Collects: 0. Wins: 0.
*Player hotshothotgg shows: Two pairs. Qs and 8s [Qd Ks]. Bets: 2.37. Collects: 5.70. Wins: 3.33.
Player Spagetti1 does not show cards.Bets: 0. Collects: 0. Wins: 0.
Player parmele does not show cards.Bets: 0. Collects: 0. Wins: 0.
Player ChrisNola does not show cards.Bets: 0.75. Collects: 0. Loses: 0.75.
Player Parcker does not show cards.Bets: 0. Collects: 0. Wins: 0.
Player FirstClan does not show cards.Bets: 0.50. Collects: 0. Loses: 0.50.
Game ended at: 2016/11/21 12:0:57

Game started
Game ID: 781004415 0.25/0.50 (PRR) Garuda (Short) (Hold'em)
Seat 6 is the button
Seat 1: haroldbb (36.45).
Seat 2: sr86 (48.09).
Seat 3: IlxxxlI (23.18).
Seat 4: hotshothotgg (22.06).
Seat 5: Spagetti1 (24.25).
Seat 6: parmele (26.95).
Seat 8: Parcker (25.25).
Seat 9: FirstClan (31.52).
Player Parcker has small blind (0.25)
Player FirstClan has big blind (0.50)
Player IlxxxlI received card: [6h]
Player IlxxxlI received card: [7c]
Player haroldbb folds
Player sr86 folds
Player IlxxxlI folds
Player hotshothotgg folds
Player Spagetti1 raises (1.50)
Player parmele folds
Player Parcker folds
Player FirstClan calls (1)
*** FLOP ***: [Jd Kh 10d]
Player FirstClan checks
Player Spagetti1 bets (2.06)
Player FirstClan folds
Uncalled bet (2.06) returned to Spagetti1
Player Spagetti1 mucks cards
------ Summary ------
Pot: 3.09. Rake 0.12. JP fee 0.04
Board: [Jd Kh 10d]
Player haroldbb does not show cards.Bets: 0. Collects: 0. Wins: 0.
Player sr86 does not show cards.Bets: 0. Collects: 0. Wins: 0.
Player IlxxxlI does not show cards.Bets: 0. Collects: 0. Wins: 0.
Player hotshothotgg does not show cards.Bets: 0. Collects: 0. Wins: 0.
*Player Spagetti1 mucks (does not show cards). Bets: 1.50. Collects: 3.09. Wins: 1.59.
Player parmele does not show cards.Bets: 0. Collects: 0. Wins: 0.
Player Parcker does not show cards.Bets: 0.25. Collects: 0. Loses: 0.25.
Player FirstClan does not show cards.Bets: 1.50. Collects: 0. Loses: 1.50.
Game ended at: 2016/11/21 11:59:4

Game started
Game ID: 781003752 0.25/0.50 (PRR) Garuda (Short) (Hold'em)
Seat 5 is the button
Seat 1: haroldbb (36.45).
Seat 2: sr86 (48.09).
Seat 3: IlxxxlI (23.18).
Seat 4: hotshothotgg (19.99).
Seat 5: Spagetti1 (24.25).
Seat 6: parmele (27.20).
Seat 7: ChrisNola (42.77).
Seat 8: Parcker (25.75).
Seat 9: FirstClan (33.02).
Player parmele has small blind (0.25)
Player ChrisNola is timed out.
Player ChrisNola sitting out
Player Parcker has big blind (0.50)
Player IlxxxlI received card: [7h]
Player IlxxxlI received card: [7c]
Player FirstClan raises (1.50)
Player haroldbb folds
Player sr86 folds
Player IlxxxlI folds
Player hotshothotgg calls (1.50)
Player Spagetti1 folds
Player parmele folds
Player Parcker folds
*** FLOP ***: [9c 4d 8h]
Player FirstClan checks
Player hotshothotgg bets (1.19)
Player FirstClan folds
Uncalled bet (1.19) returned to hotshothotgg
Player hotshothotgg mucks cards
------ Summary ------
Pot: 3.57. Rake 0.12. JP fee 0.06
Board: [9c 4d 8h]
Player haroldbb does not show cards.Bets: 0. Collects: 0. Wins: 0.
Player sr86 does not show cards.Bets: 0. Collects: 0. Wins: 0.
Player IlxxxlI does not show cards.Bets: 0. Collects: 0. Wins: 0.
*Player hotshothotgg mucks (does not show cards). Bets: 1.50. Collects: 3.57. Wins: 2.07.
Player Spagetti1 does not show cards.Bets: 0. Collects: 0. Wins: 0.
Player parmele does not show cards.Bets: 0.25. Collects: 0. Loses: 0.25.
Player ChrisNola does not show cards.Bets: 0. Collects: 0. Wins: 0.
Player Parcker does not show cards.Bets: 0.50. Collects: 0. Loses: 0.50.
Player FirstClan does not show cards.Bets: 1.50. Collects: 0. Loses: 1.50.
Game ended at: 2016/11/21 11:57:48

Game started
Game ID: 781003312 0.25/0.50 (PRR) Garuda (Short) (Hold'em)
Seat 4 is the button
Seat 1: haroldbb (36.45).
Seat 2: sr86 (48.09).
Seat 3: IlxxxlI (23.18).
Seat 4: hotshothotgg (19.24).
Seat 5: Spagetti1 (24.50).
Seat 6: parmele (27.70).
Seat 7: ChrisNola (42.77).
Seat 8: Parcker (25.75).
Seat 9: FirstClan (33.02).
Player Spagetti1 has small blind (0.25)
Player parmele has big blind (0.50)
Player IlxxxlI received card: [10c]
Player IlxxxlI received card: [5c]
Player ChrisNola folds
Player Parcker folds
Player FirstClan folds
Player haroldbb folds
Player sr86 folds
Player IlxxxlI folds
Player hotshothotgg raises (1)
Player Spagetti1 folds
Player parmele folds
Uncalled bet (0.50) returned to hotshothotgg
Player hotshothotgg mucks cards
------ Summary ------
Pot: 1.25. Rake 0
Player haroldbb does not show cards.Bets: 0. Collects: 0. Wins: 0.
Player sr86 does not show cards.Bets: 0. Collects: 0. Wins: 0.
Player IlxxxlI does not show cards.Bets: 0. Collects: 0. Wins: 0.
*Player hotshothotgg mucks (does not show cards). Bets: 0.50. Collects: 1.25. Wins: 0.75.
Player Spagetti1 does not show cards.Bets: 0.25. Collects: 0. Loses: 0.25.
Player parmele does not show cards.Bets: 0.50. Collects: 0. Loses: 0.50.
Player ChrisNola does not show cards.Bets: 0. Collects: 0. Wins: 0.
Player Parcker does not show cards.Bets: 0. Collects: 0. Wins: 0.
Player FirstClan does not show cards.Bets: 0. Collects: 0. Wins: 0.
Game ended at: 2016/11/21 11:56:24

Game started
Game ID: 781002098 0.25/0.50 (PRR) Garuda (Short) (Hold'em)
Seat 3 is the button
Seat 1: haroldbb (36.45).
Seat 2: sr86 (48.09).
Seat 3: IlxxxlI (23.18).
Seat 4: hotshothotgg (22.40).
Seat 5: Spagetti1 (25).
Seat 6: parmele (27.70).
Seat 7: ChrisNola (42.77).
Seat 8: Parcker (25.75).
Seat 9: FirstClan (29.70).
Player hotshothotgg has small blind (0.25)
Player Spagetti1 has big blind (0.50)
Player IlxxxlI received card: [3h]
Player IlxxxlI received card: [Jc]
Player parmele folds
Player ChrisNola folds
Player Parcker folds
Player FirstClan raises (1.50)
Player haroldbb folds
Player sr86 folds
Player IlxxxlI folds
Player hotshothotgg calls (1.25)
Player Spagetti1 folds
*** FLOP ***: [Qh 4s 7d]
Player hotshothotgg checks
Player FirstClan bets (1.66)
Player hotshothotgg calls (1.66)
*** TURN ***: [Qh 4s 7d] [Kd]
Player hotshothotgg checks
Player FirstClan bets (5.50)
Player hotshothotgg folds
Uncalled bet (5.50) returned to FirstClan
Player FirstClan mucks cards
------ Summary ------
Pot: 6.48. Rake 0.24. JP fee 0.10
Board: [Qh 4s 7d Kd]
Player haroldbb does not show cards.Bets: 0. Collects: 0. Wins: 0.
Player sr86 does not show cards.Bets: 0. Collects: 0. Wins: 0.
Player IlxxxlI does not show cards.Bets: 0. Collects: 0. Wins: 0.
Player hotshothotgg does not show cards.Bets: 3.16. Collects: 0. Loses: 3.16.
Player Spagetti1 does not show cards.Bets: 0.50. Collects: 0. Loses: 0.50.
Player parmele does not show cards.Bets: 0. Collects: 0. Wins: 0.
Player ChrisNola does not show cards.Bets: 0. Collects: 0. Wins: 0.
Player Parcker does not show cards.Bets: 0. Collects: 0. Wins: 0.
*Player FirstClan mucks (does not show cards). Bets: 3.16. Collects: 6.48. Wins: 3.32.
Game ended at: 2016/11/21 11:55:26

Game started
Game ID: 781000863 0.25/0.50 (PRR) Garuda (Short) (Hold'em)
Seat 2 is the button
Seat 1: haroldbb (36.45).
Seat 2: sr86 (48.09).
Seat 3: IlxxxlI (23.43).
Seat 4: hotshothotgg (21.71).
Seat 6: parmele (27.70).
Seat 7: ChrisNola (43.27).
Seat 8: Parcker (25.75).
Seat 9: FirstClan (29.70).
Player IlxxxlI has small blind (0.25)
Player hotshothotgg has big blind (0.50)
Player IlxxxlI received card: [5d]
Player IlxxxlI received card: [2d]
Player parmele folds
Player ChrisNola calls (0.50)
Player Parcker folds
Player FirstClan folds
Player haroldbb folds
Player sr86 folds
Player IlxxxlI folds
Player hotshothotgg checks
*** FLOP ***: [8d 7h 3h]
Player hotshothotgg checks
Player ChrisNola checks
*** TURN ***: [8d 7h 3h] [5h]
Player hotshothotgg checks
Player ChrisNola checks
*** RIVER ***: [8d 7h 3h 5h] [7c]
Player hotshothotgg checks
Player ChrisNola checks
Player ChrisNola mucks cards
------ Summary ------
Pot: 1.19. Rake 0.04. JP fee 0.02
Board: [8d 7h 3h 5h 7c]
Player haroldbb does not show cards.Bets: 0. Collects: 0. Wins: 0.
Player sr86 does not show cards.Bets: 0. Collects: 0. Wins: 0.
Player IlxxxlI does not show cards.Bets: 0.25. Collects: 0. Loses: 0.25.
*Player hotshothotgg shows: Two pairs. 7s and 3s [Ks 3d]. Bets: 0.50. Collects: 1.19. Wins: 0.69.
Player parmele does not show cards.Bets: 0. Collects: 0. Wins: 0.
Player ChrisNola mucks (does not show cards). Bets: 0.50. Collects: 0. Loses: 0.50.
Player Parcker does not show cards.Bets: 0. Collects: 0. Wins: 0.
Player FirstClan does not show cards.Bets: 0. Collects: 0. Wins: 0.
Game ended at: 2016/11/21 11:53:37

Game started
Game ID: 781000094 0.25/0.50 (PRR) Garuda (Short) (Hold'em)
Seat 1 is the button
Seat 1: haroldbb (38.32).
Seat 2: sr86 (48.34).
Seat 3: IlxxxlI (23.93).
Seat 4: hotshothotgg (21.71).
Seat 6: parmele (27.70).
Seat 7: ChrisNola (40.87).
Seat 8: Parcker (25.75).
Seat 9: FirstClan (29.70).
Player sr86 has small blind (0.25)
Player IlxxxlI has big blind (0.50)
Player IlxxxlI received card: [Kc]
Player IlxxxlI received card: [6d]
Player hotshothotgg folds
Player parmele folds
Player ChrisNola calls (0.50)
Player Parcker folds
Player FirstClan folds
Player haroldbb raises (1)
Player sr86 folds
Player IlxxxlI folds
Player ChrisNola calls (0.50)
*** FLOP ***: [Ad 4h 2c]
Player ChrisNola checks
Player haroldbb bets (0.87)
Player ChrisNola calls (0.87)
*** TURN ***: [Ad 4h 2c] [9c]
Player ChrisNola checks
Player haroldbb checks
*** RIVER ***: [Ad 4h 2c 9c] [Qh]
Player ChrisNola checks
Player haroldbb checks
Player haroldbb mucks cards
------ Summary ------
Pot: 4.27. Rake 0.16. JP fee 0.06
Board: [Ad 4h 2c 9c Qh]
Player haroldbb mucks (does not show cards). Bets: 1.87. Collects: 0. Loses: 1.87.
Player sr86 does not show cards.Bets: 0.25. Collects: 0. Loses: 0.25.
Player IlxxxlI does not show cards.Bets: 0.50. Collects: 0. Loses: 0.50.
Player hotshothotgg does not show cards.Bets: 0. Collects: 0. Wins: 0.
Player parmele does not show cards.Bets: 0. Collects: 0. Wins: 0.
*Player ChrisNola shows: One pair of 8s [8s 8h]. Bets: 1.87. Collects: 4.27. Wins: 2.40.
Player Parcker does not show cards.Bets: 0. Collects: 0. Wins: 0.
Player FirstClan does not show cards.Bets: 0. Collects: 0. Wins: 0.
Game ended at: 2016/11/21 11:51:56

Game started
Game ID: 780999629 0.25/0.50 (PRR) Garuda (Short) (Hold'em)
Seat 9 is the button
Seat 1: haroldbb (37.82).
Seat 2: sr86 (48.84).
Seat 3: IlxxxlI (23.93).
Seat 4: hotshothotgg (21.71).
Seat 6: parmele (27.70).
Seat 7: ChrisNola (40.87).
Seat 8: Parcker (25.75).
Seat 9: FirstClan (29.70).
Player haroldbb has small blind (0.25)
Player sr86 has big blind (0.50)
Player IlxxxlI received card: [9s]
Player IlxxxlI received card: [Ks]
Player IlxxxlI folds
Player hotshothotgg folds
Player parmele folds
Player ChrisNola folds
Player Parcker folds
Player FirstClan folds
Player haroldbb raises (0.75)
Player sr86 folds
Uncalled bet (0.50) returned to haroldbb
Player haroldbb mucks cards
------ Summary ------
Pot: 1. Rake 0
*Player haroldbb mucks (does not show cards). Bets: 0.50. Collects: 1. Wins: 0.50.
Player sr86 does not show cards.Bets: 0.50. Collects: 0. Loses: 0.50.
Player IlxxxlI does not show cards.Bets: 0. Collects: 0. Wins: 0.
Player hotshothotgg does not show cards.Bets: 0. Collects: 0. Wins: 0.
Player parmele does not show cards.Bets: 0. Collects: 0. Wins: 0.
Player ChrisNola does not show cards.Bets: 0. Collects: 0. Wins: 0.
Player Parcker does not show cards.Bets: 0. Collects: 0. Wins: 0.
Player FirstClan does not show cards.Bets: 0. Collects: 0. Wins: 0.
Game ended at: 2016/11/21 11:50:56

Game started
Game ID: 780998683 0.25/0.50 (PRR) Garuda (Short) (Hold'em)
Seat 8 is the button
Seat 1: haroldbb (35.32).
Seat 2: sr86 (48.84).
Seat 3: IlxxxlI (23.93).
Seat 4: hotshothotgg (21.71).
Seat 6: parmele (27.70).
Seat 7: ChrisNola (41.37).
Seat 8: Parcker (25.75).
Seat 9: FirstClan (31.70).
Player FirstClan has small blind (0.25)
Player haroldbb has big blind (0.50)
Player IlxxxlI received card: [2d]
Player IlxxxlI received card: [Ks]
Player sr86 folds
Player IlxxxlI folds
Player hotshothotgg folds
Player parmele folds
Player ChrisNola calls (0.50)
Player Parcker folds
Player FirstClan raises (1.75)
Player haroldbb raises (4.50)
Player ChrisNola folds
Player FirstClan folds
Uncalled bet (3) returned to haroldbb
Player haroldbb mucks cards
------ Summary ------
Pot: 4.50. Rake 0
*Player haroldbb mucks (does not show cards). Bets: 2. Collects: 4.50. Wins: 2.50.
Player sr86 does not show cards.Bets: 0. Collects: 0. Wins: 0.
Player IlxxxlI does not show cards.Bets: 0. Collects: 0. Wins: 0.
Player hotshothotgg does not show cards.Bets: 0. Collects: 0. Wins: 0.
Player parmele does not show cards.Bets: 0. Collects: 0. Wins: 0.
Player ChrisNola does not show cards.Bets: 0.50. Collects: 0. Loses: 0.50.
Player Parcker does not show cards.Bets: 0. Collects: 0. Wins: 0.
Player FirstClan does not show cards.Bets: 2. Collects: 0. Loses: 2.
Game ended at: 2016/11/21 11:50:17

Game started
Game ID: 780997753 0.25/0.50 (PRR) Garuda (Short) (Hold'em)
Seat 7 is the button
Seat 1: haroldbb (32.28).
Seat 2: sr86 (49.84).
Seat 3: IlxxxlI (23.93).
Seat 4: hotshothotgg (21.71).
Seat 6: parmele (27.70).
Seat 7: ChrisNola (42.37).
Seat 8: Parcker (26).
Seat 9: FirstClan (32.70).
Player Parcker has small blind (0.25)
Player FirstClan has big blind (0.50)
Player IlxxxlI received card: [2h]
Player IlxxxlI received card: [Qs]
Player haroldbb raises (1)
Player sr86 calls (1)
Player IlxxxlI folds
Player hotshothotgg folds
Player parmele folds
Player ChrisNola calls (1)
Player Parcker folds
Player FirstClan calls (0.50)
*** FLOP ***: [10h 3d 10c]
Player FirstClan checks
Player haroldbb bets (2.02)
Player sr86 folds
Player ChrisNola folds
Player FirstClan folds
Uncalled bet (2.02) returned to haroldbb
Player haroldbb mucks cards
------ Summary ------
Pot: 4.04. Rake 0.15. JP fee 0.06
Board: [10h 3d 10c]
*Player haroldbb mucks (does not show cards). Bets: 1. Collects: 4.04. Wins: 3.04.
Player sr86 does not show cards.Bets: 1. Collects: 0. Loses: 1.
Player IlxxxlI does not show cards.Bets: 0. Collects: 0. Wins: 0.
Player hotshothotgg does not show cards.Bets: 0. Collects: 0. Wins: 0.
Player parmele does not show cards.Bets: 0. Collects: 0. Wins: 0.
Player ChrisNola does not show cards.Bets: 1. Collects: 0. Loses: 1.
Player Parcker does not show cards.Bets: 0.25. Collects: 0. Loses: 0.25.
Player FirstClan does not show cards.Bets: 1. Collects: 0. Loses: 1.
Game ended at: 2016/11/21 11:49:0

Game started
Game ID: 780996790 0.25/0.50 (PRR) Garuda (Short) (Hold'em)
Seat 6 is the button
Seat 1: haroldbb (32.28).
Seat 2: sr86 (48.46).
Seat 3: IlxxxlI (23.93).
Seat 4: hotshothotgg (21.71).
Seat 6: parmele (27.70).
Seat 7: ChrisNola (43.37).
Seat 8: Parcker (26.50).
Seat 9: FirstClan (32.70).
Player ChrisNola has small blind (0.25)
Player Parcker has big blind (0.50)
Player IlxxxlI received card: [Jh]
Player IlxxxlI received card: [Qs]
Player FirstClan folds
Player haroldbb folds
Player sr86 raises (1)
Player IlxxxlI folds
Player hotshothotgg folds
Player parmele folds
Player ChrisNola calls (0.75)
Player Parcker folds
*** FLOP ***: [Kc Qh Jc]
Player ChrisNola checks
Player sr86 bets (1.50)
Player ChrisNola folds
Uncalled bet (1.50) returned to sr86
Player sr86 mucks cards
------ Summary ------
Pot: 2.38. Rake 0.08. JP fee 0.04
Board: [Kc Qh Jc]
Player haroldbb does not show cards.Bets: 0. Collects: 0. Wins: 0.
*Player sr86 mucks (does not show cards). Bets: 1. Collects: 2.38. Wins: 1.38.
Player IlxxxlI does not show cards.Bets: 0. Collects: 0. Wins: 0.
Player hotshothotgg does not show cards.Bets: 0. Collects: 0. Wins: 0.
Player parmele does not show cards.Bets: 0. Collects: 0. Wins: 0.
Player ChrisNola does not show cards.Bets: 1. Collects: 0. Loses: 1.
Player Parcker does not show cards.Bets: 0.50. Collects: 0. Loses: 0.50.
Player FirstClan does not show cards.Bets: 0. Collects: 0. Wins: 0.
Game ended at: 2016/11/21 11:47:42

Game started
Game ID: 780995843 0.25/0.50 (PRR) Garuda (Short) (Hold'em)
Seat 4 is the button
Seat 1: haroldbb (32.28).
Seat 2: sr86 (26).
Seat 3: IlxxxlI (23.93).
Seat 4: hotshothotgg (21.71).
Seat 5: Brucelegend (24.42).
Seat 6: parmele (28.20).
Seat 7: ChrisNola (43.37).
Seat 8: Parcker (26.50).
Seat 9: FirstClan (32.70).
Player Brucelegend has small blind (0.25)
Player parmele has big blind (0.50)
Player IlxxxlI received card: [10h]
Player IlxxxlI received card: [4s]
Player ChrisNola folds
Player Parcker folds
Player FirstClan folds
Player haroldbb folds
Player sr86 raises (1)
Player IlxxxlI folds
Player hotshothotgg folds
Player Brucelegend raises (2.75)
Player parmele folds
Player sr86 calls (2)
*** FLOP ***: [9s 3s Ac]
Player Brucelegend bets (4.12)
Player sr86 calls (4.12)
*** TURN ***: [9s 3s Ac] [4c]
Player Brucelegend bets (9.34)
Player sr86 raises (18.68)
Player Brucelegend allin (7.96)
Uncalled bet (1.38) returned to sr86
*** RIVER ***: [9s 3s Ac 4c] [Jc]
------ Summary ------
Pot: 46.88. Rake 2.22. JP fee 0.24
Board: [9s 3s Ac 4c Jc]
Player haroldbb does not show cards.Bets: 0. Collects: 0. Wins: 0.
*Player sr86 shows: Three Of Kind of 9s [9h 9d]. Bets: 24.42. Collects: 46.88. Wins: 22.46.
Player IlxxxlI does not show cards.Bets: 0. Collects: 0. Wins: 0.
Player hotshothotgg does not show cards.Bets: 0. Collects: 0. Wins: 0.
Player Brucelegend shows: One pair of As [As Qs]. Bets: 24.42. Collects: 0. Loses: 24.42.
Player parmele does not show cards.Bets: 0.50. Collects: 0. Loses: 0.50.
Player ChrisNola does not show cards.Bets: 0. Collects: 0. Wins: 0.
Player Parcker does not show cards.Bets: 0. Collects: 0. Wins: 0.
Player FirstClan does not show cards.Bets: 0. Collects: 0. Wins: 0.
Game ended at: 2016/11/21 11:46:21

Game started
Game ID: 780994837 0.25/0.50 (PRR) Garuda (Short) (Hold'em)
Seat 3 is the button
Seat 1: haroldbb (25).
Seat 2: sr86 (26).
Seat 3: IlxxxlI (23.93).
Seat 4: hotshothotgg (21.96).
Seat 5: Brucelegend (24.92).
Seat 6: parmele (28.20).
Seat 7: ChrisNola (50.66).
Seat 8: Parcker (26.50).
Seat 9: FirstClan (32.70).
Player hotshothotgg has small blind (0.25)
Player Brucelegend has big blind (0.50)
Player IlxxxlI received card: [Ad]
Player IlxxxlI received card: [3h]
Player parmele folds
Player ChrisNola calls (0.50)
Player Parcker folds
Player FirstClan folds
Player haroldbb raises (2.50)
Player sr86 folds
Player IlxxxlI folds
Player hotshothotgg folds
Player Brucelegend folds
Player ChrisNola calls (2)
*** FLOP ***: [2s 5h 5c]
Player ChrisNola checks
Player haroldbb bets (1.82)
Player ChrisNola calls (1.82)
*** TURN ***: [2s 5h 5c] [Jd]
Player ChrisNola checks
Player haroldbb bets (2.97)
Player ChrisNola calls (2.97)
*** RIVER ***: [2s 5h 5c Jd] [5s]
Player ChrisNola checks
Player haroldbb bets (14)
Player ChrisNola folds
Uncalled bet (14) returned to haroldbb
Player haroldbb mucks cards
------ Summary ------
Pot: 14.57. Rake 0.52. JP fee 0.24
Board: [2s 5h 5c Jd 5s]
*Player haroldbb mucks (does not show cards). Bets: 7.29. Collects: 14.57. Wins: 7.28.
Player sr86 does not show cards.Bets: 0. Collects: 0. Wins: 0.
Player IlxxxlI does not show cards.Bets: 0. Collects: 0. Wins: 0.
Player hotshothotgg does not show cards.Bets: 0.25. Collects: 0. Loses: 0.25.
Player Brucelegend does not show cards.Bets: 0.50. Collects: 0. Loses: 0.50.
Player parmele does not show cards.Bets: 0. Collects: 0. Wins: 0.
Player ChrisNola does not show cards.Bets: 7.29. Collects: 0. Loses: 7.29.
Player Parcker does not show cards.Bets: 0. Collects: 0. Wins: 0.
Player FirstClan does not show cards.Bets: 0. Collects: 0. Wins: 0.
Game ended at: 2016/11/21 11:45:8

Game started
Game ID: 780993211 0.25/0.50 (PRR) Garuda (Short) (Hold'em)
Seat 2 is the button
Seat 1: haroldbb (25).
Seat 2: sr86 (26).
Seat 3: IlxxxlI (24.18).
Seat 4: hotshothotgg (17.59).
Seat 5: Brucelegend (24.92).
Seat 6: parmele (28.20).
Seat 7: ChrisNola (50.66).
Seat 8: Parcker (26.50).
Seat 9: FirstClan (35.70).
Player IlxxxlI has small blind (0.25)
Player hotshothotgg has big blind (0.50)
Player IlxxxlI received card: [5c]
Player IlxxxlI received card: [10c]
Player Brucelegend folds
Player parmele folds
Player ChrisNola folds
Player Parcker folds
Player FirstClan raises (1.50)
Player haroldbb calls (1.50)
Player sr86 folds
Player IlxxxlI folds
Player hotshothotgg calls (1)
*** FLOP ***: [4s Ah 9s]
Player hotshothotgg bets (1.50)
Player FirstClan calls (1.50)
Player haroldbb folds
*** TURN ***: [4s Ah 9s] [7h]
Player hotshothotgg bets (3.68)
Player FirstClan folds
Uncalled bet (3.68) returned to hotshothotgg
Player hotshothotgg mucks cards
------ Summary ------
Pot: 7.37. Rake 0.26. JP fee 0.12
Board: [4s Ah 9s 7h]
Player haroldbb does not show cards.Bets: 1.50. Collects: 0. Loses: 1.50.
Player sr86 does not show cards.Bets: 0. Collects: 0. Wins: 0.
Player IlxxxlI does not show cards.Bets: 0.25. Collects: 0. Loses: 0.25.
*Player hotshothotgg mucks (does not show cards). Bets: 3. Collects: 7.37. Wins: 4.37.
Player Brucelegend does not show cards.Bets: 0. Collects: 0. Wins: 0.
Player parmele does not show cards.Bets: 0. Collects: 0. Wins: 0.
Player ChrisNola does not show cards.Bets: 0. Collects: 0. Wins: 0.
Player Parcker does not show cards.Bets: 0. Collects: 0. Wins: 0.
Player FirstClan does not show cards.Bets: 3. Collects: 0. Loses: 3.
Game ended at: 2016/11/21 11:43:51

Game started
Game ID: 780992426 0.25/0.50 (PRR) Garuda (Short) (Hold'em)
Seat 1 is the button
Seat 1: haroldbb (27.67).
Seat 2: sr86 (26.25).
Seat 3: IlxxxlI (24.68).
Seat 4: hotshothotgg (17.59).
Seat 5: Brucelegend (24.92).
Seat 6: parmele (28.20).
Seat 7: ChrisNola (38.85).
Seat 8: Parcker (26.50).
Seat 9: FirstClan (35.70).
Player sr86 has small blind (0.25)
Player IlxxxlI has big blind (0.50)
Player IlxxxlI received card: [10c]
Player IlxxxlI received card: [7h]
Player hotshothotgg folds
Player Brucelegend folds
Player parmele folds
Player ChrisNola raises (1)
Player Parcker folds
Player FirstClan folds
Player haroldbb raises (2.50)
Player sr86 folds
Player IlxxxlI folds
Player ChrisNola calls (1.50)
*** FLOP ***: [Jh Kh 5d]
Player ChrisNola checks
Player haroldbb bets (2.73)
Player ChrisNola calls (2.73)
*** TURN ***: [Jh Kh 5d] [8c]
Player ChrisNola checks
Player haroldbb checks
*** RIVER ***: [Jh Kh 5d 8c] [7s]
Player ChrisNola bets (7.10)
Player haroldbb calls (7.10)
Player haroldbb mucks cards
------ Summary ------
Pot: 24.14. Rake 1.03. JP fee 0.24
Board: [Jh Kh 5d 8c 7s]
Player haroldbb mucks (does not show cards). Bets: 12.33. Collects: 0. Loses: 12.33.
Player sr86 does not show cards.Bets: 0.25. Collects: 0. Loses: 0.25.
Player IlxxxlI does not show cards.Bets: 0.50. Collects: 0. Loses: 0.50.
Player hotshothotgg does not show cards.Bets: 0. Collects: 0. Wins: 0.
Player Brucelegend does not show cards.Bets: 0. Collects: 0. Wins: 0.
Player parmele does not show cards.Bets: 0. Collects: 0. Wins: 0.
*Player ChrisNola shows: One pair of Ks [Qd Kd]. Bets: 12.33. Collects: 24.14. Wins: 11.81.
Player Parcker does not show cards.Bets: 0. Collects: 0. Wins: 0.
Player FirstClan does not show cards.Bets: 0. Collects: 0. Wins: 0.
Game ended at: 2016/11/21 11:41:40

Game started
Game ID: 780991009 0.25/0.50 (PRR) Garuda (Short) (Hold'em)
Seat 9 is the button
Seat 1: haroldbb (27.92).
Seat 2: sr86 (27.75).
Seat 3: IlxxxlI (21.66).
Seat 4: hotshothotgg (17.59).
Seat 5: Brucelegend (24.92).
Seat 6: parmele (28.20).
Seat 7: ChrisNola (40.35).
Seat 8: Parcker (26.50).
Seat 9: FirstClan (35.70).
Player haroldbb has small blind (0.25)
Player sr86 has big blind (0.50)
Player IlxxxlI received card: [Kc]
Player IlxxxlI received card: [Qd]
Player IlxxxlI raises (1.50)
Player hotshothotgg folds
Player Brucelegend folds
Player parmele folds
Player ChrisNola calls (1.50)
Player Parcker folds
Player FirstClan folds
Player haroldbb folds
Player sr86 calls (1)
*** FLOP ***: [3h Kd Jh]
Player sr86 checks
Player IlxxxlI checks
Player ChrisNola checks
*** TURN ***: [3h Kd Jh] [3s]
Player sr86 checks
Player IlxxxlI bets (4)
Player ChrisNola folds
Player sr86 folds
Uncalled bet (4) returned to IlxxxlI
Player IlxxxlI mucks cards
------ Summary ------
Pot: 4.52. Rake 0.17. JP fee 0.06
Board: [3h Kd Jh 3s]
Player haroldbb does not show cards.Bets: 0.25. Collects: 0. Loses: 0.25.
Player sr86 does not show cards.Bets: 1.50. Collects: 0. Loses: 1.50.
*Player IlxxxlI mucks (does not show cards). Bets: 1.50. Collects: 4.52. Wins: 3.02.
Player hotshothotgg does not show cards.Bets: 0. Collects: 0. Wins: 0.
Player Brucelegend does not show cards.Bets: 0. Collects: 0. Wins: 0.
Player parmele does not show cards.Bets: 0. Collects: 0. Wins: 0.
Player ChrisNola does not show cards.Bets: 1.50. Collects: 0. Loses: 1.50.
Player Parcker does not show cards.Bets: 0. Collects: 0. Wins: 0.
Player FirstClan does not show cards.Bets: 0. Collects: 0. Wins: 0.
Game ended at: 2016/11/21 11:40:41

Game started
Game ID: 780989555 0.25/0.50 (PRR) Garuda (Short) (Hold'em)
Seat 8 is the button
Seat 1: haroldbb (28.42).
Seat 2: sr86 (27.75).
Seat 3: IlxxxlI (21.66).
Seat 4: hotshothotgg (17.59).
Seat 5: Brucelegend (24.92).
Seat 6: parmele (28.70).
Seat 7: ChrisNola (51.18).
Seat 8: Parcker (26.50).
Seat 9: FirstClan (25).
Player FirstClan has small blind (0.25)
Player haroldbb has big blind (0.50)
Player IlxxxlI received card: [7c]
Player IlxxxlI received card: [3h]
Player sr86 folds
Player IlxxxlI folds
Player hotshothotgg folds
Player Brucelegend folds
Player parmele calls (0.50)
Player ChrisNola calls (0.50)
Player Parcker folds
Player FirstClan calls (0.25)
Player haroldbb checks
*** FLOP ***: [10s 2s Kc]
Player FirstClan checks
Player haroldbb checks
Player parmele checks
Player ChrisNola bets (1.50)
Player FirstClan calls (1.50)
Player haroldbb folds
Player parmele folds
*** TURN ***: [10s 2s Kc] [6s]
Player FirstClan checks
Player ChrisNola bets (2.50)
Player FirstClan calls (2.50)
*** RIVER ***: [10s 2s Kc 6s] [Ac]
Player FirstClan bets (6.33)
Player ChrisNola calls (6.33)
Player ChrisNola mucks cards
------ Summary ------
Pot: 21.53. Rake 0.89. JP fee 0.24
Board: [10s 2s Kc 6s Ac]
Player haroldbb does not show cards.Bets: 0.50. Collects: 0. Loses: 0.50.
Player sr86 does not show cards.Bets: 0. Collects: 0. Wins: 0.
Player IlxxxlI does not show cards.Bets: 0. Collects: 0. Wins: 0.
Player hotshothotgg does not show cards.Bets: 0. Collects: 0. Wins: 0.
Player Brucelegend does not show cards.Bets: 0. Collects: 0. Wins: 0.
Player parmele does not show cards.Bets: 0.50. Collects: 0. Loses: 0.50.
Player ChrisNola mucks (does not show cards). Bets: 10.83. Collects: 0. Loses: 10.83.
Player Parcker does not show cards.Bets: 0. Collects: 0. Wins: 0.
*Player FirstClan shows: Straight to A [Js Qd]. Bets: 10.83. Collects: 21.53. Wins: 10.70.
Game ended at: 2016/11/21 11:38:49

Game started
Game ID: 780988859 0.25/0.50 (PRR) Garuda (Short) (Hold'em)
Seat 7 is the button
Seat 1: haroldbb (28.42).
Seat 2: sr86 (27.75).
Seat 3: IlxxxlI (21.66).
Seat 4: hotshothotgg (18.59).
Seat 5: Brucelegend (24.92).
Seat 6: parmele (28.70).
Seat 7: ChrisNola (51.18).
Seat 8: Parcker (25).
Seat 9: FirstClan (25.25).
Player Parcker has small blind (0.25)
Player FirstClan has big blind (0.50)
Player IlxxxlI received card: [5h]
Player IlxxxlI received card: [4c]
Player haroldbb folds
Player sr86 folds
Player IlxxxlI folds
Player hotshothotgg raises (1)
Player Brucelegend folds
Player parmele folds
Player ChrisNola folds
Player Parcker allin (24.75)
Player FirstClan folds
Player hotshothotgg folds
Uncalled bet (24) returned to Parcker
Player Parcker mucks cards
------ Summary ------
Pot: 2.50. Rake 0
Player haroldbb does not show cards.Bets: 0. Collects: 0. Wins: 0.
Player sr86 does not show cards.Bets: 0. Collects: 0. Wins: 0.
Player IlxxxlI does not show cards.Bets: 0. Collects: 0. Wins: 0.
Player hotshothotgg does not show cards.Bets: 1. Collects: 0. Loses: 1.
Player Brucelegend does not show cards.Bets: 0. Collects: 0. Wins: 0.
Player parmele does not show cards.Bets: 0. Collects: 0. Wins: 0.
Player ChrisNola does not show cards.Bets: 0. Collects: 0. Wins: 0.
*Player Parcker mucks (does not show cards). Bets: 1. Collects: 2.50. Wins: 1.50.
Player FirstClan does not show cards.Bets: 0.50. Collects: 0. Loses: 0.50.
Game ended at: 2016/11/21 11:37:1

Game started
Game ID: 780987640 0.25/0.50 (PRR) Garuda (Short) (Hold'em)
Seat 6 is the button
Seat 1: haroldbb (28.42).
Seat 2: sr86 (25).
Seat 3: IlxxxlI (21.66).
Seat 4: hotshothotgg (18.59).
Seat 5: Brucelegend (25.17).
Seat 6: parmele (30.70).
Seat 7: ChrisNola (51.43).
Seat 8: Parcker (25).
Seat 9: FirstClan (25.25).
Player ChrisNola has small blind (0.25)
Player Parcker has big blind (0.50)
Player Brucelegend posts (0.25)
Player IlxxxlI received card: [7h]
Player IlxxxlI received card: [As]
Player FirstClan folds
Player haroldbb folds
Player sr86 raises (2)
Player IlxxxlI folds
Player hotshothotgg folds
Player Brucelegend folds
Player parmele calls (2)
Player ChrisNola folds
Player Parcker folds
*** FLOP ***: [10s 10h Qs]
Player sr86 checks
Player parmele checks
*** TURN ***: [10s 10h Qs] [5h]
Player sr86 bets (3)
Player parmele folds
Uncalled bet (3) returned to sr86
Player sr86 mucks cards
------ Summary ------
Pot: 4.75. Rake 0.17. JP fee 0.08
Board: [10s 10h Qs 5h]
Player haroldbb does not show cards.Bets: 0. Collects: 0. Wins: 0.
*Player sr86 mucks (does not show cards). Bets: 2. Collects: 4.75. Wins: 2.75.
Player IlxxxlI does not show cards.Bets: 0. Collects: 0. Wins: 0.
Player hotshothotgg does not show cards.Bets: 0. Collects: 0. Wins: 0.
Player Brucelegend does not show cards.Bets: 0.25. Collects: 0. Loses: 0.25.
Player parmele does not show cards.Bets: 2. Collects: 0. Loses: 2.
Player ChrisNola does not show cards.Bets: 0.25. Collects: 0. Loses: 0.25.
Player Parcker does not show cards.Bets: 0.50. Collects: 0. Loses: 0.50.
Player FirstClan does not show cards.Bets: 0. Collects: 0. Wins: 0.
Game ended at: 2016/11/21 11:36:7

Game started
Game ID: 780985996 0.25/0.50 (PRR) Garuda (Short) (Hold'em)
Seat 4 is the button
Seat 1: haroldbb (28.42).
Seat 2: sr86 (25).
Seat 3: IlxxxlI (21.66).
Seat 4: hotshothotgg (24.25).
Seat 6: parmele (23.70).
Seat 7: ChrisNola (51.93).
Seat 9: FirstClan (26.75).
Player parmele has small blind (0.25)
Player ChrisNola has big blind (0.50)
Player IlxxxlI received card: [5d]
Player IlxxxlI received card: [8d]
Player FirstClan raises (1.50)
Player haroldbb folds
Player sr86 folds
Player IlxxxlI folds
Player hotshothotgg calls (1.50)
Player parmele calls (1.25)
Player ChrisNola folds
*** FLOP ***: [10d 8c Jh]
Player parmele checks
Player FirstClan checks
Player hotshothotgg bets (1.58)
Player parmele calls (1.58)
Player FirstClan folds
*** TURN ***: [10d 8c Jh] [Js]
Player parmele checks
Player hotshothotgg bets (2.58)
Player parmele calls (2.58)
*** RIVER ***: [10d 8c Jh Js] [Qs]
Player parmele bets (6.33)
Player hotshothotgg folds
Uncalled bet (6.33) returned to parmele
Player parmele mucks cards
------ Summary ------
Pot: 12.66. Rake 0.44. JP fee 0.22
Board: [10d 8c Jh Js Qs]
Player haroldbb does not show cards.Bets: 0. Collects: 0. Wins: 0.
Player sr86 does not show cards.Bets: 0. Collects: 0. Wins: 0.
Player IlxxxlI does not show cards.Bets: 0. Collects: 0. Wins: 0.
Player hotshothotgg does not show cards.Bets: 5.66. Collects: 0. Loses: 5.66.
*Player parmele mucks (does not show cards). Bets: 5.66. Collects: 12.66. Wins: 7.
Player ChrisNola does not show cards.Bets: 0.50. Collects: 0. Loses: 0.50.
Player FirstClan does not show cards.Bets: 1.50. Collects: 0. Loses: 1.50.
Game ended at: 2016/11/21 11:34:35

Game started
Game ID: 780985261 0.25/0.50 (PRR) Garuda (Short) (Hold'em)
Seat 3 is the button
Seat 1: haroldbb (28.42).
Seat 2: sr86 (25).
Seat 3: IlxxxlI (20.91).
Seat 4: hotshothotgg (24.50).
Seat 5: Brucelegend (25.67).
Seat 6: parmele (23.70).
Seat 7: ChrisNola (51.93).
Seat 9: FirstClan (26.75).
Player hotshothotgg has small blind (0.25)
Player Brucelegend has big blind (0.50)
Player IlxxxlI received card: [5h]
Player IlxxxlI received card: [5d]
Player parmele folds
Player ChrisNola folds
Player FirstClan folds
Player haroldbb folds
Player sr86 folds
Player IlxxxlI raises (1.50)
Player hotshothotgg folds
Player Brucelegend is timed out.
Player Brucelegend folds
Uncalled bet (1) returned to IlxxxlI
Player IlxxxlI mucks cards
------ Summary ------
Pot: 1.25. Rake 0
Player haroldbb does not show cards.Bets: 0. Collects: 0. Wins: 0.
Player sr86 does not show cards.Bets: 0. Collects: 0. Wins: 0.
*Player IlxxxlI mucks (does not show cards). Bets: 0.50. Collects: 1.25. Wins: 0.75.
Player hotshothotgg does not show cards.Bets: 0.25. Collects: 0. Loses: 0.25.
Player Brucelegend does not show cards.Bets: 0.50. Collects: 0. Loses: 0.50.
Player parmele does not show cards.Bets: 0. Collects: 0. Wins: 0.
Player ChrisNola does not show cards.Bets: 0. Collects: 0. Wins: 0.
Player FirstClan does not show cards.Bets: 0. Collects: 0. Wins: 0.
Game ended at: 2016/11/21 11:32:32

Game started
Game ID: 780983732 0.25/0.50 (PRR) Garuda (Short) (Hold'em)
Seat 2 is the button
Seat 1: haroldbb (28.42).
Seat 2: sr86 (25).
Seat 3: IlxxxlI (19.51).
Seat 4: hotshothotgg (25).
Seat 5: Brucelegend (26.17).
Seat 6: parmele (23.70).
Seat 7: ChrisNola (52.43).
Seat 9: FirstClan (26.75).
Player IlxxxlI has small blind (0.25)
Player hotshothotgg has big blind (0.50)
Player IlxxxlI received card: [Ac]
Player IlxxxlI received card: [9s]
Player Brucelegend calls (0.50)
Player parmele folds
Player ChrisNola calls (0.50)
Player FirstClan folds
Player haroldbb folds
Player sr86 folds
Player IlxxxlI calls (0.25)
Player hotshothotgg checks
*** FLOP ***: [8s Qh 2s]
Player IlxxxlI checks
Player hotshothotgg checks
Player Brucelegend is timed out.
Player Brucelegend checks
Player ChrisNola checks
*** TURN ***: [8s Qh 2s] [As]
Player IlxxxlI checks
Player hotshothotgg checks
Player Brucelegend checks
Player ChrisNola checks
*** RIVER ***: [8s Qh 2s As] [Qd]
Player IlxxxlI checks
Player hotshothotgg checks
Player Brucelegend is timed out.
Player Brucelegend checks
Player ChrisNola checks
Player hotshothotgg mucks cards
Player Brucelegend mucks cards
Player ChrisNola mucks cards
------ Summary ------
Pot: 1.90. Rake 0.08. JP fee 0.02
Board: [8s Qh 2s As Qd]
Player haroldbb does not show cards.Bets: 0. Collects: 0. Wins: 0.
Player sr86 does not show cards.Bets: 0. Collects: 0. Wins: 0.
*Player IlxxxlI shows: Two pairs. As and Qs [Ac 9s]. Bets: 0.50. Collects: 1.90. Wins: 1.40.
Player hotshothotgg mucks (does not show cards). Bets: 0.50. Collects: 0. Loses: 0.50.
Player Brucelegend mucks (does not show cards). Bets: 0.50. Collects: 0. Loses: 0.50.
Player parmele does not show cards.Bets: 0. Collects: 0. Wins: 0.
Player ChrisNola mucks (does not show cards). Bets: 0.50. Collects: 0. Loses: 0.50.
Player FirstClan does not show cards.Bets: 0. Collects: 0. Wins: 0.
Game ended at: 2016/11/21 11:31:34

Game started
Game ID: 780982869 0.25/0.50 (PRR) Garuda (Short) (Hold'em)
Seat 1 is the button
Seat 1: haroldbb (28.42).
Seat 2: sr86 (25.25).
Seat 3: IlxxxlI (20.01).
Seat 5: Brucelegend (26.67).
Seat 6: parmele (23.70).
Seat 7: ChrisNola (52.93).
Seat 9: FirstClan (25).
Player sr86 has small blind (0.25)
Player IlxxxlI has big blind (0.50)
Player IlxxxlI received card: [3d]
Player IlxxxlI received card: [As]
Player Brucelegend calls (0.50)
Player parmele folds
Player ChrisNola calls (0.50)
Player FirstClan raises (3)
Player haroldbb folds
Player sr86 folds
Player IlxxxlI folds
Player Brucelegend folds
Player ChrisNola folds
Uncalled bet (2.50) returned to FirstClan
Player FirstClan mucks cards
------ Summary ------
Pot: 2.25. Rake 0
Player haroldbb does not show cards.Bets: 0. Collects: 0. Wins: 0.
Player sr86 does not show cards.Bets: 0.25. Collects: 0. Loses: 0.25.
Player IlxxxlI does not show cards.Bets: 0.50. Collects: 0. Loses: 0.50.
Player Brucelegend does not show cards.Bets: 0.50. Collects: 0. Loses: 0.50.
Player parmele does not show cards.Bets: 0. Collects: 0. Wins: 0.
Player ChrisNola does not show cards.Bets: 0.50. Collects: 0. Loses: 0.50.
*Player FirstClan mucks (does not show cards). Bets: 0.50. Collects: 2.25. Wins: 1.75.
Game ended at: 2016/11/21 11:29:48

Game started
Game ID: 780981764 0.25/0.50 (PRR) Garuda (Short) (Hold'em)
Seat 9 is the button
Seat 1: haroldbb (28.67).
Seat 2: sr86 (25.75).
Seat 3: IlxxxlI (20.01).
Seat 5: Brucelegend (26.67).
Seat 6: parmele (23.70).
Seat 7: ChrisNola (49.96).
Seat 9: FirstClan (25.44).
Player haroldbb has small blind (0.25)
Player sr86 has big blind (0.50)
Player IlxxxlI received card: [3c]
Player IlxxxlI received card: [6h]
Player IlxxxlI folds
Player Brucelegend folds
Player parmele folds
Player ChrisNola calls (0.50)
Player FirstClan raises (2.50)
Player haroldbb folds
Player sr86 folds
Player ChrisNola calls (2)
*** FLOP ***: [9d 2c 4s]
Player ChrisNola bets (4)
Player FirstClan folds
Uncalled bet (4) returned to ChrisNola
Player ChrisNola mucks cards
------ Summary ------
Pot: 5.47. Rake 0.20. JP fee 0.08
Board: [9d 2c 4s]
Player haroldbb does not show cards.Bets: 0.25. Collects: 0. Loses: 0.25.
Player sr86 does not show cards.Bets: 0.50. Collects: 0. Loses: 0.50.
Player IlxxxlI does not show cards.Bets: 0. Collects: 0. Wins: 0.
Player Brucelegend does not show cards.Bets: 0. Collects: 0. Wins: 0.
Player parmele does not show cards.Bets: 0. Collects: 0. Wins: 0.
*Player ChrisNola mucks (does not show cards). Bets: 2.50. Collects: 5.47. Wins: 2.97.
Player FirstClan does not show cards.Bets: 2.50. Collects: 0. Loses: 2.50.
Game ended at: 2016/11/21 11:28:46

Game started
Game ID: 780981280 0.25/0.50 (PRR) Garuda (Short) (Hold'em)
Seat 7 is the button
Seat 1: haroldbb (29.17).
Seat 2: sr86 (25.75).
Seat 3: IlxxxlI (20.01).
Seat 6: parmele (22.95).
Seat 7: ChrisNola (49.96).
Seat 9: FirstClan (25.69).
Player FirstClan has small blind (0.25)
Player haroldbb has big blind (0.50)
Player IlxxxlI received card: [6h]
Player IlxxxlI received card: [10h]
Player sr86 folds
Player IlxxxlI folds
Player parmele raises (1.50)
Player ChrisNola folds
Player FirstClan folds
Player haroldbb folds
Uncalled bet (1) returned to parmele
Player parmele mucks cards
------ Summary ------
Pot: 1.25. Rake 0
Player haroldbb does not show cards.Bets: 0.50. Collects: 0. Loses: 0.50.
Player sr86 does not show cards.Bets: 0. Collects: 0. Wins: 0.
Player IlxxxlI does not show cards.Bets: 0. Collects: 0. Wins: 0.
*Player parmele mucks (does not show cards). Bets: 0.50. Collects: 1.25. Wins: 0.75.
Player ChrisNola does not show cards.Bets: 0. Collects: 0. Wins: 0.
Player FirstClan does not show cards.Bets: 0.25. Collects: 0. Loses: 0.25.
Game ended at: 2016/11/21 11:27:24

Game started
Game ID: 780980695 0.25/0.50 (PRR) Garuda (Short) (Hold'em)
Seat 6 is the button
Seat 2: sr86 (25.75).
Seat 3: IlxxxlI (20.01).
Seat 6: parmele (23.45).
Seat 7: ChrisNola (50.21).
Seat 9: FirstClan (25).
Player ChrisNola has small blind (0.25)
Player FirstClan has big blind (0.50)
Player IlxxxlI received card: [7s]
Player IlxxxlI received card: [10c]
Player sr86 folds
Player IlxxxlI folds
Player parmele calls (0.50)
Player ChrisNola folds
Player FirstClan checks
*** FLOP ***: [7h Qc 2c]
Player FirstClan bets (0.50)
Player parmele folds
Uncalled bet (0.50) returned to FirstClan
Player FirstClan mucks cards
------ Summary ------
Pot: 1.19. Rake 0.04. JP fee 0.02
Board: [7h Qc 2c]
Player sr86 does not show cards.Bets: 0. Collects: 0. Wins: 0.
Player IlxxxlI does not show cards.Bets: 0. Collects: 0. Wins: 0.
Player parmele does not show cards.Bets: 0.50. Collects: 0. Loses: 0.50.
Player ChrisNola does not show cards.Bets: 0.25. Collects: 0. Loses: 0.25.
*Player FirstClan mucks (does not show cards). Bets: 0.50. Collects: 1.19. Wins: 0.69.
Game ended at: 2016/11/21 11:26:48

Game started
Game ID: 780980107 0.25/0.50 (PRR) Garuda (Short) (Hold'em)
Seat 3 is the button
Seat 2: sr86 (25).
Seat 3: IlxxxlI (20.01).
Seat 5: Brucelegend (26.92).
Seat 6: parmele (23.95).
Seat 7: ChrisNola (50.21).
Seat 8: iflopznuts (44.68).
Seat 9: FirstClan (25).
Player Brucelegend has small blind (0.25)
Player parmele has big blind (0.50)
Player IlxxxlI received card: [8c]
Player IlxxxlI received card: [2s]
Player ChrisNola folds
Player iflopznuts folds
Player FirstClan folds
Player sr86 raises (1)
Player IlxxxlI folds
Player Brucelegend is timed out.
Player Brucelegend folds
Player parmele folds
Uncalled bet (0.50) returned to sr86
Player sr86 mucks cards
------ Summary ------
Pot: 1.25. Rake 0
*Player sr86 mucks (does not show cards). Bets: 0.50. Collects: 1.25. Wins: 0.75.
Player IlxxxlI does not show cards.Bets: 0. Collects: 0. Wins: 0.
Player Brucelegend does not show cards.Bets: 0.25. Collects: 0. Loses: 0.25.
Player parmele does not show cards.Bets: 0.50. Collects: 0. Loses: 0.50.
Player ChrisNola does not show cards.Bets: 0. Collects: 0. Wins: 0.
Player iflopznuts does not show cards.Bets: 0. Collects: 0. Wins: 0.
Player FirstClan does not show cards.Bets: 0. Collects: 0. Wins: 0.
Game ended at: 2016/11/21 11:26:7

Game started
Game ID: 780978311 0.25/0.50 (PRR) Garuda (Short) (Hold'em)
Seat 2 is the button
Seat 2: sr86 (25).
Seat 3: IlxxxlI (20.26).
Seat 4: WICHONSKI (48.31).
Seat 5: Brucelegend (26.92).
Seat 6: parmele (16.48).
Seat 7: ChrisNola (50.21).
Seat 8: iflopznuts (52.18).
Seat 9: FirstClan (25).
Player IlxxxlI has small blind (0.25)
Player WICHONSKI has big blind (0.50)
Player IlxxxlI received card: [4c]
Player IlxxxlI received card: [4s]
Player Brucelegend is timed out.
Player Brucelegend folds
Player parmele raises (1.50)
Player ChrisNola is timed out.
Player ChrisNola folds
Player iflopznuts calls (1.50)
Player FirstClan folds
Player sr86 folds
Player IlxxxlI folds
Player WICHONSKI folds
*** FLOP ***: [Qd 3c 8c]
Player parmele bets (2)
Player iflopznuts calls (2)
*** TURN ***: [Qd 3c 8c] [6s]
Player parmele bets (4)
Player iflopznuts calls (4)
*** RIVER ***: [Qd 3c 8c 6s] [Ks]
Player parmele checks
Player iflopznuts checks
Player iflopznuts mucks cards
------ Summary ------
Pot: 14.97. Rake 0.54. JP fee 0.24
Board: [Qd 3c 8c 6s Ks]
Player sr86 does not show cards.Bets: 0. Collects: 0. Wins: 0.
Player IlxxxlI does not show cards.Bets: 0.25. Collects: 0. Loses: 0.25.
Player WICHONSKI does not show cards.Bets: 0.50. Collects: 0. Loses: 0.50.
Player Brucelegend does not show cards.Bets: 0. Collects: 0. Wins: 0.
*Player parmele shows: One pair of As [Ah Ad]. Bets: 7.50. Collects: 14.97. Wins: 7.47.
Player ChrisNola does not show cards.Bets: 0. Collects: 0. Wins: 0.
Player iflopznuts mucks (does not show cards). Bets: 7.50. Collects: 0. Loses: 7.50.
Player FirstClan does not show cards.Bets: 0. Collects: 0. Wins: 0.
Game ended at: 2016/11/21 11:25:23

Game started
Game ID: 780977570 0.25/0.50 (PRR) Garuda (Short) (Hold'em)
Seat 9 is the button
Seat 2: sr86 (25).
Seat 3: IlxxxlI (20.76).
Seat 4: WICHONSKI (49.31).
Seat 5: Brucelegend (25.30).
Seat 6: parmele (16.48).
Seat 7: ChrisNola (50.21).
Seat 8: iflopznuts (52.18).
Seat 9: FirstClan (25).
Player sr86 has small blind (0.25)
Player IlxxxlI has big blind (0.50)
Player WICHONSKI straddle (1)
Player IlxxxlI received card: [Kc]
Player IlxxxlI received card: [4s]
Player Brucelegend calls (1)
Player parmele folds
Player ChrisNola folds
Player iflopznuts folds
Player FirstClan folds
Player sr86 folds
Player IlxxxlI folds
Player WICHONSKI checks
*** FLOP ***: [8s As Ac]
Player WICHONSKI checks
Player Brucelegend bets (1.31)
Player WICHONSKI folds
Uncalled bet (1.31) returned to Brucelegend
Player Brucelegend mucks cards
------ Summary ------
Pot: 2.62. Rake 0.09. JP fee 0.04
Board: [8s As Ac]
Player sr86 does not show cards.Bets: 0.25. Collects: 0. Loses: 0.25.
Player IlxxxlI does not show cards.Bets: 0.50. Collects: 0. Loses: 0.50.
Player WICHONSKI does not show cards.Bets: 1. Collects: 0. Loses: 1.
*Player Brucelegend mucks (does not show cards). Bets: 1. Collects: 2.62. Wins: 1.62.
Player parmele does not show cards.Bets: 0. Collects: 0. Wins: 0.
Player ChrisNola does not show cards.Bets: 0. Collects: 0. Wins: 0.
Player iflopznuts does not show cards.Bets: 0. Collects: 0. Wins: 0.
Player FirstClan does not show cards.Bets: 0. Collects: 0. Wins: 0.
Game ended at: 2016/11/21 11:23:11

Game started
Game ID: 780976758 0.25/0.50 (PRR) Garuda (Short) (Hold'em)
Seat 8 is the button
Seat 1: haroldbb (29.17).
Seat 2: sr86 (25).
Seat 3: IlxxxlI (20.76).
Seat 4: WICHONSKI (50.81).
Seat 5: Brucelegend (25.30).
Seat 6: parmele (12.99).
Seat 7: ChrisNola (50.21).
Seat 8: iflopznuts (53.68).
Seat 9: FirstClan (25).
Player FirstClan has small blind (0.25)
Player haroldbb sitting out
Player sr86 has big blind (0.50)
Player IlxxxlI received card: [9s]
Player IlxxxlI received card: [4h]
Player IlxxxlI folds
Player WICHONSKI raises (1.50)
Player Brucelegend folds
Player parmele calls (1.50)
Player ChrisNola folds
Player iflopznuts calls (1.50)
Player FirstClan folds
Player sr86 folds
*** FLOP ***: [4d 6c 3d]
Player WICHONSKI checks
Player parmele checks
Player iflopznuts checks
*** TURN ***: [4d 6c 3d] [Qd]
Player WICHONSKI checks
Player parmele checks
Player iflopznuts checks
*** RIVER ***: [4d 6c 3d Qd] [10h]
Player WICHONSKI checks
Player parmele checks
Player iflopznuts checks
Player WICHONSKI mucks cards
Player iflopznuts mucks cards
------ Summary ------
Pot: 4.99. Rake 0.18. JP fee 0.08
Board: [4d 6c 3d Qd 10h]
Player haroldbb does not show cards.Bets: 0. Collects: 0. Wins: 0.
Player sr86 does not show cards.Bets: 0.50. Collects: 0. Loses: 0.50.
Player IlxxxlI does not show cards.Bets: 0. Collects: 0. Wins: 0.
Player WICHONSKI mucks (does not show cards). Bets: 1.50. Collects: 0. Loses: 1.50.
Player Brucelegend does not show cards.Bets: 0. Collects: 0. Wins: 0.
*Player parmele shows: High card A [As 8s]. Bets: 1.50. Collects: 4.99. Wins: 3.49.
Player ChrisNola does not show cards.Bets: 0. Collects: 0. Wins: 0.
Player iflopznuts mucks (does not show cards). Bets: 1.50. Collects: 0. Loses: 1.50.
Player FirstClan does not show cards.Bets: 0.25. Collects: 0. Loses: 0.25.
Game ended at: 2016/11/21 11:22:14

Game started
Game ID: 780976677 0.25/0.50 (PRR) Garuda (Hold'em)
Seat 2 is the button
Seat 1: Haid Dasalami (31.98).
Seat 2: BBDub27 (85.81).
Seat 3: sr86 (141.20).
Seat 4: johnnyboxx7 (46.25).
Seat 5: FirstClan (51.59).
Seat 6: IlxxxlI (36.84).
Seat 8: VegasMike420 (57.95).
Seat 9: solasso (28.04).
Player sr86 has small blind (0.25)
Player johnnyboxx7 has big blind (0.50)
Player IlxxxlI received card: [2h]
Player IlxxxlI received card: [9d]
Player FirstClan folds
Player IlxxxlI folds
Player VegasMike420 folds
Player solasso calls (0.50)
Player Haid Dasalami folds
Player BBDub27 folds
Player sr86 calls (0.25)
Player johnnyboxx7 checks
*** FLOP ***: [10h Qc Ac]
Player sr86 bets (1)
Player johnnyboxx7 raises (3)
Player solasso folds
Player sr86 calls (2)
*** TURN ***: [10h Qc Ac] [3s]
Player sr86 checks
Player johnnyboxx7 bets (5.50)
Player sr86 calls (5.50)
*** RIVER ***: [10h Qc Ac 3s] [10s]
Player sr86 checks
Player johnnyboxx7 checks
------ Summary ------
Pot: 17.58. Rake 0.68. JP fee 0.24
Board: [10h Qc Ac 3s 10s]
Player Haid Dasalami does not show cards.Bets: 0. Collects: 0. Wins: 0.
Player BBDub27 does not show cards.Bets: 0. Collects: 0. Wins: 0.
*Player sr86 shows: Two pairs. As and 10s [5c Ah]. Bets: 9. Collects: 8.79. Loses: 0.21.
*Player johnnyboxx7 shows: Two pairs. As and 10s [Ad 7d]. Bets: 9. Collects: 8.79. Loses: 0.21.
Player FirstClan does not show cards.Bets: 0. Collects: 0. Wins: 0.
Player IlxxxlI does not show cards.Bets: 0. Collects: 0. Wins: 0.
Player VegasMike420 does not show cards.Bets: 0. Collects: 0. Wins: 0.
Player solasso does not show cards.Bets: 0.50. Collects: 0. Loses: 0.50.
Game ended at: 2016/11/21 11:22:59

Game started
Game ID: 780975201 0.25/0.50 (PRR) Garuda (Hold'em)
Seat 1 is the button
Seat 1: Haid Dasalami (46.98).
Seat 2: BBDub27 (86.06).
Seat 3: sr86 (141.70).
Seat 4: johnnyboxx7 (46.25).
Seat 5: FirstClan (51.59).
Seat 6: IlxxxlI (36.84).
Seat 8: VegasMike420 (43.73).
Seat 9: solasso (28.04).
Player BBDub27 has small blind (0.25)
Player sr86 has big blind (0.50)
Player IlxxxlI received card: [Jc]
Player IlxxxlI received card: [Qd]
Player johnnyboxx7 folds
Player FirstClan folds
Player IlxxxlI folds
Player VegasMike420 raises (2)
Player solasso folds
Player Haid Dasalami calls (2)
Player BBDub27 folds
Player sr86 folds
*** FLOP ***: [6d 6s 3s]
Player VegasMike420 checks
Player Haid Dasalami bets (3)
Player VegasMike420 calls (3)
*** TURN ***: [6d 6s 3s] [10s]
Player VegasMike420 checks
Player Haid Dasalami bets (5)
Player VegasMike420 raises (10)
Player Haid Dasalami calls (5)
*** RIVER ***: [6d 6s 3s 10s] [Qs]
Player VegasMike420 bets (19.48)
Player Haid Dasalami folds
Uncalled bet (19.48) returned to VegasMike420
------ Summary ------
Pot: 29.22. Rake 1.29. JP fee 0.24
Board: [6d 6s 3s 10s Qs]
Player Haid Dasalami does not show cards.Bets: 15. Collects: 0. Loses: 15.
Player BBDub27 does not show cards.Bets: 0.25. Collects: 0. Loses: 0.25.
Player sr86 does not show cards.Bets: 0.50. Collects: 0. Loses: 0.50.
Player johnnyboxx7 does not show cards.Bets: 0. Collects: 0. Wins: 0.
Player FirstClan does not show cards.Bets: 0. Collects: 0. Wins: 0.
Player IlxxxlI does not show cards.Bets: 0. Collects: 0. Wins: 0.
*Player VegasMike420 shows: Full House (6/3) [6h 3h]. Bets: 15. Collects: 29.22. Wins: 14.22.
Player solasso does not show cards.Bets: 0. Collects: 0. Wins: 0.
Game ended at: 2016/11/21 11:21:9

Game started
Game ID: 780974775 0.25/0.50 (PRR) Garuda (Short) (Hold'em)
Seat 7 is the button
Seat 1: haroldbb (29.17).
Seat 2: sr86 (25).
Seat 3: IlxxxlI (20.76).
Seat 4: WICHONSKI (42.56).
Seat 5: Brucelegend (25.30).
Seat 6: parmele (12.99).
Seat 7: ChrisNola (51.71).
Seat 8: iflopznuts (60.73).
Seat 9: FirstClan (25).
Player iflopznuts has small blind (0.25)
Player FirstClan has big blind (0.50)
Player IlxxxlI received card: [3d]
Player IlxxxlI received card: [4h]
Player haroldbb folds
Player sr86 folds
Player IlxxxlI folds
Player WICHONSKI raises (1.50)
Player Brucelegend folds
Player parmele folds
Player ChrisNola calls (1.50)
Player iflopznuts calls (1.25)
Player FirstClan folds
*** FLOP ***: [9d Qc 7h]
Player iflopznuts checks
Player WICHONSKI bets (2.56)
Player ChrisNola folds
Player iflopznuts calls (2.56)
*** TURN ***: [9d Qc 7h] [7c]
Player iflopznuts checks
Player WICHONSKI bets (2.99)
Player iflopznuts calls (2.99)
*** RIVER ***: [9d Qc 7h 7c] [5d]
Player iflopznuts checks
Player WICHONSKI bets (14)
Player iflopznuts folds
Uncalled bet (14) returned to WICHONSKI
Player WICHONSKI mucks cards
------ Summary ------
Pot: 15.30. Rake 0.56. JP fee 0.24
Board: [9d Qc 7h 7c 5d]
Player haroldbb does not show cards.Bets: 0. Collects: 0. Wins: 0.
Player sr86 does not show cards.Bets: 0. Collects: 0. Wins: 0.
Player IlxxxlI does not show cards.Bets: 0. Collects: 0. Wins: 0.
*Player WICHONSKI mucks (does not show cards). Bets: 7.05. Collects: 15.30. Wins: 8.25.
Player Brucelegend does not show cards.Bets: 0. Collects: 0. Wins: 0.
Player parmele does not show cards.Bets: 0. Collects: 0. Wins: 0.
Player ChrisNola does not show cards.Bets: 1.50. Collects: 0. Loses: 1.50.
Player iflopznuts does not show cards.Bets: 7.05. Collects: 0. Loses: 7.05.
Player FirstClan does not show cards.Bets: 0.50. Collects: 0. Loses: 0.50.
Game ended at: 2016/11/21 11:21:15

Game started
Game ID: 780974518 0.25/0.50 (PRR) Garuda (Short) (Hold'em)
Seat 6 is the button
Seat 1: haroldbb (29.17).
Seat 2: sr86 (25).
Seat 3: IlxxxlI (20.76).
Seat 4: WICHONSKI (42.56).
Seat 5: Brucelegend (25.30).
Seat 6: parmele (12.99).
Seat 7: ChrisNola (51.96).
Seat 8: iflopznuts (60.48).
Seat 9: FirstClan (25).
Player ChrisNola has small blind (0.25)
Player iflopznuts has big blind (0.50)
Player IlxxxlI received card: [10h]
Player IlxxxlI received card: [3h]
Player FirstClan folds
Player haroldbb folds
Player sr86 folds
Player IlxxxlI folds
Player WICHONSKI folds
Player Brucelegend folds
Player parmele folds
Player ChrisNola folds
Uncalled bet (0.25) returned to iflopznuts
Player iflopznuts mucks cards
------ Summary ------
Pot: 0.50. Rake 0
Player haroldbb does not show cards.Bets: 0. Collects: 0. Wins: 0.
Player sr86 does not show cards.Bets: 0. Collects: 0. Wins: 0.
Player IlxxxlI does not show cards.Bets: 0. Collects: 0. Wins: 0.
Player WICHONSKI does not show cards.Bets: 0. Collects: 0. Wins: 0.
Player Brucelegend does not show cards.Bets: 0. Collects: 0. Wins: 0.
Player parmele does not show cards.Bets: 0. Collects: 0. Wins: 0.
Player ChrisNola does not show cards.Bets: 0.25. Collects: 0. Loses: 0.25.
*Player iflopznuts mucks (does not show cards). Bets: 0.25. Collects: 0.50. Wins: 0.25.
Player FirstClan does not show cards.Bets: 0. Collects: 0. Wins: 0.
Game ended at: 2016/11/21 11:18:54

Game started
Game ID: 780974330 0.25/0.50 (PRR) Garuda (Hold'em)
Seat 9 is the button
Seat 1: Haid Dasalami (47.23).
Seat 2: BBDub27 (87.56).
Seat 3: sr86 (141.70).
Seat 4: johnnyboxx7 (46.25).
Seat 5: FirstClan (50).
Seat 6: IlxxxlI (36.84).
Seat 8: VegasMike420 (43.73).
Seat 9: solasso (28.04).
Player Haid Dasalami has small blind (0.25)
Player BBDub27 has big blind (0.50)
Player IlxxxlI received card: [Jc]
Player IlxxxlI received card: [2s]
Player sr86 folds
Player johnnyboxx7 folds
Player FirstClan raises (1.50)
Player IlxxxlI folds
Player VegasMike420 folds
Player solasso folds
Player Haid Dasalami folds
Player BBDub27 calls (1)
*** FLOP ***: [Qd 2h 3h]
Player BBDub27 checks
Player FirstClan bets (2.50)
Player BBDub27 folds
Uncalled bet (2.50) returned to FirstClan
Player FirstClan mucks cards
------ Summary ------
Pot: 3.09. Rake 0.12. JP fee 0.04
Board: [Qd 2h 3h]
Player Haid Dasalami does not show cards.Bets: 0.25. Collects: 0. Loses: 0.25.
Player BBDub27 does not show cards.Bets: 1.50. Collects: 0. Loses: 1.50.
Player sr86 does not show cards.Bets: 0. Collects: 0. Wins: 0.
Player johnnyboxx7 does not show cards.Bets: 0. Collects: 0. Wins: 0.
*Player FirstClan mucks (does not show cards). Bets: 1.50. Collects: 3.09. Wins: 1.59.
Player IlxxxlI does not show cards.Bets: 0. Collects: 0. Wins: 0.
Player VegasMike420 does not show cards.Bets: 0. Collects: 0. Wins: 0.
Player solasso does not show cards.Bets: 0. Collects: 0. Wins: 0.
Game ended at: 2016/11/21 11:19:23

Game started
Game ID: 780973941 0.25/0.50 (PRR) Garuda (Short) (Hold'em)
Seat 5 is the button
Seat 1: haroldbb (29.17).
Seat 2: sr86 (25).
Seat 3: IlxxxlI (20.76).
Seat 4: WICHONSKI (41.81).
Seat 5: Brucelegend (25.30).
Seat 6: parmele (13.24).
Seat 7: ChrisNola (52.46).
Seat 9: FirstClan (25).
Player parmele has small blind (0.25)
Player ChrisNola has big blind (0.50)
Player IlxxxlI received card: [4h]
Player IlxxxlI received card: [Jh]
Player FirstClan folds
Player haroldbb folds
Player sr86 is timed out.
Player sr86 folds
Player IlxxxlI folds
Player WICHONSKI raises (1.50)
Player Brucelegend folds
Player parmele folds
Player ChrisNola folds
Uncalled bet (1) returned to WICHONSKI
Player WICHONSKI mucks cards
------ Summary ------
Pot: 1.25. Rake 0
Player haroldbb does not show cards.Bets: 0. Collects: 0. Wins: 0.
Player sr86 does not show cards.Bets: 0. Collects: 0. Wins: 0.
Player IlxxxlI does not show cards.Bets: 0. Collects: 0. Wins: 0.
*Player WICHONSKI mucks (does not show cards). Bets: 0.50. Collects: 1.25. Wins: 0.75.
Player Brucelegend does not show cards.Bets: 0. Collects: 0. Wins: 0.
Player parmele does not show cards.Bets: 0.25. Collects: 0. Loses: 0.25.
Player ChrisNola does not show cards.Bets: 0.50. Collects: 0. Loses: 0.50.
Player FirstClan does not show cards.Bets: 0. Collects: 0. Wins: 0.
Game ended at: 2016/11/21 11:18:35

Game started
Game ID: 780973615 0.25/0.50 (PRR) Garuda (Hold'em)
Seat 8 is the button
Seat 1: Haid Dasalami (47.73).
Seat 2: BBDub27 (87.56).
Seat 3: sr86 (141.70).
Seat 4: johnnyboxx7 (46.25).
Seat 5: FirstClan (50).
Seat 6: IlxxxlI (36.84).
Seat 8: VegasMike420 (42.98).
Seat 9: solasso (28.29).
Player solasso has small blind (0.25)
Player Haid Dasalami has big blind (0.50)
Player IlxxxlI received card: [6s]
Player IlxxxlI received card: [10s]
Player BBDub27 folds
Player sr86 folds
Player johnnyboxx7 folds
Player FirstClan folds
Player IlxxxlI folds
Player VegasMike420 raises (2)
Player solasso folds
Player Haid Dasalami folds
Uncalled bet (1.50) returned to VegasMike420
Player VegasMike420 mucks cards
------ Summary ------
Pot: 1.25. Rake 0
Player Haid Dasalami does not show cards.Bets: 0.50. Collects: 0. Loses: 0.50.
Player BBDub27 does not show cards.Bets: 0. Collects: 0. Wins: 0.
Player sr86 does not show cards.Bets: 0. Collects: 0. Wins: 0.
Player johnnyboxx7 does not show cards.Bets: 0. Collects: 0. Wins: 0.
Player FirstClan does not show cards.Bets: 0. Collects: 0. Wins: 0.
Player IlxxxlI does not show cards.Bets: 0. Collects: 0. Wins: 0.
*Player VegasMike420 mucks (does not show cards). Bets: 0.50. Collects: 1.25. Wins: 0.75.
Player solasso does not show cards.Bets: 0.25. Collects: 0. Loses: 0.25.
Game ended at: 2016/11/21 11:18:19

Game started
Game ID: 780973316 0.25/0.50 (PRR) Garuda (Short) (Hold'em)
Seat 4 is the button
Seat 1: haroldbb (29.17).
Seat 2: sr86 (25).
Seat 3: IlxxxlI (20.76).
Seat 4: WICHONSKI (39.74).
Seat 5: Brucelegend (25.55).
Seat 6: parmele (13.74).
Seat 7: ChrisNola (53.96).
Seat 9: FirstClan (25).
Player Brucelegend has small blind (0.25)
Player parmele has big blind (0.50)
Player IlxxxlI received card: [4c]
Player IlxxxlI received card: [Jd]
Player ChrisNola calls (0.50)
Player FirstClan folds
Player haroldbb folds
Player sr86 folds
Player IlxxxlI folds
Player WICHONSKI raises (1.50)
Player Brucelegend folds
Player parmele folds
Player ChrisNola calls (1)
*** FLOP ***: [8s Ah Jc]
Player ChrisNola checks
Player WICHONSKI bets (2.33)
Player ChrisNola folds
Uncalled bet (2.33) returned to WICHONSKI
Player WICHONSKI mucks cards
------ Summary ------
Pot: 3.57. Rake 0.12. JP fee 0.06
Board: [8s Ah Jc]
Player haroldbb does not show cards.Bets: 0. Collects: 0. Wins: 0.
Player sr86 does not show cards.Bets: 0. Collects: 0. Wins: 0.
Player IlxxxlI does not show cards.Bets: 0. Collects: 0. Wins: 0.
*Player WICHONSKI mucks (does not show cards). Bets: 1.50. Collects: 3.57. Wins: 2.07.
Player Brucelegend does not show cards.Bets: 0.25. Collects: 0. Loses: 0.25.
Player parmele does not show cards.Bets: 0.50. Collects: 0. Loses: 0.50.
Player ChrisNola does not show cards.Bets: 1.50. Collects: 0. Loses: 1.50.
Player FirstClan does not show cards.Bets: 0. Collects: 0. Wins: 0.
Game ended at: 2016/11/21 11:17:50

Game started
Game ID: 780972216 0.25/0.50 (PRR) Garuda (Short) (Hold'em)
Seat 3 is the button
Seat 1: haroldbb (29.17).
Seat 2: sr86 (25).
Seat 3: IlxxxlI (19.17).
Seat 4: WICHONSKI (39.99).
Seat 5: Brucelegend (27.05).
Seat 6: parmele (13.74).
Seat 7: ChrisNola (53.96).
Seat 9: FirstClan (25).
Player WICHONSKI has small blind (0.25)
Player Brucelegend has big blind (0.50)
Player IlxxxlI received card: [7h]
Player IlxxxlI received card: [8h]
Player parmele folds
Player ChrisNola folds
Player FirstClan folds
Player haroldbb folds
Player sr86 folds
Player IlxxxlI raises (1.50)
Player WICHONSKI folds
Player Brucelegend calls (1)
*** FLOP ***: [6s As 9c]
Player Brucelegend checks
Player IlxxxlI checks
*** TURN ***: [6s As 9c] [Qd]
Player Brucelegend checks
Player IlxxxlI checks
*** RIVER ***: [6s As 9c Qd] [6c]
Player Brucelegend checks
Player IlxxxlI bets (1)
Player Brucelegend folds
Uncalled bet (1) returned to IlxxxlI
Player IlxxxlI mucks cards
------ Summary ------
Pot: 3.09. Rake 0.12. JP fee 0.04
Board: [6s As 9c Qd 6c]
Player haroldbb does not show cards.Bets: 0. Collects: 0. Wins: 0.
Player sr86 does not show cards.Bets: 0. Collects: 0. Wins: 0.
*Player IlxxxlI mucks (does not show cards). Bets: 1.50. Collects: 3.09. Wins: 1.59.
Player WICHONSKI does not show cards.Bets: 0.25. Collects: 0. Loses: 0.25.
Player Brucelegend does not show cards.Bets: 1.50. Collects: 0. Loses: 1.50.
Player parmele does not show cards.Bets: 0. Collects: 0. Wins: 0.
Player ChrisNola does not show cards.Bets: 0. Collects: 0. Wins: 0.
Player FirstClan does not show cards.Bets: 0. Collects: 0. Wins: 0.
Game ended at: 2016/11/21 11:17:4

Game started
Game ID: 780971993 0.25/0.50 (PRR) Garuda (Hold'em)
Seat 6 is the button
Seat 1: Haid Dasalami (47.73).
Seat 2: BBDub27 (77.23).
Seat 3: sr86 (141.70).
Seat 4: johnnyboxx7 (46.25).
Seat 5: FirstClan (54.68).
Seat 6: IlxxxlI (36.84).
Seat 8: VegasMike420 (43.23).
Seat 9: solasso (28.79).
Player VegasMike420 has small blind (0.25)
Player solasso has big blind (0.50)
Player IlxxxlI received card: [8h]
Player IlxxxlI received card: [2c]
Player Haid Dasalami folds
Player BBDub27 raises (1.50)
Player sr86 folds
Player johnnyboxx7 folds
Player FirstClan raises (4.50)
Player IlxxxlI folds
Player VegasMike420 folds
Player solasso folds
Player BBDub27 calls (3)
*** FLOP ***: [8d 3d Ad]
Player BBDub27 checks
Player FirstClan bets (6.18)
Player BBDub27 calls (6.18)
*** TURN ***: [8d 3d Ad] [2d]
Player BBDub27 checks
Player FirstClan checks
*** RIVER ***: [8d 3d Ad 2d] [9c]
Player BBDub27 bets (12)
Player FirstClan folds
Uncalled bet (12) returned to BBDub27
Player BBDub27 mucks cards
------ Summary ------
Pot: 21.01. Rake 0.86. JP fee 0.24
Board: [8d 3d Ad 2d 9c]
Player Haid Dasalami does not show cards.Bets: 0. Collects: 0. Wins: 0.
*Player BBDub27 mucks (does not show cards). Bets: 10.68. Collects: 21.01. Wins: 10.33.
Player sr86 does not show cards.Bets: 0. Collects: 0. Wins: 0.
Player johnnyboxx7 does not show cards.Bets: 0. Collects: 0. Wins: 0.
Player FirstClan does not show cards.Bets: 10.68. Collects: 0. Loses: 10.68.
Player IlxxxlI does not show cards.Bets: 0. Collects: 0. Wins: 0.
Player VegasMike420 does not show cards.Bets: 0.25. Collects: 0. Loses: 0.25.
Player solasso does not show cards.Bets: 0.50. Collects: 0. Loses: 0.50.
Game ended at: 2016/11/21 11:17:25

Game started
Game ID: 780970949 0.25/0.50 (PRR) Garuda (Short) (Hold'em)
Seat 2 is the button
Seat 1: haroldbb (29.17).
Seat 2: sr86 (25).
Seat 3: IlxxxlI (19.42).
Seat 4: WICHONSKI (40.49).
Seat 5: Brucelegend (13.86).
Seat 6: parmele (13.74).
Seat 7: ChrisNola (67.82).
Seat 9: FirstClan (25).
Player IlxxxlI has small blind (0.25)
Player WICHONSKI has big blind (0.50)
Player IlxxxlI received card: [Ks]
Player IlxxxlI received card: [7d]
Player Brucelegend raises (1)
Player parmele folds
Player ChrisNola calls (1)
Player FirstClan folds
Player haroldbb folds
Player sr86 folds
Player IlxxxlI folds
Player WICHONSKI folds
*** FLOP ***: [5d Qs 8d]
Player Brucelegend bets (1.74)
Player ChrisNola calls (1.74)
*** TURN ***: [5d Qs 8d] [Js]
Player Brucelegend bets (3.94)
Player ChrisNola calls (3.94)
*** RIVER ***: [5d Qs 8d Js] [8c]
Player Brucelegend allin (7.18)
Player ChrisNola calls (7.18)
------ Summary ------
Pot: 27.05. Rake 1.18. JP fee 0.24
Board: [5d Qs 8d Js 8c]
Player haroldbb does not show cards.Bets: 0. Collects: 0. Wins: 0.
Player sr86 does not show cards.Bets: 0. Collects: 0. Wins: 0.
Player IlxxxlI does not show cards.Bets: 0.25. Collects: 0. Loses: 0.25.
Player WICHONSKI does not show cards.Bets: 0.50. Collects: 0. Loses: 0.50.
*Player Brucelegend shows: Two pairs. Qs and 8s [Ah Qc]. Bets: 13.86. Collects: 27.05. Wins: 13.19.
Player parmele does not show cards.Bets: 0. Collects: 0. Wins: 0.
Player ChrisNola shows: Two pairs. Js and 8s [Kd Jc]. Bets: 13.86. Collects: 0. Loses: 13.86.
Player FirstClan does not show cards.Bets: 0. Collects: 0. Wins: 0.
Game ended at: 2016/11/21 11:15:46

Game started
Game ID: 780970070 0.25/0.50 (PRR) Garuda (Hold'em)
Seat 5 is the button
Seat 1: Haid Dasalami (47.73).
Seat 2: BBDub27 (77.23).
Seat 3: sr86 (97.09).
Seat 4: johnnyboxx7 (47.75).
Seat 5: FirstClan (54.68).
Seat 6: IlxxxlI (37.09).
Seat 7: Daggens (45.86).
Seat 8: VegasMike420 (43.23).
Seat 9: solasso (28.79).
Player IlxxxlI has small blind (0.25)
Player Daggens has big blind (0.50)
Player IlxxxlI received card: [2d]
Player IlxxxlI received card: [10d]
Player VegasMike420 folds
Player solasso folds
Player Haid Dasalami folds
Player BBDub27 folds
Player sr86 raises (1.50)
Player johnnyboxx7 calls (1.50)
Player FirstClan folds
Player IlxxxlI folds
Player Daggens calls (1)
*** FLOP ***: [8h 3d 7c]
Player Daggens checks
Player sr86 bets (3.50)
Player johnnyboxx7 is timed out.
Player johnnyboxx7 folds
Player Daggens calls (3.50)
*** TURN ***: [8h 3d 7c] [4c]
Player Daggens checks
Player sr86 bets (8)
Player Daggens allin (40.86)
Player sr86 calls (32.86)
*** RIVER ***: [8h 3d 7c 4c] [9c]
------ Summary ------
Pot: 90.47. Rake 2.76. JP fee 0.24
Board: [8h 3d 7c 4c 9c]
Player Haid Dasalami does not show cards.Bets: 0. Collects: 0. Wins: 0.
Player BBDub27 does not show cards.Bets: 0. Collects: 0. Wins: 0.
*Player sr86 shows: Three Of Kind of 8s [8d 8c]. Bets: 45.86. Collects: 90.47. Wins: 44.61.
Player johnnyboxx7 does not show cards.Bets: 1.50. Collects: 0. Loses: 1.50.
Player FirstClan does not show cards.Bets: 0. Collects: 0. Wins: 0.
Player IlxxxlI does not show cards.Bets: 0.25. Collects: 0. Loses: 0.25.
Player Daggens shows: Two pairs. 7s and 4s [4h 7h]. Bets: 45.86. Collects: 0. Loses: 45.86.
Player VegasMike420 does not show cards.Bets: 0. Collects: 0. Wins: 0.
Player solasso does not show cards.Bets: 0. Collects: 0. Wins: 0.
Game ended at: 2016/11/21 11:15:30

Game started
Game ID: 780969860 0.25/0.50 (PRR) Garuda (Short) (Hold'em)
Seat 1 is the button
Seat 1: haroldbb (29.17).
Seat 2: sr86 (26.12).
Seat 3: IlxxxlI (19.92).
Seat 4: WICHONSKI (37).
Seat 5: Brucelegend (15.36).
Seat 6: parmele (13.74).
Seat 7: ChrisNola (68.07).
Seat 9: FirstClan (25).
Player sr86 has small blind (0.25)
Player IlxxxlI has big blind (0.50)
Player ChrisNola posts (0.25)
Player IlxxxlI received card: [7c]
Player IlxxxlI received card: [Jc]
Player WICHONSKI raises (1.50)
Player Brucelegend calls (1.50)
Player parmele folds
Player ChrisNola folds
Player FirstClan folds
Player haroldbb folds
Player sr86 calls (1.25)
Player IlxxxlI folds
*** FLOP ***: [Ad 8s Qh]
Player sr86 checks
Player WICHONSKI bets (2.33)
Player Brucelegend folds
Player sr86 folds
Uncalled bet (2.33) returned to WICHONSKI
Player WICHONSKI mucks cards
------ Summary ------
Pot: 4.99. Rake 0.18. JP fee 0.08
Board: [Ad 8s Qh]
Player haroldbb does not show cards.Bets: 0. Collects: 0. Wins: 0.
Player sr86 does not show cards.Bets: 1.50. Collects: 0. Loses: 1.50.
Player IlxxxlI does not show cards.Bets: 0.50. Collects: 0. Loses: 0.50.
*Player WICHONSKI mucks (does not show cards). Bets: 1.50. Collects: 4.99. Wins: 3.49.
Player Brucelegend does not show cards.Bets: 1.50. Collects: 0. Loses: 1.50.
Player parmele does not show cards.Bets: 0. Collects: 0. Wins: 0.
Player ChrisNola does not show cards.Bets: 0.25. Collects: 0. Loses: 0.25.
Player FirstClan does not show cards.Bets: 0. Collects: 0. Wins: 0.
Game ended at: 2016/11/21 11:14:20

Game started
Game ID: 780969085 0.25/0.50 (PRR) Garuda (Short) (Hold'em)
Seat 9 is the button
Seat 1: haroldbb (29.42).
Seat 2: sr86 (26.62).
Seat 3: IlxxxlI (19.92).
Seat 4: WICHONSKI (36.25).
Seat 5: Brucelegend (15.36).
Seat 6: parmele (13.74).
Seat 9: FirstClan (25).
Player haroldbb has small blind (0.25)
Player sr86 has big blind (0.50)
Player IlxxxlI received card: [4h]
Player IlxxxlI received card: [10s]
Player IlxxxlI folds
Player WICHONSKI raises (1.50)
Player Brucelegend folds
Player parmele folds
Player FirstClan folds
Player haroldbb folds
Player sr86 folds
Uncalled bet (1) returned to WICHONSKI
Player WICHONSKI mucks cards
------ Summary ------
Pot: 1.25. Rake 0
Player haroldbb does not show cards.Bets: 0.25. Collects: 0. Loses: 0.25.
Player sr86 does not show cards.Bets: 0.50. Collects: 0. Loses: 0.50.
Player IlxxxlI does not show cards.Bets: 0. Collects: 0. Wins: 0.
*Player WICHONSKI mucks (does not show cards). Bets: 0.50. Collects: 1.25. Wins: 0.75.
Player Brucelegend does not show cards.Bets: 0. Collects: 0. Wins: 0.
Player parmele does not show cards.Bets: 0. Collects: 0. Wins: 0.
Player FirstClan does not show cards.Bets: 0. Collects: 0. Wins: 0.
Game ended at: 2016/11/21 11:13:4

Game started
Game ID: 780968532 0.25/0.50 (PRR) Garuda (Short) (Hold'em)
Seat 6 is the button
Seat 1: haroldbb (29.92).
Seat 2: sr86 (26.62).
Seat 3: IlxxxlI (19.92).
Seat 4: WICHONSKI (36.25).
Seat 5: Brucelegend (14.61).
Seat 6: parmele (13.74).
Seat 7: ChrisNola (68.07).
Seat 9: FirstClan (25).
Player ChrisNola is timed out.
Player ChrisNola sitting out
Player FirstClan has small blind (0.25)
Player haroldbb has big blind (0.50)
Player IlxxxlI received card: [7d]
Player IlxxxlI received card: [5d]
Player sr86 folds
Player IlxxxlI folds
Player WICHONSKI folds
Player Brucelegend raises (1)
Player parmele folds
Player FirstClan folds
Player haroldbb folds
Uncalled bet (0.50) returned to Brucelegend
Player Brucelegend mucks cards
------ Summary ------
Pot: 1.25. Rake 0
Player haroldbb does not show cards.Bets: 0.50. Collects: 0. Loses: 0.50.
Player sr86 does not show cards.Bets: 0. Collects: 0. Wins: 0.
Player IlxxxlI does not show cards.Bets: 0. Collects: 0. Wins: 0.
Player WICHONSKI does not show cards.Bets: 0. Collects: 0. Wins: 0.
*Player Brucelegend mucks (does not show cards). Bets: 0.50. Collects: 1.25. Wins: 0.75.
Player parmele does not show cards.Bets: 0. Collects: 0. Wins: 0.
Player ChrisNola does not show cards.Bets: 0. Collects: 0. Wins: 0.
Player FirstClan does not show cards.Bets: 0.25. Collects: 0. Loses: 0.25.
Game ended at: 2016/11/21 11:12:11

Game started
Game ID: 780968258 0.25/0.50 (PRR) Garuda (Hold'em)
Seat 4 is the button
Seat 1: Haid Dasalami (47.73).
Seat 2: BBDub27 (77.23).
Seat 3: sr86 (97.09).
Seat 4: johnnyboxx7 (49.25).
Seat 5: FirstClan (54.93).
Seat 6: IlxxxlI (35.50).
Seat 7: Daggens (45.86).
Seat 8: VegasMike420 (43.23).
Seat 9: solasso (28.79).
Player FirstClan has small blind (0.25)
Player IlxxxlI has big blind (0.50)
Player IlxxxlI received card: [7h]
Player IlxxxlI received card: [Ah]
Player Daggens folds
Player VegasMike420 folds
Player solasso folds
Player Haid Dasalami folds
Player BBDub27 folds
Player sr86 folds
Player johnnyboxx7 raises (1.50)
Player FirstClan folds
Player IlxxxlI calls (1)
*** FLOP ***: [4d 8c 3d]
Player IlxxxlI checks
Player johnnyboxx7 checks
*** TURN ***: [4d 8c 3d] [5h]
Player IlxxxlI checks
Player johnnyboxx7 checks
*** RIVER ***: [4d 8c 3d 5h] [7c]
Player IlxxxlI checks
Player johnnyboxx7 checks
Player johnnyboxx7 mucks cards
------ Summary ------
Pot: 3.09. Rake 0.12. JP fee 0.04
Board: [4d 8c 3d 5h 7c]
Player Haid Dasalami does not show cards.Bets: 0. Collects: 0. Wins: 0.
Player BBDub27 does not show cards.Bets: 0. Collects: 0. Wins: 0.
Player sr86 does not show cards.Bets: 0. Collects: 0. Wins: 0.
Player johnnyboxx7 mucks (does not show cards). Bets: 1.50. Collects: 0. Loses: 1.50.
Player FirstClan does not show cards.Bets: 0.25. Collects: 0. Loses: 0.25.
*Player IlxxxlI shows: One pair of 7s [7h Ah]. Bets: 1.50. Collects: 3.09. Wins: 1.59.
Player Daggens does not show cards.Bets: 0. Collects: 0. Wins: 0.
Player VegasMike420 does not show cards.Bets: 0. Collects: 0. Wins: 0.
Player solasso does not show cards.Bets: 0. Collects: 0. Wins: 0.
Game ended at: 2016/11/21 11:13:17

Game started
Game ID: 780967776 0.25/0.50 (PRR) Garuda (Short) (Hold'em)
Seat 5 is the button
Seat 1: haroldbb (29.92).
Seat 2: sr86 (26.62).
Seat 3: IlxxxlI (19.92).
Seat 4: WICHONSKI (36.25).
Seat 5: Brucelegend (13.47).
Seat 6: parmele (13.99).
Seat 7: ChrisNola (69.07).
Seat 9: FirstClan (25).
Player parmele has small blind (0.25)
Player ChrisNola has big blind (0.50)
Player IlxxxlI received card: [5c]
Player IlxxxlI received card: [Qc]
Player FirstClan folds
Player haroldbb folds
Player sr86 folds
Player IlxxxlI folds
Player WICHONSKI folds
Player Brucelegend raises (1)
Player parmele folds
Player ChrisNola calls (0.50)
*** FLOP ***: [3s 9s Qd]
Player ChrisNola checks
Player Brucelegend bets (1.42)
Player ChrisNola folds
Uncalled bet (1.42) returned to Brucelegend
Player Brucelegend mucks cards
------ Summary ------
Pot: 2.14. Rake 0.09. JP fee 0.02
Board: [3s 9s Qd]
Player haroldbb does not show cards.Bets: 0. Collects: 0. Wins: 0.
Player sr86 does not show cards.Bets: 0. Collects: 0. Wins: 0.
Player IlxxxlI does not show cards.Bets: 0. Collects: 0. Wins: 0.
Player WICHONSKI does not show cards.Bets: 0. Collects: 0. Wins: 0.
*Player Brucelegend mucks (does not show cards). Bets: 1. Collects: 2.14. Wins: 1.14.
Player parmele does not show cards.Bets: 0.25. Collects: 0. Loses: 0.25.
Player ChrisNola does not show cards.Bets: 1. Collects: 0. Loses: 1.
Player FirstClan does not show cards.Bets: 0. Collects: 0. Wins: 0.
Game ended at: 2016/11/21 11:11:34

Game started
Game ID: 780966706 0.25/0.50 (PRR) Garuda (Short) (Hold'em)
Seat 4 is the button
Seat 1: haroldbb (29.92).
Seat 2: sr86 (25).
Seat 3: IlxxxlI (19.92).
Seat 4: WICHONSKI (37.25).
Seat 5: Brucelegend (13.72).
Seat 6: parmele (14.49).
Seat 7: ChrisNola (69.07).
Seat 9: FirstClan (25).
Player Brucelegend has small blind (0.25)
Player parmele has big blind (0.50)
Player IlxxxlI received card: [4c]
Player IlxxxlI received card: [Js]
Player ChrisNola folds
Player FirstClan folds
Player haroldbb folds
Player sr86 raises (1)
Player IlxxxlI folds
Player WICHONSKI calls (1)
Player Brucelegend folds
Player parmele folds
*** FLOP ***: [2c Jh Ad]
Player sr86 checks
Player WICHONSKI checks
*** TURN ***: [2c Jh Ad] [Ah]
Player sr86 bets (1.50)
Player WICHONSKI folds
Uncalled bet (1.50) returned to sr86
Player sr86 mucks cards
------ Summary ------
Pot: 2.62. Rake 0.09. JP fee 0.04
Board: [2c Jh Ad Ah]
Player haroldbb does not show cards.Bets: 0. Collects: 0. Wins: 0.
*Player sr86 mucks (does not show cards). Bets: 1. Collects: 2.62. Wins: 1.62.
Player IlxxxlI does not show cards.Bets: 0. Collects: 0. Wins: 0.
Player WICHONSKI does not show cards.Bets: 1. Collects: 0. Loses: 1.
Player Brucelegend does not show cards.Bets: 0.25. Collects: 0. Loses: 0.25.
Player parmele does not show cards.Bets: 0.50. Collects: 0. Loses: 0.50.
Player ChrisNola does not show cards.Bets: 0. Collects: 0. Wins: 0.
Player FirstClan does not show cards.Bets: 0. Collects: 0. Wins: 0.
Game ended at: 2016/11/21 11:10:43

Game started
Game ID: 780966558 0.25/0.50 (PRR) Garuda (Hold'em)
Seat 3 is the button
Seat 1: Haid Dasalami (47.73).
Seat 2: BBDub27 (78.23).
Seat 3: sr86 (97.09).
Seat 4: johnnyboxx7 (49.50).
Seat 5: FirstClan (55.43).
Seat 6: IlxxxlI (29.77).
Seat 7: Daggens (45.86).
Seat 8: VegasMike420 (47.74).
Seat 9: solasso (28.79).
Player johnnyboxx7 has small blind (0.25)
Player FirstClan has big blind (0.50)
Player IlxxxlI received card: [7c]
Player IlxxxlI received card: [7s]
Player IlxxxlI raises (1)
Player Daggens folds
Player VegasMike420 calls (1)
Player solasso folds
Player Haid Dasalami folds
Player BBDub27 calls (1)
Player sr86 folds
Player johnnyboxx7 folds
Player FirstClan folds
*** FLOP ***: [4s 8s 9h]
Player IlxxxlI bets (0.50)
Player VegasMike420 calls (0.50)
Player BBDub27 folds
*** TURN ***: [4s 8s 9h] [5h]
Player IlxxxlI checks
Player VegasMike420 bets (3.01)
Player IlxxxlI calls (3.01)
*** RIVER ***: [4s 8s 9h 5h] [Qh]
Player IlxxxlI checks
Player VegasMike420 checks
------ Summary ------
Pot: 10.24. Rake 0.37. JP fee 0.16
Board: [4s 8s 9h 5h Qh]
Player Haid Dasalami does not show cards.Bets: 0. Collects: 0. Wins: 0.
Player BBDub27 does not show cards.Bets: 1. Collects: 0. Loses: 1.
Player sr86 does not show cards.Bets: 0. Collects: 0. Wins: 0.
Player johnnyboxx7 does not show cards.Bets: 0.25. Collects: 0. Loses: 0.25.
Player FirstClan does not show cards.Bets: 0.50. Collects: 0. Loses: 0.50.
*Player IlxxxlI shows: One pair of 7s [7c 7s]. Bets: 4.51. Collects: 10.24. Wins: 5.73.
Player Daggens does not show cards.Bets: 0. Collects: 0. Wins: 0.
Player VegasMike420 shows: High card A [Ac Jh]. Bets: 4.51. Collects: 0. Loses: 4.51.
Player solasso does not show cards.Bets: 0. Collects: 0. Wins: 0.
Game ended at: 2016/11/21 11:11:12

Game started
Game ID: 780965004 0.25/0.50 (PRR) Garuda (Short) (Hold'em)
Seat 3 is the button
Seat 1: haroldbb (29.92).
Seat 2: sr86 (25).
Seat 3: IlxxxlI (19.92).
Seat 4: WICHONSKI (37.50).
Seat 5: Brucelegend (15.72).
Seat 6: parmele (11.50).
Seat 7: ChrisNola (70.07).
Seat 8: iflopznuts (60.48).
Seat 9: FirstClan (25).
Player WICHONSKI has small blind (0.25)
Player Brucelegend has big blind (0.50)
Player IlxxxlI received card: [10h]
Player IlxxxlI received card: [6h]
Player parmele raises (1)
Player ChrisNola calls (1)
Player iflopznuts folds
Player FirstClan folds
Player haroldbb folds
Player sr86 is timed out.
Player sr86 folds
Player IlxxxlI folds
Player WICHONSKI folds
Player Brucelegend calls (0.50)
*** FLOP ***: [Kh 3c 8c]
Player Brucelegend checks
Player parmele checks
Player ChrisNola checks
*** TURN ***: [Kh 3c 8c] [10c]
Player Brucelegend checks
Player parmele checks
Player ChrisNola checks
*** RIVER ***: [Kh 3c 8c 10c] [4s]
Player Brucelegend checks
Player parmele bets (1)
Player ChrisNola folds
Player Brucelegend calls (1)
Player Brucelegend mucks cards
------ Summary ------
Pot: 4.99. Rake 0.18. JP fee 0.08
Board: [Kh 3c 8c 10c 4s]
Player haroldbb does not show cards.Bets: 0. Collects: 0. Wins: 0.
Player sr86 does not show cards.Bets: 0. Collects: 0. Wins: 0.
Player IlxxxlI does not show cards.Bets: 0. Collects: 0. Wins: 0.
Player WICHONSKI does not show cards.Bets: 0.25. Collects: 0. Loses: 0.25.
Player Brucelegend mucks (does not show cards). Bets: 2. Collects: 0. Loses: 2.
*Player parmele shows: One pair of Js [Jd Js]. Bets: 2. Collects: 4.99. Wins: 2.99.
Player ChrisNola does not show cards.Bets: 1. Collects: 0. Loses: 1.
Player iflopznuts does not show cards.Bets: 0. Collects: 0. Wins: 0.
Player FirstClan does not show cards.Bets: 0. Collects: 0. Wins: 0.
Game ended at: 2016/11/21 11:9:32

Game started
Game ID: 780964624 0.25/0.50 (PRR) Garuda (Short) (Hold'em)
Seat 2 is the button
Seat 1: haroldbb (29.92).
Seat 2: sr86 (25).
Seat 3: IlxxxlI (20.17).
Seat 4: WICHONSKI (37.25).
Seat 5: Brucelegend (15.72).
Seat 6: parmele (11.50).
Seat 7: ChrisNola (70.07).
Seat 8: iflopznuts (60.48).
Seat 9: FirstClan (25).
Player IlxxxlI has small blind (0.25)
Player WICHONSKI has big blind (0.50)
Player IlxxxlI received card: [9d]
Player IlxxxlI received card: [6c]
Player Brucelegend folds
Player parmele folds
Player ChrisNola folds
Player iflopznuts folds
Player FirstClan folds
Player haroldbb folds
Player sr86 folds
Player IlxxxlI folds
Uncalled bet (0.25) returned to WICHONSKI
Player WICHONSKI mucks cards
------ Summary ------
Pot: 0.50. Rake 0
Player haroldbb does not show cards.Bets: 0. Collects: 0. Wins: 0.
Player sr86 does not show cards.Bets: 0. Collects: 0. Wins: 0.
Player IlxxxlI does not show cards.Bets: 0.25. Collects: 0. Loses: 0.25.
*Player WICHONSKI mucks (does not show cards). Bets: 0.25. Collects: 0.50. Wins: 0.25.
Player Brucelegend does not show cards.Bets: 0. Collects: 0. Wins: 0.
Player parmele does not show cards.Bets: 0. Collects: 0. Wins: 0.
Player ChrisNola does not show cards.Bets: 0. Collects: 0. Wins: 0.
Player iflopznuts does not show cards.Bets: 0. Collects: 0. Wins: 0.
Player FirstClan does not show cards.Bets: 0. Collects: 0. Wins: 0.
Game ended at: 2016/11/21 11:7:41

Game started
Game ID: 780964586 0.25/0.50 (PRR) Garuda (Hold'em)
Seat 2 is the button
Seat 1: Haid Dasalami (47.73).
Seat 2: BBDub27 (79.73).
Seat 3: sr86 (98.59).
Seat 4: johnnyboxx7 (50).
Seat 5: FirstClan (50.75).
Seat 6: IlxxxlI (29.77).
Seat 7: Daggens (45.86).
Seat 8: VegasMike420 (49.24).
Seat 9: solasso (28.79).
Player sr86 has small blind (0.25)
Player johnnyboxx7 has big blind (0.50)
Player IlxxxlI received card: [9h]
Player IlxxxlI received card: [Qd]
Player FirstClan raises (1.50)
Player IlxxxlI folds
Player Daggens folds
Player VegasMike420 calls (1.50)
Player solasso folds
Player Haid Dasalami folds
Player BBDub27 calls (1.50)
Player sr86 calls (1.25)
Player johnnyboxx7 folds
*** FLOP ***: [2c Kh 3d]
Player sr86 checks
Player FirstClan checks
Player VegasMike420 checks
Player BBDub27 checks
*** TURN ***: [2c Kh 3d] [Kc]
Player sr86 checks
Player FirstClan bets (2.06)
Player VegasMike420 folds
Player BBDub27 folds
Player sr86 is timed out.
Player sr86 folds
Uncalled bet (2.06) returned to FirstClan
Player FirstClan mucks cards
------ Summary ------
Pot: 6.18. Rake 0.22. JP fee 0.10
Board: [2c Kh 3d Kc]
Player Haid Dasalami does not show cards.Bets: 0. Collects: 0. Wins: 0.
Player BBDub27 does not show cards.Bets: 1.50. Collects: 0. Loses: 1.50.
Player sr86 does not show cards.Bets: 1.50. Collects: 0. Loses: 1.50.
Player johnnyboxx7 does not show cards.Bets: 0.50. Collects: 0. Loses: 0.50.
*Player FirstClan mucks (does not show cards). Bets: 1.50. Collects: 6.18. Wins: 4.68.
Player IlxxxlI does not show cards.Bets: 0. Collects: 0. Wins: 0.
Player Daggens does not show cards.Bets: 0. Collects: 0. Wins: 0.
Player VegasMike420 does not show cards.Bets: 1.50. Collects: 0. Loses: 1.50.
Player solasso does not show cards.Bets: 0. Collects: 0. Wins: 0.
Game ended at: 2016/11/21 11:9:23

Game started
Game ID: 780963732 0.25/0.50 (PRR) Garuda (Hold'em)
Seat 1 is the button
Seat 1: Haid Dasalami (49.23).
Seat 2: BBDub27 (79.98).
Seat 3: sr86 (96.84).
Seat 5: FirstClan (50.75).
Seat 6: IlxxxlI (29.77).
Seat 7: Daggens (45.86).
Seat 8: VegasMike420 (49.24).
Seat 9: solasso (28.79).
Player BBDub27 has small blind (0.25)
Player sr86 has big blind (0.50)
Player IlxxxlI received card: [6h]
Player IlxxxlI received card: [8c]
Player FirstClan folds
Player IlxxxlI folds
Player Daggens folds
Player VegasMike420 folds
Player solasso folds
Player Haid Dasalami raises (1.50)
Player BBDub27 folds
Player sr86 raises (5.50)
Player Haid Dasalami folds
Uncalled bet (4.50) returned to sr86
Player sr86 mucks cards
------ Summary ------
Pot: 3.25. Rake 0
Player Haid Dasalami does not show cards.Bets: 1.50. Collects: 0. Loses: 1.50.
Player BBDub27 does not show cards.Bets: 0.25. Collects: 0. Loses: 0.25.
*Player sr86 mucks (does not show cards). Bets: 1.50. Collects: 3.25. Wins: 1.75.
Player FirstClan does not show cards.Bets: 0. Collects: 0. Wins: 0.
Player IlxxxlI does not show cards.Bets: 0. Collects: 0. Wins: 0.
Player Daggens does not show cards.Bets: 0. Collects: 0. Wins: 0.
Player VegasMike420 does not show cards.Bets: 0. Collects: 0. Wins: 0.
Player solasso does not show cards.Bets: 0. Collects: 0. Wins: 0.
Game ended at: 2016/11/21 11:7:11

Game started
Game ID: 780963285 0.25/0.50 (PRR) Garuda (Hold'em)
Seat 9 is the button
Seat 1: Haid Dasalami (49.48).
Seat 2: BBDub27 (79.73).
Seat 5: FirstClan (50.75).
Seat 6: IlxxxlI (29.77).
Seat 7: Daggens (45.86).
Seat 8: VegasMike420 (49.24).
Seat 9: solasso (28.79).
Player Haid Dasalami has small blind (0.25)
Player BBDub27 has big blind (0.50)
Player IlxxxlI received card: [2h]
Player IlxxxlI received card: [10d]
Player FirstClan folds
Player IlxxxlI folds
Player Daggens folds
Player VegasMike420 folds
Player solasso folds
Player Haid Dasalami folds
Uncalled bet (0.25) returned to BBDub27
Player BBDub27 mucks cards
------ Summary ------
Pot: 0.50. Rake 0
Player Haid Dasalami does not show cards.Bets: 0.25. Collects: 0. Loses: 0.25.
*Player BBDub27 mucks (does not show cards). Bets: 0.25. Collects: 0.50. Wins: 0.25.
Player FirstClan does not show cards.Bets: 0. Collects: 0. Wins: 0.
Player IlxxxlI does not show cards.Bets: 0. Collects: 0. Wins: 0.
Player Daggens does not show cards.Bets: 0. Collects: 0. Wins: 0.
Player VegasMike420 does not show cards.Bets: 0. Collects: 0. Wins: 0.
Player solasso does not show cards.Bets: 0. Collects: 0. Wins: 0.
Game ended at: 2016/11/21 11:6:14

Game started
Game ID: 780962732 0.25/0.50 (PRR) Garuda (Short) (Hold'em)
Seat 1 is the button
Seat 1: haroldbb (29.92).
Seat 2: sr86 (25).
Seat 3: IlxxxlI (20.67).
Seat 4: WICHONSKI (37.25).
Seat 5: Brucelegend (20.72).
Seat 6: parmele (11.50).
Seat 7: ChrisNola (60.10).
Seat 8: iflopznuts (65.48).
Seat 9: FirstClan (25).
Player sr86 has small blind (0.25)
Player IlxxxlI has big blind (0.50)
Player IlxxxlI received card: [Jh]
Player IlxxxlI received card: [2h]
Player WICHONSKI folds
Player Brucelegend calls (0.50)
Player parmele folds
Player ChrisNola calls (0.50)
Player iflopznuts raises (2.50)
Player FirstClan folds
Player haroldbb folds
Player sr86 folds
Player IlxxxlI folds
Player Brucelegend calls (2)
Player ChrisNola calls (2)
*** FLOP ***: [8d 9h 9c]
Player Brucelegend checks
Player ChrisNola checks
Player iflopznuts bets (2.50)
Player Brucelegend calls (2.50)
Player ChrisNola calls (2.50)
*** TURN ***: [8d 9h 9c] [Qd]
Player Brucelegend checks
Player ChrisNola checks
Player iflopznuts checks
*** RIVER ***: [8d 9h 9c Qd] [Qs]
Player Brucelegend checks
Player ChrisNola bets (10)
Player iflopznuts folds
Player Brucelegend folds
Uncalled bet (10) returned to ChrisNola
Player ChrisNola mucks cards
------ Summary ------
Pot: 14.97. Rake 0.54. JP fee 0.24
Board: [8d 9h 9c Qd Qs]
Player haroldbb does not show cards.Bets: 0. Collects: 0. Wins: 0.
Player sr86 does not show cards.Bets: 0.25. Collects: 0. Loses: 0.25.
Player IlxxxlI does not show cards.Bets: 0.50. Collects: 0. Loses: 0.50.
Player WICHONSKI does not show cards.Bets: 0. Collects: 0. Wins: 0.
Player Brucelegend does not show cards.Bets: 5. Collects: 0. Loses: 5.
Player parmele does not show cards.Bets: 0. Collects: 0. Wins: 0.
*Player ChrisNola mucks (does not show cards). Bets: 5. Collects: 14.97. Wins: 9.97.
Player iflopznuts does not show cards.Bets: 5. Collects: 0. Loses: 5.
Player FirstClan does not show cards.Bets: 0. Collects: 0. Wins: 0.
Game ended at: 2016/11/21 11:7:14

Game started
Game ID: 780962360 0.25/0.50 (PRR) Garuda (Hold'em)
Seat 8 is the button
Seat 1: Haid Dasalami (49.98).
Seat 2: BBDub27 (79.73).
Seat 5: FirstClan (50.75).
Seat 6: IlxxxlI (29.77).
Seat 7: Daggens (45.86).
Seat 8: VegasMike420 (48.55).
Seat 9: solasso (29.04).
Player solasso has small blind (0.25)
Player Haid Dasalami has big blind (0.50)
Player IlxxxlI received card: [Ad]
Player IlxxxlI received card: [3s]
Player BBDub27 folds
Player FirstClan folds
Player IlxxxlI folds
Player Daggens folds
Player VegasMike420 calls (0.50)
Player solasso folds
Player Haid Dasalami checks
*** FLOP ***: [10c Kh 6c]
Player Haid Dasalami checks
Player VegasMike420 checks
*** TURN ***: [10c Kh 6c] [9c]
Player Haid Dasalami checks
Player VegasMike420 bets (0.50)
Player Haid Dasalami folds
Uncalled bet (0.50) returned to VegasMike420
Player VegasMike420 mucks cards
------ Summary ------
Pot: 1.19. Rake 0.04. JP fee 0.02
Board: [10c Kh 6c 9c]
Player Haid Dasalami does not show cards.Bets: 0.50. Collects: 0. Loses: 0.50.
Player BBDub27 does not show cards.Bets: 0. Collects: 0. Wins: 0.
Player FirstClan does not show cards.Bets: 0. Collects: 0. Wins: 0.
Player IlxxxlI does not show cards.Bets: 0. Collects: 0. Wins: 0.
Player Daggens does not show cards.Bets: 0. Collects: 0. Wins: 0.
*Player VegasMike420 mucks (does not show cards). Bets: 0.50. Collects: 1.19. Wins: 0.69.
Player solasso does not show cards.Bets: 0.25. Collects: 0. Loses: 0.25.
Game ended at: 2016/11/21 11:5:43

Game started
Game ID: 780960942 0.25/0.50 (PRR) Garuda (Short) (Hold'em)
Seat 9 is the button
Seat 1: haroldbb (30.17).
Seat 2: sr86 (25.42).
Seat 3: IlxxxlI (10).
Seat 4: WICHONSKI (38.25).
Seat 5: Brucelegend (30.72).
Seat 6: parmele (11.50).
Seat 7: ChrisNola (60.10).
Seat 8: iflopznuts (65.48).
Seat 9: FirstClan (25).
Player haroldbb has small blind (0.25)
Player sr86 has big blind (0.50)
Player IlxxxlI received card: [Jc]
Player IlxxxlI received card: [Js]
Player IlxxxlI raises (1)
Player WICHONSKI calls (1)
Player Brucelegend raises (5.50)
Player parmele folds
Player ChrisNola folds
Player iflopznuts folds
Player FirstClan folds
Player haroldbb folds
Player sr86 folds
Player IlxxxlI allin (9)
Player WICHONSKI folds
Player Brucelegend calls (4.50)
*** FLOP ***: [7c Kd 8h]
*** TURN ***: [7c Kd 8h] [6d]
*** RIVER ***: [7c Kd 8h 6d] [8s]
------ Summary ------
Pot: 20.67. Rake 0.84. JP fee 0.24
Board: [7c Kd 8h 6d 8s]
Player haroldbb does not show cards.Bets: 0.25. Collects: 0. Loses: 0.25.
Player sr86 does not show cards.Bets: 0.50. Collects: 0. Loses: 0.50.
*Player IlxxxlI shows: Two pairs. Js and 8s [Jc Js]. Bets: 10. Collects: 20.67. Wins: 10.67.
Player WICHONSKI does not show cards.Bets: 1. Collects: 0. Loses: 1.
Player Brucelegend shows: Two pairs. 10s and 8s [10h 10s]. Bets: 10. Collects: 0. Loses: 10.
Player parmele does not show cards.Bets: 0. Collects: 0. Wins: 0.
Player ChrisNola does not show cards.Bets: 0. Collects: 0. Wins: 0.
Player iflopznuts does not show cards.Bets: 0. Collects: 0. Wins: 0.
Player FirstClan does not show cards.Bets: 0. Collects: 0. Wins: 0.
Game ended at: 2016/11/21 11:5:3

Game started
Game ID: 780960674 0.25/0.50 (PRR) Garuda (Hold'em)
Seat 7 is the button
Seat 1: Haid Dasalami (48.98).
Seat 2: BBDub27 (71.44).
Seat 5: FirstClan (50.75).
Seat 6: IlxxxlI (29.77).
Seat 7: Daggens (54.27).
Seat 8: VegasMike420 (48.80).
Seat 9: solasso (29.54).
Player VegasMike420 has small blind (0.25)
Player solasso has big blind (0.50)
Player IlxxxlI received card: [4h]
Player IlxxxlI received card: [Ks]
Player Haid Dasalami folds
Player BBDub27 raises (1.50)
Player FirstClan folds
Player IlxxxlI folds
Player Daggens calls (1.50)
Player VegasMike420 folds
Player solasso folds
*** FLOP ***: [7h 7c 7d]
Player BBDub27 checks
Player Daggens checks
*** TURN ***: [7h 7c 7d] [5d]
Player BBDub27 bets (2)
Player Daggens calls (2)
*** RIVER ***: [7h 7c 7d 5d] [10c]
Player BBDub27 checks
Player Daggens bets (4.91)
Player BBDub27 calls (4.91)
------ Summary ------
Pot: 16.70. Rake 0.63. JP fee 0.24
Board: [7h 7c 7d 5d 10c]
Player Haid Dasalami does not show cards.Bets: 0. Collects: 0. Wins: 0.
*Player BBDub27 shows: Three Of Kind of 7s (kicker A) [Qh Ac]. Bets: 8.41. Collects: 16.70. Wins: 8.29.
Player FirstClan does not show cards.Bets: 0. Collects: 0. Wins: 0.
Player IlxxxlI does not show cards.Bets: 0. Collects: 0. Wins: 0.
Player Daggens shows: Three Of Kind of 7s [9d 8d]. Bets: 8.41. Collects: 0. Loses: 8.41.
Player VegasMike420 does not show cards.Bets: 0.25. Collects: 0. Loses: 0.25.
Player solasso does not show cards.Bets: 0.50. Collects: 0. Loses: 0.50.
Game ended at: 2016/11/21 11:4:38

Game started
Game ID: 780959614 0.25/0.50 (PRR) Garuda (Short) (Hold'em)
Seat 8 is the button
Seat 1: haroldbb (30.67).
Seat 2: sr86 (25.42).
Seat 3: IlxxxlI (10).
Seat 4: WICHONSKI (38.25).
Seat 5: Brucelegend (30.72).
Seat 6: parmele (15.50).
Seat 7: ChrisNola (60.85).
Seat 8: iflopznuts (60.45).
Seat 9: FirstClan (25).
Player FirstClan has small blind (0.25)
Player haroldbb has big blind (0.50)
Player ChrisNola posts (0.25) as a dead bet
Player ChrisNola posts (0.50)
Player IlxxxlI received card: [Ac]
Player IlxxxlI received card: [9c]
Player sr86 folds
Player IlxxxlI folds
Player WICHONSKI folds
Player Brucelegend folds
Player parmele raises (1)
Player ChrisNola folds
Player iflopznuts calls (1)
Player FirstClan folds
Player haroldbb folds
*** FLOP ***: [7s 8h 10d]
Player parmele bets (1)
Player iflopznuts calls (1)
*** TURN ***: [7s 8h 10d] [4d]
Player parmele bets (2)
Player iflopznuts calls (2)
*** RIVER ***: [7s 8h 10d 4d] [Qh]
Player parmele checks
Player iflopznuts checks
------ Summary ------
Pot: 9.03. Rake 0.33. JP fee 0.14
Board: [7s 8h 10d 4d Qh]
Player haroldbb does not show cards.Bets: 0.50. Collects: 0. Loses: 0.50.
Player sr86 does not show cards.Bets: 0. Collects: 0. Wins: 0.
Player IlxxxlI does not show cards.Bets: 0. Collects: 0. Wins: 0.
Player WICHONSKI does not show cards.Bets: 0. Collects: 0. Wins: 0.
Player Brucelegend does not show cards.Bets: 0. Collects: 0. Wins: 0.
Player parmele shows: High card A [Kh As]. Bets: 4. Collects: 0. Loses: 4.
Player ChrisNola does not show cards.Bets: 0.75. Collects: 0. Loses: 0.75.
*Player iflopznuts shows: One pair of 8s [6d 8c]. Bets: 4. Collects: 9.03. Wins: 5.03.
Player FirstClan does not show cards.Bets: 0.25. Collects: 0. Loses: 0.25.
Game ended at: 2016/11/21 11:3:2

Game started
Game ID: 780959260 0.25/0.50 (PRR) Garuda (Hold'em)
Seat 6 is the button
Seat 1: Haid Dasalami (48.98).
Seat 2: BBDub27 (71.44).
Seat 5: FirstClan (50.75).
Seat 6: IlxxxlI (22.99).
Seat 7: Daggens (54.52).
Seat 8: VegasMike420 (56.06).
Seat 9: solasso (29.54).
Player Daggens has small blind (0.25)
Player VegasMike420 has big blind (0.50)
Player IlxxxlI received card: [Ah]
Player IlxxxlI received card: [3h]
Player solasso folds
Player Haid Dasalami folds
Player BBDub27 folds
Player FirstClan folds
Player IlxxxlI raises (1)
Player Daggens folds
Player VegasMike420 calls (0.50)
*** FLOP ***: [5d 3c Ad]
Player VegasMike420 checks
Player IlxxxlI bets (1.42)
Player VegasMike420 calls (1.42)
*** TURN ***: [5d 3c Ad] [4c]
Player VegasMike420 bets (2.42)
Player IlxxxlI raises (4.84)
Player VegasMike420 calls (2.42)
*** RIVER ***: [5d 3c Ad 4c] [4h]
Player VegasMike420 checks
Player IlxxxlI checks
Player VegasMike420 mucks cards
------ Summary ------
Pot: 14.04. Rake 0.49. JP fee 0.24
Board: [5d 3c Ad 4c 4h]
Player Haid Dasalami does not show cards.Bets: 0. Collects: 0. Wins: 0.
Player BBDub27 does not show cards.Bets: 0. Collects: 0. Wins: 0.
Player FirstClan does not show cards.Bets: 0. Collects: 0. Wins: 0.
*Player IlxxxlI shows: Two pairs. As and 4s [Ah 3h]. Bets: 7.26. Collects: 14.04. Wins: 6.78.
Player Daggens does not show cards.Bets: 0.25. Collects: 0. Loses: 0.25.
Player VegasMike420 mucks (does not show cards). Bets: 7.26. Collects: 0. Loses: 7.26.
Player solasso does not show cards.Bets: 0. Collects: 0. Wins: 0.
Game ended at: 2016/11/21 11:2:44

Game started
Game ID: 780958870 0.25/0.50 (PRR) Garuda (Short) (Hold'em)
Seat 6 is the button
Seat 1: haroldbb (30.67).
Seat 2: sr86 (25.42).
Seat 3: IlxxxlI (10).
Seat 4: WICHONSKI (38.25).
Seat 5: Brucelegend (29.97).
Seat 6: parmele (15.50).
Seat 8: iflopznuts (60.70).
Seat 9: FirstClan (25).
Player iflopznuts has small blind (0.25)
Player FirstClan has big blind (0.50)
Player IlxxxlI received card: [5h]
Player IlxxxlI received card: [8h]
Player haroldbb folds
Player sr86 folds
Player IlxxxlI folds
Player WICHONSKI folds
Player Brucelegend raises (2)
Player parmele folds
Player iflopznuts folds
Player FirstClan folds
Uncalled bet (1.50) returned to Brucelegend
Player Brucelegend mucks cards
------ Summary ------
Pot: 1.25. Rake 0
Player haroldbb does not show cards.Bets: 0. Collects: 0. Wins: 0.
Player sr86 does not show cards.Bets: 0. Collects: 0. Wins: 0.
Player IlxxxlI does not show cards.Bets: 0. Collects: 0. Wins: 0.
Player WICHONSKI does not show cards.Bets: 0. Collects: 0. Wins: 0.
*Player Brucelegend mucks (does not show cards). Bets: 0.50. Collects: 1.25. Wins: 0.75.
Player parmele does not show cards.Bets: 0. Collects: 0. Wins: 0.
Player iflopznuts does not show cards.Bets: 0.25. Collects: 0. Loses: 0.25.
Player FirstClan does not show cards.Bets: 0.50. Collects: 0. Loses: 0.50.
Game ended at: 2016/11/21 11:1:31

Game started
Game ID: 780958725 0.25/0.50 (PRR) Garuda (Hold'em)
Seat 5 is the button
Seat 1: Haid Dasalami (48.98).
Seat 2: BBDub27 (71.44).
Seat 3: sr86 (96.84).
Seat 5: FirstClan (50).
Seat 6: IlxxxlI (23.24).
Seat 7: Daggens (55.02).
Seat 8: VegasMike420 (56.06).
Seat 9: solasso (29.54).
Player IlxxxlI has small blind (0.25)
Player Daggens has big blind (0.50)
Player sr86 wait BB
Player IlxxxlI received card: [Qh]
Player IlxxxlI received card: [6h]
Player VegasMike420 folds
Player solasso folds
Player Haid Dasalami folds
Player BBDub27 folds
Player FirstClan raises (1.10)
Player IlxxxlI folds
Player Daggens folds
Uncalled bet (0.60) returned to FirstClan
Player FirstClan mucks cards
------ Summary ------
Pot: 1.25. Rake 0
Player Haid Dasalami does not show cards.Bets: 0. Collects: 0. Wins: 0.
Player BBDub27 does not show cards.Bets: 0. Collects: 0. Wins: 0.
Player sr86 does not show cards.Bets: 0. Collects: 0. Wins: 0.
*Player FirstClan mucks (does not show cards). Bets: 0.50. Collects: 1.25. Wins: 0.75.
Player IlxxxlI does not show cards.Bets: 0.25. Collects: 0. Loses: 0.25.
Player Daggens does not show cards.Bets: 0.50. Collects: 0. Loses: 0.50.
Player VegasMike420 does not show cards.Bets: 0. Collects: 0. Wins: 0.
Player solasso does not show cards.Bets: 0. Collects: 0. Wins: 0.
Game ended at: 2016/11/21 11:1:6

Game started
Game ID: 780958240 0.25/0.50 (PRR) Garuda (Short) (Hold'em)
Seat 5 is the button
Seat 1: haroldbb (30.67).
Seat 2: sr86 (25.42).
Seat 3: IlxxxlI (10).
Seat 4: WICHONSKI (38.25).
Seat 5: Brucelegend (29.97).
Seat 6: parmele (17.50).
Seat 7: ChrisNola (60.85).
Seat 8: iflopznuts (58.90).
Seat 9: FirstClan (25).
Player parmele has small blind (0.25)
Player ChrisNola is timed out.
Player ChrisNola sitting out
Player iflopznuts has big blind (0.50)
Player IlxxxlI received card: [9h]
Player IlxxxlI received card: [Ks]
Player FirstClan folds
Player haroldbb folds
Player sr86 folds
Player IlxxxlI folds
Player WICHONSKI folds
Player Brucelegend folds
Player parmele calls (0.25)
Player iflopznuts checks
*** FLOP ***: [9s Qc 5s]
Player parmele checks
Player iflopznuts checks
*** TURN ***: [9s Qc 5s] [Jh]
Player parmele bets (0.50)
Player iflopznuts calls (0.50)
*** RIVER ***: [9s Qc 5s Jh] [10c]
Player parmele bets (1)
Player iflopznuts calls (1)
------ Summary ------
Pot: 3.80. Rake 0.14. JP fee 0.06
Board: [9s Qc 5s Jh 10c]
Player haroldbb does not show cards.Bets: 0. Collects: 0. Wins: 0.
Player sr86 does not show cards.Bets: 0. Collects: 0. Wins: 0.
Player IlxxxlI does not show cards.Bets: 0. Collects: 0. Wins: 0.
Player WICHONSKI does not show cards.Bets: 0. Collects: 0. Wins: 0.
Player Brucelegend does not show cards.Bets: 0. Collects: 0. Wins: 0.
Player parmele shows: One pair of Js [Jd 6d]. Bets: 2. Collects: 0. Loses: 2.
Player ChrisNola does not show cards.Bets: 0. Collects: 0. Wins: 0.
*Player iflopznuts shows: Straight to Q [8s 10h]. Bets: 2. Collects: 3.80. Wins: 1.80.
Player FirstClan does not show cards.Bets: 0. Collects: 0. Wins: 0.
Game ended at: 2016/11/21 11:0:36

Game started
Game ID: 780958083 0.25/0.50 (PRR) Garuda (Hold'em)
Seat 2 is the button
Seat 1: Haid Dasalami (48.98).
Seat 2: BBDub27 (73.94).
Seat 5: FirstClan (50).
Seat 6: IlxxxlI (23.74).
Seat 7: Daggens (55.02).
Seat 8: VegasMike420 (56.06).
Seat 9: solasso (26.57).
Player FirstClan has small blind (0.25)
Player IlxxxlI has big blind (0.50)
Player IlxxxlI received card: [Jd]
Player IlxxxlI received card: [4h]
Player Daggens folds
Player VegasMike420 folds
Player solasso raises (2.50)
Player Haid Dasalami folds
Player BBDub27 calls (2.50)
Player FirstClan folds
Player IlxxxlI folds
*** FLOP ***: [3c 5h Jc]
Player solasso bets (3.64)
Player BBDub27 folds
Uncalled bet (3.64) returned to solasso
Player solasso mucks cards
------ Summary ------
Pot: 5.47. Rake 0.20. JP fee 0.08
Board: [3c 5h Jc]
Player Haid Dasalami does not show cards.Bets: 0. Collects: 0. Wins: 0.
Player BBDub27 does not show cards.Bets: 2.50. Collects: 0. Loses: 2.50.
Player FirstClan does not show cards.Bets: 0.25. Collects: 0. Loses: 0.25.
Player IlxxxlI does not show cards.Bets: 0.50. Collects: 0. Loses: 0.50.
Player Daggens does not show cards.Bets: 0. Collects: 0. Wins: 0.
Player VegasMike420 does not show cards.Bets: 0. Collects: 0. Wins: 0.
*Player solasso mucks (does not show cards). Bets: 2.50. Collects: 5.47. Wins: 2.97.
Game ended at: 2016/11/21 11:0:23

Game started
Game ID: 780957176 0.25/0.50 (PRR) Garuda (Short) (Hold'em)
Seat 4 is the button
Seat 1: haroldbb (30.67).
Seat 2: sr86 (25.42).
Seat 3: IlxxxlI (12.67).
Seat 4: WICHONSKI (42.08).
Seat 5: Brucelegend (30.22).
Seat 6: parmele (18).
Seat 7: ChrisNola (45.09).
Seat 8: iflopznuts (58.90).
Seat 9: FirstClan (25).
Player Brucelegend has small blind (0.25)
Player parmele has big blind (0.50)
Player IlxxxlI received card: [As]
Player IlxxxlI received card: [Kh]
Player ChrisNola calls (0.50)
Player iflopznuts folds
Player FirstClan folds
Player haroldbb folds
Player sr86 folds
Player IlxxxlI raises (1.50)
Player WICHONSKI calls (1.50)
Player Brucelegend folds
Player parmele folds
Player ChrisNola calls (1)
*** FLOP ***: [7d 10s Qc]
Player ChrisNola checks
Player IlxxxlI checks
Player WICHONSKI bets (2.33)
Player ChrisNola calls (2.33)
Player IlxxxlI allin (11.17)
Player WICHONSKI folds
Player ChrisNola calls (8.84)
*** TURN ***: [7d 10s Qc] [9s]
*** RIVER ***: [7d 10s Qc 9s] [2h]
------ Summary ------
Pot: 28.43. Rake 1.25. JP fee 0.24
Board: [7d 10s Qc 9s 2h]
Player haroldbb does not show cards.Bets: 0. Collects: 0. Wins: 0.
Player sr86 does not show cards.Bets: 0. Collects: 0. Wins: 0.
Player IlxxxlI shows: High card A [As Kh]. Bets: 12.67. Collects: 0. Loses: 12.67.
Player WICHONSKI does not show cards.Bets: 3.83. Collects: 0. Loses: 3.83.
Player Brucelegend does not show cards.Bets: 0.25. Collects: 0. Loses: 0.25.
Player parmele does not show cards.Bets: 0.50. Collects: 0. Loses: 0.50.
*Player ChrisNola shows: One pair of 9s [9h Jh]. Bets: 12.67. Collects: 28.43. Wins: 15.76.
Player iflopznuts does not show cards.Bets: 0. Collects: 0. Wins: 0.
Player FirstClan does not show cards.Bets: 0. Collects: 0. Wins: 0.
Game ended at: 2016/11/21 10:59:33

Game started
Game ID: 780957114 0.25/0.50 (PRR) Garuda (Hold'em)
Seat 9 is the button
Seat 1: Haid Dasalami (49.23).
Seat 2: BBDub27 (76.85).
Seat 3: sr86 (96.84).
Seat 4: pineapplesand (21.45).
Seat 6: IlxxxlI (23.74).
Seat 7: Daggens (55.02).
Seat 8: VegasMike420 (56.06).
Seat 9: solasso (23.25).
Player Haid Dasalami has small blind (0.25)
Player BBDub27 has big blind (0.50)
Player IlxxxlI received card: [10c]
Player IlxxxlI received card: [Kh]
Player sr86 folds
Player pineapplesand folds
Player IlxxxlI folds
Player Daggens folds
Player VegasMike420 folds
Player solasso folds
Player Haid Dasalami folds
Uncalled bet (0.25) returned to BBDub27
Player BBDub27 mucks cards
------ Summary ------
Pot: 0.50. Rake 0
Player Haid Dasalami does not show cards.Bets: 0.25. Collects: 0. Loses: 0.25.
*Player BBDub27 mucks (does not show cards). Bets: 0.25. Collects: 0.50. Wins: 0.25.
Player sr86 does not show cards.Bets: 0. Collects: 0. Wins: 0.
Player pineapplesand does not show cards.Bets: 0. Collects: 0. Wins: 0.
Player IlxxxlI does not show cards.Bets: 0. Collects: 0. Wins: 0.
Player Daggens does not show cards.Bets: 0. Collects: 0. Wins: 0.
Player VegasMike420 does not show cards.Bets: 0. Collects: 0. Wins: 0.
Player solasso does not show cards.Bets: 0. Collects: 0. Wins: 0.
Game ended at: 2016/11/21 10:58:19

Game started
Game ID: 780956397 0.25/0.50 (PRR) Garuda (Hold'em)
Seat 8 is the button
Seat 1: Haid Dasalami (49.73).
Seat 2: BBDub27 (81.35).
Seat 3: sr86 (96.84).
Seat 4: pineapplesand (21.45).
Seat 6: IlxxxlI (23.74).
Seat 7: Daggens (55.02).
Seat 8: VegasMike420 (51.29).
Seat 9: solasso (23.50).
Player solasso has small blind (0.25)
Player Haid Dasalami has big blind (0.50)
Player IlxxxlI received card: [Jd]
Player IlxxxlI received card: [10c]
Player BBDub27 raises (1.50)
Player sr86 folds
Player pineapplesand folds
Player IlxxxlI folds
Player Daggens folds
Player VegasMike420 raises (4.50)
Player solasso folds
Player Haid Dasalami folds
Player BBDub27 calls (3)
*** FLOP ***: [2h Qs 4d]
Player BBDub27 checks
Player VegasMike420 bets (4.63)
Player BBDub27 folds
Uncalled bet (4.63) returned to VegasMike420
Player VegasMike420 mucks cards
------ Summary ------
Pot: 9.27. Rake 0.32. JP fee 0.16
Board: [2h Qs 4d]
Player Haid Dasalami does not show cards.Bets: 0.50. Collects: 0. Loses: 0.50.
Player BBDub27 does not show cards.Bets: 4.50. Collects: 0. Loses: 4.50.
Player sr86 does not show cards.Bets: 0. Collects: 0. Wins: 0.
Player pineapplesand does not show cards.Bets: 0. Collects: 0. Wins: 0.
Player IlxxxlI does not show cards.Bets: 0. Collects: 0. Wins: 0.
Player Daggens does not show cards.Bets: 0. Collects: 0. Wins: 0.
*Player VegasMike420 mucks (does not show cards). Bets: 4.50. Collects: 9.27. Wins: 4.77.
Player solasso does not show cards.Bets: 0.25. Collects: 0. Loses: 0.25.
Game ended at: 2016/11/21 10:57:35

Game started
Game ID: 780956326 0.25/0.50 (PRR) Garuda (Short) (Hold'em)
Seat 3 is the button
Seat 1: haroldbb (30.67).
Seat 2: sr86 (25.42).
Seat 3: IlxxxlI (12.67).
Seat 4: WICHONSKI (42.58).
Seat 5: Brucelegend (24.21).
Seat 6: parmele (18).
Seat 7: ChrisNola (50.71).
Seat 8: iflopznuts (59.40).
Seat 9: FirstClan (25).
Player WICHONSKI has small blind (0.25)
Player Brucelegend has big blind (0.50)
Player IlxxxlI received card: [2d]
Player IlxxxlI received card: [6h]
Player parmele folds
Player ChrisNola calls (0.50)
Player iflopznuts calls (0.50)
Player FirstClan folds
Player haroldbb folds
Player sr86 folds
Player IlxxxlI folds
Player WICHONSKI calls (0.25)
Player Brucelegend checks
*** FLOP ***: [3s 6d Jc]
Player WICHONSKI checks
Player Brucelegend bets (1.26)
Player ChrisNola calls (1.26)
Player iflopznuts folds
Player WICHONSKI folds
*** TURN ***: [3s 6d Jc] [5s]
Player Brucelegend bets (2.86)
Player ChrisNola calls (2.86)
*** RIVER ***: [3s 6d Jc 5s] [Qs]
Player Brucelegend bets (1)
Player ChrisNola calls (1)
Player ChrisNola mucks cards
------ Summary ------
Pot: 11.63. Rake 0.41. JP fee 0.20
Board: [3s 6d Jc 5s Qs]
Player haroldbb does not show cards.Bets: 0. Collects: 0. Wins: 0.
Player sr86 does not show cards.Bets: 0. Collects: 0. Wins: 0.
Player IlxxxlI does not show cards.Bets: 0. Collects: 0. Wins: 0.
Player WICHONSKI does not show cards.Bets: 0.50. Collects: 0. Loses: 0.50.
*Player Brucelegend shows: One pair of Js [4s Jh]. Bets: 5.62. Collects: 11.63. Wins: 6.01.
Player parmele does not show cards.Bets: 0. Collects: 0. Wins: 0.
Player ChrisNola mucks (does not show cards). Bets: 5.62. Collects: 0. Loses: 5.62.
Player iflopznuts does not show cards.Bets: 0.50. Collects: 0. Loses: 0.50.
Player FirstClan does not show cards.Bets: 0. Collects: 0. Wins: 0.
Game ended at: 2016/11/21 10:57:41

Game started
Game ID: 780955764 0.25/0.50 (PRR) Garuda (Hold'em)
Seat 7 is the button
Seat 1: Haid Dasalami (49.73).
Seat 2: BBDub27 (81.35).
Seat 3: sr86 (93.82).
Seat 4: pineapplesand (21.45).
Seat 6: IlxxxlI (23.74).
Seat 7: Daggens (56.52).
Seat 8: VegasMike420 (51.54).
Seat 9: solasso (25).
Player VegasMike420 has small blind (0.25)
Player solasso has big blind (0.50)
Player IlxxxlI received card: [6c]
Player IlxxxlI received card: [Jh]
Player Haid Dasalami folds
Player BBDub27 folds
Player sr86 raises (1.50)
Player pineapplesand folds
Player IlxxxlI folds
Player Daggens calls (1.50)
Player VegasMike420 folds
Player solasso calls (1)
*** FLOP ***: [6h Ac 10s]
Player solasso checks
Player sr86 bets (3)
Player Daggens folds
Player solasso folds
Uncalled bet (3) returned to sr86
Player sr86 mucks cards
------ Summary ------
Pot: 4.52. Rake 0.17. JP fee 0.06
Board: [6h Ac 10s]
Player Haid Dasalami does not show cards.Bets: 0. Collects: 0. Wins: 0.
Player BBDub27 does not show cards.Bets: 0. Collects: 0. Wins: 0.
*Player sr86 mucks (does not show cards). Bets: 1.50. Collects: 4.52. Wins: 3.02.
Player pineapplesand does not show cards.Bets: 0. Collects: 0. Wins: 0.
Player IlxxxlI does not show cards.Bets: 0. Collects: 0. Wins: 0.
Player Daggens does not show cards.Bets: 1.50. Collects: 0. Loses: 1.50.
Player VegasMike420 does not show cards.Bets: 0.25. Collects: 0. Loses: 0.25.
Player solasso does not show cards.Bets: 1.50. Collects: 0. Loses: 1.50.
Game ended at: 2016/11/21 10:56:24

Game started
Game ID: 780955654 0.25/0.50 (PRR) Garuda (Short) (Hold'em)
Seat 2 is the button
Seat 1: haroldbb (30.67).
Seat 2: sr86 (25.42).
Seat 3: IlxxxlI (12.92).
Seat 4: WICHONSKI (44.08).
Seat 6: parmele (18).
Seat 7: ChrisNola (50.71).
Seat 8: iflopznuts (57.81).
Seat 9: FirstClan (25).
Player IlxxxlI has small blind (0.25)
Player WICHONSKI has big blind (0.50)
Player IlxxxlI received card: [Ks]
Player IlxxxlI received card: [9d]
Player parmele folds
Player ChrisNola folds
Player iflopznuts calls (0.50)
Player FirstClan folds
Player haroldbb folds
Player sr86 folds
Player IlxxxlI folds
Player WICHONSKI raises (0.50)
Player iflopznuts calls (0.50)
*** FLOP ***: [10c 4c Jc]
Player WICHONSKI checks
Player iflopznuts checks
*** TURN ***: [10c 4c Jc] [3h]
Player WICHONSKI checks
Player iflopznuts checks
*** RIVER ***: [10c 4c Jc 3h] [10d]
Player WICHONSKI bets (0.50)
Player iflopznuts raises (3)
Player WICHONSKI folds
Uncalled bet (2.50) returned to iflopznuts
Player iflopznuts mucks cards
------ Summary ------
Pot: 3.09. Rake 0.12. JP fee 0.04
Board: [10c 4c Jc 3h 10d]
Player haroldbb does not show cards.Bets: 0. Collects: 0. Wins: 0.
Player sr86 does not show cards.Bets: 0. Collects: 0. Wins: 0.
Player IlxxxlI does not show cards.Bets: 0.25. Collects: 0. Loses: 0.25.
Player WICHONSKI does not show cards.Bets: 1.50. Collects: 0. Loses: 1.50.
Player parmele does not show cards.Bets: 0. Collects: 0. Wins: 0.
Player ChrisNola does not show cards.Bets: 0. Collects: 0. Wins: 0.
*Player iflopznuts mucks (does not show cards). Bets: 1.50. Collects: 3.09. Wins: 1.59.
Player FirstClan does not show cards.Bets: 0. Collects: 0. Wins: 0.
Game ended at: 2016/11/21 10:56:19

Game started
Game ID: 780955508 0.25/0.50 (PRR) Garuda (Hold'em)
Seat 6 is the button
Seat 1: Haid Dasalami (49.73).
Seat 2: BBDub27 (81.35).
Seat 3: sr86 (93.82).
Seat 4: pineapplesand (21.45).
Seat 6: IlxxxlI (23.74).
Seat 7: Daggens (56.02).
Seat 8: VegasMike420 (52.04).
Player Daggens has small blind (0.25)
Player VegasMike420 has big blind (0.50)
Player IlxxxlI received card: [2s]
Player IlxxxlI received card: [4c]
Player Haid Dasalami folds
Player BBDub27 folds
Player sr86 folds
Player pineapplesand folds
Player IlxxxlI folds
Player Daggens raises (1.25)
Player VegasMike420 folds
Uncalled bet (1) returned to Daggens
Player Daggens mucks cards
------ Summary ------
Pot: 1. Rake 0
Player Haid Dasalami does not show cards.Bets: 0. Collects: 0. Wins: 0.
Player BBDub27 does not show cards.Bets: 0. Collects: 0. Wins: 0.
Player sr86 does not show cards.Bets: 0. Collects: 0. Wins: 0.
Player pineapplesand does not show cards.Bets: 0. Collects: 0. Wins: 0.
Player IlxxxlI does not show cards.Bets: 0. Collects: 0. Wins: 0.
*Player Daggens mucks (does not show cards). Bets: 0.50. Collects: 1. Wins: 0.50.
Player VegasMike420 does not show cards.Bets: 0.50. Collects: 0. Loses: 0.50.
Game ended at: 2016/11/21 10:55:23

Game started
Game ID: 780954174 0.25/0.50 (PRR) Garuda (Short) (Hold'em)
Seat 1 is the button
Seat 1: haroldbb (25).
Seat 2: sr86 (25.67).
Seat 3: IlxxxlI (13.42).
Seat 4: WICHONSKI (44.08).
Seat 6: parmele (23.50).
Seat 7: ChrisNola (50.71).
Seat 8: iflopznuts (57.81).
Seat 9: FirstClan (25).
Player sr86 has small blind (0.25)
Player IlxxxlI has big blind (0.50)
Player IlxxxlI received card: [9h]
Player IlxxxlI received card: [8s]
Player WICHONSKI folds
Player parmele calls (0.50)
Player ChrisNola folds
Player iflopznuts folds
Player FirstClan folds
Player haroldbb raises (1)
Player sr86 folds
Player IlxxxlI folds
Player parmele calls (0.50)
*** FLOP ***: [Qc Qs 4s]
Player parmele bets (1)
Player haroldbb calls (1)
*** TURN ***: [Qc Qs 4s] [Js]
Player parmele bets (3.50)
Player haroldbb calls (3.50)
*** RIVER ***: [Qc Qs 4s Js] [Ad]
Player parmele checks
Player haroldbb bets (8)
Player parmele folds
Uncalled bet (8) returned to haroldbb
Player haroldbb mucks cards
------ Summary ------
Pot: 11.17. Rake 0.40. JP fee 0.18
Board: [Qc Qs 4s Js Ad]
*Player haroldbb mucks (does not show cards). Bets: 5.50. Collects: 11.17. Wins: 5.67.
Player sr86 does not show cards.Bets: 0.25. Collects: 0. Loses: 0.25.
Player IlxxxlI does not show cards.Bets: 0.50. Collects: 0. Loses: 0.50.
Player WICHONSKI does not show cards.Bets: 0. Collects: 0. Wins: 0.
Player parmele does not show cards.Bets: 5.50. Collects: 0. Loses: 5.50.
Player ChrisNola does not show cards.Bets: 0. Collects: 0. Wins: 0.
Player iflopznuts does not show cards.Bets: 0. Collects: 0. Wins: 0.
Player FirstClan does not show cards.Bets: 0. Collects: 0. Wins: 0.
Game ended at: 2016/11/21 10:55:12

Game started
Game ID: 780954071 0.25/0.50 (PRR) Garuda (Hold'em)
Seat 5 is the button
Seat 1: Haid Dasalami (49.73).
Seat 2: BBDub27 (81.35).
Seat 3: sr86 (85.99).
Seat 4: pineapplesand (21.45).
Seat 5: PoePoe28 (7.90).
Seat 6: IlxxxlI (23.99).
Seat 7: Daggens (56.52).
Seat 8: VegasMike420 (52.04).
Player IlxxxlI has small blind (0.25)
Player Daggens has big blind (0.50)
Player IlxxxlI received card: [2c]
Player IlxxxlI received card: [7h]
Player VegasMike420 folds
Player Haid Dasalami folds
Player BBDub27 folds
Player sr86 raises (1.50)
Player pineapplesand folds
Player PoePoe28 calls (1.50)
Player IlxxxlI folds
Player Daggens folds
*** FLOP ***: [4c 6c Js]
Player sr86 checks
Player PoePoe28 checks
*** TURN ***: [4c 6c Js] [9s]
Player sr86 bets (2)
Player PoePoe28 calls (2)
*** RIVER ***: [4c 6c Js 9s] [2h]
Player sr86 bets (5)
Player PoePoe28 allin (4.40)
Uncalled bet (0.60) returned to sr86
------ Summary ------
Pot: 15.73. Rake 0.58. JP fee 0.24
Board: [4c 6c Js 9s 2h]
Player Haid Dasalami does not show cards.Bets: 0. Collects: 0. Wins: 0.
Player BBDub27 does not show cards.Bets: 0. Collects: 0. Wins: 0.
*Player sr86 shows: Three Of Kind of Js [Jh Jc]. Bets: 7.90. Collects: 15.73. Wins: 7.83.
Player pineapplesand does not show cards.Bets: 0. Collects: 0. Wins: 0.
Player PoePoe28 shows: One pair of 6s [6h 8s]. Bets: 7.90. Collects: 0. Loses: 7.90.
Player IlxxxlI does not show cards.Bets: 0.25. Collects: 0. Loses: 0.25.
Player Daggens does not show cards.Bets: 0.50. Collects: 0. Loses: 0.50.
Player VegasMike420 does not show cards.Bets: 0. Collects: 0. Wins: 0.
Game ended at: 2016/11/21 10:54:55

Game started
Game ID: 780953330 0.25/0.50 (PRR) Garuda (Short) (Hold'em)
Seat 9 is the button
Seat 1: haroldbb (25).
Seat 2: sr86 (26.17).
Seat 3: IlxxxlI (13.42).
Seat 4: WICHONSKI (44.08).
Seat 6: parmele (23.50).
Seat 7: ChrisNola (50.71).
Seat 8: iflopznuts (57.12).
Seat 9: FirstClan (25).
Player haroldbb has small blind (0.25)
Player sr86 has big blind (0.50)
Player IlxxxlI received card: [10d]
Player IlxxxlI received card: [3h]
Player IlxxxlI folds
Player WICHONSKI folds
Player parmele folds
Player ChrisNola folds
Player iflopznuts calls (0.50)
Player FirstClan folds
Player haroldbb folds
Player sr86 checks
*** FLOP ***: [Qh 3d Js]
Player sr86 checks
Player iflopznuts bets (1)
Player sr86 folds
Uncalled bet (1) returned to iflopznuts
Player iflopznuts mucks cards
------ Summary ------
Pot: 1.19. Rake 0.04. JP fee 0.02
Board: [Qh 3d Js]
Player haroldbb does not show cards.Bets: 0.25. Collects: 0. Loses: 0.25.
Player sr86 does not show cards.Bets: 0.50. Collects: 0. Loses: 0.50.
Player IlxxxlI does not show cards.Bets: 0. Collects: 0. Wins: 0.
Player WICHONSKI does not show cards.Bets: 0. Collects: 0. Wins: 0.
Player parmele does not show cards.Bets: 0. Collects: 0. Wins: 0.
Player ChrisNola does not show cards.Bets: 0. Collects: 0. Wins: 0.
*Player iflopznuts mucks (does not show cards). Bets: 0.50. Collects: 1.19. Wins: 0.69.
Player FirstClan does not show cards.Bets: 0. Collects: 0. Wins: 0.
Game ended at: 2016/11/21 10:53:27

Game started
Game ID: 780953319 0.25/0.50 (PRR) Garuda (Hold'em)
Seat 4 is the button
Seat 1: Haid Dasalami (48.50).
Seat 2: BBDub27 (80.60).
Seat 3: sr86 (85.99).
Seat 4: pineapplesand (21.45).
Seat 5: PoePoe28 (8.15).
Seat 6: IlxxxlI (24.49).
Seat 7: Daggens (56.52).
Seat 8: VegasMike420 (52.04).
Player PoePoe28 has small blind (0.25)
Player IlxxxlI has big blind (0.50)
Player IlxxxlI received card: [4h]
Player IlxxxlI received card: [6s]
Player Daggens folds
Player VegasMike420 folds
Player Haid Dasalami folds
Player BBDub27 raises (1.50)
Player sr86 folds
Player pineapplesand folds
Player PoePoe28 folds
Player IlxxxlI folds
Uncalled bet (1) returned to BBDub27
Player BBDub27 mucks cards
------ Summary ------
Pot: 1.25. Rake 0
Player Haid Dasalami does not show cards.Bets: 0. Collects: 0. Wins: 0.
*Player BBDub27 mucks (does not show cards). Bets: 0.50. Collects: 1.25. Wins: 0.75.
Player sr86 does not show cards.Bets: 0. Collects: 0. Wins: 0.
Player pineapplesand does not show cards.Bets: 0. Collects: 0. Wins: 0.
Player PoePoe28 does not show cards.Bets: 0.25. Collects: 0. Loses: 0.25.
Player IlxxxlI does not show cards.Bets: 0.50. Collects: 0. Loses: 0.50.
Player Daggens does not show cards.Bets: 0. Collects: 0. Wins: 0.
Player VegasMike420 does not show cards.Bets: 0. Collects: 0. Wins: 0.
Game ended at: 2016/11/21 10:53:19

Game started
Game ID: 780952445 0.25/0.50 (PRR) Garuda (Short) (Hold'em)
Seat 8 is the button
Seat 1: haroldbb (25).
Seat 2: sr86 (26.17).
Seat 3: IlxxxlI (13.42).
Seat 4: WICHONSKI (44.08).
Seat 5: Brucelegend (18.23).
Seat 6: parmele (23.50).
Seat 7: ChrisNola (33.59).
Seat 8: iflopznuts (57.12).
Seat 9: FirstClan (25).
Player FirstClan has small blind (0.25)
Player haroldbb has big blind (0.50)
Player IlxxxlI received card: [4h]
Player IlxxxlI received card: [Ah]
Player sr86 folds
Player IlxxxlI folds
Player WICHONSKI folds
Player Brucelegend raises (1)
Player parmele folds
Player ChrisNola raises (3.50)
Player iflopznuts folds
Player FirstClan folds
Player haroldbb folds
Player Brucelegend calls (2.50)
*** FLOP ***: [Jc 2s 9h]
Player Brucelegend checks
Player ChrisNola bets (5)
Player Brucelegend calls (5)
*** TURN ***: [Jc 2s 9h] [4s]
Player Brucelegend checks
Player ChrisNola bets (11.24)
Player Brucelegend allin (9.73)
Uncalled bet (1.51) returned to ChrisNola
*** RIVER ***: [Jc 2s 9h 4s] [Ad]
------ Summary ------
Pot: 35.35. Rake 1.62. JP fee 0.24
Board: [Jc 2s 9h 4s Ad]
Player haroldbb does not show cards.Bets: 0.50. Collects: 0. Loses: 0.50.
Player sr86 does not show cards.Bets: 0. Collects: 0. Wins: 0.
Player IlxxxlI does not show cards.Bets: 0. Collects: 0. Wins: 0.
Player WICHONSKI does not show cards.Bets: 0. Collects: 0. Wins: 0.
Player Brucelegend shows: High card A [Qc 10h]. Bets: 18.23. Collects: 0. Loses: 18.23.
Player parmele does not show cards.Bets: 0. Collects: 0. Wins: 0.
*Player ChrisNola shows: One pair of Ks [Kd Ks]. Bets: 18.23. Collects: 35.35. Wins: 17.12.
Player iflopznuts does not show cards.Bets: 0. Collects: 0. Wins: 0.
Player FirstClan does not show cards.Bets: 0.25. Collects: 0. Loses: 0.25.
Game ended at: 2016/11/21 10:52:30

Game started
Game ID: 780952330 0.25/0.50 (PRR) Garuda (Hold'em)
Seat 3 is the button
Seat 1: Haid Dasalami (48.50).
Seat 2: BBDub27 (80.60).
Seat 3: sr86 (90.15).
Seat 4: pineapplesand (21.70).
Seat 5: PoePoe28 (4.16).
Seat 6: IlxxxlI (24.49).
Seat 7: Daggens (56.52).
Seat 8: VegasMike420 (52.04).
Player pineapplesand has small blind (0.25)
Player PoePoe28 has big blind (0.50)
Player IlxxxlI received card: [7c]
Player IlxxxlI received card: [2h]
Player IlxxxlI folds
Player Daggens folds
Player VegasMike420 folds
Player Haid Dasalami folds
Player BBDub27 folds
Player sr86 raises (1.50)
Player pineapplesand folds
Player PoePoe28 allin (3.66)
Player sr86 calls (2.66)
*** FLOP ***: [4c 5h 2c]
*** TURN ***: [4c 5h 2c] [Qd]
*** RIVER ***: [4c 5h 2c Qd] [3d]
------ Summary ------
Pot: 8.15. Rake 0.28. JP fee 0.14
Board: [4c 5h 2c Qd 3d]
Player Haid Dasalami does not show cards.Bets: 0. Collects: 0. Wins: 0.
Player BBDub27 does not show cards.Bets: 0. Collects: 0. Wins: 0.
Player sr86 shows: One pair of 5s [Kd 5d]. Bets: 4.16. Collects: 0. Loses: 4.16.
Player pineapplesand does not show cards.Bets: 0.25. Collects: 0. Loses: 0.25.
*Player PoePoe28 shows: Straight to 6 [Ah 6s]. Bets: 4.16. Collects: 8.15. Wins: 3.99.
Player IlxxxlI does not show cards.Bets: 0. Collects: 0. Wins: 0.
Player Daggens does not show cards.Bets: 0. Collects: 0. Wins: 0.
Player VegasMike420 does not show cards.Bets: 0. Collects: 0. Wins: 0.
Game ended at: 2016/11/21 10:52:30

Game started
Game ID: 780951685 0.25/0.50 (PRR) Garuda (Short) (Hold'em)
Seat 7 is the button
Seat 2: sr86 (26.17).
Seat 3: IlxxxlI (10).
Seat 4: WICHONSKI (44.08).
Seat 5: Brucelegend (21.23).
Seat 6: parmele (23.50).
Seat 7: ChrisNola (33.59).
Seat 8: iflopznuts (57.37).
Seat 9: FirstClan (25).
Player iflopznuts has small blind (0.25)
Player FirstClan has big blind (0.50)
Player IlxxxlI received card: [Qs]
Player IlxxxlI received card: [Kc]
Player sr86 folds
Player IlxxxlI raises (1)
Player WICHONSKI folds
Player Brucelegend calls (1)
Player parmele folds
Player ChrisNola folds
Player iflopznuts folds
Player FirstClan folds
*** FLOP ***: [Qc 10d Qh]
Player IlxxxlI bets (0.50)
Player Brucelegend calls (0.50)
*** TURN ***: [Qc 10d Qh] [Ks]
Player IlxxxlI bets (1.50)
Player Brucelegend calls (1.50)
*** RIVER ***: [Qc 10d Qh Ks] [2s]
Player IlxxxlI allin (7)
Player Brucelegend folds
Uncalled bet (7) returned to IlxxxlI
Player IlxxxlI mucks cards
------ Summary ------
Pot: 6.42. Rake 0.23. JP fee 0.10
Board: [Qc 10d Qh Ks 2s]
Player sr86 does not show cards.Bets: 0. Collects: 0. Wins: 0.
*Player IlxxxlI mucks (does not show cards). Bets: 3. Collects: 6.42. Wins: 3.42.
Player WICHONSKI does not show cards.Bets: 0. Collects: 0. Wins: 0.
Player Brucelegend does not show cards.Bets: 3. Collects: 0. Loses: 3.
Player parmele does not show cards.Bets: 0. Collects: 0. Wins: 0.
Player ChrisNola does not show cards.Bets: 0. Collects: 0. Wins: 0.
Player iflopznuts does not show cards.Bets: 0.25. Collects: 0. Loses: 0.25.
Player FirstClan does not show cards.Bets: 0.50. Collects: 0. Loses: 0.50.
Game ended at: 2016/11/21 10:51:35

Game started
Game ID: 780950845 0.25/0.50 (PRR) Garuda (Hold'em)
Seat 2 is the button
Seat 1: Haid Dasalami (48.50).
Seat 2: BBDub27 (82.60).
Seat 3: sr86 (50).
Seat 4: pineapplesand (22.20).
Seat 5: PoePoe28 (6.16).
Seat 6: IlxxxlI (24.49).
Seat 7: Daggens (56.52).
Seat 8: VegasMike420 (52.04).
Seat 9: Mestre83 (38.65).
Player sr86 has small blind (0.25)
Player pineapplesand has big blind (0.50)
Player IlxxxlI received card: [7c]
Player IlxxxlI received card: [Qc]
Player PoePoe28 calls (0.50)
Player IlxxxlI folds
Player Daggens folds
Player VegasMike420 folds
Player Mestre83 raises (2)
Player Haid Dasalami folds
Player BBDub27 calls (2)
Player sr86 calls (1.75)
Player pineapplesand folds
Player PoePoe28 calls (1.50)
*** FLOP ***: [3d 2d 9c]
Player sr86 checks
Player PoePoe28 checks
Player Mestre83 bets (4.50)
Player BBDub27 folds
Player sr86 raises (15.50)
Player PoePoe28 folds
Player Mestre83 allin (32.15)
Player sr86 calls (21.15)
*** TURN ***: [3d 2d 9c] [7s]
*** RIVER ***: [3d 2d 9c 7s] [Ac]
------ Summary ------
Pot: 78.80. Rake 2.76. JP fee 0.24
Board: [3d 2d 9c 7s Ac]
Player Haid Dasalami does not show cards.Bets: 0. Collects: 0. Wins: 0.
Player BBDub27 does not show cards.Bets: 2. Collects: 0. Loses: 2.
*Player sr86 shows: One pair of As [5d Ad]. Bets: 38.65. Collects: 78.80. Wins: 40.15.
Player pineapplesand does not show cards.Bets: 0.50. Collects: 0. Loses: 0.50.
Player PoePoe28 does not show cards.Bets: 2. Collects: 0. Loses: 2.
Player IlxxxlI does not show cards.Bets: 0. Collects: 0. Wins: 0.
Player Daggens does not show cards.Bets: 0. Collects: 0. Wins: 0.
Player VegasMike420 does not show cards.Bets: 0. Collects: 0. Wins: 0.
Player Mestre83 shows: One pair of 10s [10s 10c]. Bets: 38.65. Collects: 0. Loses: 38.65.
Game ended at: 2016/11/21 10:51:26

Game started
Game ID: 780950400 0.25/0.50 (PRR) Garuda (Hold'em)
Seat 1 is the button
Seat 1: Haid Dasalami (47.75).
Seat 2: BBDub27 (82.85).
Seat 3: sr86 (50).
Seat 4: pineapplesand (22.20).
Seat 5: PoePoe28 (6.16).
Seat 6: IlxxxlI (24.49).
Seat 7: Daggens (56.52).
Seat 8: VegasMike420 (52.04).
Seat 9: Mestre83 (38.65).
Player BBDub27 has small blind (0.25)
Player sr86 has big blind (0.50)
Player IlxxxlI received card: [9s]
Player IlxxxlI received card: [6d]
Player pineapplesand folds
Player PoePoe28 folds
Player IlxxxlI folds
Player Daggens folds
Player VegasMike420 folds
Player Mestre83 folds
Player Haid Dasalami raises (1.50)
Player BBDub27 folds
Player sr86 folds
Uncalled bet (1) returned to Haid Dasalami
Player Haid Dasalami mucks cards
------ Summary ------
Pot: 1.25. Rake 0
*Player Haid Dasalami mucks (does not show cards). Bets: 0.50. Collects: 1.25. Wins: 0.75.
Player BBDub27 does not show cards.Bets: 0.25. Collects: 0. Loses: 0.25.
Player sr86 does not show cards.Bets: 0.50. Collects: 0. Loses: 0.50.
Player pineapplesand does not show cards.Bets: 0. Collects: 0. Wins: 0.
Player PoePoe28 does not show cards.Bets: 0. Collects: 0. Wins: 0.
Player IlxxxlI does not show cards.Bets: 0. Collects: 0. Wins: 0.
Player Daggens does not show cards.Bets: 0. Collects: 0. Wins: 0.
Player VegasMike420 does not show cards.Bets: 0. Collects: 0. Wins: 0.
Player Mestre83 does not show cards.Bets: 0. Collects: 0. Wins: 0.
Game ended at: 2016/11/21 10:49:51

Game started
Game ID: 780950147 0.25/0.50 (PRR) Garuda (Short) (Hold'em)
Seat 6 is the button
Seat 2: sr86 (26.17).
Seat 3: IlxxxlI (10).
Seat 4: WICHONSKI (44.58).
Seat 5: Brucelegend (24.25).
Seat 6: parmele (23.50).
Seat 7: ChrisNola (29.92).
Seat 8: iflopznuts (57.87).
Seat 9: FirstClan (25).
Player ChrisNola has small blind (0.25)
Player iflopznuts has big blind (0.50)
Player IlxxxlI received card: [8c]
Player IlxxxlI received card: [Kh]
Player FirstClan folds
Player sr86 folds
Player IlxxxlI folds
Player WICHONSKI calls (0.50)
Player Brucelegend calls (0.50)
Player parmele folds
Player ChrisNola calls (0.25)
Player iflopznuts checks
*** FLOP ***: [As 6s 2d]
Player ChrisNola checks
Player iflopznuts checks
Player WICHONSKI checks
Player Brucelegend bets (1.26)
Player ChrisNola raises (2.52)
Player iflopznuts folds
Player WICHONSKI folds
Player Brucelegend calls (1.26)
*** TURN ***: [As 6s 2d] [Kd]
Player ChrisNola is timed out.
Player ChrisNola checks
Player Brucelegend checks
*** RIVER ***: [As 6s 2d Kd] [2c]
Player ChrisNola bets (4.46)
Player Brucelegend folds
Uncalled bet (4.46) returned to ChrisNola
Player ChrisNola mucks cards
------ Summary ------
Pot: 6.69. Rake 0.25. JP fee 0.10
Board: [As 6s 2d Kd 2c]
Player sr86 does not show cards.Bets: 0. Collects: 0. Wins: 0.
Player IlxxxlI does not show cards.Bets: 0. Collects: 0. Wins: 0.
Player WICHONSKI does not show cards.Bets: 0.50. Collects: 0. Loses: 0.50.
Player Brucelegend does not show cards.Bets: 3.02. Collects: 0. Loses: 3.02.
Player parmele does not show cards.Bets: 0. Collects: 0. Wins: 0.
*Player ChrisNola mucks (does not show cards). Bets: 3.02. Collects: 6.69. Wins: 3.67.
Player iflopznuts does not show cards.Bets: 0.50. Collects: 0. Loses: 0.50.
Player FirstClan does not show cards.Bets: 0. Collects: 0. Wins: 0.
Game ended at: 2016/11/21 10:50:45

Game started
Game ID: 780949821 0.25/0.50 (PRR) Garuda (Hold'em)
Seat 9 is the button
Seat 1: Haid Dasalami (48).
Seat 2: BBDub27 (84.85).
Seat 4: pineapplesand (22.20).
Seat 5: PoePoe28 (6.16).
Seat 6: IlxxxlI (24.49).
Seat 7: Daggens (56.52).
Seat 8: VegasMike420 (50).
Seat 9: Mestre83 (38.65).
Player Haid Dasalami has small blind (0.25)
Player BBDub27 has big blind (0.50)
Player VegasMike420 posts (0.25)
Player IlxxxlI received card: [2s]
Player IlxxxlI received card: [7h]
Player pineapplesand folds
Player PoePoe28 folds
Player IlxxxlI folds
Player Daggens folds
Player VegasMike420 raises (1.75)
Player Mestre83 folds
Player Haid Dasalami folds
Player BBDub27 calls (1.50)
*** FLOP ***: [4c 4d 6h]
Player BBDub27 checks
Player VegasMike420 bets (5)
Player BBDub27 folds
Uncalled bet (5) returned to VegasMike420
Player VegasMike420 mucks cards
------ Summary ------
Pot: 4.04. Rake 0.15. JP fee 0.06
Board: [4c 4d 6h]
Player Haid Dasalami does not show cards.Bets: 0.25. Collects: 0. Loses: 0.25.
Player BBDub27 does not show cards.Bets: 2. Collects: 0. Loses: 2.
Player pineapplesand does not show cards.Bets: 0. Collects: 0. Wins: 0.
Player PoePoe28 does not show cards.Bets: 0. Collects: 0. Wins: 0.
Player IlxxxlI does not show cards.Bets: 0. Collects: 0. Wins: 0.
Player Daggens does not show cards.Bets: 0. Collects: 0. Wins: 0.
*Player VegasMike420 mucks (does not show cards). Bets: 2. Collects: 4.04. Wins: 2.04.
Player Mestre83 does not show cards.Bets: 0. Collects: 0. Wins: 0.
Game ended at: 2016/11/21 10:49:21

Game started
Game ID: 780949347 0.25/0.50 (PRR) Garuda (Short) (Hold'em)
Seat 5 is the button
Seat 2: sr86 (26.17).
Seat 3: IlxxxlI (10).
Seat 4: WICHONSKI (44.58).
Seat 5: Brucelegend (24.25).
Seat 6: parmele (24.50).
Seat 7: ChrisNola (27.21).
Seat 8: iflopznuts (59.82).
Seat 9: FirstClan (25).
Player parmele has small blind (0.25)
Player ChrisNola has big blind (0.50)
Player IlxxxlI received card: [Js]
Player IlxxxlI received card: [7c]
Player iflopznuts raises (1)
Player FirstClan folds
Player sr86 folds
Player IlxxxlI folds
Player WICHONSKI folds
Player Brucelegend folds
Player parmele calls (0.75)
Player ChrisNola calls (0.50)
*** FLOP ***: [3c 8h Jc]
Player parmele checks
Player ChrisNola checks
Player iflopznuts checks
*** TURN ***: [3c 8h Jc] [9h]
Player parmele checks
Player ChrisNola bets (0.95)
Player iflopznuts calls (0.95)
Player parmele folds
*** RIVER ***: [3c 8h Jc 9h] [4c]
Player ChrisNola bets (2.50)
Player iflopznuts folds
Uncalled bet (2.50) returned to ChrisNola
Player ChrisNola mucks cards
------ Summary ------
Pot: 4.66. Rake 0.16. JP fee 0.08
Board: [3c 8h Jc 9h 4c]
Player sr86 does not show cards.Bets: 0. Collects: 0. Wins: 0.
Player IlxxxlI does not show cards.Bets: 0. Collects: 0. Wins: 0.
Player WICHONSKI does not show cards.Bets: 0. Collects: 0. Wins: 0.
Player Brucelegend does not show cards.Bets: 0. Collects: 0. Wins: 0.
Player parmele does not show cards.Bets: 1. Collects: 0. Loses: 1.
*Player ChrisNola mucks (does not show cards). Bets: 1.95. Collects: 4.66. Wins: 2.71.
Player iflopznuts does not show cards.Bets: 1.95. Collects: 0. Loses: 1.95.
Player FirstClan does not show cards.Bets: 0. Collects: 0. Wins: 0.
Game ended at: 2016/11/21 10:49:5

Game started
Game ID: 780948660 0.25/0.50 (PRR) Garuda (Hold'em)
Seat 7 is the button
Seat 1: Haid Dasalami (48.50).
Seat 2: BBDub27 (84.85).
Seat 4: pineapplesand (22.20).
Seat 5: PoePoe28 (6.66).
Seat 6: IlxxxlI (24.49).
Seat 7: Daggens (56.52).
Seat 9: Mestre83 (37.72).
Player Mestre83 has small blind (0.25)
Player Haid Dasalami has big blind (0.50)
Player IlxxxlI received card: [2s]
Player IlxxxlI received card: [8d]
Player BBDub27 folds
Player pineapplesand folds
Player PoePoe28 calls (0.50)
Player IlxxxlI folds
Player Daggens folds
Player Mestre83 calls (0.25)
Player Haid Dasalami checks
*** FLOP ***: [10d 3c Qs]
Player Mestre83 checks
Player Haid Dasalami checks
Player PoePoe28 checks
*** TURN ***: [10d 3c Qs] [5d]
Player Mestre83 checks
Player Haid Dasalami checks
Player PoePoe28 checks
*** RIVER ***: [10d 3c Qs 5d] [3s]
Player Mestre83 bets (1.50)
Player Haid Dasalami folds
Player PoePoe28 folds
Uncalled bet (1.50) returned to Mestre83
Player Mestre83 mucks cards
------ Summary ------
Pot: 1.43. Rake 0.05. JP fee 0.02
Board: [10d 3c Qs 5d 3s]
Player Haid Dasalami does not show cards.Bets: 0.50. Collects: 0. Loses: 0.50.
Player BBDub27 does not show cards.Bets: 0. Collects: 0. Wins: 0.
Player pineapplesand does not show cards.Bets: 0. Collects: 0. Wins: 0.
Player PoePoe28 does not show cards.Bets: 0.50. Collects: 0. Loses: 0.50.
Player IlxxxlI does not show cards.Bets: 0. Collects: 0. Wins: 0.
Player Daggens does not show cards.Bets: 0. Collects: 0. Wins: 0.
*Player Mestre83 mucks (does not show cards). Bets: 0.50. Collects: 1.43. Wins: 0.93.
Game ended at: 2016/11/21 10:48:43

Game started
Game ID: 780947953 0.25/0.50 (PRR) Garuda (Short) (Hold'em)
Seat 4 is the button
Seat 2: sr86 (26.17).
Seat 3: IlxxxlI (10).
Seat 4: WICHONSKI (44.58).
Seat 5: Brucelegend (24.50).
Seat 6: parmele (25).
Seat 7: ChrisNola (27.21).
Seat 8: iflopznuts (50.10).
Seat 9: FirstClan (25).
Player Brucelegend has small blind (0.25)
Player parmele has big blind (0.50)
Player IlxxxlI received card: [Qs]
Player IlxxxlI received card: [Ks]
Player ChrisNola is timed out.
Player ChrisNola folds
Player iflopznuts calls (0.50)
Player FirstClan folds
Player sr86 folds
Player IlxxxlI raises (1.50)
Player WICHONSKI folds
Player Brucelegend folds
Player parmele folds
Player iflopznuts calls (1)
*** FLOP ***: [Qh 9s 10s]
Player iflopznuts checks
Player IlxxxlI bets (2.50)
Player iflopznuts raises (8.50)
Player IlxxxlI allin (6)
*** TURN ***: [Qh 9s 10s] [4h]
*** RIVER ***: [Qh 9s 10s 4h] [2c]
------ Summary ------
Pot: 19.72. Rake 0.79. JP fee 0.24
Board: [Qh 9s 10s 4h 2c]
Player sr86 does not show cards.Bets: 0. Collects: 0. Wins: 0.
Player IlxxxlI shows: One pair of Qs [Qs Ks]. Bets: 10. Collects: 0. Loses: 10.
Player WICHONSKI does not show cards.Bets: 0. Collects: 0. Wins: 0.
Player Brucelegend does not show cards.Bets: 0.25. Collects: 0. Loses: 0.25.
Player parmele does not show cards.Bets: 0.50. Collects: 0. Loses: 0.50.
Player ChrisNola does not show cards.Bets: 0. Collects: 0. Wins: 0.
*Player iflopznuts shows: Straight to Q [8s Jc]. Bets: 10. Collects: 19.72. Wins: 9.72.
Player FirstClan does not show cards.Bets: 0. Collects: 0. Wins: 0.
Game ended at: 2016/11/21 10:48:10

Game started
Game ID: 780946776 0.25/0.50 (PRR) Garuda (Hold'em)
Seat 6 is the button
Seat 1: Haid Dasalami (48.50).
Seat 2: BBDub27 (67.22).
Seat 4: pineapplesand (22.20).
Seat 5: PoePoe28 (6.66).
Seat 6: IlxxxlI (24.49).
Seat 7: Daggens (58.02).
Seat 8: VegasMike420 (18).
Seat 9: Mestre83 (37.72).
Player Daggens has small blind (0.25)
Player VegasMike420 has big blind (0.50)
Player IlxxxlI received card: [3h]
Player IlxxxlI received card: [8s]
Player Mestre83 folds
Player Haid Dasalami folds
Player BBDub27 raises (1.50)
Player pineapplesand folds
Player PoePoe28 folds
Player IlxxxlI folds
Player Daggens calls (1.25)
Player VegasMike420 calls (1)
*** FLOP ***: [Qh Jc Kh]
Player Daggens checks
Player VegasMike420 checks
Player BBDub27 bets (3)
Player Daggens folds
Player VegasMike420 raises (6)
Player BBDub27 calls (3)
*** TURN ***: [Qh Jc Kh] [4c]
Player VegasMike420 bets (5.22)
Player BBDub27 calls (5.22)
*** RIVER ***: [Qh Jc Kh 4c] [9h]
Player VegasMike420 allin (5.28)
Player BBDub27 calls (5.28)
------ Summary ------
Pot: 35.63. Rake 1.63. JP fee 0.24
Board: [Qh Jc Kh 4c 9h]
Player Haid Dasalami does not show cards.Bets: 0. Collects: 0. Wins: 0.
*Player BBDub27 shows: Straight to K [Qc 10s]. Bets: 18. Collects: 35.63. Wins: 17.63.
Player pineapplesand does not show cards.Bets: 0. Collects: 0. Wins: 0.
Player PoePoe28 does not show cards.Bets: 0. Collects: 0. Wins: 0.
Player IlxxxlI does not show cards.Bets: 0. Collects: 0. Wins: 0.
Player Daggens does not show cards.Bets: 1.50. Collects: 0. Loses: 1.50.
Player VegasMike420 shows: One pair of Js [5d Js]. Bets: 18. Collects: 0. Loses: 18.
Player Mestre83 does not show cards.Bets: 0. Collects: 0. Wins: 0.
Game ended at: 2016/11/21 10:47:24

Game started
Game ID: 780946708 0.25/0.50 (PRR) Garuda (Short) (Hold'em)
Seat 3 is the button
Seat 2: sr86 (26.17).
Seat 3: IlxxxlI (10).
Seat 4: WICHONSKI (42.75).
Seat 5: Brucelegend (25).
Seat 7: ChrisNola (27.21).
Seat 8: iflopznuts (51.60).
Seat 9: FirstClan (25).
Player WICHONSKI has small blind (0.25)
Player Brucelegend has big blind (0.50)
Player IlxxxlI received card: [8s]
Player IlxxxlI received card: [3d]
Player ChrisNola folds
Player iflopznuts raises (1.50)
Player FirstClan folds
Player sr86 folds
Player IlxxxlI folds
Player WICHONSKI calls (1.25)
Player Brucelegend folds
*** FLOP ***: [6d 6s 7h]
Player WICHONSKI checks
Player iflopznuts checks
*** TURN ***: [6d 6s 7h] [As]
Player WICHONSKI checks
Player iflopznuts checks
*** RIVER ***: [6d 6s 7h As] [Qc]
Player WICHONSKI bets (3.26)
Player iflopznuts folds
Uncalled bet (3.26) returned to WICHONSKI
Player WICHONSKI mucks cards
------ Summary ------
Pot: 3.33. Rake 0.13. JP fee 0.04
Board: [6d 6s 7h As Qc]
Player sr86 does not show cards.Bets: 0. Collects: 0. Wins: 0.
Player IlxxxlI does not show cards.Bets: 0. Collects: 0. Wins: 0.
*Player WICHONSKI mucks (does not show cards). Bets: 1.50. Collects: 3.33. Wins: 1.83.
Player Brucelegend does not show cards.Bets: 0.50. Collects: 0. Loses: 0.50.
Player ChrisNola does not show cards.Bets: 0. Collects: 0. Wins: 0.
Player iflopznuts does not show cards.Bets: 1.50. Collects: 0. Loses: 1.50.
Player FirstClan does not show cards.Bets: 0. Collects: 0. Wins: 0.
Game ended at: 2016/11/21 10:46:41

Game started
Game ID: 780946313 0.25/0.50 (PRR) Garuda (Short) (Hold'em)
Seat 2 is the button
Seat 2: sr86 (26.17).
Seat 3: IlxxxlI (10).
Seat 4: WICHONSKI (43.25).
Seat 7: ChrisNola (27.21).
Seat 8: iflopznuts (50.91).
Seat 9: FirstClan (25).
Player IlxxxlI has small blind (0.25)
Player WICHONSKI has big blind (0.50)
Player IlxxxlI received card: [Kc]
Player IlxxxlI received card: [5s]
Player ChrisNola folds
Player iflopznuts calls (0.50)
Player FirstClan folds
Player sr86 folds
Player IlxxxlI folds
Player WICHONSKI checks
*** FLOP ***: [9c Qs 6h]
Player WICHONSKI checks
Player iflopznuts bets (1)
Player WICHONSKI folds
Uncalled bet (1) returned to iflopznuts
Player iflopznuts mucks cards
------ Summary ------
Pot: 1.19. Rake 0.04. JP fee 0.02
Board: [9c Qs 6h]
Player sr86 does not show cards.Bets: 0. Collects: 0. Wins: 0.
Player IlxxxlI does not show cards.Bets: 0.25. Collects: 0. Loses: 0.25.
Player WICHONSKI does not show cards.Bets: 0.50. Collects: 0. Loses: 0.50.
Player ChrisNola does not show cards.Bets: 0. Collects: 0. Wins: 0.
*Player iflopznuts mucks (does not show cards). Bets: 0.50. Collects: 1.19. Wins: 0.69.
Player FirstClan does not show cards.Bets: 0. Collects: 0. Wins: 0.
Game ended at: 2016/11/21 10:45:21

Game started
Game ID: 780945533 0.25/0.50 (PRR) Garuda (Hold'em)
Seat 5 is the button
Seat 1: Haid Dasalami (50).
Seat 2: BBDub27 (67.22).
Seat 4: pineapplesand (22.20).
Seat 5: PoePoe28 (8.16).
Seat 6: IlxxxlI (24.74).
Seat 7: Daggens (59.52).
Seat 8: VegasMike420 (18).
Seat 9: Mestre83 (33.28).
Player IlxxxlI has small blind (0.25)
Player Daggens has big blind (0.50)
Player IlxxxlI received card: [Ks]
Player IlxxxlI received card: [8h]
Player VegasMike420 folds
Player Mestre83 raises (1.50)
Player Haid Dasalami calls (1.50)
Player BBDub27 folds
Player pineapplesand folds
Player PoePoe28 calls (1.50)
Player IlxxxlI folds
Player Daggens calls (1)
*** FLOP ***: [4s 9s 3h]
Player Daggens checks
Player Mestre83 bets (3.50)
Player Haid Dasalami folds
Player PoePoe28 folds
Player Daggens folds
Uncalled bet (3.50) returned to Mestre83
Player Mestre83 mucks cards
------ Summary ------
Pot: 5.94. Rake 0.21. JP fee 0.10
Board: [4s 9s 3h]
Player Haid Dasalami does not show cards.Bets: 1.50. Collects: 0. Loses: 1.50.
Player BBDub27 does not show cards.Bets: 0. Collects: 0. Wins: 0.
Player pineapplesand does not show cards.Bets: 0. Collects: 0. Wins: 0.
Player PoePoe28 does not show cards.Bets: 1.50. Collects: 0. Loses: 1.50.
Player IlxxxlI does not show cards.Bets: 0.25. Collects: 0. Loses: 0.25.
Player Daggens does not show cards.Bets: 1.50. Collects: 0. Loses: 1.50.
Player VegasMike420 does not show cards.Bets: 0. Collects: 0. Wins: 0.
*Player Mestre83 mucks (does not show cards). Bets: 1.50. Collects: 5.94. Wins: 4.44.
Game ended at: 2016/11/21 10:45:25

Game started
Game ID: 780945380 0.25/0.50 (PRR) Garuda (Short) (Hold'em)
Seat 9 is the button
Seat 2: sr86 (26.67).
Seat 3: IlxxxlI (10).
Seat 4: WICHONSKI (42.32).
Seat 7: ChrisNola (27.21).
Seat 8: iflopznuts (50.91).
Seat 9: FirstClan (25).
Player sr86 has small blind (0.25)
Player IlxxxlI has big blind (0.50)
Player IlxxxlI received card: [2c]
Player IlxxxlI received card: [Jd]
Player WICHONSKI calls (0.50)
Player ChrisNola folds
Player iflopznuts folds
Player FirstClan folds
Player sr86 calls (0.25)
Player IlxxxlI checks
*** FLOP ***: [Kd Qs 9d]
Player sr86 checks
Player IlxxxlI checks
Player WICHONSKI bets (1)
Player sr86 folds
Player IlxxxlI folds
Uncalled bet (1) returned to WICHONSKI
Player WICHONSKI mucks cards
------ Summary ------
Pot: 1.43. Rake 0.05. JP fee 0.02
Board: [Kd Qs 9d]
Player sr86 does not show cards.Bets: 0.50. Collects: 0. Loses: 0.50.
Player IlxxxlI does not show cards.Bets: 0.50. Collects: 0. Loses: 0.50.
*Player WICHONSKI mucks (does not show cards). Bets: 0.50. Collects: 1.43. Wins: 0.93.
Player ChrisNola does not show cards.Bets: 0. Collects: 0. Wins: 0.
Player iflopznuts does not show cards.Bets: 0. Collects: 0. Wins: 0.
Player FirstClan does not show cards.Bets: 0. Collects: 0. Wins: 0.
Game ended at: 2016/11/21 10:44:55

Game started
Game ID: 780944963 0.25/0.50 (PRR) Garuda (Short) (Hold'em)
Seat 8 is the button
Seat 2: sr86 (27.17).
Seat 3: IlxxxlI (10).
Seat 4: WICHONSKI (41.57).
Seat 7: ChrisNola (27.21).
Seat 8: iflopznuts (50.91).
Seat 9: FirstClan (25).
Player FirstClan has small blind (0.25)
Player sr86 has big blind (0.50)
Player IlxxxlI received card: [7s]
Player IlxxxlI received card: [5d]
Player IlxxxlI folds
Player WICHONSKI raises (1.50)
Player ChrisNola folds
Player iflopznuts folds
Player FirstClan folds
Player sr86 folds
Uncalled bet (1) returned to WICHONSKI
Player WICHONSKI mucks cards
------ Summary ------
Pot: 1.25. Rake 0
Player sr86 does not show cards.Bets: 0.50. Collects: 0. Loses: 0.50.
Player IlxxxlI does not show cards.Bets: 0. Collects: 0. Wins: 0.
*Player WICHONSKI mucks (does not show cards). Bets: 0.50. Collects: 1.25. Wins: 0.75.
Player ChrisNola does not show cards.Bets: 0. Collects: 0. Wins: 0.
Player iflopznuts does not show cards.Bets: 0. Collects: 0. Wins: 0.
Player FirstClan does not show cards.Bets: 0.25. Collects: 0. Loses: 0.25.
Game ended at: 2016/11/21 10:43:54

Game started
Game ID: 780944191 0.25/0.50 (PRR) Garuda (Hold'em)
Seat 4 is the button
Seat 1: Haid Dasalami (50).
Seat 2: BBDub27 (67.22).
Seat 3: sr86 (50).
Seat 4: pineapplesand (22.20).
Seat 5: PoePoe28 (13.42).
Seat 6: IlxxxlI (20).
Seat 7: Daggens (59.52).
Seat 8: VegasMike420 (18).
Seat 9: Mestre83 (33.28).
Player PoePoe28 has small blind (0.25)
Player IlxxxlI has big blind (0.50)
Player sr86 is timed out.
Player sr86 wait BB
Player IlxxxlI received card: [Qd]
Player IlxxxlI received card: [10s]
Player Daggens folds
Player VegasMike420 folds
Player Mestre83 folds
Player Haid Dasalami folds
Player BBDub27 folds
Player pineapplesand folds
Player PoePoe28 calls (0.25)
Player IlxxxlI raises (0.50)
Player PoePoe28 calls (0.50)
*** FLOP ***: [3h 5s Qs]
Player PoePoe28 checks
Player IlxxxlI bets (1.26)
Player PoePoe28 calls (1.26)
*** TURN ***: [3h 5s Qs] [4h]
Player PoePoe28 checks
Player IlxxxlI bets (3)
Player PoePoe28 calls (3)
*** RIVER ***: [3h 5s Qs 4h] [10d]
Player PoePoe28 checks
Player IlxxxlI bets (14.50)
Player PoePoe28 folds
Uncalled bet (14.50) returned to IlxxxlI
Player IlxxxlI mucks cards
------ Summary ------
Pot: 10. Rake 0.36. JP fee 0.16
Board: [3h 5s Qs 4h 10d]
Player Haid Dasalami does not show cards.Bets: 0. Collects: 0. Wins: 0.
Player BBDub27 does not show cards.Bets: 0. Collects: 0. Wins: 0.
Player sr86 does not show cards.Bets: 0. Collects: 0. Wins: 0.
Player pineapplesand does not show cards.Bets: 0. Collects: 0. Wins: 0.
Player PoePoe28 does not show cards.Bets: 5.26. Collects: 0. Loses: 5.26.
*Player IlxxxlI mucks (does not show cards). Bets: 5.26. Collects: 10. Wins: 4.74.
Player Daggens does not show cards.Bets: 0. Collects: 0. Wins: 0.
Player VegasMike420 does not show cards.Bets: 0. Collects: 0. Wins: 0.
Player Mestre83 does not show cards.Bets: 0. Collects: 0. Wins: 0.
Game ended at: 2016/11/21 10:44:4

Game started
Game ID: 780943900 0.25/0.50 (PRR) Garuda (Short) (Hold'em)
Seat 7 is the button
Seat 2: sr86 (31.53).
Seat 3: IlxxxlI (10).
Seat 4: WICHONSKI (36.93).
Seat 7: ChrisNola (27.21).
Seat 8: iflopznuts (51.16).
Seat 9: FirstClan (25).
Player iflopznuts has small blind (0.25)
Player FirstClan has big blind (0.50)
Player IlxxxlI received card: [Ks]
Player IlxxxlI received card: [7s]
Player sr86 raises (1.50)
Player IlxxxlI folds
Player WICHONSKI raises (4.36)
Player ChrisNola folds
Player iflopznuts folds
Player FirstClan folds
Player sr86 calls (2.86)
*** FLOP ***: [Qh Jd 10c]
Player sr86 checks
Player WICHONSKI bets (4.69)
Player sr86 folds
Uncalled bet (4.69) returned to WICHONSKI
Player WICHONSKI mucks cards
------ Summary ------
Pot: 9. Rake 0.33. JP fee 0.14
Board: [Qh Jd 10c]
Player sr86 does not show cards.Bets: 4.36. Collects: 0. Loses: 4.36.
Player IlxxxlI does not show cards.Bets: 0. Collects: 0. Wins: 0.
*Player WICHONSKI mucks (does not show cards). Bets: 4.36. Collects: 9. Wins: 4.64.
Player ChrisNola does not show cards.Bets: 0. Collects: 0. Wins: 0.
Player iflopznuts does not show cards.Bets: 0.25. Collects: 0. Loses: 0.25.
Player FirstClan does not show cards.Bets: 0.50. Collects: 0. Loses: 0.50.
Game ended at: 2016/11/21 10:43:27

Game started
Game ID: 780942558 0.25/0.50 (PRR) Garuda (Short) (Hold'em)
Seat 4 is the button
Seat 2: sr86 (31.53).
Seat 3: IlxxxlI (10).
Seat 4: WICHONSKI (28.36).
Seat 7: ChrisNola (36.20).
Seat 8: iflopznuts (51.66).
Player ChrisNola has small blind (0.25)
Player iflopznuts has big blind (0.50)
Player IlxxxlI received card: [5c]
Player IlxxxlI received card: [10c]
Player sr86 folds
Player IlxxxlI folds
Player WICHONSKI raises (1.50)
Player ChrisNola calls (1.25)
Player iflopznuts folds
*** FLOP ***: [Ad 4s 6s]
Player ChrisNola checks
Player WICHONSKI bets (1.50)
Player ChrisNola calls (1.50)
*** TURN ***: [Ad 4s 6s] [9s]
Player ChrisNola checks
Player WICHONSKI bets (5.99)
Player ChrisNola calls (5.99)
*** RIVER ***: [Ad 4s 6s 9s] [10h]
Player ChrisNola checks
Player WICHONSKI bets (9.69)
Player ChrisNola folds
Uncalled bet (9.69) returned to WICHONSKI
Player WICHONSKI mucks cards
------ Summary ------
Pot: 17.56. Rake 0.68. JP fee 0.24
Board: [Ad 4s 6s 9s 10h]
Player sr86 does not show cards.Bets: 0. Collects: 0. Wins: 0.
Player IlxxxlI does not show cards.Bets: 0. Collects: 0. Wins: 0.
*Player WICHONSKI mucks (does not show cards). Bets: 8.99. Collects: 17.56. Wins: 8.57.
Player ChrisNola does not show cards.Bets: 8.99. Collects: 0. Loses: 8.99.
Player iflopznuts does not show cards.Bets: 0.50. Collects: 0. Loses: 0.50.
Game ended at: 2016/11/21 10:42:20

Game started
Game ID: 780941779 0.25/0.50 (PRR) Garuda (Short) (Hold'em)
Seat 3 is the button
Seat 2: sr86 (31.53).
Seat 3: IlxxxlI (10).
Seat 4: WICHONSKI (28.61).
Seat 7: ChrisNola (37.20).
Seat 8: iflopznuts (50.52).
Player WICHONSKI has small blind (0.25)
Player ChrisNola has big blind (0.50)
Player IlxxxlI received card: [6c]
Player IlxxxlI received card: [2s]
Player iflopznuts raises (1)
Player sr86 folds
Player IlxxxlI folds
Player WICHONSKI folds
Player ChrisNola calls (0.50)
*** FLOP ***: [4d Kd 9c]
Player ChrisNola checks
Player iflopznuts checks
*** TURN ***: [4d Kd 9c] [7d]
Player ChrisNola checks
Player iflopznuts checks
*** RIVER ***: [4d Kd 9c 7d] [2c]
Player ChrisNola checks
Player iflopznuts checks
Player ChrisNola mucks cards
------ Summary ------
Pot: 2.14. Rake 0.09. JP fee 0.02
Board: [4d Kd 9c 7d 2c]
Player sr86 does not show cards.Bets: 0. Collects: 0. Wins: 0.
Player IlxxxlI does not show cards.Bets: 0. Collects: 0. Wins: 0.
Player WICHONSKI does not show cards.Bets: 0.25. Collects: 0. Loses: 0.25.
Player ChrisNola mucks (does not show cards). Bets: 1. Collects: 0. Loses: 1.
*Player iflopznuts shows: High card A [8s Ac]. Bets: 1. Collects: 2.14. Wins: 1.14.
Game ended at: 2016/11/21 10:40:51

Game started
Game ID: 780941429 0.25/0.50 (PRR) Garuda (Short) (Hold'em)
Seat 2 is the button
Seat 2: sr86 (31.53).
Seat 3: IlxxxlI (10.25).
Seat 4: WICHONSKI (28.36).
Seat 8: iflopznuts (50.52).
Player IlxxxlI has small blind (0.25)
Player WICHONSKI has big blind (0.50)
Player IlxxxlI received card: [3s]
Player IlxxxlI received card: [4c]
Player iflopznuts folds
Player sr86 folds
Player IlxxxlI folds
Uncalled bet (0.25) returned to WICHONSKI
Player WICHONSKI mucks cards
------ Summary ------
Pot: 0.50. Rake 0
Player sr86 does not show cards.Bets: 0. Collects: 0. Wins: 0.
Player IlxxxlI does not show cards.Bets: 0.25. Collects: 0. Loses: 0.25.
*Player WICHONSKI mucks (does not show cards). Bets: 0.25. Collects: 0.50. Wins: 0.25.
Player iflopznuts does not show cards.Bets: 0. Collects: 0. Wins: 0.
Game ended at: 2016/11/21 10:40:6

Game started
Game ID: 780941177 0.25/0.50 (PRR) Garuda (Short) (Hold'em)
Seat 8 is the button
Seat 2: sr86 (31.78).
Seat 3: IlxxxlI (10).
Seat 4: WICHONSKI (28.36).
Seat 7: ChrisNola (37.20).
Seat 8: iflopznuts (50.52).
Player sr86 has small blind (0.25)
Player IlxxxlI has big blind (0.50)
Player ChrisNola is timed out.
Player ChrisNola wait BB
Player IlxxxlI received card: [Ad]
Player IlxxxlI received card: [Qd]
Player WICHONSKI folds
Player iflopznuts folds
Player sr86 folds
Uncalled bet (0.25) returned to IlxxxlI
Player IlxxxlI mucks cards
------ Summary ------
Pot: 0.50. Rake 0
Player sr86 does not show cards.Bets: 0.25. Collects: 0. Loses: 0.25.
*Player IlxxxlI mucks (does not show cards). Bets: 0.25. Collects: 0.50. Wins: 0.25.
Player WICHONSKI does not show cards.Bets: 0. Collects: 0. Wins: 0.
Player ChrisNola does not show cards.Bets: 0. Collects: 0. Wins: 0.
Player iflopznuts does not show cards.Bets: 0. Collects: 0. Wins: 0.
Game ended at: 2016/11/21 10:39:42

Game started
Game ID: 779478945 0.25/0.50 (PRR) Garuda (Hold'em)
Seat 9 is the button
Seat 1: jviana (51.76).
Seat 3: naprimer (50).
Seat 4: Log_in (13.86).
Seat 5: IlxxxlI (25.84).
Seat 8: MANTISGUYV10 (130.47).
Seat 9: pineapplesand (20).
Player jviana has small blind (0.25)
Player naprimer has big blind (0.50)
Player IlxxxlI received card: [Qd]
Player IlxxxlI received card: [Kd]
Player Log_in raises (1.50)
Player IlxxxlI folds
Player MANTISGUYV10 raises (4.31)
Player pineapplesand folds
Player jviana folds
Player naprimer folds
Player Log_in folds
Uncalled bet (2.81) returned to MANTISGUYV10
Player MANTISGUYV10 mucks cards
------ Summary ------
Pot: 3.75. Rake 0
Player jviana does not show cards.Bets: 0.25. Collects: 0. Loses: 0.25.
Player naprimer does not show cards.Bets: 0.50. Collects: 0. Loses: 0.50.
Player Log_in does not show cards.Bets: 1.50. Collects: 0. Loses: 1.50.
Player IlxxxlI does not show cards.Bets: 0. Collects: 0. Wins: 0.
*Player MANTISGUYV10 mucks (does not show cards). Bets: 1.50. Collects: 3.75. Wins: 2.25.
Player pineapplesand does not show cards.Bets: 0. Collects: 0. Wins: 0.
Game ended at: 2016/11/20 0:0:41

Game started
Game ID: 779478723 0.25/0.50 (PRR) Garuda (Hold'em)
Seat 8 is the button
Seat 1: jviana (52.26).
Seat 3: naprimer (50).
Seat 4: Log_in (13.86).
Seat 5: IlxxxlI (25.84).
Seat 8: MANTISGUYV10 (129.72).
Seat 9: pineapplesand (20).
Player pineapplesand has small blind (0.25)
Player jviana has big blind (0.50)
Player IlxxxlI received card: [3h]
Player IlxxxlI received card: [Ks]
Player naprimer folds
Player Log_in folds
Player IlxxxlI folds
Player MANTISGUYV10 raises (1.44)
Player pineapplesand folds
Player jviana folds
Uncalled bet (0.94) returned to MANTISGUYV10
Player MANTISGUYV10 mucks cards
------ Summary ------
Pot: 1.25. Rake 0
Player jviana does not show cards.Bets: 0.50. Collects: 0. Loses: 0.50.
Player naprimer does not show cards.Bets: 0. Collects: 0. Wins: 0.
Player Log_in does not show cards.Bets: 0. Collects: 0. Wins: 0.
Player IlxxxlI does not show cards.Bets: 0. Collects: 0. Wins: 0.
*Player MANTISGUYV10 mucks (does not show cards). Bets: 0.50. Collects: 1.25. Wins: 0.75.
Player pineapplesand does not show cards.Bets: 0.25. Collects: 0. Loses: 0.25.
Game ended at: 2016/11/19 23:59:54

Game started
Game ID: 779478504 0.25/0.50 (PRR) Garuda (Hold'em)
Seat 5 is the button
Seat 1: jviana (47.51).
Seat 3: naprimer (50).
Seat 4: Log_in (13.86).
Seat 5: IlxxxlI (25.84).
Seat 8: MANTISGUYV10 (129.97).
Seat 9: pineapplesand (20).
Player MANTISGUYV10 has small blind (0.25)
Player pineapplesand has big blind (0.50)
Player IlxxxlI received card: [8c]
Player IlxxxlI received card: [4d]
Player jviana raises (1.25)
Player naprimer raises (4)
Player Log_in folds
Player IlxxxlI folds
Player MANTISGUYV10 folds
Player pineapplesand folds
Player jviana raises (11)
Player naprimer folds
Uncalled bet (8.25) returned to jviana
Player jviana mucks cards
------ Summary ------
Pot: 8.75. Rake 0
*Player jviana mucks (does not show cards). Bets: 4. Collects: 8.75. Wins: 4.75.
Player naprimer does not show cards.Bets: 4. Collects: 0. Loses: 4.
Player Log_in does not show cards.Bets: 0. Collects: 0. Wins: 0.
Player IlxxxlI does not show cards.Bets: 0. Collects: 0. Wins: 0.
Player MANTISGUYV10 does not show cards.Bets: 0.25. Collects: 0. Loses: 0.25.
Player pineapplesand does not show cards.Bets: 0.50. Collects: 0. Loses: 0.50.
Game ended at: 2016/11/19 23:59:14

Game started
Game ID: 779478272 0.25/0.50 (PRR) Garuda (Hold'em)
Seat 4 is the button
Seat 1: jviana (47.51).
Seat 3: naprimer (50).
Seat 4: Log_in (13.11).
Seat 5: IlxxxlI (26.09).
Seat 8: MANTISGUYV10 (130.47).
Seat 9: pineapplesand (20).
Player IlxxxlI has small blind (0.25)
Player MANTISGUYV10 has big blind (0.50)
Player IlxxxlI received card: [Qh]
Player IlxxxlI received card: [6s]
Player pineapplesand folds
Player jviana folds
Player naprimer folds
Player Log_in raises (1.12)
Player IlxxxlI folds
Player MANTISGUYV10 folds
Uncalled bet (0.62) returned to Log_in
Player Log_in mucks cards
------ Summary ------
Pot: 1.25. Rake 0
Player jviana does not show cards.Bets: 0. Collects: 0. Wins: 0.
Player naprimer does not show cards.Bets: 0. Collects: 0. Wins: 0.
*Player Log_in mucks (does not show cards). Bets: 0.50. Collects: 1.25. Wins: 0.75.
Player IlxxxlI does not show cards.Bets: 0.25. Collects: 0. Loses: 0.25.
Player MANTISGUYV10 does not show cards.Bets: 0.50. Collects: 0. Loses: 0.50.
Player pineapplesand does not show cards.Bets: 0. Collects: 0. Wins: 0.
Game ended at: 2016/11/19 23:58:36

Game started
Game ID: 779477696 0.25/0.50 (PRR) Garuda (Hold'em)
Seat 3 is the button
Seat 1: jviana (47.51).
Seat 3: naprimer (56.01).
Seat 4: Log_in (13.36).
Seat 5: IlxxxlI (20).
Seat 8: MANTISGUYV10 (130.47).
Seat 9: pineapplesand (20).
Player Log_in has small blind (0.25)
Player IlxxxlI has big blind (0.50)
Player IlxxxlI received card: [Jh]
Player IlxxxlI received card: [7h]
Player MANTISGUYV10 folds
Player pineapplesand folds
Player jviana folds
Player naprimer raises (1)
Player Log_in folds
Player IlxxxlI calls (0.50)
*** FLOP ***: [8s 10d 10h]
Player IlxxxlI checks
Player naprimer bets (1)
Player IlxxxlI calls (1)
*** TURN ***: [8s 10d 10h] [9c]
Player IlxxxlI bets (1.50)
Player naprimer raises (4.50)
Player IlxxxlI allin (16.50)
Player naprimer folds
Uncalled bet (13.50) returned to IlxxxlI
Player IlxxxlI mucks cards
------ Summary ------
Pot: 12.59. Rake 0.44. JP fee 0.22
Board: [8s 10d 10h 9c]
Player jviana does not show cards.Bets: 0. Collects: 0. Wins: 0.
Player naprimer does not show cards.Bets: 6.50. Collects: 0. Loses: 6.50.
Player Log_in does not show cards.Bets: 0.25. Collects: 0. Loses: 0.25.
*Player IlxxxlI mucks (does not show cards). Bets: 6.50. Collects: 12.59. Wins: 6.09.
Player MANTISGUYV10 does not show cards.Bets: 0. Collects: 0. Wins: 0.
Player pineapplesand does not show cards.Bets: 0. Collects: 0. Wins: 0.
Game ended at: 2016/11/19 23:57:58

Game started
Game ID: 779477464 0.25/0.50 (PRR) Garuda (Hold'em)
Seat 1 is the button
Seat 1: jviana (48.95).
Seat 3: naprimer (52.63).
Seat 4: Log_in (13.86).
Seat 5: IlxxxlI (20).
Seat 8: MANTISGUYV10 (131.91).
Seat 9: pineapplesand (20).
Player naprimer has small blind (0.25)
Player Log_in has big blind (0.50)
Player IlxxxlI received card: [3d]
Player IlxxxlI received card: [Qh]
Player IlxxxlI folds
Player MANTISGUYV10 raises (1.44)
Player pineapplesand folds
Player jviana calls (1.44)
Player naprimer raises (5.25)
Player Log_in folds
Player MANTISGUYV10 folds
Player jviana folds
Uncalled bet (4.06) returned to naprimer
Player naprimer mucks cards
------ Summary ------
Pot: 4.82. Rake 0
Player jviana does not show cards.Bets: 1.44. Collects: 0. Loses: 1.44.
*Player naprimer mucks (does not show cards). Bets: 1.44. Collects: 4.82. Wins: 3.38.
Player Log_in does not show cards.Bets: 0.50. Collects: 0. Loses: 0.50.
Player IlxxxlI does not show cards.Bets: 0. Collects: 0. Wins: 0.
Player MANTISGUYV10 does not show cards.Bets: 1.44. Collects: 0. Loses: 1.44.
Player pineapplesand does not show cards.Bets: 0. Collects: 0. Wins: 0.
Game ended at: 2016/11/19 23:56:22

Game started
Game ID: 779477361 0.25/0.50 (PRR) Garuda (Hold'em)
Seat 9 is the button
Seat 1: jviana (49.20).
Seat 3: naprimer (52.38).
Seat 4: Log_in (13.86).
Seat 5: IlxxxlI (20).
Seat 8: MANTISGUYV10 (131.91).
Seat 9: pineapplesand (20).
Player jviana has small blind (0.25)
Player naprimer has big blind (0.50)
Player IlxxxlI received card: [Ad]
Player IlxxxlI received card: [8c]
Player Log_in folds
Player IlxxxlI folds
Player MANTISGUYV10 folds
Player pineapplesand folds
Player jviana folds
Uncalled bet (0.25) returned to naprimer
Player naprimer mucks cards
------ Summary ------
Pot: 0.50. Rake 0
Player jviana does not show cards.Bets: 0.25. Collects: 0. Loses: 0.25.
*Player naprimer mucks (does not show cards). Bets: 0.25. Collects: 0.50. Wins: 0.25.
Player Log_in does not show cards.Bets: 0. Collects: 0. Wins: 0.
Player IlxxxlI does not show cards.Bets: 0. Collects: 0. Wins: 0.
Player MANTISGUYV10 does not show cards.Bets: 0. Collects: 0. Wins: 0.
Player pineapplesand does not show cards.Bets: 0. Collects: 0. Wins: 0.
Game ended at: 2016/11/19 23:55:41

Game started
Game ID: 779476850 0.25/0.50 (PRR) Garuda (Hold'em)
Seat 8 is the button
Seat 1: jviana (39.95).
Seat 3: naprimer (53.38).
Seat 4: Log_in (13.86).
Seat 5: IlxxxlI (20).
Seat 8: MANTISGUYV10 (140.86).
Seat 9: pineapplesand (20).
Player pineapplesand has small blind (0.25)
Player jviana has big blind (0.50)
Player IlxxxlI received card: [10s]
Player IlxxxlI received card: [8c]
Player naprimer raises (1)
Player Log_in folds
Player IlxxxlI folds
Player MANTISGUYV10 calls (1)
Player pineapplesand folds
Player jviana calls (0.50)
*** FLOP ***: [Ah Kd 6c]
Player jviana checks
Player naprimer checks
Player MANTISGUYV10 bets (2.32)
Player jviana calls (2.32)
Player naprimer folds
*** TURN ***: [Ah Kd 6c] [9d]
Player jviana checks
Player MANTISGUYV10 bets (5.63)
Player jviana calls (5.63)
*** RIVER ***: [Ah Kd 6c 9d] [7d]
Player jviana checks
Player MANTISGUYV10 checks
------ Summary ------
Pot: 18.20. Rake 0.71. JP fee 0.24
Board: [Ah Kd 6c 9d 7d]
*Player jviana shows: One pair of As [Ac Qd]. Bets: 8.95. Collects: 18.20. Wins: 9.25.
Player naprimer does not show cards.Bets: 1. Collects: 0. Loses: 1.
Player Log_in does not show cards.Bets: 0. Collects: 0. Wins: 0.
Player IlxxxlI does not show cards.Bets: 0. Collects: 0. Wins: 0.
Player MANTISGUYV10 shows: High card A [4h 5h]. Bets: 8.95. Collects: 0. Loses: 8.95.
Player pineapplesand does not show cards.Bets: 0.25. Collects: 0. Loses: 0.25.
Game ended at: 2016/11/19 23:55:22

Game started
Game ID: 779476706 0.25/0.50 (PRR) Garuda (Hold'em)
Seat 5 is the button
Seat 1: jviana (39.95).
Seat 3: naprimer (53.38).
Seat 4: Log_in (13.86).
Seat 5: IlxxxlI (20).
Seat 7: Tanker123 (45.92).
Seat 8: MANTISGUYV10 (140.61).
Seat 9: pineapplesand (20).
Player Tanker123 has small blind (0.25)
Player MANTISGUYV10 has big blind (0.50)
Player IlxxxlI received card: [8s]
Player IlxxxlI received card: [5d]
Player pineapplesand folds
Player jviana folds
Player naprimer folds
Player Log_in folds
Player IlxxxlI folds
Player Tanker123 folds
Uncalled bet (0.25) returned to MANTISGUYV10
Player MANTISGUYV10 mucks cards
------ Summary ------
Pot: 0.50. Rake 0
Player jviana does not show cards.Bets: 0. Collects: 0. Wins: 0.
Player naprimer does not show cards.Bets: 0. Collects: 0. Wins: 0.
Player Log_in does not show cards.Bets: 0. Collects: 0. Wins: 0.
Player IlxxxlI does not show cards.Bets: 0. Collects: 0. Wins: 0.
Player Tanker123 does not show cards.Bets: 0.25. Collects: 0. Loses: 0.25.
*Player MANTISGUYV10 mucks (does not show cards). Bets: 0.25. Collects: 0.50. Wins: 0.25.
Player pineapplesand does not show cards.Bets: 0. Collects: 0. Wins: 0.
Game ended at: 2016/11/19 23:54:8

Game started
Game ID: 779476036 0.25/0.50 (PRR) Garuda (Hold'em)
Seat 4 is the button
Seat 1: jviana (45.70).
Seat 3: naprimer (53.38).
Seat 4: Log_in (13.86).
Seat 5: IlxxxlI (20).
Seat 7: Tanker123 (40.50).
Seat 8: MANTISGUYV10 (140.61).
Seat 9: pineapplesand (20).
Player IlxxxlI has small blind (0.25)
Player Tanker123 has big blind (0.50)
Player IlxxxlI received card: [10h]
Player IlxxxlI received card: [4s]
Player MANTISGUYV10 folds
Player pineapplesand folds
Player jviana raises (1.25)
Player naprimer folds
Player Log_in folds
Player IlxxxlI folds
Player Tanker123 calls (0.75)
*** FLOP ***: [8s 3s 8h]
Player Tanker123 checks
Player jviana bets (1.50)
Player Tanker123 calls (1.50)
*** TURN ***: [8s 3s 8h] [Kd]
Player Tanker123 checks
Player jviana checks
*** RIVER ***: [8s 3s 8h Kd] [7s]
Player Tanker123 checks
Player jviana bets (1)
Player Tanker123 raises (3)
Player jviana calls (2)
Player jviana mucks cards
------ Summary ------
Pot: 11.17. Rake 0.40. JP fee 0.18
Board: [8s 3s 8h Kd 7s]
Player jviana mucks (does not show cards). Bets: 5.75. Collects: 0. Loses: 5.75.
Player naprimer does not show cards.Bets: 0. Collects: 0. Wins: 0.
Player Log_in does not show cards.Bets: 0. Collects: 0. Wins: 0.
Player IlxxxlI does not show cards.Bets: 0.25. Collects: 0. Loses: 0.25.
*Player Tanker123 shows: Full House (8/7) [7d 8d]. Bets: 5.75. Collects: 11.17. Wins: 5.42.
Player MANTISGUYV10 does not show cards.Bets: 0. Collects: 0. Wins: 0.
Player pineapplesand does not show cards.Bets: 0. Collects: 0. Wins: 0.
Game ended at: 2016/11/19 23:53:49

Game started
Game ID: 779475769 0.25/0.50 (PRR) Garuda (Hold'em)
Seat 3 is the button
Seat 1: jviana (45.70).
Seat 3: naprimer (51.31).
Seat 4: Log_in (14.11).
Seat 5: IlxxxlI (20).
Seat 6: emmagrace (19).
Seat 7: Tanker123 (42).
Seat 8: MANTISGUYV10 (140.61).
Seat 9: pineapplesand (20).
Player Log_in has small blind (0.25)
Player IlxxxlI has big blind (0.50)
Player IlxxxlI received card: [9c]
Player IlxxxlI received card: [7s]
Player emmagrace folds
Player Tanker123 calls (0.50)
Player MANTISGUYV10 folds
Player pineapplesand folds
Player jviana folds
Player naprimer raises (1.50)
Player Log_in folds
Player IlxxxlI folds
Player Tanker123 calls (1)
*** FLOP ***: [As 6d Qs]
Player Tanker123 checks
Player naprimer bets (1.50)
Player Tanker123 folds
Uncalled bet (1.50) returned to naprimer
Player naprimer mucks cards
------ Summary ------
Pot: 3.57. Rake 0.12. JP fee 0.06
Board: [As 6d Qs]
Player jviana does not show cards.Bets: 0. Collects: 0. Wins: 0.
*Player naprimer mucks (does not show cards). Bets: 1.50. Collects: 3.57. Wins: 2.07.
Player Log_in does not show cards.Bets: 0.25. Collects: 0. Loses: 0.25.
Player IlxxxlI does not show cards.Bets: 0.50. Collects: 0. Loses: 0.50.
Player emmagrace does not show cards.Bets: 0. Collects: 0. Wins: 0.
Player Tanker123 does not show cards.Bets: 1.50. Collects: 0. Loses: 1.50.
Player MANTISGUYV10 does not show cards.Bets: 0. Collects: 0. Wins: 0.
Player pineapplesand does not show cards.Bets: 0. Collects: 0. Wins: 0.
Game ended at: 2016/11/19 23:52:23

Game started
Game ID: 779475267 0.25/0.50 (PRR) Garuda (Hold'em)
Seat 1 is the button
Seat 1: jviana (45.70).
Seat 3: naprimer (51.81).
Seat 4: Log_in (14.61).
Seat 5: IlxxxlI (20).
Seat 6: emmagrace (19.50).
Seat 7: Tanker123 (40.60).
Seat 8: MANTISGUYV10 (140.61).
Seat 9: pineapplesand (20).
Player naprimer has small blind (0.25)
Player Log_in has big blind (0.50)
Player IlxxxlI received card: [Jd]
Player IlxxxlI received card: [8c]
Player IlxxxlI folds
Player emmagrace calls (0.50)
Player Tanker123 calls (0.50)
Player MANTISGUYV10 folds
Player pineapplesand folds
Player jviana folds
Player naprimer calls (0.25)
Player Log_in checks
*** FLOP ***: [10d 8s 2s]
Player naprimer checks
Player Log_in checks
Player emmagrace checks
Player Tanker123 bets (2)
Player naprimer folds
Player Log_in folds
Player emmagrace folds
Uncalled bet (2) returned to Tanker123
Player Tanker123 mucks cards
------ Summary ------
Pot: 1.90. Rake 0.08. JP fee 0.02
Board: [10d 8s 2s]
Player jviana does not show cards.Bets: 0. Collects: 0. Wins: 0.
Player naprimer does not show cards.Bets: 0.50. Collects: 0. Loses: 0.50.
Player Log_in does not show cards.Bets: 0.50. Collects: 0. Loses: 0.50.
Player IlxxxlI does not show cards.Bets: 0. Collects: 0. Wins: 0.
Player emmagrace does not show cards.Bets: 0.50. Collects: 0. Loses: 0.50.
*Player Tanker123 mucks (does not show cards). Bets: 0.50. Collects: 1.90. Wins: 1.40.
Player MANTISGUYV10 does not show cards.Bets: 0. Collects: 0. Wins: 0.
Player pineapplesand does not show cards.Bets: 0. Collects: 0. Wins: 0.
Game ended at: 2016/11/19 23:51:45

Game started
Game ID: 779474824 0.25/0.50 (PRR) Garuda (Hold'em)
Seat 9 is the button
Seat 1: jviana (45.95).
Seat 3: naprimer (52.31).
Seat 4: Log_in (14.61).
Seat 5: IlxxxlI (20).
Seat 6: emmagrace (19.50).
Seat 7: Tanker123 (42.10).
Seat 8: MANTISGUYV10 (138.54).
Seat 9: pineapplesand (20).
Player jviana has small blind (0.25)
Player naprimer has big blind (0.50)
Player IlxxxlI received card: [3d]
Player IlxxxlI received card: [4s]
Player Log_in folds
Player IlxxxlI folds
Player emmagrace folds
Player Tanker123 calls (0.50)
Player MANTISGUYV10 calls (0.50)
Player pineapplesand folds
Player jviana folds
Player naprimer checks
*** FLOP ***: [7h 3c Ac]
Player naprimer checks
Player Tanker123 bets (1)
Player MANTISGUYV10 raises (4.67)
Player naprimer folds
Player Tanker123 folds
Uncalled bet (3.67) returned to MANTISGUYV10
Player MANTISGUYV10 mucks cards
------ Summary ------
Pot: 3.57. Rake 0.12. JP fee 0.06
Board: [7h 3c Ac]
Player jviana does not show cards.Bets: 0.25. Collects: 0. Loses: 0.25.
Player naprimer does not show cards.Bets: 0.50. Collects: 0. Loses: 0.50.
Player Log_in does not show cards.Bets: 0. Collects: 0. Wins: 0.
Player IlxxxlI does not show cards.Bets: 0. Collects: 0. Wins: 0.
Player emmagrace does not show cards.Bets: 0. Collects: 0. Wins: 0.
Player Tanker123 does not show cards.Bets: 1.50. Collects: 0. Loses: 1.50.
*Player MANTISGUYV10 mucks (does not show cards). Bets: 1.50. Collects: 3.57. Wins: 2.07.
Player pineapplesand does not show cards.Bets: 0. Collects: 0. Wins: 0.
Game ended at: 2016/11/19 23:50:40

Game started
Game ID: 779473932 0.25/0.50 (PRR) Garuda (Hold'em)
Seat 8 is the button
Seat 1: jviana (41.78).
Seat 3: naprimer (52.31).
Seat 4: Log_in (18.97).
Seat 5: IlxxxlI (20).
Seat 6: emmagrace (19.50).
Seat 7: Tanker123 (42.10).
Seat 8: MANTISGUYV10 (138.54).
Seat 9: pineapplesand (20).
Player pineapplesand has small blind (0.25)
Player jviana has big blind (0.50)
Player IlxxxlI received card: [8d]
Player IlxxxlI received card: [Ks]
Player naprimer folds
Player Log_in raises (1.50)
Player IlxxxlI folds
Player emmagrace folds
Player Tanker123 folds
Player MANTISGUYV10 folds
Player pineapplesand folds
Player jviana calls (1)
*** FLOP ***: [Kc 6s 9d]
Player jviana checks
Player Log_in bets (1.12)
Player jviana calls (1.12)
*** TURN ***: [Kc 6s 9d] [10s]
Player jviana checks
Player Log_in bets (1.74)
Player jviana raises (4.25)
Player Log_in folds
Uncalled bet (2.51) returned to jviana
Player jviana mucks cards
------ Summary ------
Pot: 8.53. Rake 0.30. JP fee 0.14
Board: [Kc 6s 9d 10s]
*Player jviana mucks (does not show cards). Bets: 4.36. Collects: 8.53. Wins: 4.17.
Player naprimer does not show cards.Bets: 0. Collects: 0. Wins: 0.
Player Log_in does not show cards.Bets: 4.36. Collects: 0. Loses: 4.36.
Player IlxxxlI does not show cards.Bets: 0. Collects: 0. Wins: 0.
Player emmagrace does not show cards.Bets: 0. Collects: 0. Wins: 0.
Player Tanker123 does not show cards.Bets: 0. Collects: 0. Wins: 0.
Player MANTISGUYV10 does not show cards.Bets: 0. Collects: 0. Wins: 0.
Player pineapplesand does not show cards.Bets: 0.25. Collects: 0. Loses: 0.25.
Game ended at: 2016/11/19 23:49:38

Game started
Game ID: 779473651 0.25/0.50 (PRR) Garuda (Hold'em)
Seat 7 is the button
Seat 1: jviana (39.25).
Seat 3: naprimer (52.31).
Seat 4: Log_in (18.97).
Seat 5: IlxxxlI (20).
Seat 6: emmagrace (20).
Seat 7: Tanker123 (42.10).
Seat 8: MANTISGUYV10 (140.29).
Seat 9: pineapplesand (20).
Player MANTISGUYV10 has small blind (0.25)
Player pineapplesand has big blind (0.50)
Player emmagrace posts (0.50)
Player IlxxxlI received card: [7d]
Player IlxxxlI received card: [9h]
Player jviana raises (1.75)
Player naprimer folds
Player Log_in folds
Player IlxxxlI folds
Player emmagrace folds
Player Tanker123 folds
Player MANTISGUYV10 calls (1.50)
Player pineapplesand folds
*** FLOP ***: [Kd 3c 2s]
Player MANTISGUYV10 checks
Player jviana bets (2)
Player MANTISGUYV10 folds
Uncalled bet (2) returned to jviana
Player jviana mucks cards
------ Summary ------
Pot: 4.28. Rake 0.16. JP fee 0.06
Board: [Kd 3c 2s]
*Player jviana mucks (does not show cards). Bets: 1.75. Collects: 4.28. Wins: 2.53.
Player naprimer does not show cards.Bets: 0. Collects: 0. Wins: 0.
Player Log_in does not show cards.Bets: 0. Collects: 0. Wins: 0.
Player IlxxxlI does not show cards.Bets: 0. Collects: 0. Wins: 0.
Player emmagrace does not show cards.Bets: 0.50. Collects: 0. Loses: 0.50.
Player Tanker123 does not show cards.Bets: 0. Collects: 0. Wins: 0.
Player MANTISGUYV10 does not show cards.Bets: 1.75. Collects: 0. Loses: 1.75.
Player pineapplesand does not show cards.Bets: 0.50. Collects: 0. Loses: 0.50.
Game ended at: 2016/11/19 23:47:37

Game started
Game ID: 779473014 0.25/0.50 (PRR) Garuda (Hold'em)
Seat 5 is the button
Seat 1: jviana (39.25).
Seat 2: tbmfc (12.34).
Seat 3: naprimer (52.31).
Seat 4: Log_in (18.97).
Seat 5: IlxxxlI (20).
Seat 7: Tanker123 (30.51).
Seat 8: MANTISGUYV10 (140.79).
Seat 9: pineapplesand (20).
Player Tanker123 has small blind (0.25)
Player MANTISGUYV10 has big blind (0.50)
Player IlxxxlI received card: [3s]
Player IlxxxlI received card: [Ac]
Player pineapplesand folds
Player jviana folds
Player tbmfc allin (12.34)
Player naprimer folds
Player Log_in folds
Player IlxxxlI folds
Player Tanker123 allin (30.26)
Player MANTISGUYV10 folds
Uncalled bet (18.17) returned to Tanker123
*** FLOP ***: [5d Qc Qs]
*** TURN ***: [5d Qc Qs] [6s]
*** RIVER ***: [5d Qc Qs 6s] [7c]
------ Summary ------
Pot: 23.93. Rake 1.01. JP fee 0.24
Board: [5d Qc Qs 6s 7c]
Player jviana does not show cards.Bets: 0. Collects: 0. Wins: 0.
Player tbmfc shows: Two pairs. Qs and 8s [8s 8d]. Bets: 12.34. Collects: 0. Loses: 12.34.
Player naprimer does not show cards.Bets: 0. Collects: 0. Wins: 0.
Player Log_in does not show cards.Bets: 0. Collects: 0. Wins: 0.
Player IlxxxlI does not show cards.Bets: 0. Collects: 0. Wins: 0.
*Player Tanker123 shows: Three Of Kind of Qs [Qd Jh]. Bets: 12.34. Collects: 23.93. Wins: 11.59.
Player MANTISGUYV10 does not show cards.Bets: 0.50. Collects: 0. Loses: 0.50.
Player pineapplesand does not show cards.Bets: 0. Collects: 0. Wins: 0.
Game ended at: 2016/11/19 23:46:57

Game started
Game ID: 779472549 0.25/0.50 (PRR) Garuda (Hold'em)
Seat 4 is the button
Seat 1: jviana (39.25).
Seat 2: tbmfc (12.59).
Seat 3: naprimer (52.31).
Seat 4: Log_in (18.97).
Seat 5: IlxxxlI (20).
Seat 7: Tanker123 (31.01).
Seat 8: MANTISGUYV10 (139.86).
Seat 9: pineapplesand (20).
Player IlxxxlI has small blind (0.25)
Player Tanker123 has big blind (0.50)
Player tbmfc posts (0.25)
Player IlxxxlI received card: [6h]
Player IlxxxlI received card: [2c]
Player MANTISGUYV10 calls (0.50)
Player pineapplesand folds
Player jviana folds
Player tbmfc folds
Player naprimer folds
Player Log_in folds
Player IlxxxlI folds
Player Tanker123 checks
*** FLOP ***: [Kc Jc 7h]
Player Tanker123 checks
Player MANTISGUYV10 bets (0.72)
Player Tanker123 folds
Uncalled bet (0.72) returned to MANTISGUYV10
Player MANTISGUYV10 mucks cards
------ Summary ------
Pot: 1.43. Rake 0.05. JP fee 0.02
Board: [Kc Jc 7h]
Player jviana does not show cards.Bets: 0. Collects: 0. Wins: 0.
Player tbmfc does not show cards.Bets: 0.25. Collects: 0. Loses: 0.25.
Player naprimer does not show cards.Bets: 0. Collects: 0. Wins: 0.
Player Log_in does not show cards.Bets: 0. Collects: 0. Wins: 0.
Player IlxxxlI does not show cards.Bets: 0.25. Collects: 0. Loses: 0.25.
Player Tanker123 does not show cards.Bets: 0.50. Collects: 0. Loses: 0.50.
*Player MANTISGUYV10 mucks (does not show cards). Bets: 0.50. Collects: 1.43. Wins: 0.93.
Player pineapplesand does not show cards.Bets: 0. Collects: 0. Wins: 0.
Game ended at: 2016/11/19 23:45:40

Game started
Game ID: 779471765 0.25/0.50 (PRR) Garuda (Hold'em)
Seat 3 is the button
Seat 1: jviana (39.25).
Seat 3: naprimer (52.31).
Seat 4: Log_in (19.22).
Seat 5: IlxxxlI (20).
Seat 6: Vonalarta (65.77).
Seat 7: Tanker123 (31.01).
Seat 8: MANTISGUYV10 (76.34).
Seat 9: pineapplesand (20).
Player Log_in has small blind (0.25)
Player IlxxxlI has big blind (0.50)
Player IlxxxlI received card: [5s]
Player IlxxxlI received card: [8d]
Player Vonalarta raises (1.50)
Player Tanker123 folds
Player MANTISGUYV10 raises (4.31)
Player pineapplesand folds
Player jviana folds
Player naprimer folds
Player Log_in folds
Player IlxxxlI folds
Player Vonalarta raises (11)
Player MANTISGUYV10 calls (8.19)
*** FLOP ***: [4d 9c Qc]
Player Vonalarta checks
Player MANTISGUYV10 bets (18.35)
Player Vonalarta allin (53.27)
Player MANTISGUYV10 calls (34.92)
*** TURN ***: [4d 9c Qc] [7s]
*** RIVER ***: [4d 9c Qc 7s] [Jd]
------ Summary ------
Pot: 129.29. Rake 2.76. JP fee 0.24
Board: [4d 9c Qc 7s Jd]
Player jviana does not show cards.Bets: 0. Collects: 0. Wins: 0.
Player naprimer does not show cards.Bets: 0. Collects: 0. Wins: 0.
Player Log_in does not show cards.Bets: 0.25. Collects: 0. Loses: 0.25.
Player IlxxxlI does not show cards.Bets: 0.50. Collects: 0. Loses: 0.50.
Player Vonalarta shows: One pair of Ks [Kh Kd]. Bets: 65.77. Collects: 0. Loses: 65.77.
Player Tanker123 does not show cards.Bets: 0. Collects: 0. Wins: 0.
*Player MANTISGUYV10 shows: One pair of As [Ac Ad]. Bets: 65.77. Collects: 129.29. Wins: 63.52.
Player pineapplesand does not show cards.Bets: 0. Collects: 0. Wins: 0.
Game ended at: 2016/11/19 23:44:37

Game started
Game ID: 779471274 0.25/0.50 (PRR) Garuda (Hold'em)
Seat 1 is the button
Seat 1: jviana (39.25).
Seat 3: naprimer (52.56).
Seat 4: Log_in (19.72).
Seat 5: IlxxxlI (20).
Seat 6: Vonalarta (65.77).
Seat 7: Tanker123 (38.36).
Seat 8: MANTISGUYV10 (69.01).
Seat 9: pineapplesand (20).
Player naprimer has small blind (0.25)
Player Log_in has big blind (0.50)
Player IlxxxlI received card: [Jc]
Player IlxxxlI received card: [Kd]
Player IlxxxlI folds
Player Vonalarta folds
Player Tanker123 calls (0.50)
Player MANTISGUYV10 raises (1.81)
Player pineapplesand folds
Player jviana folds
Player naprimer folds
Player Log_in folds
Player Tanker123 calls (1.31)
*** FLOP ***: [Qs 8c Ad]
Player Tanker123 bets (2.77)
Player MANTISGUYV10 raises (5.54)
Player Tanker123 calls (2.77)
*** TURN ***: [Qs 8c Ad] [5d]
Player Tanker123 checks
Player MANTISGUYV10 bets (7.34)
Player Tanker123 folds
Uncalled bet (7.34) returned to MANTISGUYV10
Player MANTISGUYV10 mucks cards
------ Summary ------
Pot: 14.68. Rake 0.53. JP fee 0.24
Board: [Qs 8c Ad 5d]
Player jviana does not show cards.Bets: 0. Collects: 0. Wins: 0.
Player naprimer does not show cards.Bets: 0.25. Collects: 0. Loses: 0.25.
Player Log_in does not show cards.Bets: 0.50. Collects: 0. Loses: 0.50.
Player IlxxxlI does not show cards.Bets: 0. Collects: 0. Wins: 0.
Player Vonalarta does not show cards.Bets: 0. Collects: 0. Wins: 0.
Player Tanker123 does not show cards.Bets: 7.35. Collects: 0. Loses: 7.35.
*Player MANTISGUYV10 mucks (does not show cards). Bets: 7.35. Collects: 14.68. Wins: 7.33.
Player pineapplesand does not show cards.Bets: 0. Collects: 0. Wins: 0.
Game ended at: 2016/11/19 23:42:57

Game started
Game ID: 779470925 0.25/0.50 (PRR) Garuda (Hold'em)
Seat 9 is the button
Seat 1: jviana (39.50).
Seat 2: tbmfc (13.09).
Seat 3: naprimer (52.56).
Seat 4: Log_in (19.72).
Seat 5: IlxxxlI (20).
Seat 6: Vonalarta (65.77).
Seat 7: Tanker123 (38.36).
Seat 8: MANTISGUYV10 (68.26).
Seat 9: pineapplesand (20).
Player jviana has small blind (0.25)
Player tbmfc has big blind (0.50)
Player IlxxxlI received card: [4c]
Player IlxxxlI received card: [Jd]
Player naprimer folds
Player Log_in folds
Player IlxxxlI folds
Player Vonalarta folds
Player Tanker123 folds
Player MANTISGUYV10 raises (1.75)
Player pineapplesand folds
Player jviana folds
Player tbmfc is timed out.
Player tbmfc folds
Uncalled bet (1.25) returned to MANTISGUYV10
Player MANTISGUYV10 mucks cards
------ Summary ------
Pot: 1.25. Rake 0
Player jviana does not show cards.Bets: 0.25. Collects: 0. Loses: 0.25.
Player tbmfc does not show cards.Bets: 0.50. Collects: 0. Loses: 0.50.
Player naprimer does not show cards.Bets: 0. Collects: 0. Wins: 0.
Player Log_in does not show cards.Bets: 0. Collects: 0. Wins: 0.
Player IlxxxlI does not show cards.Bets: 0. Collects: 0. Wins: 0.
Player Vonalarta does not show cards.Bets: 0. Collects: 0. Wins: 0.
Player Tanker123 does not show cards.Bets: 0. Collects: 0. Wins: 0.
*Player MANTISGUYV10 mucks (does not show cards). Bets: 0.50. Collects: 1.25. Wins: 0.75.
Player pineapplesand does not show cards.Bets: 0. Collects: 0. Wins: 0.
Game ended at: 2016/11/19 23:41:53

Game started
Game ID: 779470488 0.25/0.50 (PRR) Garuda (Hold'em)
Seat 8 is the button
Seat 1: jviana (40).
Seat 2: tbmfc (13.09).
Seat 3: naprimer (53.56).
Seat 4: Log_in (19.72).
Seat 5: IlxxxlI (20).
Seat 6: Vonalarta (65.77).
Seat 7: Tanker123 (36.74).
Seat 8: MANTISGUYV10 (68.26).
Seat 9: pineapplesand (20).
Player pineapplesand has small blind (0.25)
Player jviana has big blind (0.50)
Player IlxxxlI received card: [7h]
Player IlxxxlI received card: [4h]
Player tbmfc folds
Player naprimer raises (1)
Player Log_in folds
Player IlxxxlI folds
Player Vonalarta folds
Player Tanker123 calls (1)
Player MANTISGUYV10 folds
Player pineapplesand folds
Player jviana folds
*** FLOP ***: [Ad 9c 4s]
Player naprimer checks
Player Tanker123 bets (0.87)
Player naprimer folds
Uncalled bet (0.87) returned to Tanker123
Player Tanker123 mucks cards
------ Summary ------
Pot: 2.62. Rake 0.09. JP fee 0.04
Board: [Ad 9c 4s]
Player jviana does not show cards.Bets: 0.50. Collects: 0. Loses: 0.50.
Player tbmfc does not show cards.Bets: 0. Collects: 0. Wins: 0.
Player naprimer does not show cards.Bets: 1. Collects: 0. Loses: 1.
Player Log_in does not show cards.Bets: 0. Collects: 0. Wins: 0.
Player IlxxxlI does not show cards.Bets: 0. Collects: 0. Wins: 0.
Player Vonalarta does not show cards.Bets: 0. Collects: 0. Wins: 0.
*Player Tanker123 mucks (does not show cards). Bets: 1. Collects: 2.62. Wins: 1.62.
Player MANTISGUYV10 does not show cards.Bets: 0. Collects: 0. Wins: 0.
Player pineapplesand does not show cards.Bets: 0.25. Collects: 0. Loses: 0.25.
Game ended at: 2016/11/19 23:41:10

Game started
Game ID: 779470075 0.25/0.50 (PRR) Garuda (Hold'em)
Seat 7 is the button
Seat 2: tbmfc (13.09).
Seat 3: naprimer (53.56).
Seat 4: Log_in (19.72).
Seat 5: IlxxxlI (20).
Seat 6: Vonalarta (65.02).
Seat 7: Tanker123 (36.74).
Seat 8: MANTISGUYV10 (68.51).
Seat 9: pineapplesand (20).
Player MANTISGUYV10 has small blind (0.25)
Player pineapplesand has big blind (0.50)
Player IlxxxlI received card: [8c]
Player IlxxxlI received card: [2h]
Player tbmfc folds
Player naprimer folds
Player Log_in folds
Player IlxxxlI folds
Player Vonalarta raises (1.50)
Player Tanker123 folds
Player MANTISGUYV10 folds
Player pineapplesand folds
Uncalled bet (1) returned to Vonalarta
Player Vonalarta mucks cards
------ Summary ------
Pot: 1.25. Rake 0
Player tbmfc does not show cards.Bets: 0. Collects: 0. Wins: 0.
Player naprimer does not show cards.Bets: 0. Collects: 0. Wins: 0.
Player Log_in does not show cards.Bets: 0. Collects: 0. Wins: 0.
Player IlxxxlI does not show cards.Bets: 0. Collects: 0. Wins: 0.
*Player Vonalarta mucks (does not show cards). Bets: 0.50. Collects: 1.25. Wins: 0.75.
Player Tanker123 does not show cards.Bets: 0. Collects: 0. Wins: 0.
Player MANTISGUYV10 does not show cards.Bets: 0.25. Collects: 0. Loses: 0.25.
Player pineapplesand does not show cards.Bets: 0.50. Collects: 0. Loses: 0.50.
Game ended at: 2016/11/19 23:40:13

Game started
Game ID: 779469645 0.25/0.50 (PRR) Garuda (Hold'em)
Seat 6 is the button
Seat 2: tbmfc (6.76).
Seat 3: naprimer (53.56).
Seat 4: Log_in (19.72).
Seat 5: IlxxxlI (20).
Seat 6: Vonalarta (65.02).
Seat 7: Tanker123 (36.99).
Seat 8: MANTISGUYV10 (75.27).
Player Tanker123 has small blind (0.25)
Player MANTISGUYV10 has big blind (0.50)
Player IlxxxlI received card: [4h]
Player IlxxxlI received card: [6h]
Player tbmfc allin (6.76)
Player naprimer folds
Player Log_in folds
Player IlxxxlI folds
Player Vonalarta folds
Player Tanker123 folds
Player MANTISGUYV10 calls (6.26)
*** FLOP ***: [Jc Js 5c]
*** TURN ***: [Jc Js 5c] [10c]
*** RIVER ***: [Jc Js 5c 10c] [Qh]
------ Summary ------
Pot: 13.09. Rake 0.46. JP fee 0.22
Board: [Jc Js 5c 10c Qh]
*Player tbmfc shows: Straight to Q [8d 9d]. Bets: 6.76. Collects: 13.09. Wins: 6.33.
Player naprimer does not show cards.Bets: 0. Collects: 0. Wins: 0.
Player Log_in does not show cards.Bets: 0. Collects: 0. Wins: 0.
Player IlxxxlI does not show cards.Bets: 0. Collects: 0. Wins: 0.
Player Vonalarta does not show cards.Bets: 0. Collects: 0. Wins: 0.
Player Tanker123 does not show cards.Bets: 0.25. Collects: 0. Loses: 0.25.
Player MANTISGUYV10 shows: Two pairs. Qs and Js [Qs Ks]. Bets: 6.76. Collects: 0. Loses: 6.76.
Game ended at: 2016/11/19 23:39:19

Game started
Game ID: 779469191 0.25/0.50 (PRR) Garuda (Hold'em)
Seat 5 is the button
Seat 2: tbmfc (6.76).
Seat 3: naprimer (53.56).
Seat 4: Log_in (19.72).
Seat 5: IlxxxlI (20).
Seat 6: Vonalarta (66.52).
Seat 7: Tanker123 (35.64).
Seat 8: MANTISGUYV10 (75.27).
Player Vonalarta has small blind (0.25)
Player Tanker123 has big blind (0.50)
Player IlxxxlI received card: [7h]
Player IlxxxlI received card: [6d]
Player MANTISGUYV10 folds
Player tbmfc folds
Player naprimer folds
Player Log_in folds
Player IlxxxlI folds
Player Vonalarta raises (1.25)
Player Tanker123 calls (1)
*** FLOP ***: [3h 6h 4s]
Player Vonalarta checks
Player Tanker123 bets (2)
Player Vonalarta folds
Uncalled bet (2) returned to Tanker123
Player Tanker123 mucks cards
------ Summary ------
Pot: 2.85. Rake 0.11. JP fee 0.04
Board: [3h 6h 4s]
Player tbmfc does not show cards.Bets: 0. Collects: 0. Wins: 0.
Player naprimer does not show cards.Bets: 0. Collects: 0. Wins: 0.
Player Log_in does not show cards.Bets: 0. Collects: 0. Wins: 0.
Player IlxxxlI does not show cards.Bets: 0. Collects: 0. Wins: 0.
Player Vonalarta does not show cards.Bets: 1.50. Collects: 0. Loses: 1.50.
*Player Tanker123 mucks (does not show cards). Bets: 1.50. Collects: 2.85. Wins: 1.35.
Player MANTISGUYV10 does not show cards.Bets: 0. Collects: 0. Wins: 0.
Game ended at: 2016/11/19 23:38:25

Game started
Game ID: 779468672 0.25/0.50 (PRR) Garuda (Hold'em)
Seat 4 is the button
Seat 2: tbmfc (6.76).
Seat 3: naprimer (53.56).
Seat 4: Log_in (21.22).
Seat 5: IlxxxlI (20).
Seat 6: Vonalarta (67.02).
Seat 7: Tanker123 (33.39).
Seat 8: MANTISGUYV10 (75.27).
Player IlxxxlI has small blind (0.25)
Player Vonalarta has big blind (0.50)
Player IlxxxlI received card: [3h]
Player IlxxxlI received card: [7d]
Player Tanker123 calls (0.50)
Player MANTISGUYV10 folds
Player tbmfc folds
Player naprimer folds
Player Log_in raises (1.50)
Player IlxxxlI folds
Player Vonalarta folds
Player Tanker123 raises (4)
Player Log_in folds
Uncalled bet (3) returned to Tanker123
Player Tanker123 mucks cards
------ Summary ------
Pot: 3.75. Rake 0
Player tbmfc does not show cards.Bets: 0. Collects: 0. Wins: 0.
Player naprimer does not show cards.Bets: 0. Collects: 0. Wins: 0.
Player Log_in does not show cards.Bets: 1.50. Collects: 0. Loses: 1.50.
Player IlxxxlI does not show cards.Bets: 0.25. Collects: 0. Loses: 0.25.
Player Vonalarta does not show cards.Bets: 0.50. Collects: 0. Loses: 0.50.
*Player Tanker123 mucks (does not show cards). Bets: 1.50. Collects: 3.75. Wins: 2.25.
Player MANTISGUYV10 does not show cards.Bets: 0. Collects: 0. Wins: 0.
Game ended at: 2016/11/19 23:37:28

Game started
Game ID: 779468134 0.25/0.50 (PRR) Garuda (Hold'em)
Seat 3 is the button
Seat 2: tbmfc (8.57).
Seat 3: naprimer (53.56).
Seat 4: Log_in (21.47).
Seat 5: IlxxxlI (20).
Seat 6: Vonalarta (67.02).
Seat 7: Tanker123 (19.25).
Seat 8: MANTISGUYV10 (71.20).
Player Log_in has small blind (0.25)
Player IlxxxlI has big blind (0.50)
Player IlxxxlI received card: [Qc]
Player IlxxxlI received card: [2s]
Player Vonalarta folds
Player Tanker123 calls (0.50)
Player MANTISGUYV10 raises (1.81)
Player tbmfc calls (1.81)
Player naprimer folds
Player Log_in folds
Player IlxxxlI folds
Player Tanker123 calls (1.31)
*** FLOP ***: [Kh 3h 5c]
Player Tanker123 checks
Player MANTISGUYV10 bets (5.88)
Player tbmfc folds
Player Tanker123 folds
Uncalled bet (5.88) returned to MANTISGUYV10
Player MANTISGUYV10 mucks cards
------ Summary ------
Pot: 5.88. Rake 0.20. JP fee 0.10
Board: [Kh 3h 5c]
Player tbmfc does not show cards.Bets: 1.81. Collects: 0. Loses: 1.81.
Player naprimer does not show cards.Bets: 0. Collects: 0. Wins: 0.
Player Log_in does not show cards.Bets: 0.25. Collects: 0. Loses: 0.25.
Player IlxxxlI does not show cards.Bets: 0.50. Collects: 0. Loses: 0.50.
Player Vonalarta does not show cards.Bets: 0. Collects: 0. Wins: 0.
Player Tanker123 does not show cards.Bets: 1.81. Collects: 0. Loses: 1.81.
*Player MANTISGUYV10 mucks (does not show cards). Bets: 1.81. Collects: 5.88. Wins: 4.07.
Game ended at: 2016/11/19 23:36:22

Game started
Game ID: 779467750 0.25/0.50 (PRR) Garuda (Hold'em)
Seat 2 is the button
Seat 2: tbmfc (10.01).
Seat 3: naprimer (53.81).
Seat 4: Log_in (21.97).
Seat 5: IlxxxlI (20).
Seat 6: Vonalarta (67.02).
Seat 7: Tanker123 (19.25).
Seat 8: MANTISGUYV10 (69.19).
Player naprimer has small blind (0.25)
Player Log_in has big blind (0.50)
Player IlxxxlI received card: [4c]
Player IlxxxlI received card: [5d]
Player IlxxxlI folds
Player Vonalarta folds
Player Tanker123 folds
Player MANTISGUYV10 raises (1.44)
Player tbmfc calls (1.44)
Player naprimer folds
Player Log_in folds
*** FLOP ***: [8c 10s 8s]
Player MANTISGUYV10 bets (1.73)
Player tbmfc folds
Uncalled bet (1.73) returned to MANTISGUYV10
Player MANTISGUYV10 mucks cards
------ Summary ------
Pot: 3.45. Rake 0.12. JP fee 0.06
Board: [8c 10s 8s]
Player tbmfc does not show cards.Bets: 1.44. Collects: 0. Loses: 1.44.
Player naprimer does not show cards.Bets: 0.25. Collects: 0. Loses: 0.25.
Player Log_in does not show cards.Bets: 0.50. Collects: 0. Loses: 0.50.
Player IlxxxlI does not show cards.Bets: 0. Collects: 0. Wins: 0.
Player Vonalarta does not show cards.Bets: 0. Collects: 0. Wins: 0.
Player Tanker123 does not show cards.Bets: 0. Collects: 0. Wins: 0.
*Player MANTISGUYV10 mucks (does not show cards). Bets: 1.44. Collects: 3.45. Wins: 2.01.
Game ended at: 2016/11/19 23:35:17

Game started
Game ID: 779467280 0.25/0.50 (PRR) Garuda (Hold'em)
Seat 8 is the button
Seat 2: tbmfc (10.26).
Seat 3: naprimer (54.31).
Seat 4: Log_in (24.59).
Seat 5: IlxxxlI (20).
Seat 6: Vonalarta (67.02).
Seat 7: Tanker123 (19.25).
Seat 8: MANTISGUYV10 (66.11).
Player tbmfc has small blind (0.25)
Player naprimer has big blind (0.50)
Player IlxxxlI received card: [7h]
Player IlxxxlI received card: [8c]
Player Log_in raises (1.12)
Player IlxxxlI folds
Player Vonalarta folds
Player Tanker123 folds
Player MANTISGUYV10 raises (2.62)
Player tbmfc folds
Player naprimer folds
Player Log_in calls (1.50)
*** FLOP ***: [Js Qh 4s]
Player Log_in checks
Player MANTISGUYV10 bets (4.28)
Player Log_in folds
Uncalled bet (4.28) returned to MANTISGUYV10
Player MANTISGUYV10 mucks cards
------ Summary ------
Pot: 5.70. Rake 0.21. JP fee 0.08
Board: [Js Qh 4s]
Player tbmfc does not show cards.Bets: 0.25. Collects: 0. Loses: 0.25.
Player naprimer does not show cards.Bets: 0.50. Collects: 0. Loses: 0.50.
Player Log_in does not show cards.Bets: 2.62. Collects: 0. Loses: 2.62.
Player IlxxxlI does not show cards.Bets: 0. Collects: 0. Wins: 0.
Player Vonalarta does not show cards.Bets: 0. Collects: 0. Wins: 0.
Player Tanker123 does not show cards.Bets: 0. Collects: 0. Wins: 0.
*Player MANTISGUYV10 mucks (does not show cards). Bets: 2.62. Collects: 5.70. Wins: 3.08.
Game ended at: 2016/11/19 23:34:31

Game started
Game ID: 779467109 0.25/0.50 (PRR) Garuda (Hold'em)
Seat 7 is the button
Seat 1: n0hvn (56).
Seat 2: tbmfc (10.01).
Seat 3: naprimer (54.31).
Seat 4: Log_in (24.59).
Seat 5: IlxxxlI (20).
Seat 6: Vonalarta (67.02).
Seat 7: Tanker123 (19.25).
Seat 8: MANTISGUYV10 (66.36).
Seat 9: BiGFck (32.07).
Player MANTISGUYV10 has small blind (0.25)
Player BiGFck sitting out
Player n0hvn sitting out
Player tbmfc has big blind (0.50)
Player IlxxxlI received card: [3h]
Player IlxxxlI received card: [5c]
Player naprimer folds
Player Log_in folds
Player IlxxxlI folds
Player Vonalarta folds
Player Tanker123 folds
Player MANTISGUYV10 folds
Uncalled bet (0.25) returned to tbmfc
Player tbmfc mucks cards
------ Summary ------
Pot: 0.50. Rake 0
Player n0hvn does not show cards.Bets: 0. Collects: 0. Wins: 0.
*Player tbmfc mucks (does not show cards). Bets: 0.25. Collects: 0.50. Wins: 0.25.
Player naprimer does not show cards.Bets: 0. Collects: 0. Wins: 0.
Player Log_in does not show cards.Bets: 0. Collects: 0. Wins: 0.
Player IlxxxlI does not show cards.Bets: 0. Collects: 0. Wins: 0.
Player Vonalarta does not show cards.Bets: 0. Collects: 0. Wins: 0.
Player Tanker123 does not show cards.Bets: 0. Collects: 0. Wins: 0.
Player MANTISGUYV10 does not show cards.Bets: 0.25. Collects: 0. Loses: 0.25.
Player BiGFck does not show cards.Bets: 0. Collects: 0. Wins: 0.
Game ended at: 2016/11/19 23:33:34

Game started
Game ID: 779466823 0.25/0.50 (PRR) Garuda (Hold'em)
Seat 6 is the button
Seat 1: n0hvn (56).
Seat 2: tbmfc (9.26).
Seat 3: naprimer (54.31).
Seat 4: Log_in (24.59).
Seat 5: IlxxxlI (20).
Seat 6: Vonalarta (67.02).
Seat 7: Tanker123 (19.50).
Seat 8: MANTISGUYV10 (66.86).
Seat 9: BiGFck (32.07).
Player Tanker123 has small blind (0.25)
Player MANTISGUYV10 has big blind (0.50)
Player IlxxxlI received card: [8h]
Player IlxxxlI received card: [6d]
Player BiGFck folds
Player n0hvn folds
Player tbmfc allin (9.26)
Player naprimer folds
Player Log_in folds
Player IlxxxlI folds
Player Vonalarta folds
Player Tanker123 folds
Player MANTISGUYV10 folds
Uncalled bet (8.76) returned to tbmfc
------ Summary ------
Pot: 1.25. Rake 0
Player n0hvn does not show cards.Bets: 0. Collects: 0. Wins: 0.
*Player tbmfc shows: High card 4 [4s 3s]. Bets: 0.50. Collects: 1.25. Wins: 0.75.
Player naprimer does not show cards.Bets: 0. Collects: 0. Wins: 0.
Player Log_in does not show cards.Bets: 0. Collects: 0. Wins: 0.
Player IlxxxlI does not show cards.Bets: 0. Collects: 0. Wins: 0.
Player Vonalarta does not show cards.Bets: 0. Collects: 0. Wins: 0.
Player Tanker123 does not show cards.Bets: 0.25. Collects: 0. Loses: 0.25.
Player MANTISGUYV10 does not show cards.Bets: 0.50. Collects: 0. Loses: 0.50.
Player BiGFck does not show cards.Bets: 0. Collects: 0. Wins: 0.
Game ended at: 2016/11/19 23:33:13

Game started
Game ID: 779466049 0.25/0.50 (PRR) Garuda (Hold'em)
Seat 5 is the button
Seat 1: n0hvn (56).
Seat 2: tbmfc (11.19).
Seat 3: naprimer (54.31).
Seat 4: Log_in (24.59).
Seat 5: IlxxxlI (20).
Seat 6: Vonalarta (68.95).
Seat 7: Tanker123 (20).
Seat 8: MANTISGUYV10 (62.81).
Seat 9: BiGFck (32.07).
Player Vonalarta has small blind (0.25)
Player Tanker123 has big blind (0.50)
Player IlxxxlI received card: [7c]
Player IlxxxlI received card: [10s]
Player MANTISGUYV10 calls (0.50)
Player BiGFck folds
Player n0hvn folds
Player tbmfc calls (0.50)
Player naprimer folds
Player Log_in folds
Player IlxxxlI folds
Player Vonalarta calls (0.25)
Player Tanker123 checks
*** FLOP ***: [9s 3c Js]
Player Vonalarta checks
Player Tanker123 checks
Player MANTISGUYV10 bets (1.43)
Player tbmfc calls (1.43)
Player Vonalarta calls (1.43)
Player Tanker123 folds
*** TURN ***: [9s 3c Js] [Kd]
Player Vonalarta checks
Player MANTISGUYV10 bets (2.99)
Player tbmfc folds
Player Vonalarta folds
Uncalled bet (2.99) returned to MANTISGUYV10
Player MANTISGUYV10 mucks cards
------ Summary ------
Pot: 5.98. Rake 0.21. JP fee 0.10
Board: [9s 3c Js Kd]
Player n0hvn does not show cards.Bets: 0. Collects: 0. Wins: 0.
Player tbmfc does not show cards.Bets: 1.93. Collects: 0. Loses: 1.93.
Player naprimer does not show cards.Bets: 0. Collects: 0. Wins: 0.
Player Log_in does not show cards.Bets: 0. Collects: 0. Wins: 0.
Player IlxxxlI does not show cards.Bets: 0. Collects: 0. Wins: 0.
Player Vonalarta does not show cards.Bets: 1.93. Collects: 0. Loses: 1.93.
Player Tanker123 does not show cards.Bets: 0.50. Collects: 0. Loses: 0.50.
*Player MANTISGUYV10 mucks (does not show cards). Bets: 1.93. Collects: 5.98. Wins: 4.05.
Player BiGFck does not show cards.Bets: 0. Collects: 0. Wins: 0.
Game ended at: 2016/11/19 23:32:42

Game started
Game ID: 779465513 0.25/0.50 (PRR) Garuda (Hold'em)
Seat 4 is the button
Seat 1: n0hvn (56).
Seat 2: tbmfc (11.19).
Seat 3: naprimer (54.31).
Seat 4: Log_in (24.59).
Seat 5: IlxxxlI (20).
Seat 6: Vonalarta (69.45).
Seat 8: MANTISGUYV10 (79.31).
Seat 9: BiGFck (16.50).
Player IlxxxlI has small blind (0.25)
Player Vonalarta has big blind (0.50)
Player IlxxxlI received card: [Qs]
Player IlxxxlI received card: [5c]
Player MANTISGUYV10 calls (0.50)
Player BiGFck raises (2)
Player n0hvn folds
Player tbmfc folds
Player naprimer folds
Player Log_in folds
Player IlxxxlI folds
Player Vonalarta folds
Player MANTISGUYV10 calls (1.50)
*** FLOP ***: [Jd Qd 3s]
Player MANTISGUYV10 checks
Player BiGFck bets (3.50)
Player MANTISGUYV10 calls (3.50)
*** TURN ***: [Jd Qd 3s] [7d]
Player MANTISGUYV10 checks
Player BiGFck bets (7.44)
Player MANTISGUYV10 allin (73.81)
Player BiGFck allin (3.56)
Uncalled bet (62.81) returned to MANTISGUYV10
*** RIVER ***: [Jd Qd 3s 7d] [Ks]
------ Summary ------
Pot: 32.07. Rake 1.44. JP fee 0.24
Board: [Jd Qd 3s 7d Ks]
Player n0hvn does not show cards.Bets: 0. Collects: 0. Wins: 0.
Player tbmfc does not show cards.Bets: 0. Collects: 0. Wins: 0.
Player naprimer does not show cards.Bets: 0. Collects: 0. Wins: 0.
Player Log_in does not show cards.Bets: 0. Collects: 0. Wins: 0.
Player IlxxxlI does not show cards.Bets: 0.25. Collects: 0. Loses: 0.25.
Player Vonalarta does not show cards.Bets: 0.50. Collects: 0. Loses: 0.50.
Player MANTISGUYV10 shows: One pair of 2s [2d 2s]. Bets: 16.50. Collects: 0. Loses: 16.50.
*Player BiGFck shows: One pair of As [Ah Ad]. Bets: 16.50. Collects: 32.07. Wins: 15.57.
Game ended at: 2016/11/19 23:31:2

Game started
Game ID: 779465197 0.25/0.50 (PRR) Garuda (Hold'em)
Seat 3 is the button
Seat 1: n0hvn (56).
Seat 2: tbmfc (11.19).
Seat 3: naprimer (54.31).
Seat 4: Log_in (24.84).
Seat 5: IlxxxlI (20).
Seat 6: Vonalarta (68.70).
Seat 7: gmjohn (30.71).
Seat 8: MANTISGUYV10 (79.31).
Seat 9: BiGFck (16.50).
Player Log_in has small blind (0.25)
Player IlxxxlI has big blind (0.50)
Player IlxxxlI received card: [Jc]
Player IlxxxlI received card: [4d]
Player Vonalarta raises (1.50)
Player gmjohn folds
Player MANTISGUYV10 folds
Player BiGFck folds
Player n0hvn folds
Player tbmfc folds
Player naprimer folds
Player Log_in folds
Player IlxxxlI folds
Uncalled bet (1) returned to Vonalarta
Player Vonalarta mucks cards
------ Summary ------
Pot: 1.25. Rake 0
Player n0hvn does not show cards.Bets: 0. Collects: 0. Wins: 0.
Player tbmfc does not show cards.Bets: 0. Collects: 0. Wins: 0.
Player naprimer does not show cards.Bets: 0. Collects: 0. Wins: 0.
Player Log_in does not show cards.Bets: 0.25. Collects: 0. Loses: 0.25.
Player IlxxxlI does not show cards.Bets: 0.50. Collects: 0. Loses: 0.50.
*Player Vonalarta mucks (does not show cards). Bets: 0.50. Collects: 1.25. Wins: 0.75.
Player gmjohn does not show cards.Bets: 0. Collects: 0. Wins: 0.
Player MANTISGUYV10 does not show cards.Bets: 0. Collects: 0. Wins: 0.
Player BiGFck does not show cards.Bets: 0. Collects: 0. Wins: 0.
Game ended at: 2016/11/19 23:29:56

Game started
Game ID: 779463735 0.25/0.50 (PRR) Garuda (Hold'em)
Seat 1 is the button
Seat 1: n0hvn (56).
Seat 2: tbmfc (13.01).
Seat 3: naprimer (55.06).
Seat 4: Log_in (25.34).
Seat 5: IlxxxlI (20).
Seat 6: Vonalarta (68.70).
Seat 7: gmjohn (29.60).
Seat 8: MANTISGUYV10 (77.74).
Seat 9: BiGFck (16.50).
Player tbmfc has small blind (0.25)
Player naprimer has big blind (0.50)
Player IlxxxlI received card: [2h]
Player IlxxxlI received card: [4d]
Player Log_in folds
Player IlxxxlI folds
Player Vonalarta folds
Player gmjohn raises (1.50)
Player MANTISGUYV10 calls (1.50)
Player BiGFck folds
Player n0hvn folds
Player tbmfc folds
Player naprimer folds
*** FLOP ***: [Qs Ks 4c]
Player gmjohn checks
Player MANTISGUYV10 bets (2.68)
Player gmjohn folds
Uncalled bet (2.68) returned to MANTISGUYV10
Player MANTISGUYV10 mucks cards
------ Summary ------
Pot: 3.57. Rake 0.12. JP fee 0.06
Board: [Qs Ks 4c]
Player n0hvn does not show cards.Bets: 0. Collects: 0. Wins: 0.
Player tbmfc does not show cards.Bets: 0.25. Collects: 0. Loses: 0.25.
Player naprimer does not show cards.Bets: 0.50. Collects: 0. Loses: 0.50.
Player Log_in does not show cards.Bets: 0. Collects: 0. Wins: 0.
Player IlxxxlI does not show cards.Bets: 0. Collects: 0. Wins: 0.
Player Vonalarta does not show cards.Bets: 0. Collects: 0. Wins: 0.
Player gmjohn does not show cards.Bets: 1.50. Collects: 0. Loses: 1.50.
*Player MANTISGUYV10 mucks (does not show cards). Bets: 1.50. Collects: 3.57. Wins: 2.07.
Player BiGFck does not show cards.Bets: 0. Collects: 0. Wins: 0.
Game ended at: 2016/11/19 23:27:22

Game started
Game ID: 779463116 0.25/0.50 (PRR) Garuda (Hold'em)
Seat 9 is the button
Seat 1: n0hvn (56.25).
Seat 2: tbmfc (14.51).
Seat 3: naprimer (55.06).
Seat 4: Log_in (25.34).
Seat 5: IlxxxlI (20).
Seat 6: Vonalarta (68.70).
Seat 7: gmjohn (28.01).
Seat 9: BiGFck (16.50).
Player n0hvn has small blind (0.25)
Player tbmfc has big blind (0.50)
Player IlxxxlI received card: [2s]
Player IlxxxlI received card: [6d]
Player naprimer folds
Player Log_in folds
Player IlxxxlI folds
Player Vonalarta folds
Player gmjohn raises (1.50)
Player BiGFck folds
Player n0hvn folds
Player tbmfc calls (1)
*** FLOP ***: [10c 5c 2h]
Player tbmfc checks
Player gmjohn bets (2.06)
Player tbmfc folds
Uncalled bet (2.06) returned to gmjohn
Player gmjohn mucks cards
------ Summary ------
Pot: 3.09. Rake 0.12. JP fee 0.04
Board: [10c 5c 2h]
Player n0hvn does not show cards.Bets: 0.25. Collects: 0. Loses: 0.25.
Player tbmfc does not show cards.Bets: 1.50. Collects: 0. Loses: 1.50.
Player naprimer does not show cards.Bets: 0. Collects: 0. Wins: 0.
Player Log_in does not show cards.Bets: 0. Collects: 0. Wins: 0.
Player IlxxxlI does not show cards.Bets: 0. Collects: 0. Wins: 0.
Player Vonalarta does not show cards.Bets: 0. Collects: 0. Wins: 0.
*Player gmjohn mucks (does not show cards). Bets: 1.50. Collects: 3.09. Wins: 1.59.
Player BiGFck does not show cards.Bets: 0. Collects: 0. Wins: 0.
Game ended at: 2016/11/19 23:26:12

Game started
Game ID: 779462578 0.25/0.50 (PRR) Garuda (Hold'em)
Seat 7 is the button
Seat 1: n0hvn (55.50).
Seat 2: tbmfc (14.51).
Seat 3: naprimer (55.06).
Seat 4: Log_in (25.34).
Seat 5: IlxxxlI (20).
Seat 6: Vonalarta (68.70).
Seat 7: gmjohn (28.01).
Seat 8: MANTISGUYV10 (77.99).
Seat 9: BiGFck (17).
Player MANTISGUYV10 has small blind (0.25)
Player BiGFck has big blind (0.50)
Player IlxxxlI received card: [2s]
Player IlxxxlI received card: [2h]
Player n0hvn raises (1.50)
Player tbmfc folds
Player naprimer folds
Player Log_in folds
Player IlxxxlI folds
Player Vonalarta folds
Player gmjohn folds
Player MANTISGUYV10 is timed out.
Player MANTISGUYV10 folds
Player BiGFck folds
Uncalled bet (1) returned to n0hvn
Player n0hvn mucks cards
------ Summary ------
Pot: 1.25. Rake 0
*Player n0hvn mucks (does not show cards). Bets: 0.50. Collects: 1.25. Wins: 0.75.
Player tbmfc does not show cards.Bets: 0. Collects: 0. Wins: 0.
Player naprimer does not show cards.Bets: 0. Collects: 0. Wins: 0.
Player Log_in does not show cards.Bets: 0. Collects: 0. Wins: 0.
Player IlxxxlI does not show cards.Bets: 0. Collects: 0. Wins: 0.
Player Vonalarta does not show cards.Bets: 0. Collects: 0. Wins: 0.
Player gmjohn does not show cards.Bets: 0. Collects: 0. Wins: 0.
Player MANTISGUYV10 does not show cards.Bets: 0.25. Collects: 0. Loses: 0.25.
Player BiGFck does not show cards.Bets: 0.50. Collects: 0. Loses: 0.50.
Game ended at: 2016/11/19 23:25:0

Game started
Game ID: 779462175 0.25/0.50 (PRR) Garuda (Hold'em)
Seat 6 is the button
Seat 1: n0hvn (55.50).
Seat 2: tbmfc (27.47).
Seat 3: naprimer (55.06).
Seat 4: Log_in (12.96).
Seat 5: IlxxxlI (20).
Seat 6: Vonalarta (68.70).
Seat 7: gmjohn (28.26).
Seat 8: MANTISGUYV10 (78.49).
Seat 9: BiGFck (17).
Player gmjohn has small blind (0.25)
Player MANTISGUYV10 has big blind (0.50)
Player IlxxxlI received card: [7h]
Player IlxxxlI received card: [3s]
Player BiGFck folds
Player n0hvn folds
Player tbmfc raises (2)
Player naprimer folds
Player Log_in allin (12.96)
Player IlxxxlI folds
Player Vonalarta folds
Player gmjohn folds
Player MANTISGUYV10 folds
Player tbmfc calls (10.96)
*** FLOP ***: [8c 8h 5d]
*** TURN ***: [8c 8h 5d] [7d]
*** RIVER ***: [8c 8h 5d 7d] [Js]
------ Summary ------
Pot: 25.34. Rake 1.09. JP fee 0.24
Board: [8c 8h 5d 7d Js]
Player n0hvn does not show cards.Bets: 0. Collects: 0. Wins: 0.
Player tbmfc shows: Two pairs. 9s and 8s [9h 9d]. Bets: 12.96. Collects: 0. Loses: 12.96.
Player naprimer does not show cards.Bets: 0. Collects: 0. Wins: 0.
*Player Log_in shows: Two pairs. Js and 8s [Jc Ah]. Bets: 12.96. Collects: 25.34. Wins: 12.38.
Player IlxxxlI does not show cards.Bets: 0. Collects: 0. Wins: 0.
Player Vonalarta does not show cards.Bets: 0. Collects: 0. Wins: 0.
Player gmjohn does not show cards.Bets: 0.25. Collects: 0. Loses: 0.25.
Player MANTISGUYV10 does not show cards.Bets: 0.50. Collects: 0. Loses: 0.50.
Player BiGFck does not show cards.Bets: 0. Collects: 0. Wins: 0.
Game ended at: 2016/11/19 23:23:51

Game started
Game ID: 779461600 0.25/0.50 (PRR) Garuda (Hold'em)
Seat 5 is the button
Seat 1: n0hvn (55.50).
Seat 2: tbmfc (27.47).
Seat 3: naprimer (55.06).
Seat 4: Log_in (14.40).
Seat 5: IlxxxlI (20).
Seat 6: Vonalarta (68.95).
Seat 7: gmjohn (28.76).
Seat 8: MANTISGUYV10 (76.48).
Seat 9: BiGFck (17).
Player Vonalarta has small blind (0.25)
Player gmjohn has big blind (0.50)
Player IlxxxlI received card: [7d]
Player IlxxxlI received card: [Ac]
Player MANTISGUYV10 raises (1.44)
Player BiGFck folds
Player n0hvn folds
Player tbmfc folds
Player naprimer folds
Player Log_in calls (1.44)
Player IlxxxlI folds
Player Vonalarta folds
Player gmjohn folds
*** FLOP ***: [7c 3c 3h]
Player MANTISGUYV10 bets (2.59)
Player Log_in folds
Uncalled bet (2.59) returned to MANTISGUYV10
Player MANTISGUYV10 mucks cards
------ Summary ------
Pot: 3.45. Rake 0.12. JP fee 0.06
Board: [7c 3c 3h]
Player n0hvn does not show cards.Bets: 0. Collects: 0. Wins: 0.
Player tbmfc does not show cards.Bets: 0. Collects: 0. Wins: 0.
Player naprimer does not show cards.Bets: 0. Collects: 0. Wins: 0.
Player Log_in does not show cards.Bets: 1.44. Collects: 0. Loses: 1.44.
Player IlxxxlI does not show cards.Bets: 0. Collects: 0. Wins: 0.
Player Vonalarta does not show cards.Bets: 0.25. Collects: 0. Loses: 0.25.
Player gmjohn does not show cards.Bets: 0.50. Collects: 0. Loses: 0.50.
*Player MANTISGUYV10 mucks (does not show cards). Bets: 1.44. Collects: 3.45. Wins: 2.01.
Player BiGFck does not show cards.Bets: 0. Collects: 0. Wins: 0.
Game ended at: 2016/11/19 23:22:58

Game started
Game ID: 779460959 0.25/0.50 (PRR) Garuda (Hold'em)
Seat 4 is the button
Seat 1: n0hvn (55.50).
Seat 2: tbmfc (28.47).
Seat 3: naprimer (55.06).
Seat 4: Log_in (14.40).
Seat 5: IlxxxlI (20).
Seat 6: Vonalarta (50).
Seat 7: gmjohn (28.76).
Seat 8: MANTISGUYV10 (76.48).
Seat 9: BiGFck (17).
Player IlxxxlI has small blind (0.25)
Player Vonalarta has big blind (0.50)
Player IlxxxlI received card: [As]
Player IlxxxlI received card: [Ks]
Player gmjohn folds
Player MANTISGUYV10 folds
Player BiGFck folds
Player n0hvn folds
Player tbmfc raises (1)
Player naprimer folds
Player Log_in folds
Player IlxxxlI raises (10.25)
Player Vonalarta allin (49.50)
Player tbmfc folds
Player IlxxxlI allin (9.50)
Uncalled bet (30) returned to Vonalarta
*** FLOP ***: [9h Jh 3h]
*** TURN ***: [9h Jh 3h] [5c]
*** RIVER ***: [9h Jh 3h 5c] [Js]
------ Summary ------
Pot: 38.95. Rake 1.81. JP fee 0.24
Board: [9h Jh 3h 5c Js]
Player n0hvn does not show cards.Bets: 0. Collects: 0. Wins: 0.
Player tbmfc does not show cards.Bets: 1. Collects: 0. Loses: 1.
Player naprimer does not show cards.Bets: 0. Collects: 0. Wins: 0.
Player Log_in does not show cards.Bets: 0. Collects: 0. Wins: 0.
Player IlxxxlI shows: One pair of Js [As Ks]. Bets: 20. Collects: 0. Loses: 20.
*Player Vonalarta shows: Two pairs. Js and 10s [10h 10s]. Bets: 20. Collects: 38.95. Wins: 18.95.
Player gmjohn does not show cards.Bets: 0. Collects: 0. Wins: 0.
Player MANTISGUYV10 does not show cards.Bets: 0. Collects: 0. Wins: 0.
Player BiGFck does not show cards.Bets: 0. Collects: 0. Wins: 0.
Game ended at: 2016/11/19 23:21:41

Game started
Game ID: 779460276 0.25/0.50 (PRR) Garuda (Hold'em)
Seat 3 is the button
Seat 1: n0hvn (55.50).
Seat 2: tbmfc (28.47).
Seat 3: naprimer (55.06).
Seat 4: Log_in (14.65).
Seat 5: IlxxxlI (20).
Seat 7: gmjohn (28.76).
Seat 8: MANTISGUYV10 (58.24).
Seat 9: BiGFck (17).
Player Log_in has small blind (0.25)
Player IlxxxlI has big blind (0.50)
Player IlxxxlI received card: [8h]
Player IlxxxlI received card: [Ah]
Player gmjohn folds
Player MANTISGUYV10 calls (0.50)
Player BiGFck folds
Player n0hvn folds
Player tbmfc folds
Player naprimer folds
Player Log_in folds
Player IlxxxlI checks
*** FLOP ***: [5h 3d 3s]
Player IlxxxlI checks
Player MANTISGUYV10 bets (1.19)
Player IlxxxlI calls (1.19)
*** TURN ***: [5h 3d 3s] [8s]
Player IlxxxlI checks
Player MANTISGUYV10 bets (2.59)
Player IlxxxlI calls (2.59)
*** RIVER ***: [5h 3d 3s 8s] [7h]
Player IlxxxlI checks
Player MANTISGUYV10 allin (53.96)
Player IlxxxlI allin (15.72)
Uncalled bet (38.24) returned to MANTISGUYV10
------ Summary ------
Pot: 38.24. Rake 1.77. JP fee 0.24
Board: [5h 3d 3s 8s 7h]
Player n0hvn does not show cards.Bets: 0. Collects: 0. Wins: 0.
Player tbmfc does not show cards.Bets: 0. Collects: 0. Wins: 0.
Player naprimer does not show cards.Bets: 0. Collects: 0. Wins: 0.
Player Log_in does not show cards.Bets: 0.25. Collects: 0. Loses: 0.25.
Player IlxxxlI shows: Two pairs. 8s and 3s [8h Ah]. Bets: 20. Collects: 0. Loses: 20.
Player gmjohn does not show cards.Bets: 0. Collects: 0. Wins: 0.
*Player MANTISGUYV10 shows: Straight to 8 [6c 4d]. Bets: 20. Collects: 38.24. Wins: 18.24.
Player BiGFck does not show cards.Bets: 0. Collects: 0. Wins: 0.
Game ended at: 2016/11/19 23:20:12

Game started
Game ID: 779459871 0.25/0.50 (PRR) Garuda (Hold'em)
Seat 2 is the button
Seat 1: n0hvn (55.50).
Seat 2: tbmfc (28.47).
Seat 3: naprimer (55.31).
Seat 4: Log_in (15.15).
Seat 5: IlxxxlI (20).
Seat 7: gmjohn (28.76).
Seat 8: MANTISGUYV10 (57.49).
Seat 9: BiGFck (17).
Player naprimer has small blind (0.25)
Player Log_in has big blind (0.50)
Player IlxxxlI received card: [Kh]
Player IlxxxlI received card: [6h]
Player IlxxxlI folds
Player gmjohn folds
Player MANTISGUYV10 raises (1.44)
Player BiGFck folds
Player n0hvn folds
Player tbmfc folds
Player naprimer folds
Player Log_in folds
Uncalled bet (0.94) returned to MANTISGUYV10
Player MANTISGUYV10 mucks cards
------ Summary ------
Pot: 1.25. Rake 0
Player n0hvn does not show cards.Bets: 0. Collects: 0. Wins: 0.
Player tbmfc does not show cards.Bets: 0. Collects: 0. Wins: 0.
Player naprimer does not show cards.Bets: 0.25. Collects: 0. Loses: 0.25.
Player Log_in does not show cards.Bets: 0.50. Collects: 0. Loses: 0.50.
Player IlxxxlI does not show cards.Bets: 0. Collects: 0. Wins: 0.
Player gmjohn does not show cards.Bets: 0. Collects: 0. Wins: 0.
*Player MANTISGUYV10 mucks (does not show cards). Bets: 0.50. Collects: 1.25. Wins: 0.75.
Player BiGFck does not show cards.Bets: 0. Collects: 0. Wins: 0.
Game ended at: 2016/11/19 23:18:41

Game started
Game ID: 779459360 0.25/0.50 (PRR) Garuda (Hold'em)
Seat 1 is the button
Seat 1: n0hvn (55.50).
Seat 2: tbmfc (29.97).
Seat 3: naprimer (55.81).
Seat 4: Log_in (13.32).
Seat 5: IlxxxlI (20).
Seat 7: gmjohn (28.76).
Seat 9: BiGFck (17).
Player tbmfc has small blind (0.25)
Player naprimer has big blind (0.50)
Player IlxxxlI received card: [9c]
Player IlxxxlI received card: [5c]
Player Log_in raises (1.50)
Player IlxxxlI folds
Player gmjohn folds
Player BiGFck folds
Player n0hvn folds
Player tbmfc calls (1.25)
Player naprimer folds
*** FLOP ***: [4s Qs Kd]
Player tbmfc checks
Player Log_in bets (1.66)
Player tbmfc folds
Uncalled bet (1.66) returned to Log_in
Player Log_in mucks cards
------ Summary ------
Pot: 3.33. Rake 0.13. JP fee 0.04
Board: [4s Qs Kd]
Player n0hvn does not show cards.Bets: 0. Collects: 0. Wins: 0.
Player tbmfc does not show cards.Bets: 1.50. Collects: 0. Loses: 1.50.
Player naprimer does not show cards.Bets: 0.50. Collects: 0. Loses: 0.50.
*Player Log_in mucks (does not show cards). Bets: 1.50. Collects: 3.33. Wins: 1.83.
Player IlxxxlI does not show cards.Bets: 0. Collects: 0. Wins: 0.
Player gmjohn does not show cards.Bets: 0. Collects: 0. Wins: 0.
Player BiGFck does not show cards.Bets: 0. Collects: 0. Wins: 0.
Game ended at: 2016/11/19 23:17:47

Game started
Game ID: 779458970 0.25/0.50 (PRR) Garuda (Hold'em)
Seat 9 is the button
Seat 1: n0hvn (55.75).
Seat 2: tbmfc (30.47).
Seat 3: naprimer (55.06).
Seat 4: Log_in (13.32).
Seat 5: IlxxxlI (20).
Seat 7: gmjohn (28.76).
Seat 8: MANTISGUYV10 (57.49).
Seat 9: BiGFck (17).
Player n0hvn has small blind (0.25)
Player tbmfc has big blind (0.50)
Player IlxxxlI received card: [Kc]
Player IlxxxlI received card: [2h]
Player naprimer raises (1)
Player Log_in folds
Player IlxxxlI folds
Player gmjohn folds
Player MANTISGUYV10 is timed out.
Player MANTISGUYV10 folds
Player BiGFck folds
Player n0hvn folds
Player tbmfc folds
Uncalled bet (0.50) returned to naprimer
Player naprimer mucks cards
------ Summary ------
Pot: 1.25. Rake 0
Player n0hvn does not show cards.Bets: 0.25. Collects: 0. Loses: 0.25.
Player tbmfc does not show cards.Bets: 0.50. Collects: 0. Loses: 0.50.
*Player naprimer mucks (does not show cards). Bets: 0.50. Collects: 1.25. Wins: 0.75.
Player Log_in does not show cards.Bets: 0. Collects: 0. Wins: 0.
Player IlxxxlI does not show cards.Bets: 0. Collects: 0. Wins: 0.
Player gmjohn does not show cards.Bets: 0. Collects: 0. Wins: 0.
Player MANTISGUYV10 does not show cards.Bets: 0. Collects: 0. Wins: 0.
Player BiGFck does not show cards.Bets: 0. Collects: 0. Wins: 0.
Game ended at: 2016/11/19 23:16:44

Game started
Game ID: 779458296 0.25/0.50 (PRR) Garuda (Hold'em)
Seat 8 is the button
Seat 1: n0hvn (57.25).
Seat 2: tbmfc (30.47).
Seat 3: naprimer (55.06).
Seat 4: Log_in (13.32).
Seat 5: IlxxxlI (20).
Seat 7: gmjohn (27.17).
Seat 8: MANTISGUYV10 (57.49).
Seat 9: BiGFck (17.25).
Player BiGFck has small blind (0.25)
Player n0hvn has big blind (0.50)
Player IlxxxlI received card: [3d]
Player IlxxxlI received card: [6d]
Player tbmfc folds
Player naprimer folds
Player Log_in folds
Player IlxxxlI folds
Player gmjohn raises (1.50)
Player MANTISGUYV10 folds
Player BiGFck folds
Player n0hvn calls (1)
*** FLOP ***: [4h 8s 9c]
Player n0hvn checks
Player gmjohn bets (1.54)
Player n0hvn folds
Uncalled bet (1.54) returned to gmjohn
Player gmjohn mucks cards
------ Summary ------
Pot: 3.09. Rake 0.12. JP fee 0.04
Board: [4h 8s 9c]
Player n0hvn does not show cards.Bets: 1.50. Collects: 0. Loses: 1.50.
Player tbmfc does not show cards.Bets: 0. Collects: 0. Wins: 0.
Player naprimer does not show cards.Bets: 0. Collects: 0. Wins: 0.
Player Log_in does not show cards.Bets: 0. Collects: 0. Wins: 0.
Player IlxxxlI does not show cards.Bets: 0. Collects: 0. Wins: 0.
*Player gmjohn mucks (does not show cards). Bets: 1.50. Collects: 3.09. Wins: 1.59.
Player MANTISGUYV10 does not show cards.Bets: 0. Collects: 0. Wins: 0.
Player BiGFck does not show cards.Bets: 0.25. Collects: 0. Loses: 0.25.
Game ended at: 2016/11/19 23:15:54

Game started
Game ID: 779458017 0.25/0.50 (PRR) Garuda (Hold'em)
Seat 7 is the button
Seat 1: n0hvn (57.25).
Seat 2: tbmfc (30.47).
Seat 3: naprimer (54.31).
Seat 4: Log_in (13.32).
Seat 5: IlxxxlI (20).
Seat 7: gmjohn (27.17).
Seat 8: MANTISGUYV10 (57.74).
Seat 9: BiGFck (17.75).
Player MANTISGUYV10 has small blind (0.25)
Player BiGFck has big blind (0.50)
Player IlxxxlI received card: [Jh]
Player IlxxxlI received card: [9h]
Player n0hvn folds
Player tbmfc folds
Player naprimer raises (1)
Player Log_in folds
Player IlxxxlI folds
Player gmjohn folds
Player MANTISGUYV10 folds
Player BiGFck folds
Uncalled bet (0.50) returned to naprimer
Player naprimer mucks cards
------ Summary ------
Pot: 1.25. Rake 0
Player n0hvn does not show cards.Bets: 0. Collects: 0. Wins: 0.
Player tbmfc does not show cards.Bets: 0. Collects: 0. Wins: 0.
*Player naprimer mucks (does not show cards). Bets: 0.50. Collects: 1.25. Wins: 0.75.
Player Log_in does not show cards.Bets: 0. Collects: 0. Wins: 0.
Player IlxxxlI does not show cards.Bets: 0. Collects: 0. Wins: 0.
Player gmjohn does not show cards.Bets: 0. Collects: 0. Wins: 0.
Player MANTISGUYV10 does not show cards.Bets: 0.25. Collects: 0. Loses: 0.25.
Player BiGFck does not show cards.Bets: 0.50. Collects: 0. Loses: 0.50.
Game ended at: 2016/11/19 23:14:28

Game started
Game ID: 779457483 0.25/0.50 (PRR) Garuda (Hold'em)
Seat 5 is the button
Seat 1: n0hvn (57.25).
Seat 2: tbmfc (31.97).
Seat 3: naprimer (54.31).
Seat 4: Log_in (11.25).
Seat 5: IlxxxlI (20).
Seat 7: gmjohn (27.42).
Seat 8: MANTISGUYV10 (58.24).
Seat 9: BiGFck (17.75).
Player gmjohn has small blind (0.25)
Player MANTISGUYV10 has big blind (0.50)
Player IlxxxlI received card: [9h]
Player IlxxxlI received card: [Ah]
Player BiGFck folds
Player n0hvn folds
Player tbmfc calls (0.50)
Player naprimer folds
Player Log_in raises (1.50)
Player IlxxxlI folds
Player gmjohn folds
Player MANTISGUYV10 folds
Player tbmfc calls (1)
*** FLOP ***: [4d 3c Ac]
Player tbmfc checks
Player Log_in bets (1.83)
Player tbmfc folds
Uncalled bet (1.83) returned to Log_in
Player Log_in mucks cards
------ Summary ------
Pot: 3.57. Rake 0.12. JP fee 0.06
Board: [4d 3c Ac]
Player n0hvn does not show cards.Bets: 0. Collects: 0. Wins: 0.
Player tbmfc does not show cards.Bets: 1.50. Collects: 0. Loses: 1.50.
Player naprimer does not show cards.Bets: 0. Collects: 0. Wins: 0.
*Player Log_in mucks (does not show cards). Bets: 1.50. Collects: 3.57. Wins: 2.07.
Player IlxxxlI does not show cards.Bets: 0. Collects: 0. Wins: 0.
Player gmjohn does not show cards.Bets: 0.25. Collects: 0. Loses: 0.25.
Player MANTISGUYV10 does not show cards.Bets: 0.50. Collects: 0. Loses: 0.50.
Player BiGFck does not show cards.Bets: 0. Collects: 0. Wins: 0.
Game ended at: 2016/11/19 23:13:53

Game started
Game ID: 779457092 0.25/0.50 (PRR) Garuda (Hold'em)
Seat 4 is the button
Seat 1: n0hvn (57.25).
Seat 2: tbmfc (29.03).
Seat 3: naprimer (54.31).
Seat 4: Log_in (11.25).
Seat 5: IlxxxlI (20).
Seat 6: coldkilla (43.96).
Seat 7: gmjohn (30.42).
Seat 8: MANTISGUYV10 (58.24).
Seat 9: BiGFck (17.75).
Player IlxxxlI has small blind (0.25)
Player coldkilla sitting out
Player gmjohn has big blind (0.50)
Player IlxxxlI received card: [4c]
Player IlxxxlI received card: [7c]
Player MANTISGUYV10 folds
Player BiGFck folds
Player n0hvn folds
Player tbmfc raises (3)
Player naprimer folds
Player Log_in folds
Player IlxxxlI folds
Player gmjohn calls (2.50)
*** FLOP ***: [4s 9h 6c]
Player gmjohn checks
Player tbmfc bets (8)
Player gmjohn folds
Uncalled bet (8) returned to tbmfc
Player tbmfc mucks cards
------ Summary ------
Pot: 5.94. Rake 0.21. JP fee 0.10
Board: [4s 9h 6c]
Player n0hvn does not show cards.Bets: 0. Collects: 0. Wins: 0.
*Player tbmfc mucks (does not show cards). Bets: 3. Collects: 5.94. Wins: 2.94.
Player naprimer does not show cards.Bets: 0. Collects: 0. Wins: 0.
Player Log_in does not show cards.Bets: 0. Collects: 0. Wins: 0.
Player IlxxxlI does not show cards.Bets: 0.25. Collects: 0. Loses: 0.25.
Player coldkilla does not show cards.Bets: 0. Collects: 0. Wins: 0.
Player gmjohn does not show cards.Bets: 3. Collects: 0. Loses: 3.
Player MANTISGUYV10 does not show cards.Bets: 0. Collects: 0. Wins: 0.
Player BiGFck does not show cards.Bets: 0. Collects: 0. Wins: 0.
Game ended at: 2016/11/19 23:12:47

Game started
Game ID: 779456625 0.25/0.50 (PRR) Garuda (Hold'em)
Seat 3 is the button
Seat 1: n0hvn (57.25).
Seat 2: tbmfc (29.03).
Seat 3: naprimer (54.31).
Seat 4: Log_in (11.50).
Seat 5: IlxxxlI (20).
Seat 6: coldkilla (43.96).
Seat 7: gmjohn (29.73).
Seat 8: MANTISGUYV10 (58.24).
Seat 9: BiGFck (17.75).
Player Log_in has small blind (0.25)
Player IlxxxlI has big blind (0.50)
Player IlxxxlI received card: [10h]
Player IlxxxlI received card: [8d]
Player coldkilla folds
Player gmjohn calls (0.50)
Player MANTISGUYV10 folds
Player BiGFck folds
Player n0hvn folds
Player tbmfc folds
Player naprimer folds
Player Log_in folds
Player IlxxxlI checks
*** FLOP ***: [Qc 9s Ad]
Player IlxxxlI checks
Player gmjohn checks
*** TURN ***: [Qc 9s Ad] [Ks]
Player IlxxxlI checks
Player gmjohn bets (1)
Player IlxxxlI folds
Uncalled bet (1) returned to gmjohn
Player gmjohn mucks cards
------ Summary ------
Pot: 1.19. Rake 0.04. JP fee 0.02
Board: [Qc 9s Ad Ks]
Player n0hvn does not show cards.Bets: 0. Collects: 0. Wins: 0.
Player tbmfc does not show cards.Bets: 0. Collects: 0. Wins: 0.
Player naprimer does not show cards.Bets: 0. Collects: 0. Wins: 0.
Player Log_in does not show cards.Bets: 0.25. Collects: 0. Loses: 0.25.
Player IlxxxlI does not show cards.Bets: 0.50. Collects: 0. Loses: 0.50.
Player coldkilla does not show cards.Bets: 0. Collects: 0. Wins: 0.
*Player gmjohn mucks (does not show cards). Bets: 0.50. Collects: 1.19. Wins: 0.69.
Player MANTISGUYV10 does not show cards.Bets: 0. Collects: 0. Wins: 0.
Player BiGFck does not show cards.Bets: 0. Collects: 0. Wins: 0.
Game ended at: 2016/11/19 23:12:0

PokerStars Hand #771320318: Hold'em No Limit ($0.25/$0.50 USD) - 2016/11/09 19:37:27 ET
Table 'WPN_909249931' 6-max  Seat #4 is the button
Seat 1: v0landito ($30.09 in chips)
Seat 2: IlxxxlI ($10.00 in chips)
Seat 3: Oral-Bet ($20.00 in chips)
Seat 4: DBAcardplayer ($106.04 in chips)
Seat 5: xxHandSoloxx ($11.50 in chips)
Seat 6: Driver80296 ($33.70 in chips)
xxHandSoloxx: posts small blind $0.25
Driver80296: posts big blind $0.50
*** HOLE CARDS ***
Dealt to IlxxxlI [Ac 2d]
v0landito: folds
IlxxxlI: folds
Oral-Bet: folds
DBAcardplayer: raises $0.50 to $1
xxHandSoloxx: folds
Driver80296: calls $0.50
*** FLOP *** [2h 9h Ks]
Driver80296: checks
DBAcardplayer: bets $1.07
Driver80296: folds
Uncalled bet ($1.07) returned to DBAcardplayer
DBAcardplayer: doesn't show hand
DBAcardplayer collected $2.14 from pot
*** SUMMARY ***
Total pot $2.25 | Rake $0.11
Board [2h 9h Ks]
Seat 1: v0landito folded before Flop (didn't bet)
Seat 2: IlxxxlI folded before Flop (didn't bet)
Seat 3: Oral-Bet folded before Flop (didn't bet)
Seat 4: DBAcardplayer (button) collected ($2.14)
Seat 5: xxHandSoloxx (small blind) folded before Flop
Seat 6: Driver80296 (big blind) folded on the Flop

PokerStars Hand #771320144: Hold'em No Limit ($0.25/$0.50 USD) - 2016/11/09 19:36:58 ET
Table 'WPN_893255843' 6-max  Seat #5 is the button
Seat 1: v0landito ($50.00 in chips)
Seat 2: Oral-Bet ($22.44 in chips)
Seat 3: IlxxxlI ($22.49 in chips)
Seat 4: ls5ndr ($150.80 in chips)
Seat 5: CertifiedG ($58.19 in chips)
Seat 6: MrCRABS333 ($50.25 in chips)
MrCRABS333: posts small blind $0.25
v0landito: posts big blind $0.50
*** HOLE CARDS ***
Dealt to IlxxxlI [Qh 3d]
Oral-Bet: folds
IlxxxlI: folds
ls5ndr: raises $0.50 to $1
CertifiedG: folds
MrCRABS333: folds
v0landito: raises $4 to $5
ls5ndr: folds
Uncalled bet ($4.00) returned to v0landito
v0landito: doesn't show hand
v0landito collected $2.25 from pot
*** SUMMARY ***
Total pot $2.25 | Rake $0
Seat 1: v0landito (big blind) collected ($2.25)
Seat 2: Oral-Bet folded before Flop (didn't bet)
Seat 3: IlxxxlI folded before Flop (didn't bet)
Seat 4: ls5ndr folded before Flop
Seat 5: CertifiedG (button) folded before Flop (didn't bet)
Seat 6: MrCRABS333 (small blind) folded before Flop

PokerStars Hand #771320095: Hold'em No Limit ($0.25/$0.50 USD) - 2016/11/09 19:36:50 ET
Table 'WPN_909249931' 6-max  Seat #3 is the button
Seat 1: v0landito ($30.09 in chips)
Seat 2: IlxxxlI ($10.00 in chips)
Seat 3: Oral-Bet ($20.00 in chips)
Seat 4: DBAcardplayer ($105.54 in chips)
Seat 5: xxHandSoloxx ($12.00 in chips)
Seat 6: Driver80296 ($33.70 in chips)
DBAcardplayer: posts small blind $0.25
xxHandSoloxx: posts big blind $0.50
*** HOLE CARDS ***
Dealt to IlxxxlI [6h 2c]
Driver80296: folds
v0landito: folds
IlxxxlI: folds
Oral-Bet: folds
DBAcardplayer: raises $1.50 to $2
xxHandSoloxx: folds
Uncalled bet ($1.50) returned to DBAcardplayer
DBAcardplayer: doesn't show hand
DBAcardplayer collected $1 from pot
*** SUMMARY ***
Total pot $1 | Rake $0
Seat 1: v0landito folded before Flop (didn't bet)
Seat 2: IlxxxlI folded before Flop (didn't bet)
Seat 3: Oral-Bet (button) folded before Flop (didn't bet)
Seat 4: DBAcardplayer (small blind) collected ($1)
Seat 5: xxHandSoloxx (big blind) folded before Flop
Seat 6: Driver80296 folded before Flop (didn't bet)

PokerStars Hand #771320022: Hold'em No Limit ($0.25/$0.50 USD) - 2016/11/09 19:36:38 ET
Table 'WPN_2355604438' 6-max  Seat #3 is the button
Seat 1: CertifiedG ($55.15 in chips)
Seat 2: IlxxxlI ($21.50 in chips)
Seat 3: Karas321 ($20.75 in chips)
Seat 5: illoke ($63.95 in chips)
Seat 6: built2tilttttttttt ($51.14 in chips)
illoke: posts small blind $0.25
built2tilttttttttt: posts big blind $0.50
*** HOLE CARDS ***
Dealt to IlxxxlI [Kd 5h]
CertifiedG: folds
IlxxxlI: folds
Karas321: folds
illoke: folds
Uncalled bet ($0.25) returned to built2tilttttttttt
built2tilttttttttt: doesn't show hand
built2tilttttttttt collected $0.50 from pot
*** SUMMARY ***
Total pot $0.50 | Rake $0
Seat 1: CertifiedG folded before Flop (didn't bet)
Seat 2: IlxxxlI folded before Flop (didn't bet)
Seat 3: Karas321 (button) folded before Flop (didn't bet)
Seat 5: illoke (small blind) folded before Flop
Seat 6: built2tilttttttttt (big blind) collected ($0.50)

PokerStars Hand #771319774: Hold'em No Limit ($0.25/$0.50 USD) - 2016/11/09 19:36:04 ET
Table 'WPN_2355604438' 6-max  Seat #2 is the button
Seat 1: CertifiedG ($55.15 in chips)
Seat 2: IlxxxlI ($21.50 in chips)
Seat 3: Karas321 ($20.25 in chips)
Seat 5: illoke ($64.45 in chips)
Seat 6: built2tilttttttttt ($51.14 in chips)
Karas321: posts small blind $0.25
illoke: posts big blind $0.50
*** HOLE CARDS ***
Dealt to IlxxxlI [6h Th]
built2tilttttttttt: folds
CertifiedG: folds
IlxxxlI: folds
Karas321: raises $2 to $2.50
illoke: folds
Uncalled bet ($2.00) returned to Karas321
Karas321: doesn't show hand
Karas321 collected $1 from pot
*** SUMMARY ***
Total pot $1 | Rake $0
Seat 1: CertifiedG folded before Flop (didn't bet)
Seat 2: IlxxxlI (button) folded before Flop (didn't bet)
Seat 3: Karas321 (small blind) collected ($1)
Seat 5: illoke (big blind) folded before Flop
Seat 6: built2tilttttttttt folded before Flop (didn't bet)

PokerStars Hand #771319727: Hold'em No Limit ($0.25/$0.50 USD) - 2016/11/09 19:35:57 ET
Table 'WPN_893255843' 6-max  Seat #4 is the button
Seat 1: v0landito ($50.00 in chips)
Seat 2: Oral-Bet ($22.44 in chips)
Seat 3: IlxxxlI ($22.49 in chips)
Seat 4: ls5ndr ($151.80 in chips)
Seat 5: CertifiedG ($56.69 in chips)
Seat 6: MrCRABS333 ($50.75 in chips)
CertifiedG: posts small blind $0.25
MrCRABS333: posts big blind $0.50
*** HOLE CARDS ***
Dealt to IlxxxlI [Kh 4c]
v0landito: folds
Oral-Bet: folds
IlxxxlI: folds
ls5ndr: raises $0.50 to $1
CertifiedG: raises $2.50 to $3.50
MrCRABS333: folds
ls5ndr: folds
Uncalled bet ($2.50) returned to CertifiedG
CertifiedG: doesn't show hand
CertifiedG collected $2.50 from pot
*** SUMMARY ***
Total pot $2.50 | Rake $0
Seat 1: v0landito folded before Flop (didn't bet)
Seat 2: Oral-Bet folded before Flop (didn't bet)
Seat 3: IlxxxlI folded before Flop (didn't bet)
Seat 4: ls5ndr (button) folded before Flop
Seat 5: CertifiedG (small blind) collected ($2.50)
Seat 6: MrCRABS333 (big blind) folded before Flop

PokerStars Hand #771319587: Hold'em No Limit ($0.25/$0.50 USD) - 2016/11/09 19:35:38 ET
Table 'WPN_2355604438' 6-max  Seat #1 is the button
Seat 1: CertifiedG ($54.40 in chips)
Seat 2: IlxxxlI ($21.75 in chips)
Seat 3: Karas321 ($20.75 in chips)
Seat 5: illoke ($64.45 in chips)
Seat 6: built2tilttttttttt ($51.14 in chips)
IlxxxlI: posts small blind $0.25
Karas321: posts big blind $0.50
*** HOLE CARDS ***
Dealt to IlxxxlI [8s 3c]
illoke: folds
built2tilttttttttt: folds
CertifiedG: raises $0.62 to $1.12
IlxxxlI: folds
Karas321: folds
Uncalled bet ($0.62) returned to CertifiedG
CertifiedG: doesn't show hand
CertifiedG collected $1.25 from pot
*** SUMMARY ***
Total pot $1.25 | Rake $0
Seat 1: CertifiedG (button) collected ($1.25)
Seat 2: IlxxxlI (small blind) folded before Flop
Seat 3: Karas321 (big blind) folded before Flop
Seat 5: illoke folded before Flop (didn't bet)
Seat 6: built2tilttttttttt folded before Flop (didn't bet)

PokerStars Hand #771319341: Hold'em No Limit ($0.25/$0.50 USD) - 2016/11/09 19:35:03 ET
Table 'WPN_909249931' 6-max  Seat #2 is the button
Seat 1: v0landito ($30.09 in chips)
Seat 2: IlxxxlI ($10.00 in chips)
Seat 3: Oral-Bet ($20.00 in chips)
Seat 4: DBAcardplayer ($103.95 in chips)
Seat 5: xxHandSoloxx ($12.00 in chips)
Seat 6: Driver80296 ($33.70 in chips)
Oral-Bet: posts small blind $0.25
DBAcardplayer: posts big blind $0.50
*** HOLE CARDS ***
Dealt to IlxxxlI [7h Ah]
xxHandSoloxx: folds
Driver80296: folds
v0landito: folds
IlxxxlI: raises $0.50 to $1
Oral-Bet: folds
DBAcardplayer: calls $0.50
*** FLOP *** [Td 4s 5c]
DBAcardplayer: checks
IlxxxlI: bets $0.50
DBAcardplayer: calls $0.50
*** TURN *** [Td 4s 5c] [Ks]
DBAcardplayer: checks
IlxxxlI: checks
*** RIVER *** [Td 4s 5c Ks] [5d]
DBAcardplayer: bets $2.06
IlxxxlI: folds
Uncalled bet ($2.06) returned to DBAcardplayer
DBAcardplayer: doesn't show hand
DBAcardplayer collected $3.09 from pot
*** SUMMARY ***
Total pot $3.25 | Rake $0.16
Board [Td 4s 5c Ks 5d]
Seat 1: v0landito folded before Flop (didn't bet)
Seat 2: IlxxxlI (button) folded on the River
Seat 3: Oral-Bet (small blind) folded before Flop
Seat 4: DBAcardplayer (big blind) collected ($3.09)
Seat 5: xxHandSoloxx folded before Flop (didn't bet)
Seat 6: Driver80296 folded before Flop (didn't bet)

PokerStars Hand #771319306: Hold'em No Limit ($0.50/$1.00 USD) - 2016/11/09 19:35:00 ET
Table 'WPN_2128003642' 6-max  Seat #4 is the button
Seat 1: v0landito ($257.62 in chips)
Seat 2: IlxxxlI ($40.00 in chips)
Seat 3: dellindi ($152.54 in chips)
Seat 4: illoke ($127.47 in chips)
Seat 5: 38979 ($173.10 in chips)
38979: posts small blind $0.50
v0landito: posts big blind $1
*** HOLE CARDS ***
Dealt to IlxxxlI [8h 3c]
IlxxxlI: folds
dellindi: folds
illoke: raises $1.50 to $2.50
38979: folds
v0landito: calls $1.50
*** FLOP *** [6c 3d 9s]
v0landito: checks
illoke: checks
*** TURN *** [6c 3d 9s] [Qh]
v0landito: bets $2.62
illoke: calls $2.62
*** RIVER *** [6c 3d 9s Qh] [5s]
v0landito: bets $3.40
illoke: folds
Uncalled bet ($3.40) returned to v0landito
v0landito: doesn't show hand
v0landito collected $10.21 from pot
*** SUMMARY ***
Total pot $10.74 | Rake $0.53
Board [6c 3d 9s Qh 5s]
Seat 1: v0landito (big blind) collected ($10.21)
Seat 2: IlxxxlI folded before Flop (didn't bet)
Seat 3: dellindi folded before Flop (didn't bet)
Seat 4: illoke (button) folded on the River
Seat 5: 38979 (small blind) folded before Flop

PokerStars Hand #771319192: Hold'em No Limit ($0.25/$0.50 USD) - 2016/11/09 19:34:42 ET
Table 'WPN_2355604438' 6-max  Seat #6 is the button
Seat 1: CertifiedG ($54.65 in chips)
Seat 2: IlxxxlI ($20.00 in chips)
Seat 3: Karas321 ($20.75 in chips)
Seat 5: illoke ($65.95 in chips)
Seat 6: built2tilttttttttt ($51.14 in chips)
CertifiedG: posts small blind $0.25
IlxxxlI: posts big blind $0.50
*** HOLE CARDS ***
Dealt to IlxxxlI [Ac As]
Karas321: folds
illoke: raises $1 to $1.50
built2tilttttttttt: folds
CertifiedG: folds
IlxxxlI: raises $2 to $3.50
illoke: folds
Uncalled bet ($2.00) returned to IlxxxlI
IlxxxlI: doesn't show hand
IlxxxlI collected $3.25 from pot
*** SUMMARY ***
Total pot $3.25 | Rake $0
Seat 1: CertifiedG (small blind) folded before Flop
Seat 2: IlxxxlI (big blind) collected ($3.25)
Seat 3: Karas321 folded before Flop (didn't bet)
Seat 5: illoke folded before Flop
Seat 6: built2tilttttttttt (button) folded before Flop (didn't bet)

PokerStars Hand #771319182: Hold'em No Limit ($0.25/$0.50 USD) - 2016/11/09 19:34:42 ET
Table 'WPN_481228527' 6-max  Seat #4 is the button
Seat 1: v0landito ($51.50 in chips)
Seat 2: IlxxxlI ($20.75 in chips)
Seat 3: CertifiedG ($82.74 in chips)
Seat 4: ls5ndr ($58.59 in chips)
Seat 5: Oral-Bet ($20.00 in chips)
Seat 6: MrCRABS333 ($62.47 in chips)
Oral-Bet: posts small blind $0.25
MrCRABS333: posts big blind $0.50
*** HOLE CARDS ***
Dealt to IlxxxlI [5c 6c]
v0landito: folds
IlxxxlI: folds
CertifiedG: folds
ls5ndr: folds
Oral-Bet: raises $0.75 to $1.25
MrCRABS333: calls $0.75
*** FLOP *** [5h Jh Kh]
Oral-Bet: bets $1.19
MrCRABS333: calls $1.19
*** TURN *** [5h Jh Kh] [Jc]
Oral-Bet: checks
MrCRABS333: checks
*** RIVER *** [5h Jh Kh Jc] [2h]
Oral-Bet: checks
MrCRABS333: checks
*** SHOW DOWN ***
Oral-Bet: mucks hand
MrCRABS333: shows [4c Kc] (Two pairs. Ks and Js)
MrCRABS333 collected $4.64 from pot
*** SUMMARY ***
Total pot $4.88 | Rake $0.24
Board [5h Jh Kh Jc 2h]
Seat 1: v0landito folded before Flop (didn't bet)
Seat 2: IlxxxlI folded before Flop (didn't bet)
Seat 3: CertifiedG folded before Flop (didn't bet)
Seat 4: ls5ndr (button) folded before Flop (didn't bet)
Seat 5: Oral-Bet (small blind) mucked
Seat 6: MrCRABS333 (big blind) showed [4c Kc] and won ($4.64) with Two pairs. Ks and Js

PokerStars Hand #771319141: Hold'em No Limit ($0.25/$0.50 USD) - 2016/11/09 19:34:35 ET
Table 'WPN_893255843' 6-max  Seat #3 is the button
Seat 1: v0landito ($51.87 in chips)
Seat 2: Oral-Bet ($22.44 in chips)
Seat 3: IlxxxlI ($22.49 in chips)
Seat 4: ls5ndr ($152.05 in chips)
Seat 5: CertifiedG ($51.72 in chips)
Seat 6: MrCRABS333 ($50.75 in chips)
ls5ndr: posts small blind $0.25
CertifiedG: posts big blind $0.50
*** HOLE CARDS ***
Dealt to IlxxxlI [9h Td]
MrCRABS333: folds
v0landito: raises $1 to $1.50
Oral-Bet: folds
IlxxxlI: folds
ls5ndr: folds
CertifiedG: raises $3.75 to $5.25
v0landito: calls $3.75
*** FLOP *** [4h 9c 2h]
CertifiedG: bets $4.50
v0landito: folds
Uncalled bet ($4.50) returned to CertifiedG
CertifiedG: doesn't show hand
CertifiedG collected $10.22 from pot
*** SUMMARY ***
Total pot $10.75 | Rake $0.53
Board [4h 9c 2h]
Seat 1: v0landito folded on the Flop
Seat 2: Oral-Bet folded before Flop (didn't bet)
Seat 3: IlxxxlI (button) folded before Flop (didn't bet)
Seat 4: ls5ndr (small blind) folded before Flop
Seat 5: CertifiedG (big blind) collected ($10.22)
Seat 6: MrCRABS333 folded before Flop (didn't bet)

PokerStars Hand #771319077: Hold'em No Limit ($0.25/$0.50 USD) - 2016/11/09 19:34:27 ET
Table 'WPN_2355604438' 6-max  Seat #5 is the button
Seat 1: CertifiedG ($54.40 in chips)
Seat 2: IlxxxlI ($20.00 in chips)
Seat 3: Karas321 ($20.75 in chips)
Seat 5: illoke ($65.95 in chips)
Seat 6: built2tilttttttttt ($51.39 in chips)
built2tilttttttttt: posts small blind $0.25
CertifiedG: posts big blind $0.50
*** HOLE CARDS ***
Dealt to IlxxxlI [2s 8d]
IlxxxlI: folds
Karas321: folds
illoke: folds
built2tilttttttttt: folds
Uncalled bet ($0.25) returned to CertifiedG
CertifiedG: doesn't show hand
CertifiedG collected $0.50 from pot
*** SUMMARY ***
Total pot $0.50 | Rake $0
Seat 1: CertifiedG (big blind) collected ($0.50)
Seat 2: IlxxxlI folded before Flop (didn't bet)
Seat 3: Karas321 folded before Flop (didn't bet)
Seat 5: illoke (button) folded before Flop (didn't bet)
Seat 6: built2tilttttttttt (small blind) folded before Flop

PokerStars Hand #771318963: Hold'em No Limit ($0.50/$1.00 USD) - 2016/11/09 19:34:11 ET
Table 'WPN_2128003642' 6-max  Seat #3 is the button
Seat 1: v0landito ($257.62 in chips)
Seat 2: IlxxxlI ($40.00 in chips)
Seat 3: dellindi ($152.54 in chips)
Seat 4: illoke ($124.77 in chips)
Seat 5: 38979 ($176.10 in chips)
illoke: posts small blind $0.50
38979: posts big blind $1
*** HOLE CARDS ***
Dealt to IlxxxlI [4s Kc]
v0landito: folds
IlxxxlI: folds
dellindi: folds
illoke: raises $2 to $3
38979: calls $2
*** FLOP *** [Qs 2h 5s]
illoke: bets $2.85
38979: folds
Uncalled bet ($2.85) returned to illoke
illoke: doesn't show hand
illoke collected $5.70 from pot
*** SUMMARY ***
Total pot $6 | Rake $0.30
Board [Qs 2h 5s]
Seat 1: v0landito folded before Flop (didn't bet)
Seat 2: IlxxxlI folded before Flop (didn't bet)
Seat 3: dellindi (button) folded before Flop (didn't bet)
Seat 4: illoke (small blind) collected ($5.70)
Seat 5: 38979 (big blind) folded on the Flop

PokerStars Hand #771318958: Hold'em No Limit ($0.25/$0.50 USD) - 2016/11/09 19:34:09 ET
Table 'WPN_2355604438' 6-max  Seat #3 is the button
Seat 1: CertifiedG ($54.40 in chips)
Seat 2: IlxxxlI ($20.00 in chips)
Seat 3: Karas321 ($20.75 in chips)
Seat 5: illoke ($66.20 in chips)
Seat 6: built2tilttttttttt ($51.14 in chips)
illoke: posts small blind $0.25
built2tilttttttttt: posts big blind $0.50
*** HOLE CARDS ***
Dealt to IlxxxlI [3d Ks]
CertifiedG: folds
IlxxxlI: folds
Karas321: folds
illoke: folds
Uncalled bet ($0.25) returned to built2tilttttttttt
built2tilttttttttt: doesn't show hand
built2tilttttttttt collected $0.50 from pot
*** SUMMARY ***
Total pot $0.50 | Rake $0
Seat 1: CertifiedG folded before Flop (didn't bet)
Seat 2: IlxxxlI folded before Flop (didn't bet)
Seat 3: Karas321 (button) folded before Flop (didn't bet)
Seat 5: illoke (small blind) folded before Flop
Seat 6: built2tilttttttttt (big blind) collected ($0.50)

Game started
Game ID: 771318908 0.25/0.50 (PRR) Gorgons - 9 (Hold'em)
Seat 4 is the button
Seat 1: IlxxxlI (20.45).
Seat 2: ls5ndr (51.94).
Seat 4: saidafrente (56.74).
Seat 5: Kryuk13 (55.14).
Seat 6: v0landito (101.12).
Player Kryuk13 has small blind (0.25)
Player v0landito has big blind (0.50)
Player IlxxxlI received card: [Ks]
Player IlxxxlI received card: [8c]
Player IlxxxlI folds
Player ls5ndr raises (1)
Player saidafrente raises (3.50)
Player Kryuk13 folds
Player v0landito folds
Player ls5ndr folds
Uncalled bet (2.50) returned to saidafrente
Player saidafrente mucks cards
------ Summary ------
Pot: 2.75. Rake 0
Player IlxxxlI does not show cards.Bets: 0. Collects: 0. Wins: 0.
Player ls5ndr does not show cards.Bets: 1. Collects: 0. Loses: 1.
*Player saidafrente mucks (does not show cards). Bets: 1. Collects: 2.75. Wins: 1.75.
Player Kryuk13 does not show cards.Bets: 0.25. Collects: 0. Loses: 0.25.
Player v0landito does not show cards.Bets: 0.50. Collects: 0. Loses: 0.50.
Game ended at: 2016/11/9 23:34:45

PokerStars Hand #771318863: Hold'em No Limit ($0.25/$0.50 USD) - 2016/11/09 19:33:57 ET
Table 'WPN_893255843' 6-max  Seat #2 is the button
Seat 1: v0landito ($51.87 in chips)
Seat 2: Oral-Bet ($22.44 in chips)
Seat 3: IlxxxlI ($22.74 in chips)
Seat 4: ls5ndr ($152.55 in chips)
Seat 5: CertifiedG ($51.72 in chips)
Seat 6: MrCRABS333 ($50.00 in chips)
IlxxxlI: posts small blind $0.25
ls5ndr: posts big blind $0.50
*** HOLE CARDS ***
Dealt to IlxxxlI [Ad 4c]
CertifiedG: folds
MrCRABS333: raises $1 to $1.50
v0landito: folds
Oral-Bet: folds
IlxxxlI: folds
ls5ndr: folds
Uncalled bet ($1.00) returned to MrCRABS333
MrCRABS333: doesn't show hand
MrCRABS333 collected $1.25 from pot
*** SUMMARY ***
Total pot $1.25 | Rake $0
Seat 1: v0landito folded before Flop (didn't bet)
Seat 2: Oral-Bet (button) folded before Flop (didn't bet)
Seat 3: IlxxxlI (small blind) folded before Flop
Seat 4: ls5ndr (big blind) folded before Flop
Seat 5: CertifiedG folded before Flop (didn't bet)
Seat 6: MrCRABS333 collected ($1.25)

PokerStars Hand #771318846: Hold'em No Limit ($0.25/$0.50 USD) - 2016/11/09 19:33:55 ET
Table 'WPN_3219946394' 6-max  Seat #4 is the button
Seat 1: CertifiedG ($50.00 in chips)
Seat 2: IlxxxlI ($20.00 in chips)
Seat 3: v0landito ($76.19 in chips)
Seat 4: ls5ndr ($50.00 in chips)
Seat 6: 38979 ($78.64 in chips)
38979: posts small blind $0.25
CertifiedG: posts big blind $0.50
*** HOLE CARDS ***
Dealt to IlxxxlI [3c Qd]
IlxxxlI: folds
v0landito: folds
ls5ndr: raises $0.50 to $1
38979: raises $2.50 to $3.50
CertifiedG: folds
ls5ndr: calls $2.50
*** FLOP *** [6s 7s Qc]
38979: checks
ls5ndr: bets $4
38979: folds
Uncalled bet ($4.00) returned to ls5ndr
ls5ndr: doesn't show hand
ls5ndr collected $7.13 from pot
*** SUMMARY ***
Total pot $7.50 | Rake $0.37
Board [6s 7s Qc]
Seat 1: CertifiedG (big blind) folded before Flop
Seat 2: IlxxxlI folded before Flop (didn't bet)
Seat 3: v0landito folded before Flop (didn't bet)
Seat 4: ls5ndr (button) collected ($7.13)
Seat 6: 38979 (small blind) folded on the Flop

PokerStars Hand #771318708: Hold'em No Limit ($0.25/$0.50 USD) - 2016/11/09 19:33:33 ET
Table 'WPN_909249931' 6-max  Seat #1 is the button
Seat 1: v0landito ($30.59 in chips)
Seat 2: IlxxxlI ($10.00 in chips)
Seat 3: Oral-Bet ($20.00 in chips)
Seat 4: DBAcardplayer ($102.55 in chips)
Seat 5: xxHandSoloxx ($12.00 in chips)
Seat 6: Driver80296 ($33.70 in chips)
IlxxxlI: posts small blind $0.25
Oral-Bet: posts big blind $0.50
*** HOLE CARDS ***
Dealt to IlxxxlI [Th Qh]
DBAcardplayer: calls $0.50
xxHandSoloxx: folds
Driver80296: folds
v0landito: calls $0.50
IlxxxlI: calls $0.25
Oral-Bet: checks
*** FLOP *** [9d As 7c]
IlxxxlI: checks
Oral-Bet: checks
DBAcardplayer: checks
v0landito: checks
*** TURN *** [9d As 7c] [2h]
IlxxxlI: checks
Oral-Bet: checks
DBAcardplayer: bets $1.26
v0landito: folds
IlxxxlI: folds
Oral-Bet: folds
Uncalled bet ($1.26) returned to DBAcardplayer
DBAcardplayer: doesn't show hand
DBAcardplayer collected $1.90 from pot
*** SUMMARY ***
Total pot $2 | Rake $0.10
Board [9d As 7c 2h]
Seat 1: v0landito (button) folded on the Turn
Seat 2: IlxxxlI (small blind) folded on the Turn
Seat 3: Oral-Bet (big blind) folded on the Turn
Seat 4: DBAcardplayer collected ($1.90)
Seat 5: xxHandSoloxx folded before Flop (didn't bet)
Seat 6: Driver80296 folded before Flop (didn't bet)

PokerStars Hand #771318584: Hold'em No Limit ($0.25/$0.50 USD) - 2016/11/09 19:33:15 ET
Table 'WPN_3421571163' 6-max  Seat #2 is the button
Seat 1: IlxxxlI ($20.45 in chips)
Seat 2: ls5ndr ($50.80 in chips)
Seat 4: saidafrente ($56.99 in chips)
Seat 5: Kryuk13 ($56.14 in chips)
Seat 6: v0landito ($101.12 in chips)
saidafrente: posts small blind $0.25
Kryuk13: posts big blind $0.50
*** HOLE CARDS ***
Dealt to IlxxxlI [Tc 7s]
v0landito: folds
IlxxxlI: folds
ls5ndr: raises $0.50 to $1
saidafrente: folds
Kryuk13: calls $0.50
*** FLOP *** [5c 9h As]
Kryuk13: checks
ls5ndr: bets $1
Kryuk13: folds
Uncalled bet ($1.00) returned to ls5ndr
ls5ndr: doesn't show hand
ls5ndr collected $2.14 from pot
*** SUMMARY ***
Total pot $2.25 | Rake $0.11
Board [5c 9h As]
Seat 1: IlxxxlI folded before Flop (didn't bet)
Seat 2: ls5ndr (button) collected ($2.14)
Seat 4: saidafrente (small blind) folded before Flop
Seat 5: Kryuk13 (big blind) folded on the Flop
Seat 6: v0landito folded before Flop (didn't bet)

PokerStars Hand #771318498: Hold'em No Limit ($0.25/$0.50 USD) - 2016/11/09 19:33:02 ET
Table 'WPN_3219946394' 6-max  Seat #3 is the button
Seat 1: CertifiedG ($50.00 in chips)
Seat 2: IlxxxlI ($20.00 in chips)
Seat 3: v0landito ($71.19 in chips)
Seat 4: ls5ndr ($50.25 in chips)
Seat 6: 38979 ($79.14 in chips)
ls5ndr: posts small blind $0.25
38979: posts big blind $0.50
*** HOLE CARDS ***
Dealt to IlxxxlI [5d 9d]
CertifiedG: folds
IlxxxlI: folds
v0landito: raises $0.50 to $1
ls5ndr: raises $3.50 to $4.50
38979: folds
v0landito: raises $6.50 to $11
ls5ndr: folds
Uncalled bet ($6.50) returned to v0landito
v0landito: doesn't show hand
v0landito collected $9.50 from pot
*** SUMMARY ***
Total pot $9.50 | Rake $0
Seat 1: CertifiedG folded before Flop (didn't bet)
Seat 2: IlxxxlI folded before Flop (didn't bet)
Seat 3: v0landito (button) collected ($9.50)
Seat 4: ls5ndr (small blind) folded before Flop
Seat 6: 38979 (big blind) folded before Flop

PokerStars Hand #771318488: Hold'em No Limit ($0.50/$1.00 USD) - 2016/11/09 19:33:01 ET
Table 'WPN_2128003642' 6-max  Seat #2 is the button
Seat 1: v0landito ($263.95 in chips)
Seat 2: IlxxxlI ($40.00 in chips)
Seat 3: dellindi ($145.89 in chips)
Seat 4: illoke ($125.77 in chips)
Seat 5: 38979 ($176.10 in chips)
dellindi: posts small blind $0.50
illoke: posts big blind $1
*** HOLE CARDS ***
Dealt to IlxxxlI [5s Th]
38979: folds
v0landito: raises $2 to $3
IlxxxlI: folds
dellindi: calls $2.50
illoke: folds
*** FLOP *** [2c Qs Qc]
dellindi: checks
v0landito: bets $3.33
dellindi: raises $9.99 to $13.32
v0landito: folds
Uncalled bet ($9.99) returned to dellindi
dellindi: doesn't show hand
dellindi collected $12.98 from pot
*** SUMMARY ***
Total pot $13.66 | Rake $0.68
Board [2c Qs Qc]
Seat 1: v0landito folded on the Flop
Seat 2: IlxxxlI (button) folded before Flop (didn't bet)
Seat 3: dellindi (small blind) collected ($12.98)
Seat 4: illoke (big blind) folded before Flop
Seat 5: 38979 folded before Flop (didn't bet)

PokerStars Hand #771318459: Hold'em No Limit ($0.25/$0.50 USD) - 2016/11/09 19:32:58 ET
Table 'WPN_481228527' 6-max  Seat #3 is the button
Seat 1: v0landito ($51.50 in chips)
Seat 2: IlxxxlI ($20.75 in chips)
Seat 3: CertifiedG ($92.00 in chips)
Seat 4: ls5ndr ($58.84 in chips)
Seat 5: Oral-Bet ($20.00 in chips)
Seat 6: MrCRABS333 ($52.47 in chips)
ls5ndr: posts small blind $0.25
Oral-Bet: posts big blind $0.50
*** HOLE CARDS ***
Dealt to IlxxxlI [5h 6d]
MrCRABS333: raises $1 to $1.50
v0landito: folds
IlxxxlI: folds
CertifiedG: calls $1.50
ls5ndr: folds
Oral-Bet: calls $1
*** FLOP *** [7c 2s Kh]
Oral-Bet: checks
MrCRABS333: bets $2.26
CertifiedG: calls $2.26
Oral-Bet: folds
*** TURN *** [7c 2s Kh] [8h]
MrCRABS333: bets $5.50
CertifiedG: calls $5.50
*** RIVER *** [7c 2s Kh 8h] [Ts]
MrCRABS333: bets $18
CertifiedG: folds
Uncalled bet ($18.00) returned to MrCRABS333
MrCRABS333: doesn't show hand
MrCRABS333 collected $19.26 from pot
*** SUMMARY ***
Total pot $20.27 | Rake $1.01
Board [7c 2s Kh 8h Ts]
Seat 1: v0landito folded before Flop (didn't bet)
Seat 2: IlxxxlI folded before Flop (didn't bet)
Seat 3: CertifiedG (button) folded on the River
Seat 4: ls5ndr (small blind) folded before Flop
Seat 5: Oral-Bet (big blind) folded on the Flop
Seat 6: MrCRABS333 collected ($19.26)

PokerStars Hand #771318431: Hold'em No Limit ($0.25/$0.50 USD) - 2016/11/09 19:32:53 ET
Table 'WPN_893255843' 6-max  Seat #1 is the button
Seat 1: v0landito ($51.87 in chips)
Seat 2: Oral-Bet ($25.48 in chips)
Seat 3: IlxxxlI ($20.00 in chips)
Seat 4: ls5ndr ($152.55 in chips)
Seat 5: CertifiedG ($51.72 in chips)
Seat 6: MrCRABS333 ($50.00 in chips)
Oral-Bet: posts small blind $0.25
IlxxxlI: posts big blind $0.50
*** HOLE CARDS ***
Dealt to IlxxxlI [2h Ah]
ls5ndr: folds
CertifiedG: folds
MrCRABS333: folds
v0landito: folds
Oral-Bet: raises $0.75 to $1.25
IlxxxlI: raises $1.79 to $3.04
Oral-Bet: calls $1.79
*** FLOP *** [2s 7c 6c]
Oral-Bet: checks
IlxxxlI: checks
*** TURN *** [2s 7c 6c] [Jd]
Oral-Bet: checks
IlxxxlI: bets $2.50
Oral-Bet: folds
Uncalled bet ($2.50) returned to IlxxxlI
IlxxxlI: doesn't show hand
IlxxxlI collected $5.78 from pot
*** SUMMARY ***
Total pot $6.08 | Rake $0.30
Board [2s 7c 6c Jd]
Seat 1: v0landito (button) folded before Flop (didn't bet)
Seat 2: Oral-Bet (small blind) folded on the Turn
Seat 3: IlxxxlI (big blind) collected ($5.78)
Seat 4: ls5ndr folded before Flop (didn't bet)
Seat 5: CertifiedG folded before Flop (didn't bet)
Seat 6: MrCRABS333 folded before Flop (didn't bet)

PokerStars Hand #771318346: Hold'em No Limit ($0.25/$0.50 USD) - 2016/11/09 19:32:41 ET
Table 'WPN_3421571163' 6-max  Seat #1 is the button
Seat 1: IlxxxlI ($20.45 in chips)
Seat 2: ls5ndr ($51.05 in chips)
Seat 4: saidafrente ($57.49 in chips)
Seat 5: Kryuk13 ($56.14 in chips)
Seat 6: v0landito ($100.37 in chips)
ls5ndr: posts small blind $0.25
saidafrente: posts big blind $0.50
*** HOLE CARDS ***
Dealt to IlxxxlI [8s 3s]
Kryuk13: folds
v0landito: raises $1 to $1.50
IlxxxlI: folds
ls5ndr: folds
saidafrente: folds
Uncalled bet ($1.00) returned to v0landito
v0landito: doesn't show hand
v0landito collected $1.25 from pot
*** SUMMARY ***
Total pot $1.25 | Rake $0
Seat 1: IlxxxlI (button) folded before Flop (didn't bet)
Seat 2: ls5ndr (small blind) folded before Flop
Seat 4: saidafrente (big blind) folded before Flop
Seat 5: Kryuk13 folded before Flop (didn't bet)
Seat 6: v0landito collected ($1.25)

PokerStars Hand #771318331: Hold'em No Limit ($0.25/$0.50 USD) - 2016/11/09 19:32:40 ET
Table 'WPN_2355604438' 6-max  Seat #2 is the button
Seat 1: CertifiedG ($58.90 in chips)
Seat 2: IlxxxlI ($20.00 in chips)
Seat 3: Karas321 ($21.00 in chips)
Seat 5: illoke ($61.91 in chips)
Seat 6: built2tilttttttttt ($51.14 in chips)
Karas321: posts small blind $0.25
illoke: posts big blind $0.50
*** HOLE CARDS ***
Dealt to IlxxxlI [5d Qh]
built2tilttttttttt: folds
CertifiedG: raises $0.75 to $1.25
IlxxxlI: folds
Karas321: folds
illoke: raises $3.25 to $4.50
CertifiedG: calls $3.25
*** FLOP *** [2c 3h Qd]
illoke: bets $4.39
CertifiedG: folds
Uncalled bet ($4.39) returned to illoke
illoke: doesn't show hand
illoke collected $8.79 from pot
*** SUMMARY ***
Total pot $9.25 | Rake $0.46
Board [2c 3h Qd]
Seat 1: CertifiedG folded on the Flop
Seat 2: IlxxxlI (button) folded before Flop (didn't bet)
Seat 3: Karas321 (small blind) folded before Flop
Seat 5: illoke collected ($8.79)
Seat 6: built2tilttttttttt folded before Flop (didn't bet)

PokerStars Hand #771318258: Hold'em No Limit ($0.50/$1.00 USD) - 2016/11/09 19:32:29 ET
Table 'WPN_2128003642' 6-max  Seat #1 is the button
Seat 1: v0landito ($263.95 in chips)
Seat 2: IlxxxlI ($40.00 in chips)
Seat 3: dellindi ($146.89 in chips)
Seat 4: illoke ($124.27 in chips)
Seat 5: 38979 ($176.10 in chips)
IlxxxlI: posts small blind $0.50
dellindi: posts big blind $1
*** HOLE CARDS ***
Dealt to IlxxxlI [8s Jc]
illoke: raises $2 to $3
38979: folds
v0landito: folds
IlxxxlI: folds
dellindi: folds
Uncalled bet ($2.00) returned to illoke
illoke: doesn't show hand
illoke collected $2.50 from pot
*** SUMMARY ***
Total pot $2.50 | Rake $0
Seat 1: v0landito (button) folded before Flop (didn't bet)
Seat 2: IlxxxlI (small blind) folded before Flop
Seat 3: dellindi (big blind) folded before Flop
Seat 4: illoke collected ($2.50)
Seat 5: 38979 folded before Flop (didn't bet)

PokerStars Hand #771318229: Hold'em No Limit ($0.25/$0.50 USD) - 2016/11/09 19:32:25 ET
Table 'WPN_2355604438' 6-max  Seat #1 is the button
Seat 1: CertifiedG ($58.90 in chips)
Seat 2: IlxxxlI ($20.00 in chips)
Seat 3: Karas321 ($20.75 in chips)
Seat 5: illoke ($61.91 in chips)
Seat 6: built2tilttttttttt ($51.14 in chips)
IlxxxlI: posts small blind $0.25
Karas321: posts big blind $0.50
*** HOLE CARDS ***
Dealt to IlxxxlI [2d Ks]
illoke: folds
built2tilttttttttt: folds
CertifiedG: folds
IlxxxlI: folds
Uncalled bet ($0.25) returned to Karas321
Karas321: doesn't show hand
Karas321 collected $0.50 from pot
*** SUMMARY ***
Total pot $0.50 | Rake $0
Seat 1: CertifiedG (button) folded before Flop (didn't bet)
Seat 2: IlxxxlI (small blind) folded before Flop
Seat 3: Karas321 (big blind) collected ($0.50)
Seat 5: illoke folded before Flop (didn't bet)
Seat 6: built2tilttttttttt folded before Flop (didn't bet)

PokerStars Hand #771318180: Hold'em No Limit ($0.25/$0.50 USD) - 2016/11/09 19:32:18 ET
Table 'WPN_909249931' 6-max  Seat #6 is the button
Seat 1: v0landito ($31.09 in chips)
Seat 2: IlxxxlI ($10.00 in chips)
Seat 3: Oral-Bet ($20.00 in chips)
Seat 4: DBAcardplayer ($101.62 in chips)
Seat 5: xxHandSoloxx ($12.00 in chips)
Seat 6: Driver80296 ($33.70 in chips)
v0landito: posts small blind $0.25
IlxxxlI: posts big blind $0.50
*** HOLE CARDS ***
Dealt to IlxxxlI [8h Ts]
Oral-Bet: folds
DBAcardplayer: calls $0.50
xxHandSoloxx: folds
Driver80296: folds
v0landito: calls $0.25
IlxxxlI: checks
*** FLOP *** [4h 2h 5c]
v0landito: checks
IlxxxlI: checks
DBAcardplayer: bets $0.95
v0landito: folds
IlxxxlI: folds
Uncalled bet ($0.95) returned to DBAcardplayer
DBAcardplayer: doesn't show hand
DBAcardplayer collected $1.43 from pot
*** SUMMARY ***
Total pot $1.50 | Rake $0.07
Board [4h 2h 5c]
Seat 1: v0landito (small blind) folded on the Flop
Seat 2: IlxxxlI (big blind) folded on the Flop
Seat 3: Oral-Bet folded before Flop (didn't bet)
Seat 4: DBAcardplayer collected ($1.43)
Seat 5: xxHandSoloxx folded before Flop (didn't bet)
Seat 6: Driver80296 (button) folded before Flop (didn't bet)

PokerStars Hand #771318104: Hold'em No Limit ($0.25/$0.50 USD) - 2016/11/09 19:32:06 ET
Table 'WPN_481228527' 6-max  Seat #2 is the button
Seat 1: v0landito ($51.50 in chips)
Seat 2: IlxxxlI ($20.75 in chips)
Seat 3: CertifiedG ($93.50 in chips)
Seat 4: ls5ndr ($57.34 in chips)
Seat 5: Oral-Bet ($20.00 in chips)
Seat 6: MrCRABS333 ($52.47 in chips)
CertifiedG: posts small blind $0.25
ls5ndr: posts big blind $0.50
*** HOLE CARDS ***
Dealt to IlxxxlI [Td 5d]
Oral-Bet: folds
MrCRABS333: folds
v0landito: folds
IlxxxlI: folds
CertifiedG: raises $1 to $1.50
ls5ndr: raises $3 to $4.50
CertifiedG: folds
Uncalled bet ($3.00) returned to ls5ndr
ls5ndr: doesn't show hand
ls5ndr collected $3 from pot
*** SUMMARY ***
Total pot $3 | Rake $0
Seat 1: v0landito folded before Flop (didn't bet)
Seat 2: IlxxxlI (button) folded before Flop (didn't bet)
Seat 3: CertifiedG (small blind) folded before Flop
Seat 4: ls5ndr (big blind) collected ($3)
Seat 5: Oral-Bet folded before Flop (didn't bet)
Seat 6: MrCRABS333 folded before Flop (didn't bet)

PokerStars Hand #771318036: Hold'em No Limit ($0.25/$0.50 USD) - 2016/11/09 19:31:56 ET
Table 'WPN_3421571163' 6-max  Seat #6 is the button
Seat 1: IlxxxlI ($20.00 in chips)
Seat 2: ls5ndr ($51.55 in chips)
Seat 4: saidafrente ($57.49 in chips)
Seat 5: Kryuk13 ($56.14 in chips)
Seat 6: v0landito ($100.37 in chips)
IlxxxlI: posts small blind $0.25
ls5ndr: posts big blind $0.50
*** HOLE CARDS ***
Dealt to IlxxxlI [Jc 3c]
saidafrente: folds
Kryuk13: folds
v0landito: folds
IlxxxlI: calls $0.25
ls5ndr: checks
*** FLOP *** [3s Ad 4d]
IlxxxlI: bets $0.50
ls5ndr: folds
Uncalled bet ($0.50) returned to IlxxxlI
IlxxxlI: doesn't show hand
IlxxxlI collected $0.95 from pot
*** SUMMARY ***
Total pot $1 | Rake $0.05
Board [3s Ad 4d]
Seat 1: IlxxxlI (small blind) collected ($0.95)
Seat 2: ls5ndr (big blind) folded on the Flop
Seat 4: saidafrente folded before Flop (didn't bet)
Seat 5: Kryuk13 folded before Flop (didn't bet)
Seat 6: v0landito (button) folded before Flop (didn't bet)

PokerStars Hand #771318009: Hold'em No Limit ($0.25/$0.50 USD) - 2016/11/09 19:31:52 ET
Table 'WPN_3219946394' 6-max  Seat #2 is the button
Seat 1: CertifiedG ($50.00 in chips)
Seat 2: IlxxxlI ($20.00 in chips)
Seat 3: v0landito ($69.84 in chips)
Seat 4: ls5ndr ($51.75 in chips)
Seat 6: 38979 ($79.14 in chips)
v0landito: posts small blind $0.25
ls5ndr: posts big blind $0.50
*** HOLE CARDS ***
Dealt to IlxxxlI [9d 5s]
38979: folds
CertifiedG: folds
IlxxxlI: folds
v0landito: raises $1 to $1.50
ls5ndr: calls $1
*** FLOP *** [Ad Tc 8c]
v0landito: bets $1.43
ls5ndr: folds
Uncalled bet ($1.43) returned to v0landito
v0landito: doesn't show hand
v0landito collected $2.85 from pot
*** SUMMARY ***
Total pot $3 | Rake $0.15
Board [Ad Tc 8c]
Seat 1: CertifiedG folded before Flop (didn't bet)
Seat 2: IlxxxlI (button) folded before Flop (didn't bet)
Seat 3: v0landito (small blind) collected ($2.85)
Seat 4: ls5ndr (big blind) folded on the Flop
Seat 6: 38979 folded before Flop (didn't bet)

PokerStars Hand #771317992: Hold'em No Limit ($0.50/$1.00 USD) - 2016/11/09 19:31:51 ET
Table 'WPN_2128003642' 6-max  Seat #5 is the button
Seat 1: v0landito ($264.45 in chips)
Seat 2: IlxxxlI ($40.00 in chips)
Seat 3: dellindi ($145.39 in chips)
Seat 4: illoke ($124.27 in chips)
Seat 5: 38979 ($176.10 in chips)
v0landito: posts small blind $0.50
IlxxxlI: posts big blind $1
*** HOLE CARDS ***
Dealt to IlxxxlI [7c 6c]
dellindi: raises $2 to $3
illoke: folds
38979: folds
v0landito: folds
IlxxxlI: folds
Uncalled bet ($2.00) returned to dellindi
dellindi: doesn't show hand
dellindi collected $2.50 from pot
*** SUMMARY ***
Total pot $2.50 | Rake $0
Seat 1: v0landito (small blind) folded before Flop
Seat 2: IlxxxlI (big blind) folded before Flop
Seat 3: dellindi collected ($2.50)
Seat 4: illoke folded before Flop (didn't bet)
Seat 5: 38979 (button) folded before Flop (didn't bet)

PokerStars Hand #771317843: Hold'em No Limit ($0.25/$0.50 USD) - 2016/11/09 19:31:28 ET
Table 'WPN_2355604438' 6-max  Seat #6 is the button
Seat 1: CertifiedG ($59.15 in chips)
Seat 2: IlxxxlI ($20.00 in chips)
Seat 3: Karas321 ($20.75 in chips)
Seat 5: illoke ($61.91 in chips)
Seat 6: built2tilttttttttt ($50.00 in chips)
CertifiedG: posts small blind $0.25
IlxxxlI: posts big blind $0.50
*** HOLE CARDS ***
Dealt to IlxxxlI [6s Kd]
Karas321: folds
illoke: folds
built2tilttttttttt: raises $0.50 to $1
CertifiedG: folds
IlxxxlI: calls $0.50
*** FLOP *** [4c 2d Ah]
IlxxxlI: checks
built2tilttttttttt: bets $1.07
IlxxxlI: folds
Uncalled bet ($1.07) returned to built2tilttttttttt
built2tilttttttttt: doesn't show hand
built2tilttttttttt collected $2.14 from pot
*** SUMMARY ***
Total pot $2.25 | Rake $0.11
Board [4c 2d Ah]
Seat 1: CertifiedG (small blind) folded before Flop
Seat 2: IlxxxlI (big blind) folded on the Flop
Seat 3: Karas321 folded before Flop (didn't bet)
Seat 5: illoke folded before Flop (didn't bet)
Seat 6: built2tilttttttttt (button) collected ($2.14)

PokerStars Hand #771317831: Hold'em No Limit ($0.50/$1.00 USD) - 2016/11/09 19:31:27 ET
Table 'WPN_2128003642' 6-max  Seat #4 is the button
Seat 1: v0landito ($263.95 in chips)
Seat 2: IlxxxlI ($40.00 in chips)
Seat 3: dellindi ($145.39 in chips)
Seat 4: illoke ($124.27 in chips)
Seat 5: 38979 ($176.60 in chips)
38979: posts small blind $0.50
v0landito: posts big blind $1
*** HOLE CARDS ***
Dealt to IlxxxlI [2h 6c]
IlxxxlI: folds
dellindi: folds
illoke: folds
38979: folds
Uncalled bet ($0.50) returned to v0landito
v0landito: doesn't show hand
v0landito collected $1 from pot
*** SUMMARY ***
Total pot $1 | Rake $0
Seat 1: v0landito collected ($1)
Seat 2: IlxxxlI folded before Flop (didn't bet)
Seat 3: dellindi folded before Flop (didn't bet)
Seat 4: illoke (button) folded before Flop (didn't bet)
Seat 5: 38979 (small blind) folded before Flop

PokerStars Hand #771317761: Hold'em No Limit ($0.25/$0.50 USD) - 2016/11/09 19:31:17 ET
Table 'WPN_481228527' 6-max  Seat #1 is the button
Seat 1: v0landito ($50.75 in chips)
Seat 2: IlxxxlI ($21.00 in chips)
Seat 3: CertifiedG ($94.00 in chips)
Seat 4: ls5ndr ($57.34 in chips)
Seat 5: Oral-Bet ($20.00 in chips)
Seat 6: MrCRABS333 ($52.47 in chips)
IlxxxlI: posts small blind $0.25
CertifiedG: posts big blind $0.50
*** HOLE CARDS ***
Dealt to IlxxxlI [4h 9s]
ls5ndr: folds
Oral-Bet: folds
MrCRABS333: folds
v0landito: raises $0.50 to $1
IlxxxlI: folds
CertifiedG: folds
Uncalled bet ($0.50) returned to v0landito
v0landito: doesn't show hand
v0landito collected $1.25 from pot
*** SUMMARY ***
Total pot $1.25 | Rake $0
Seat 1: v0landito (button) collected ($1.25)
Seat 2: IlxxxlI (small blind) folded before Flop
Seat 3: CertifiedG (big blind) folded before Flop
Seat 4: ls5ndr folded before Flop (didn't bet)
Seat 5: Oral-Bet folded before Flop (didn't bet)
Seat 6: MrCRABS333 folded before Flop (didn't bet)

PokerStars Hand #771317616: Hold'em No Limit ($0.25/$0.50 USD) - 2016/11/09 19:30:56 ET
Table 'WPN_2355604438' 6-max  Seat #5 is the button
Seat 1: CertifiedG ($59.65 in chips)
Seat 2: IlxxxlI ($20.00 in chips)
Seat 3: Karas321 ($20.00 in chips)
Seat 5: illoke ($61.91 in chips)
Seat 6: built2tilttttttttt ($50.25 in chips)
built2tilttttttttt: posts small blind $0.25
CertifiedG: posts big blind $0.50
*** HOLE CARDS ***
Dealt to IlxxxlI [2s 3c]
IlxxxlI: folds
Karas321: raises $0.75 to $1.25
illoke: folds
built2tilttttttttt: folds
CertifiedG: folds
Uncalled bet ($0.75) returned to Karas321
Karas321: doesn't show hand
Karas321 collected $1.25 from pot
*** SUMMARY ***
Total pot $1.25 | Rake $0
Seat 1: CertifiedG (big blind) folded before Flop
Seat 2: IlxxxlI folded before Flop (didn't bet)
Seat 3: Karas321 collected ($1.25)
Seat 5: illoke (button) folded before Flop (didn't bet)
Seat 6: built2tilttttttttt (small blind) folded before Flop

PokerStars Hand #771317598: Hold'em No Limit ($0.25/$0.50 USD) - 2016/11/09 19:30:54 ET
Table 'WPN_3219946394' 6-max  Seat #1 is the button
Seat 1: CertifiedG ($50.00 in chips)
Seat 2: IlxxxlI ($20.00 in chips)
Seat 3: v0landito ($70.34 in chips)
Seat 4: ls5ndr ($51.00 in chips)
Seat 5: Xiniay ($71.36 in chips)
Seat 6: 38979 ($79.14 in chips)
IlxxxlI: posts small blind $0.25
v0landito: posts big blind $0.50
*** HOLE CARDS ***
Dealt to IlxxxlI [8c Tc]
ls5ndr: raises $0.50 to $1
Xiniay: folds
38979: folds
CertifiedG: folds
IlxxxlI: folds
v0landito: folds
Uncalled bet ($0.50) returned to ls5ndr
ls5ndr: doesn't show hand
ls5ndr collected $1.25 from pot
*** SUMMARY ***
Total pot $1.25 | Rake $0
Seat 1: CertifiedG (button) folded before Flop (didn't bet)
Seat 2: IlxxxlI (small blind) folded before Flop
Seat 3: v0landito (big blind) folded before Flop
Seat 4: ls5ndr collected ($1.25)
Seat 5: Xiniay folded before Flop (didn't bet)
Seat 6: 38979 folded before Flop (didn't bet)

PokerStars Hand #771317574: Hold'em No Limit ($0.50/$1.00 USD) - 2016/11/09 19:30:50 ET
Table 'WPN_2128003642' 6-max  Seat #3 is the button
Seat 1: v0landito ($263.95 in chips)
Seat 2: IlxxxlI ($40.00 in chips)
Seat 3: dellindi ($143.89 in chips)
Seat 4: illoke ($124.77 in chips)
Seat 5: 38979 ($177.60 in chips)
Seat 6: gust ($40.00 in chips)
illoke: posts small blind $0.50
38979: posts big blind $1
*** HOLE CARDS ***
Dealt to IlxxxlI [Ah 2c]
gust: folds
v0landito: folds
IlxxxlI: folds
dellindi: raises $2 to $3
illoke: folds
38979: folds
Uncalled bet ($2.00) returned to dellindi
dellindi: doesn't show hand
dellindi collected $2.50 from pot
*** SUMMARY ***
Total pot $2.50 | Rake $0
Seat 1: v0landito folded before Flop (didn't bet)
Seat 2: IlxxxlI folded before Flop (didn't bet)
Seat 3: dellindi (button) collected ($2.50)
Seat 4: illoke (small blind) folded before Flop
Seat 5: 38979 (big blind) folded before Flop
Seat 6: gust folded before Flop (didn't bet)

PokerStars Hand #771317536: Hold'em No Limit ($0.25/$0.50 USD) - 2016/11/09 19:30:44 ET
Table 'WPN_481228527' 6-max  Seat #6 is the button
Seat 1: v0landito ($51.00 in chips)
Seat 2: IlxxxlI ($20.75 in chips)
Seat 3: CertifiedG ($94.00 in chips)
Seat 4: ls5ndr ($57.34 in chips)
Seat 5: Oral-Bet ($20.00 in chips)
Seat 6: MrCRABS333 ($52.47 in chips)
v0landito: posts small blind $0.25
IlxxxlI: posts big blind $0.50
*** HOLE CARDS ***
Dealt to IlxxxlI [Td 6d]
CertifiedG: folds
ls5ndr: folds
Oral-Bet: folds
MrCRABS333: folds
v0landito: folds
Uncalled bet ($0.25) returned to IlxxxlI
IlxxxlI: doesn't show hand
IlxxxlI collected $0.50 from pot
*** SUMMARY ***
Total pot $0.50 | Rake $0
Seat 1: v0landito (small blind) folded before Flop
Seat 2: IlxxxlI (big blind) collected ($0.50)
Seat 3: CertifiedG folded before Flop (didn't bet)
Seat 4: ls5ndr folded before Flop (didn't bet)
Seat 5: Oral-Bet folded before Flop (didn't bet)
Seat 6: MrCRABS333 (button) folded before Flop (didn't bet)

PokerStars Hand #771317495: Hold'em No Limit ($0.25/$0.50 USD) - 2016/11/09 19:30:39 ET
Table 'WPN_3421571163' 6-max  Seat #5 is the button
Seat 1: IlxxxlI ($20.00 in chips)
Seat 2: ls5ndr ($52.55 in chips)
Seat 4: saidafrente ($58.49 in chips)
Seat 5: Kryuk13 ($57.14 in chips)
Seat 6: v0landito ($96.87 in chips)
v0landito: posts small blind $0.25
IlxxxlI: posts big blind $0.50
*** HOLE CARDS ***
Dealt to IlxxxlI [4d 6c]
ls5ndr: raises $0.50 to $1
saidafrente: calls $1
Kryuk13: calls $1
v0landito: raises $5 to $6
IlxxxlI: folds
ls5ndr: folds
saidafrente: folds
Kryuk13: folds
Uncalled bet ($5.00) returned to v0landito
v0landito: doesn't show hand
v0landito collected $4.50 from pot
*** SUMMARY ***
Total pot $4.50 | Rake $0
Seat 1: IlxxxlI (big blind) folded before Flop
Seat 2: ls5ndr folded before Flop
Seat 4: saidafrente folded before Flop
Seat 5: Kryuk13 (button) folded before Flop
Seat 6: v0landito (small blind) collected ($4.50)

PokerStars Hand #771317374: Hold'em No Limit ($0.25/$0.50 USD) - 2016/11/09 19:30:22 ET
Table 'WPN_3219946394' 6-max  Seat #6 is the button
Seat 1: CertifiedG ($50.00 in chips)
Seat 2: IlxxxlI ($20.00 in chips)
Seat 3: v0landito ($70.34 in chips)
Seat 4: ls5ndr ($51.00 in chips)
Seat 6: 38979 ($78.39 in chips)
CertifiedG: posts small blind $0.25
IlxxxlI: posts big blind $0.50
*** HOLE CARDS ***
Dealt to IlxxxlI [5d Qh]
v0landito: folds
ls5ndr: folds
38979: raises $1 to $1.50
CertifiedG: folds
IlxxxlI: folds
Uncalled bet ($1.00) returned to 38979
38979: doesn't show hand
38979 collected $1.25 from pot
*** SUMMARY ***
Total pot $1.25 | Rake $0
Seat 1: CertifiedG (small blind) folded before Flop
Seat 2: IlxxxlI (big blind) folded before Flop
Seat 3: v0landito folded before Flop (didn't bet)
Seat 4: ls5ndr folded before Flop (didn't bet)
Seat 6: 38979 (button) collected ($1.25)

PokerStars Hand #771317366: Hold'em No Limit ($0.25/$0.50 USD) - 2016/11/09 19:30:20 ET
Table 'WPN_481228527' 6-max  Seat #5 is the button
Seat 1: v0landito ($50.75 in chips)
Seat 2: IlxxxlI ($20.75 in chips)
Seat 3: CertifiedG ($94.00 in chips)
Seat 4: ls5ndr ($57.34 in chips)
Seat 5: Oral-Bet ($20.00 in chips)
Seat 6: MrCRABS333 ($52.72 in chips)
MrCRABS333: posts small blind $0.25
v0landito: posts big blind $0.50
*** HOLE CARDS ***
Dealt to IlxxxlI [Ks 4d]
IlxxxlI: folds
CertifiedG: folds
ls5ndr: folds
Oral-Bet: folds
MrCRABS333: folds
Uncalled bet ($0.25) returned to v0landito
v0landito: doesn't show hand
v0landito collected $0.50 from pot
*** SUMMARY ***
Total pot $0.50 | Rake $0
Seat 1: v0landito (big blind) collected ($0.50)
Seat 2: IlxxxlI folded before Flop (didn't bet)
Seat 3: CertifiedG folded before Flop (didn't bet)
Seat 4: ls5ndr folded before Flop (didn't bet)
Seat 5: Oral-Bet (button) folded before Flop (didn't bet)
Seat 6: MrCRABS333 (small blind) folded before Flop

PokerStars Hand #771316984: Hold'em No Limit ($0.50/$1.00 USD) - 2016/11/09 19:29:29 ET
Table 'WPN_2128003642' 6-max  Seat #2 is the button
Seat 1: v0landito ($263.95 in chips)
Seat 2: IlxxxlI ($40.00 in chips)
Seat 3: dellindi ($150.89 in chips)
Seat 4: illoke ($125.77 in chips)
Seat 5: 38979 ($170.35 in chips)
Seat 6: gust ($40.00 in chips)
dellindi: posts small blind $0.50
illoke: posts big blind $1
*** HOLE CARDS ***
Dealt to IlxxxlI [6c Qc]
38979: raises $2 to $3
gust: folds
v0landito: folds
IlxxxlI: folds
dellindi: calls $2.50
illoke: folds
*** FLOP *** [Jc 7d Kd]
dellindi: checks
38979: checks
*** TURN *** [Jc 7d Kd] [4c]
dellindi: checks
38979: bets $4
dellindi: calls $4
*** RIVER *** [Jc 7d Kd 4c] [Kc]
dellindi: checks
38979: bets $10
dellindi: folds
Uncalled bet ($10.00) returned to 38979
38979: doesn't show hand
38979 collected $14.25 from pot
*** SUMMARY ***
Total pot $15 | Rake $0.75
Board [Jc 7d Kd 4c Kc]
Seat 1: v0landito folded before Flop (didn't bet)
Seat 2: IlxxxlI (button) folded before Flop (didn't bet)
Seat 3: dellindi (small blind) folded on the River
Seat 4: illoke (big blind) folded before Flop
Seat 5: 38979 collected ($14.25)
Seat 6: gust folded before Flop (didn't bet)

PokerStars Hand #771316882: Hold'em No Limit ($0.25/$0.50 USD) - 2016/11/09 19:29:14 ET
Table 'WPN_2355604438' 6-max  Seat #2 is the button
Seat 1: CertifiedG ($56.20 in chips)
Seat 2: IlxxxlI ($20.70 in chips)
Seat 3: Karas321 ($20.00 in chips)
Seat 4: Xiniay ($39.50 in chips)
Seat 5: illoke ($62.16 in chips)
Karas321: posts small blind $0.25
Xiniay: posts big blind $0.50
*** HOLE CARDS ***
Dealt to IlxxxlI [Ac 7c]
illoke: folds
CertifiedG: raises $0.75 to $1.25
IlxxxlI: raises $1.79 to $3.04
Karas321: folds
Xiniay: folds
CertifiedG: calls $1.79
*** FLOP *** [Js Qc 8h]
CertifiedG: checks
IlxxxlI: checks
*** TURN *** [Js Qc 8h] [9h]
CertifiedG: checks
IlxxxlI: checks
*** RIVER *** [Js Qc 8h 9h] [Ts]
CertifiedG: checks
IlxxxlI: checks
*** SHOW DOWN ***
CertifiedG: shows [Kh Jh] (Straight to K)
IlxxxlI: mucks hand
CertifiedG collected $6.49 from pot
*** SUMMARY ***
Total pot $6.83 | Rake $0.34
Board [Js Qc 8h 9h Ts]
Seat 1: CertifiedG showed [Kh Jh] and won ($6.49) with Straight to K
Seat 2: IlxxxlI (button) mucked
Seat 3: Karas321 (small blind) folded before Flop
Seat 4: Xiniay (big blind) folded before Flop
Seat 5: illoke folded before Flop (didn't bet)

PokerStars Hand #771316839: Hold'em No Limit ($0.25/$0.50 USD) - 2016/11/09 19:29:08 ET
Table 'WPN_3219946394' 6-max  Seat #4 is the button
Seat 1: CertifiedG ($50.00 in chips)
Seat 2: IlxxxlI ($20.00 in chips)
Seat 3: v0landito ($70.34 in chips)
Seat 4: ls5ndr ($51.00 in chips)
Seat 5: Xiniay ($71.61 in chips)
Seat 6: 38979 ($78.14 in chips)
Xiniay: posts small blind $0.25
38979: posts big blind $0.50
*** HOLE CARDS ***
Dealt to IlxxxlI [7c Ah]
CertifiedG: folds
IlxxxlI: folds
v0landito: folds
ls5ndr: folds
Xiniay: folds
Uncalled bet ($0.25) returned to 38979
38979: doesn't show hand
38979 collected $0.50 from pot
*** SUMMARY ***
Total pot $0.50 | Rake $0
Seat 1: CertifiedG folded before Flop (didn't bet)
Seat 2: IlxxxlI folded before Flop (didn't bet)
Seat 3: v0landito folded before Flop (didn't bet)
Seat 4: ls5ndr (button) folded before Flop (didn't bet)
Seat 5: Xiniay (small blind) folded before Flop
Seat 6: 38979 (big blind) collected ($0.50)

PokerStars Hand #771316732: Hold'em No Limit ($0.25/$0.50 USD) - 2016/11/09 19:28:53 ET
Table 'WPN_481228527' 6-max  Seat #4 is the button
Seat 1: v0landito ($50.75 in chips)
Seat 2: IlxxxlI ($20.75 in chips)
Seat 3: CertifiedG ($96.75 in chips)
Seat 4: ls5ndr ($57.34 in chips)
Seat 5: Oral-Bet ($20.00 in chips)
Seat 6: MrCRABS333 ($50.00 in chips)
Oral-Bet: posts small blind $0.25
MrCRABS333: posts big blind $0.50
*** HOLE CARDS ***
Dealt to IlxxxlI [3s Th]
v0landito: folds
IlxxxlI: folds
CertifiedG: raises $0.75 to $1.25
ls5ndr: folds
Oral-Bet: folds
MrCRABS333: calls $0.75
*** FLOP *** [9s Ah Qd]
MrCRABS333: checks
CertifiedG: checks
*** TURN *** [9s Ah Qd] [5s]
MrCRABS333: bets $1.50
CertifiedG: calls $1.50
*** RIVER *** [9s Ah Qd 5s] [6h]
MrCRABS333: checks
CertifiedG: checks
*** SHOW DOWN ***
CertifiedG: mucks hand
MrCRABS333: shows [Ac 8c] (One pair of As)
MrCRABS333 collected $5.47 from pot
*** SUMMARY ***
Total pot $5.75 | Rake $0.28
Board [9s Ah Qd 5s 6h]
Seat 1: v0landito folded before Flop (didn't bet)
Seat 2: IlxxxlI folded before Flop (didn't bet)
Seat 3: CertifiedG mucked
Seat 4: ls5ndr (button) folded before Flop (didn't bet)
Seat 5: Oral-Bet (small blind) folded before Flop
Seat 6: MrCRABS333 (big blind) showed [Ac 8c] and won ($5.47) with One pair of As

PokerStars Hand #771316721: Hold'em No Limit ($0.25/$0.50 USD) - 2016/11/09 19:28:50 ET
Table 'WPN_3421571163' 6-max  Seat #4 is the button
Seat 1: IlxxxlI ($20.00 in chips)
Seat 2: ls5ndr ($52.55 in chips)
Seat 3: Xiniay ($44.45 in chips)
Seat 4: saidafrente ($53.27 in chips)
Seat 5: Kryuk13 ($57.39 in chips)
Seat 6: v0landito ($97.37 in chips)
Kryuk13: posts small blind $0.25
v0landito: posts big blind $0.50
*** HOLE CARDS ***
Dealt to IlxxxlI [6c As]
IlxxxlI: folds
ls5ndr: folds
Xiniay: raises $1 to $1.50
saidafrente: raises $3.50 to $5
Kryuk13: folds
v0landito: folds
Xiniay: calls $3.50
*** FLOP *** [Tc 5s 3h]
Xiniay: checks
saidafrente: bets $4.35
Xiniay: folds
Uncalled bet ($4.35) returned to saidafrente
saidafrente: doesn't show hand
saidafrente collected $10.22 from pot
*** SUMMARY ***
Total pot $10.75 | Rake $0.53
Board [Tc 5s 3h]
Seat 1: IlxxxlI folded before Flop (didn't bet)
Seat 2: ls5ndr folded before Flop (didn't bet)
Seat 3: Xiniay folded on the Flop
Seat 4: saidafrente (button) collected ($10.22)
Seat 5: Kryuk13 (small blind) folded before Flop
Seat 6: v0landito (big blind) folded before Flop

PokerStars Hand #771316702: Hold'em No Limit ($0.25/$0.50 USD) - 2016/11/09 19:28:47 ET
Table 'WPN_2355604438' 6-max  Seat #1 is the button
Seat 1: CertifiedG ($56.20 in chips)
Seat 2: IlxxxlI ($20.25 in chips)
Seat 3: Karas321 ($20.25 in chips)
Seat 4: Xiniay ($39.50 in chips)
Seat 5: illoke ($62.16 in chips)
IlxxxlI: posts small blind $0.25
Karas321: posts big blind $0.50
*** HOLE CARDS ***
Dealt to IlxxxlI [8c Ks]
Xiniay: folds
illoke: folds
CertifiedG: folds
IlxxxlI: calls $0.25
Karas321: checks
*** FLOP *** [Kd Td 2d]
IlxxxlI: bets $0.50
Karas321: folds
Uncalled bet ($0.50) returned to IlxxxlI
IlxxxlI: doesn't show hand
IlxxxlI collected $0.95 from pot
*** SUMMARY ***
Total pot $1 | Rake $0.05
Board [Kd Td 2d]
Seat 1: CertifiedG (button) folded before Flop (didn't bet)
Seat 2: IlxxxlI (small blind) collected ($0.95)
Seat 3: Karas321 (big blind) folded on the Flop
Seat 4: Xiniay folded before Flop (didn't bet)
Seat 5: illoke folded before Flop (didn't bet)

PokerStars Hand #771316590: Hold'em No Limit ($0.25/$0.50 USD) - 2016/11/09 19:28:30 ET
Table 'WPN_3219946394' 6-max  Seat #3 is the button
Seat 1: CertifiedG ($50.00 in chips)
Seat 2: IlxxxlI ($20.00 in chips)
Seat 3: v0landito ($70.34 in chips)
Seat 4: ls5ndr ($51.25 in chips)
Seat 5: Xiniay ($72.11 in chips)
Seat 6: 38979 ($77.39 in chips)
ls5ndr: posts small blind $0.25
Xiniay: posts big blind $0.50
*** HOLE CARDS ***
Dealt to IlxxxlI [Qs 7h]
38979: raises $1 to $1.50
CertifiedG: folds
IlxxxlI: folds
v0landito: folds
ls5ndr: folds
Xiniay: folds
Uncalled bet ($1.00) returned to 38979
38979: doesn't show hand
38979 collected $1.25 from pot
*** SUMMARY ***
Total pot $1.25 | Rake $0
Seat 1: CertifiedG folded before Flop (didn't bet)
Seat 2: IlxxxlI folded before Flop (didn't bet)
Seat 3: v0landito (button) folded before Flop (didn't bet)
Seat 4: ls5ndr (small blind) folded before Flop
Seat 5: Xiniay (big blind) folded before Flop
Seat 6: 38979 collected ($1.25)

PokerStars Hand #771316468: Hold'em No Limit ($0.25/$0.50 USD) - 2016/11/09 19:28:12 ET
Table 'WPN_481228527' 6-max  Seat #3 is the button
Seat 1: v0landito ($50.75 in chips)
Seat 2: IlxxxlI ($20.00 in chips)
Seat 3: CertifiedG ($96.75 in chips)
Seat 4: ls5ndr ($57.59 in chips)
Seat 5: Oral-Bet ($20.00 in chips)
ls5ndr: posts small blind $0.25
Oral-Bet: posts big blind $0.50
*** HOLE CARDS ***
Dealt to IlxxxlI [5c 5h]
v0landito: folds
IlxxxlI: raises $0.70 to $1.20
CertifiedG: folds
ls5ndr: folds
Oral-Bet: folds
Uncalled bet ($0.70) returned to IlxxxlI
IlxxxlI: doesn't show hand
IlxxxlI collected $1.25 from pot
*** SUMMARY ***
Total pot $1.25 | Rake $0
Seat 1: v0landito folded before Flop (didn't bet)
Seat 2: IlxxxlI collected ($1.25)
Seat 3: CertifiedG (button) folded before Flop (didn't bet)
Seat 4: ls5ndr (small blind) folded before Flop
Seat 5: Oral-Bet (big blind) folded before Flop

PokerStars Hand #771316335: Hold'em No Limit ($0.25/$0.50 USD) - 2016/11/09 19:27:54 ET
Table 'WPN_3219946394' 6-max  Seat #2 is the button
Seat 1: CertifiedG ($50.00 in chips)
Seat 2: IlxxxlI ($20.73 in chips)
Seat 3: v0landito ($70.59 in chips)
Seat 4: ls5ndr ($50.00 in chips)
Seat 5: Xiniay ($72.11 in chips)
Seat 6: 38979 ($77.39 in chips)
v0landito: posts small blind $0.25
ls5ndr: posts big blind $0.50
*** HOLE CARDS ***
Dealt to IlxxxlI [Ah 2d]
Xiniay: folds
38979: folds
CertifiedG: folds
IlxxxlI: raises $0.50 to $1
v0landito: folds
ls5ndr: raises $3.50 to $4.50
IlxxxlI: folds
Uncalled bet ($3.50) returned to ls5ndr
ls5ndr: doesn't show hand
ls5ndr collected $2.25 from pot
*** SUMMARY ***
Total pot $2.25 | Rake $0
Seat 1: CertifiedG folded before Flop (didn't bet)
Seat 2: IlxxxlI (button) folded before Flop
Seat 3: v0landito (small blind) folded before Flop
Seat 4: ls5ndr (big blind) collected ($2.25)
Seat 5: Xiniay folded before Flop (didn't bet)
Seat 6: 38979 folded before Flop (didn't bet)

PokerStars Hand #771316240: Hold'em No Limit ($0.25/$0.50 USD) - 2016/11/09 19:27:44 ET
Table 'WPN_3421571163' 6-max  Seat #3 is the button
Seat 1: IlxxxlI ($20.00 in chips)
Seat 2: ls5ndr ($52.55 in chips)
Seat 3: Xiniay ($46.16 in chips)
Seat 4: saidafrente ($53.52 in chips)
Seat 5: Kryuk13 ($55.61 in chips)
Seat 6: v0landito ($97.37 in chips)
saidafrente: posts small blind $0.25
Kryuk13: posts big blind $0.50
*** HOLE CARDS ***
Dealt to IlxxxlI [4s Td]
v0landito: folds
IlxxxlI: folds
ls5ndr: folds
Xiniay: raises $0.50 to $1
saidafrente: folds
Kryuk13: calls $0.50
*** FLOP *** [2h 6h Th]
Kryuk13: checks
Xiniay: bets $0.71
Kryuk13: raises $1.42 to $2.13
Xiniay: folds
Uncalled bet ($1.42) returned to Kryuk13
Kryuk13: doesn't show hand
Kryuk13 collected $3.49 from pot
*** SUMMARY ***
Total pot $3.67 | Rake $0.18
Board [2h 6h Th]
Seat 1: IlxxxlI folded before Flop (didn't bet)
Seat 2: ls5ndr folded before Flop (didn't bet)
Seat 3: Xiniay (button) folded on the Flop
Seat 4: saidafrente (small blind) folded before Flop
Seat 5: Kryuk13 (big blind) collected ($3.49)
Seat 6: v0landito folded before Flop (didn't bet)

PokerStars Hand #771316215: Hold'em No Limit ($0.50/$1.00 USD) - 2016/11/09 19:27:38 ET
Table 'WPN_2128003642' 6-max  Seat #1 is the button
Seat 1: v0landito ($279.79 in chips)
Seat 2: IlxxxlI ($40.00 in chips)
Seat 3: dellindi ($136.15 in chips)
Seat 4: illoke ($125.77 in chips)
Seat 5: 38979 ($170.35 in chips)
Seat 6: gust ($40.00 in chips)
IlxxxlI: posts small blind $0.50
dellindi: posts big blind $1
*** HOLE CARDS ***
Dealt to IlxxxlI [4c 7s]
illoke: folds
38979: folds
gust: folds
v0landito: raises $1 to $2
IlxxxlI: folds
dellindi: raises $5 to $7
v0landito: calls $5
*** FLOP *** [8d Qc 9d]
dellindi: checks
v0landito: checks
*** TURN *** [8d Qc 9d] [4h]
dellindi: bets $1
v0landito: calls $1
*** RIVER *** [8d Qc 9d 4h] [Td]
dellindi: bets $7.84
v0landito: calls $7.84
*** SHOW DOWN ***
v0landito: mucks hand
dellindi: shows [Ks Js] (Straight to K)
dellindi collected $30.58 from pot
*** SUMMARY ***
Total pot $32.18 | Rake $1.60
Board [8d Qc 9d 4h Td]
Seat 1: v0landito (button) mucked
Seat 2: IlxxxlI (small blind) folded before Flop
Seat 3: dellindi (big blind) showed [Ks Js] and won ($30.58) with Straight to K
Seat 4: illoke folded before Flop (didn't bet)
Seat 5: 38979 folded before Flop (didn't bet)
Seat 6: gust folded before Flop (didn't bet)

PokerStars Hand #771316071: Hold'em No Limit ($0.25/$0.50 USD) - 2016/11/09 19:27:19 ET
Table 'WPN_2355604438' 6-max  Seat #5 is the button
Seat 1: CertifiedG ($51.00 in chips)
Seat 2: IlxxxlI ($20.75 in chips)
Seat 3: Karas321 ($20.25 in chips)
Seat 4: Xiniay ($39.50 in chips)
Seat 5: illoke ($67.41 in chips)
CertifiedG: posts small blind $0.25
IlxxxlI: posts big blind $0.50
*** HOLE CARDS ***
Dealt to IlxxxlI [5s 9d]
Karas321: folds
Xiniay: folds
illoke: raises $0.75 to $1.25
CertifiedG: raises $4 to $5.25
IlxxxlI: folds
illoke: calls $4
*** FLOP *** [Ks 3d Qh]
CertifiedG: checks
illoke: checks
*** TURN *** [Ks 3d Qh] [Jc]
CertifiedG: checks
illoke: checks
*** RIVER *** [Ks 3d Qh Jc] [Kd]
CertifiedG: checks
illoke: checks
*** SHOW DOWN ***
CertifiedG: shows [Qs Ah] (Two pairs. Ks and Qs)
illoke: mucks hand
CertifiedG collected $10.45 from pot
*** SUMMARY ***
Total pot $11 | Rake $0.55
Board [Ks 3d Qh Jc Kd]
Seat 1: CertifiedG (small blind) showed [Qs Ah] and won ($10.45) with Two pairs. Ks and Qs
Seat 2: IlxxxlI (big blind) folded before Flop
Seat 3: Karas321 folded before Flop (didn't bet)
Seat 4: Xiniay folded before Flop (didn't bet)
Seat 5: illoke (button) mucked

PokerStars Hand #771316066: Hold'em No Limit ($0.25/$0.50 USD) - 2016/11/09 19:27:19 ET
Table 'WPN_481228527' 6-max  Seat #2 is the button
Seat 1: v0landito ($50.75 in chips)
Seat 2: IlxxxlI ($20.00 in chips)
Seat 3: CertifiedG ($98.25 in chips)
Seat 4: ls5ndr ($56.24 in chips)
Seat 5: Oral-Bet ($20.00 in chips)
CertifiedG: posts small blind $0.25
ls5ndr: posts big blind $0.50
*** HOLE CARDS ***
Dealt to IlxxxlI [5d 2s]
Oral-Bet: folds
v0landito: folds
IlxxxlI: folds
CertifiedG: raises $1 to $1.50
ls5ndr: calls $1
*** FLOP *** [Ac Qs Kd]
CertifiedG: checks
ls5ndr: bets $1
CertifiedG: folds
Uncalled bet ($1.00) returned to ls5ndr
ls5ndr: doesn't show hand
ls5ndr collected $2.85 from pot
*** SUMMARY ***
Total pot $3 | Rake $0.15
Board [Ac Qs Kd]
Seat 1: v0landito folded before Flop (didn't bet)
Seat 2: IlxxxlI (button) folded before Flop (didn't bet)
Seat 3: CertifiedG (small blind) folded on the Flop
Seat 4: ls5ndr (big blind) collected ($2.85)
Seat 5: Oral-Bet folded before Flop (didn't bet)

PokerStars Hand #771315865: Hold'em No Limit ($0.50/$1.00 USD) - 2016/11/09 19:26:50 ET
Table 'WPN_2128003642' 6-max  Seat #6 is the button
Seat 1: v0landito ($280.29 in chips)
Seat 2: IlxxxlI ($40.00 in chips)
Seat 3: dellindi ($136.15 in chips)
Seat 4: illoke ($125.77 in chips)
Seat 5: 38979 ($168.85 in chips)
Seat 6: gust ($40.00 in chips)
v0landito: posts small blind $0.50
IlxxxlI: posts big blind $1
*** HOLE CARDS ***
Dealt to IlxxxlI [5d 3s]
dellindi: folds
illoke: folds
38979: raises $2 to $3
gust: folds
v0landito: folds
IlxxxlI: folds
Uncalled bet ($2.00) returned to 38979
38979: doesn't show hand
38979 collected $2.50 from pot
*** SUMMARY ***
Total pot $2.50 | Rake $0
Seat 1: v0landito (small blind) folded before Flop
Seat 2: IlxxxlI (big blind) folded before Flop
Seat 3: dellindi folded before Flop (didn't bet)
Seat 4: illoke folded before Flop (didn't bet)
Seat 5: 38979 collected ($2.50)
Seat 6: gust (button) folded before Flop (didn't bet)

PokerStars Hand #771315866: Hold'em No Limit ($0.25/$0.50 USD) - 2016/11/09 19:26:50 ET
Table 'WPN_2355604438' 6-max  Seat #4 is the button
Seat 1: CertifiedG ($51.50 in chips)
Seat 2: IlxxxlI ($20.00 in chips)
Seat 3: Karas321 ($20.25 in chips)
Seat 4: Xiniay ($39.50 in chips)
Seat 5: illoke ($67.66 in chips)
illoke: posts small blind $0.25
CertifiedG: posts big blind $0.50
*** HOLE CARDS ***
Dealt to IlxxxlI [9c Qc]
IlxxxlI: raises $0.50 to $1
Karas321: folds
Xiniay: folds
illoke: folds
CertifiedG: folds
Uncalled bet ($0.50) returned to IlxxxlI
IlxxxlI: doesn't show hand
IlxxxlI collected $1.25 from pot
*** SUMMARY ***
Total pot $1.25 | Rake $0
Seat 1: CertifiedG (big blind) folded before Flop
Seat 2: IlxxxlI collected ($1.25)
Seat 3: Karas321 folded before Flop (didn't bet)
Seat 4: Xiniay (button) folded before Flop (didn't bet)
Seat 5: illoke (small blind) folded before Flop

PokerStars Hand #771315845: Hold'em No Limit ($0.25/$0.50 USD) - 2016/11/09 19:26:47 ET
Table 'WPN_3421571163' 6-max  Seat #2 is the button
Seat 1: IlxxxlI ($20.00 in chips)
Seat 2: ls5ndr ($50.75 in chips)
Seat 3: Xiniay ($46.41 in chips)
Seat 4: saidafrente ($54.02 in chips)
Seat 5: Kryuk13 ($55.61 in chips)
Seat 6: v0landito ($97.37 in chips)
Xiniay: posts small blind $0.25
saidafrente: posts big blind $0.50
*** HOLE CARDS ***
Dealt to IlxxxlI [6c 6d]
Kryuk13: folds
v0landito: folds
IlxxxlI: raises $0.70 to $1.20
ls5ndr: calls $1.20
Xiniay: folds
saidafrente: folds
*** FLOP *** [5s Ac 5h]
IlxxxlI: checks
ls5ndr: bets $1
IlxxxlI: folds
Uncalled bet ($1.00) returned to ls5ndr
ls5ndr: doesn't show hand
ls5ndr collected $3 from pot
*** SUMMARY ***
Total pot $3.15 | Rake $0.15
Board [5s Ac 5h]
Seat 1: IlxxxlI folded on the Flop
Seat 2: ls5ndr (button) collected ($3)
Seat 3: Xiniay (small blind) folded before Flop
Seat 4: saidafrente (big blind) folded before Flop
Seat 5: Kryuk13 folded before Flop (didn't bet)
Seat 6: v0landito folded before Flop (didn't bet)

PokerStars Hand #771315823: Hold'em No Limit ($0.25/$0.50 USD) - 2016/11/09 19:26:44 ET
Table 'WPN_3219946394' 6-max  Seat #1 is the button
Seat 1: CertifiedG ($50.00 in chips)
Seat 2: IlxxxlI ($20.98 in chips)
Seat 3: v0landito ($69.22 in chips)
Seat 4: ls5ndr ($50.00 in chips)
Seat 5: Xiniay ($72.11 in chips)
Seat 6: 38979 ($77.39 in chips)
IlxxxlI: posts small blind $0.25
v0landito: posts big blind $0.50
*** HOLE CARDS ***
Dealt to IlxxxlI [6s 4h]
ls5ndr: folds
Xiniay: folds
38979: folds
CertifiedG: raises $0.62 to $1.12
IlxxxlI: folds
v0landito: raises $3.88 to $5
CertifiedG: folds
Uncalled bet ($3.88) returned to v0landito
v0landito: doesn't show hand
v0landito collected $2.49 from pot
*** SUMMARY ***
Total pot $2.49 | Rake $0
Seat 1: CertifiedG (button) folded before Flop
Seat 2: IlxxxlI (small blind) folded before Flop
Seat 3: v0landito (big blind) collected ($2.49)
Seat 4: ls5ndr folded before Flop (didn't bet)
Seat 5: Xiniay folded before Flop (didn't bet)
Seat 6: 38979 folded before Flop (didn't bet)

PokerStars Hand #771315747: Hold'em No Limit ($0.25/$0.50 USD) - 2016/11/09 19:26:33 ET
Table 'WPN_481228527' 6-max  Seat #1 is the button
Seat 1: v0landito ($50.00 in chips)
Seat 2: IlxxxlI ($20.00 in chips)
Seat 3: CertifiedG ($98.75 in chips)
Seat 4: ls5ndr ($56.24 in chips)
Seat 5: Oral-Bet ($20.00 in chips)
IlxxxlI: posts small blind $0.25
CertifiedG: posts big blind $0.50
*** HOLE CARDS ***
Dealt to IlxxxlI [6s 3d]
ls5ndr: folds
Oral-Bet: folds
v0landito: raises $0.50 to $1
IlxxxlI: folds
CertifiedG: folds
Uncalled bet ($0.50) returned to v0landito
v0landito: doesn't show hand
v0landito collected $1.25 from pot
*** SUMMARY ***
Total pot $1.25 | Rake $0
Seat 1: v0landito (button) collected ($1.25)
Seat 2: IlxxxlI (small blind) folded before Flop
Seat 3: CertifiedG (big blind) folded before Flop
Seat 4: ls5ndr folded before Flop (didn't bet)
Seat 5: Oral-Bet folded before Flop (didn't bet)

PokerStars Hand #771315566: Hold'em No Limit ($0.25/$0.50 USD) - 2016/11/09 19:26:10 ET
Table 'WPN_3421571163' 6-max  Seat #1 is the button
Seat 1: IlxxxlI ($20.00 in chips)
Seat 2: ls5ndr ($50.25 in chips)
Seat 3: Xiniay ($46.91 in chips)
Seat 4: saidafrente ($54.02 in chips)
Seat 5: Kryuk13 ($55.61 in chips)
Seat 6: v0landito ($97.37 in chips)
ls5ndr: posts small blind $0.25
Xiniay: posts big blind $0.50
*** HOLE CARDS ***
Dealt to IlxxxlI [7h Ks]
saidafrente: folds
Kryuk13: folds
v0landito: folds
IlxxxlI: folds
ls5ndr: raises $1 to $1.50
Xiniay: folds
Uncalled bet ($1.00) returned to ls5ndr
ls5ndr: doesn't show hand
ls5ndr collected $1 from pot
*** SUMMARY ***
Total pot $1 | Rake $0
Seat 1: IlxxxlI (button) folded before Flop (didn't bet)
Seat 2: ls5ndr (small blind) collected ($1)
Seat 3: Xiniay (big blind) folded before Flop
Seat 4: saidafrente folded before Flop (didn't bet)
Seat 5: Kryuk13 folded before Flop (didn't bet)
Seat 6: v0landito folded before Flop (didn't bet)

PokerStars Hand #771315502: Hold'em No Limit ($0.25/$0.50 USD) - 2016/11/09 19:26:00 ET
Table 'WPN_481228527' 6-max  Seat #5 is the button
Seat 1: v0landito ($50.25 in chips)
Seat 2: IlxxxlI ($20.00 in chips)
Seat 3: CertifiedG ($98.75 in chips)
Seat 4: ls5ndr ($55.49 in chips)
Seat 5: Oral-Bet ($20.00 in chips)
v0landito: posts small blind $0.25
IlxxxlI: posts big blind $0.50
*** HOLE CARDS ***
Dealt to IlxxxlI [6s 9h]
CertifiedG: folds
ls5ndr: raises $0.50 to $1
Oral-Bet: folds
v0landito: folds
IlxxxlI: folds
Uncalled bet ($0.50) returned to ls5ndr
ls5ndr: doesn't show hand
ls5ndr collected $1.25 from pot
*** SUMMARY ***
Total pot $1.25 | Rake $0
Seat 1: v0landito (small blind) folded before Flop
Seat 2: IlxxxlI (big blind) folded before Flop
Seat 3: CertifiedG folded before Flop (didn't bet)
Seat 4: ls5ndr collected ($1.25)
Seat 5: Oral-Bet (button) folded before Flop (didn't bet)

PokerStars Hand #771315408: Hold'em No Limit ($0.25/$0.50 USD) - 2016/11/09 19:25:46 ET
Table 'WPN_3219946394' 6-max  Seat #6 is the button
Seat 1: CertifiedG ($50.00 in chips)
Seat 2: IlxxxlI ($21.48 in chips)
Seat 3: v0landito ($69.22 in chips)
Seat 4: ls5ndr ($50.00 in chips)
Seat 5: Xiniay ($73.61 in chips)
Seat 6: 38979 ($75.14 in chips)
CertifiedG: posts small blind $0.25
IlxxxlI: posts big blind $0.50
*** HOLE CARDS ***
Dealt to IlxxxlI [As Js]
v0landito: folds
ls5ndr: folds
Xiniay: raises $1 to $1.50
38979: raises $4 to $5.50
CertifiedG: folds
IlxxxlI: folds
Xiniay: folds
Uncalled bet ($4.00) returned to 38979
38979: doesn't show hand
38979 collected $3.75 from pot
*** SUMMARY ***
Total pot $3.75 | Rake $0
Seat 1: CertifiedG (small blind) folded before Flop
Seat 2: IlxxxlI (big blind) folded before Flop
Seat 3: v0landito folded before Flop (didn't bet)
Seat 4: ls5ndr folded before Flop (didn't bet)
Seat 5: Xiniay folded before Flop
Seat 6: 38979 (button) collected ($3.75)

PokerStars Hand #771315298: Hold'em No Limit ($0.25/$0.50 USD) - 2016/11/09 19:25:29 ET
Table 'WPN_2355604438' 6-max  Seat #3 is the button
Seat 1: CertifiedG ($51.50 in chips)
Seat 2: IlxxxlI ($20.00 in chips)
Seat 3: Karas321 ($20.25 in chips)
Seat 4: Xiniay ($41.00 in chips)
Seat 5: illoke ($64.88 in chips)
Seat 6: dellindi ($55.03 in chips)
Xiniay: posts small blind $0.25
illoke: posts big blind $0.50
*** HOLE CARDS ***
Dealt to IlxxxlI [5c 3c]
dellindi: folds
CertifiedG: folds
IlxxxlI: calls $0.50
Karas321: folds
Xiniay: calls $0.25
illoke: raises $1 to $1.50
IlxxxlI: calls $1
Xiniay: calls $1
*** FLOP *** [9s 9h 9d]
Xiniay: checks
illoke: checks
IlxxxlI: checks
*** TURN *** [9s 9h 9d] [Td]
Xiniay: checks
illoke: bets $2.14
IlxxxlI: folds
Xiniay: folds
Uncalled bet ($2.14) returned to illoke
illoke: doesn't show hand
illoke collected $4.28 from pot
*** SUMMARY ***
Total pot $4.50 | Rake $0.22
Board [9s 9h 9d Td]
Seat 1: CertifiedG folded before Flop (didn't bet)
Seat 2: IlxxxlI folded on the Turn
Seat 3: Karas321 (button) folded before Flop (didn't bet)
Seat 4: Xiniay (small blind) folded on the Turn
Seat 5: illoke (big blind) collected ($4.28)
Seat 6: dellindi folded before Flop (didn't bet)

PokerStars Hand #771315279: Hold'em No Limit ($0.25/$0.50 USD) - 2016/11/09 19:25:28 ET
Table 'WPN_3421571163' 6-max  Seat #6 is the button
Seat 1: IlxxxlI ($20.00 in chips)
Seat 2: ls5ndr ($50.75 in chips)
Seat 3: Xiniay ($46.91 in chips)
Seat 4: saidafrente ($53.27 in chips)
Seat 5: Kryuk13 ($55.61 in chips)
Seat 6: v0landito ($97.37 in chips)
IlxxxlI: posts small blind $0.25
ls5ndr: posts big blind $0.50
*** HOLE CARDS ***
Dealt to IlxxxlI [7s Ac]
Xiniay: folds
saidafrente: raises $1 to $1.50
Kryuk13: folds
v0landito: folds
IlxxxlI: folds
ls5ndr: folds
Uncalled bet ($1.00) returned to saidafrente
saidafrente: doesn't show hand
saidafrente collected $1.25 from pot
*** SUMMARY ***
Total pot $1.25 | Rake $0
Seat 1: IlxxxlI (small blind) folded before Flop
Seat 2: ls5ndr (big blind) folded before Flop
Seat 3: Xiniay folded before Flop (didn't bet)
Seat 4: saidafrente collected ($1.25)
Seat 5: Kryuk13 folded before Flop (didn't bet)
Seat 6: v0landito (button) folded before Flop (didn't bet)

PokerStars Hand #771315160: Hold'em No Limit ($0.25/$0.50 USD) - 2016/11/09 19:25:12 ET
Table 'WPN_2355604438' 6-max  Seat #2 is the button
Seat 1: CertifiedG ($51.50 in chips)
Seat 2: IlxxxlI ($20.00 in chips)
Seat 3: Karas321 ($20.50 in chips)
Seat 4: Xiniay ($40.75 in chips)
Seat 5: illoke ($64.88 in chips)
Seat 6: dellindi ($55.03 in chips)
Karas321: posts small blind $0.25
Xiniay: posts big blind $0.50
*** HOLE CARDS ***
Dealt to IlxxxlI [Js 5d]
illoke: folds
dellindi: folds
CertifiedG: folds
IlxxxlI: folds
Karas321: folds
Uncalled bet ($0.25) returned to Xiniay
Xiniay: doesn't show hand
Xiniay collected $0.50 from pot
*** SUMMARY ***
Total pot $0.50 | Rake $0
Seat 1: CertifiedG folded before Flop (didn't bet)
Seat 2: IlxxxlI (button) folded before Flop (didn't bet)
Seat 3: Karas321 (small blind) folded before Flop
Seat 4: Xiniay (big blind) collected ($0.50)
Seat 5: illoke folded before Flop (didn't bet)
Seat 6: dellindi folded before Flop (didn't bet)

PokerStars Hand #771315093: Hold'em No Limit ($0.50/$1.00 USD) - 2016/11/09 19:25:00 ET
Table 'WPN_2128003642' 6-max  Seat #5 is the button
Seat 1: v0landito ($281.29 in chips)
Seat 2: IlxxxlI ($40.00 in chips)
Seat 3: dellindi ($136.15 in chips)
Seat 4: illoke ($121.64 in chips)
Seat 5: 38979 ($171.85 in chips)
Seat 6: gust ($40.50 in chips)
gust: posts small blind $0.50
v0landito: posts big blind $1
*** HOLE CARDS ***
Dealt to IlxxxlI [2d Jc]
IlxxxlI: folds
dellindi: folds
illoke: raises $2 to $3
38979: calls $3
gust: folds
v0landito: folds
*** FLOP *** [Tc 8s Js]
illoke: checks
38979: checks
*** TURN *** [Tc 8s Js] [Ks]
illoke: checks
38979: checks
*** RIVER *** [Tc 8s Js Ks] [9c]
illoke: bets $2.37
38979: folds
Uncalled bet ($2.37) returned to illoke
illoke: doesn't show hand
illoke collected $7.13 from pot
*** SUMMARY ***
Total pot $7.50 | Rake $0.37
Board [Tc 8s Js Ks 9c]
Seat 1: v0landito (big blind) folded before Flop
Seat 2: IlxxxlI folded before Flop (didn't bet)
Seat 3: dellindi folded before Flop (didn't bet)
Seat 4: illoke collected ($7.13)
Seat 5: 38979 (button) folded on the River
Seat 6: gust (small blind) folded before Flop

PokerStars Hand #771315027: Hold'em No Limit ($0.25/$0.50 USD) - 2016/11/09 19:24:52 ET
Table 'WPN_2355604438' 6-max  Seat #1 is the button
Seat 1: CertifiedG ($50.75 in chips)
Seat 2: IlxxxlI ($20.00 in chips)
Seat 3: Karas321 ($21.00 in chips)
Seat 4: Xiniay ($40.75 in chips)
Seat 5: illoke ($64.88 in chips)
Seat 6: dellindi ($55.03 in chips)
IlxxxlI: posts small blind $0.25
Karas321: posts big blind $0.50
*** HOLE CARDS ***
Dealt to IlxxxlI [4c Qd]
Xiniay: folds
illoke: folds
dellindi: folds
CertifiedG: raises $0.62 to $1.12
IlxxxlI: folds
Karas321: folds
Uncalled bet ($0.62) returned to CertifiedG
CertifiedG: doesn't show hand
CertifiedG collected $1.25 from pot
*** SUMMARY ***
Total pot $1.25 | Rake $0
Seat 1: CertifiedG (button) collected ($1.25)
Seat 2: IlxxxlI (small blind) folded before Flop
Seat 3: Karas321 (big blind) folded before Flop
Seat 4: Xiniay folded before Flop (didn't bet)
Seat 5: illoke folded before Flop (didn't bet)
Seat 6: dellindi folded before Flop (didn't bet)

PokerStars Hand #771314971: Hold'em No Limit ($0.25/$0.50 USD) - 2016/11/09 19:24:44 ET
Table 'WPN_3421571163' 6-max  Seat #5 is the button
Seat 1: IlxxxlI ($20.38 in chips)
Seat 2: ls5ndr ($50.75 in chips)
Seat 3: Xiniay ($46.16 in chips)
Seat 4: saidafrente ($53.27 in chips)
Seat 5: Kryuk13 ($55.61 in chips)
Seat 6: v0landito ($97.62 in chips)
v0landito: posts small blind $0.25
IlxxxlI: posts big blind $0.50
*** HOLE CARDS ***
Dealt to IlxxxlI [Ks 4h]
ls5ndr: folds
Xiniay: raises $1 to $1.50
saidafrente: folds
Kryuk13: folds
v0landito: folds
IlxxxlI: folds
Uncalled bet ($1.00) returned to Xiniay
Xiniay: doesn't show hand
Xiniay collected $1.25 from pot
*** SUMMARY ***
Total pot $1.25 | Rake $0
Seat 1: IlxxxlI (big blind) folded before Flop
Seat 2: ls5ndr folded before Flop (didn't bet)
Seat 3: Xiniay collected ($1.25)
Seat 4: saidafrente folded before Flop (didn't bet)
Seat 5: Kryuk13 (button) folded before Flop (didn't bet)
Seat 6: v0landito (small blind) folded before Flop

PokerStars Hand #771314953: Hold'em No Limit ($0.25/$0.50 USD) - 2016/11/09 19:24:42 ET
Table 'WPN_3219946394' 6-max  Seat #5 is the button
Seat 1: CertifiedG ($50.00 in chips)
Seat 2: IlxxxlI ($21.48 in chips)
Seat 3: v0landito ($69.22 in chips)
Seat 4: ls5ndr ($50.00 in chips)
Seat 5: Xiniay ($72.23 in chips)
Seat 6: 38979 ($76.14 in chips)
38979: posts small blind $0.25
CertifiedG: posts big blind $0.50
*** HOLE CARDS ***
Dealt to IlxxxlI [Ts Jc]
IlxxxlI: folds
v0landito: folds
ls5ndr: folds
Xiniay: raises $0.50 to $1
38979: calls $0.75
CertifiedG: folds
*** FLOP *** [8h 5c Ac]
38979: checks
Xiniay: bets $0.79
38979: folds
Uncalled bet ($0.79) returned to Xiniay
Xiniay: doesn't show hand
Xiniay collected $2.38 from pot
*** SUMMARY ***
Total pot $2.50 | Rake $0.12
Board [8h 5c Ac]
Seat 1: CertifiedG (big blind) folded before Flop
Seat 2: IlxxxlI folded before Flop (didn't bet)
Seat 3: v0landito folded before Flop (didn't bet)
Seat 4: ls5ndr folded before Flop (didn't bet)
Seat 5: Xiniay (button) collected ($2.38)
Seat 6: 38979 (small blind) folded on the Flop

PokerStars Hand #771314871: Hold'em No Limit ($0.50/$1.00 USD) - 2016/11/09 19:24:32 ET
Table 'WPN_2128003642' 6-max  Seat #4 is the button
Seat 1: v0landito ($281.29 in chips)
Seat 2: IlxxxlI ($40.00 in chips)
Seat 3: dellindi ($136.15 in chips)
Seat 4: illoke ($120.14 in chips)
Seat 5: 38979 ($172.35 in chips)
Seat 6: gust ($41.50 in chips)
38979: posts small blind $0.50
gust: posts big blind $1
*** HOLE CARDS ***
Dealt to IlxxxlI [2d 9c]
v0landito: folds
IlxxxlI: folds
dellindi: folds
illoke: raises $1.50 to $2.50
38979: folds
gust: folds
Uncalled bet ($1.50) returned to illoke
illoke: doesn't show hand
illoke collected $2.50 from pot
*** SUMMARY ***
Total pot $2.50 | Rake $0
Seat 1: v0landito folded before Flop (didn't bet)
Seat 2: IlxxxlI folded before Flop (didn't bet)
Seat 3: dellindi folded before Flop (didn't bet)
Seat 4: illoke (button) collected ($2.50)
Seat 5: 38979 (small blind) folded before Flop
Seat 6: gust (big blind) folded before Flop

PokerStars Hand #771314617: Hold'em No Limit ($0.25/$0.50 USD) - 2016/11/09 19:23:57 ET
Table 'WPN_3421571163' 6-max  Seat #4 is the button
Seat 1: IlxxxlI ($20.38 in chips)
Seat 2: ls5ndr ($50.00 in chips)
Seat 3: Xiniay ($46.16 in chips)
Seat 4: saidafrente ($53.27 in chips)
Seat 5: Kryuk13 ($55.86 in chips)
Seat 6: v0landito ($98.12 in chips)
Kryuk13: posts small blind $0.25
v0landito: posts big blind $0.50
*** HOLE CARDS ***
Dealt to IlxxxlI [9d Ks]
IlxxxlI: folds
ls5ndr: raises $0.50 to $1
Xiniay: folds
saidafrente: folds
Kryuk13: folds
v0landito: folds
Uncalled bet ($0.50) returned to ls5ndr
ls5ndr: doesn't show hand
ls5ndr collected $1.25 from pot
*** SUMMARY ***
Total pot $1.25 | Rake $0
Seat 1: IlxxxlI folded before Flop (didn't bet)
Seat 2: ls5ndr collected ($1.25)
Seat 3: Xiniay folded before Flop (didn't bet)
Seat 4: saidafrente (button) folded before Flop (didn't bet)
Seat 5: Kryuk13 (small blind) folded before Flop
Seat 6: v0landito (big blind) folded before Flop

PokerStars Hand #771314421: Hold'em No Limit ($0.25/$0.50 USD) - 2016/11/09 19:23:28 ET
Table 'WPN_3219946394' 6-max  Seat #4 is the button
Seat 2: IlxxxlI ($21.48 in chips)
Seat 3: v0landito ($69.22 in chips)
Seat 4: ls5ndr ($50.00 in chips)
Seat 5: Xiniay ($73.73 in chips)
Seat 6: 38979 ($74.79 in chips)
Xiniay: posts small blind $0.25
38979: posts big blind $0.50
*** HOLE CARDS ***
Dealt to IlxxxlI [8d Qd]
IlxxxlI: folds
v0landito: folds
ls5ndr: folds
Xiniay: raises $1 to $1.50
38979: calls $1
*** FLOP *** [Kc Ad 5d]
Xiniay: checks
38979: bets $2
Xiniay: folds
Uncalled bet ($2.00) returned to 38979
38979: doesn't show hand
38979 collected $2.85 from pot
*** SUMMARY ***
Total pot $3 | Rake $0.15
Board [Kc Ad 5d]
Seat 2: IlxxxlI folded before Flop (didn't bet)
Seat 3: v0landito folded before Flop (didn't bet)
Seat 4: ls5ndr (button) folded before Flop (didn't bet)
Seat 5: Xiniay (small blind) folded on the Flop
Seat 6: 38979 (big blind) collected ($2.85)

PokerStars Hand #771314351: Hold'em No Limit ($0.25/$0.50 USD) - 2016/11/09 19:23:19 ET
Table 'WPN_2355604438' 6-max  Seat #6 is the button
Seat 1: CertifiedG ($51.00 in chips)
Seat 2: IlxxxlI ($20.00 in chips)
Seat 3: Karas321 ($21.00 in chips)
Seat 4: Xiniay ($40.75 in chips)
Seat 5: illoke ($63.29 in chips)
Seat 6: dellindi ($55.03 in chips)
CertifiedG: posts small blind $0.25
IlxxxlI: posts big blind $0.50
*** HOLE CARDS ***
Dealt to IlxxxlI [8d 5d]
Karas321: folds
Xiniay: folds
illoke: raises $1 to $1.50
dellindi: folds
CertifiedG: folds
IlxxxlI: calls $1
*** FLOP *** [Tc 6c As]
IlxxxlI: checks
illoke: checks
*** TURN *** [Tc 6c As] [5c]
IlxxxlI: checks
illoke: checks
*** RIVER *** [Tc 6c As 5c] [2h]
IlxxxlI: checks
illoke: checks
*** SHOW DOWN ***
IlxxxlI: mucks hand
illoke: shows [Qd Qs] (One pair of Qs)
illoke collected $3.09 from pot
*** SUMMARY ***
Total pot $3.25 | Rake $0.16
Board [Tc 6c As 5c 2h]
Seat 1: CertifiedG (small blind) folded before Flop
Seat 2: IlxxxlI (big blind) mucked
Seat 3: Karas321 folded before Flop (didn't bet)
Seat 4: Xiniay folded before Flop (didn't bet)
Seat 5: illoke showed [Qd Qs] and won ($3.09) with One pair of Qs
Seat 6: dellindi (button) folded before Flop (didn't bet)

PokerStars Hand #771314202: Hold'em No Limit ($0.25/$0.50 USD) - 2016/11/09 19:22:57 ET
Table 'WPN_3421571163' 6-max  Seat #3 is the button
Seat 1: IlxxxlI ($20.38 in chips)
Seat 2: ls5ndr ($51.14 in chips)
Seat 3: Xiniay ($46.16 in chips)
Seat 4: saidafrente ($53.52 in chips)
Seat 5: Kryuk13 ($56.36 in chips)
Seat 6: v0landito ($96.05 in chips)
saidafrente: posts small blind $0.25
Kryuk13: posts big blind $0.50
*** HOLE CARDS ***
Dealt to IlxxxlI [2s Ad]
v0landito: raises $1 to $1.50
IlxxxlI: folds
ls5ndr: calls $1.50
Xiniay: folds
saidafrente: folds
Kryuk13: folds
*** FLOP *** [3d 3h 9d]
v0landito: bets $1.79
ls5ndr: folds
Uncalled bet ($1.79) returned to v0landito
v0landito: doesn't show hand
v0landito collected $3.57 from pot
*** SUMMARY ***
Total pot $3.75 | Rake $0.18
Board [3d 3h 9d]
Seat 1: IlxxxlI folded before Flop (didn't bet)
Seat 2: ls5ndr folded on the Flop
Seat 3: Xiniay (button) folded before Flop (didn't bet)
Seat 4: saidafrente (small blind) folded before Flop
Seat 5: Kryuk13 (big blind) folded before Flop
Seat 6: v0landito collected ($3.57)

PokerStars Hand #771314191: Hold'em No Limit ($0.25/$0.50 USD) - 2016/11/09 19:22:56 ET
Table 'WPN_1341348958' 6-max  Seat #4 is the button
Seat 1: Dikmann ($27.36 in chips)
Seat 2: v0landito ($30.87 in chips)
Seat 3: IlxxxlI ($25.04 in chips)
Seat 4: Xiniay ($22.63 in chips)
Seat 6: Karas321 ($19.81 in chips)
Karas321: posts small blind $0.25
Dikmann: posts big blind $0.50
*** HOLE CARDS ***
Dealt to IlxxxlI [Ah Th]
v0landito: raises $1 to $1.50
IlxxxlI: raises $1 to $2.50
Xiniay: folds
Karas321: folds
Dikmann: folds
v0landito: calls $1
*** FLOP *** [2c 7c 3c]
v0landito: checks
IlxxxlI: bets $2.73
v0landito: folds
Uncalled bet ($2.73) returned to IlxxxlI
IlxxxlI: doesn't show hand
IlxxxlI collected $5.47 from pot
*** SUMMARY ***
Total pot $5.75 | Rake $0.28
Board [2c 7c 3c]
Seat 1: Dikmann (big blind) folded before Flop
Seat 2: v0landito folded on the Flop
Seat 3: IlxxxlI collected ($5.47)
Seat 4: Xiniay (button) folded before Flop (didn't bet)
Seat 6: Karas321 (small blind) folded before Flop

PokerStars Hand #771314164: Hold'em No Limit ($0.25/$0.50 USD) - 2016/11/09 19:22:54 ET
Table 'WPN_2355604438' 6-max  Seat #5 is the button
Seat 1: CertifiedG ($51.50 in chips)
Seat 2: IlxxxlI ($20.00 in chips)
Seat 3: Karas321 ($21.00 in chips)
Seat 4: Xiniay ($40.75 in chips)
Seat 5: illoke ($63.29 in chips)
Seat 6: dellindi ($54.53 in chips)
dellindi: posts small blind $0.25
CertifiedG: posts big blind $0.50
*** HOLE CARDS ***
Dealt to IlxxxlI [Kh 7s]
IlxxxlI: folds
Karas321: folds
Xiniay: folds
illoke: folds
dellindi: raises $1 to $1.50
CertifiedG: folds
Uncalled bet ($1.00) returned to dellindi
dellindi: doesn't show hand
dellindi collected $1 from pot
*** SUMMARY ***
Total pot $1 | Rake $0
Seat 1: CertifiedG (big blind) folded before Flop
Seat 2: IlxxxlI folded before Flop (didn't bet)
Seat 3: Karas321 folded before Flop (didn't bet)
Seat 4: Xiniay folded before Flop (didn't bet)
Seat 5: illoke (button) folded before Flop (didn't bet)
Seat 6: dellindi (small blind) collected ($1)

PokerStars Hand #771314151: Hold'em No Limit ($0.25/$0.50 USD) - 2016/11/09 19:22:51 ET
Table 'WPN_3219946394' 6-max  Seat #3 is the button
Seat 2: IlxxxlI ($21.48 in chips)
Seat 3: v0landito ($69.22 in chips)
Seat 4: ls5ndr ($50.25 in chips)
Seat 5: Xiniay ($73.48 in chips)
Seat 6: 38979 ($74.79 in chips)
ls5ndr: posts small blind $0.25
Xiniay: posts big blind $0.50
*** HOLE CARDS ***
Dealt to IlxxxlI [3s Qd]
38979: folds
IlxxxlI: folds
v0landito: folds
ls5ndr: folds
Uncalled bet ($0.25) returned to Xiniay
Xiniay: doesn't show hand
Xiniay collected $0.50 from pot
*** SUMMARY ***
Total pot $0.50 | Rake $0
Seat 2: IlxxxlI folded before Flop (didn't bet)
Seat 3: v0landito (button) folded before Flop (didn't bet)
Seat 4: ls5ndr (small blind) folded before Flop
Seat 5: Xiniay (big blind) collected ($0.50)
Seat 6: 38979 folded before Flop (didn't bet)

PokerStars Hand #771314147: Hold'em No Limit ($0.50/$1.00 USD) - 2016/11/09 19:22:50 ET
Table 'WPN_2128003642' 6-max  Seat #3 is the button
Seat 1: v0landito ($281.29 in chips)
Seat 2: IlxxxlI ($40.00 in chips)
Seat 3: dellindi ($128.97 in chips)
Seat 4: illoke ($120.64 in chips)
Seat 5: 38979 ($173.35 in chips)
Seat 6: gust ($41.50 in chips)
illoke: posts small blind $0.50
38979: posts big blind $1
*** HOLE CARDS ***
Dealt to IlxxxlI [Jd 8d]
gust: folds
v0landito: folds
IlxxxlI: raises $1.40 to $2.40
dellindi: calls $2.40
illoke: folds
38979: folds
*** FLOP *** [8c 6d 7h]
IlxxxlI: checks
dellindi: bets $3.99
IlxxxlI: calls $3.99
*** TURN *** [8c 6d 7h] [9d]
IlxxxlI: checks
dellindi: bets $15
IlxxxlI: folds
Uncalled bet ($15.00) returned to dellindi
dellindi: doesn't show hand
dellindi collected $13.57 from pot
*** SUMMARY ***
Total pot $14.28 | Rake $0.71
Board [8c 6d 7h 9d]
Seat 1: v0landito folded before Flop (didn't bet)
Seat 2: IlxxxlI folded on the Turn
Seat 3: dellindi (button) collected ($13.57)
Seat 4: illoke (small blind) folded before Flop
Seat 5: 38979 (big blind) folded before Flop
Seat 6: gust folded before Flop (didn't bet)

PokerStars Hand #771313979: Hold'em No Limit ($0.25/$0.50 USD) - 2016/11/09 19:22:27 ET
Table 'WPN_2355604438' 6-max  Seat #4 is the button
Seat 1: CertifiedG ($50.75 in chips)
Seat 2: IlxxxlI ($20.00 in chips)
Seat 3: Karas321 ($21.00 in chips)
Seat 4: Xiniay ($40.75 in chips)
Seat 5: illoke ($63.54 in chips)
Seat 6: dellindi ($55.03 in chips)
illoke: posts small blind $0.25
dellindi: posts big blind $0.50
*** HOLE CARDS ***
Dealt to IlxxxlI [Tc 5h]
CertifiedG: raises $0.75 to $1.25
IlxxxlI: folds
Karas321: folds
Xiniay: folds
illoke: folds
dellindi: folds
Uncalled bet ($0.75) returned to CertifiedG
CertifiedG: doesn't show hand
CertifiedG collected $1.25 from pot
*** SUMMARY ***
Total pot $1.25 | Rake $0
Seat 1: CertifiedG collected ($1.25)
Seat 2: IlxxxlI folded before Flop (didn't bet)
Seat 3: Karas321 folded before Flop (didn't bet)
Seat 4: Xiniay (button) folded before Flop (didn't bet)
Seat 5: illoke (small blind) folded before Flop
Seat 6: dellindi (big blind) folded before Flop

PokerStars Hand #771313974: Hold'em No Limit ($0.25/$0.50 USD) - 2016/11/09 19:22:26 ET
Table 'WPN_3219946394' 6-max  Seat #2 is the button
Seat 2: IlxxxlI ($21.48 in chips)
Seat 3: v0landito ($69.47 in chips)
Seat 4: ls5ndr ($50.00 in chips)
Seat 5: Xiniay ($73.48 in chips)
Seat 6: 38979 ($74.79 in chips)
v0landito: posts small blind $0.25
ls5ndr: posts big blind $0.50
*** HOLE CARDS ***
Dealt to IlxxxlI [7c Jd]
Xiniay: folds
38979: folds
IlxxxlI: folds
v0landito: folds
Uncalled bet ($0.25) returned to ls5ndr
ls5ndr: doesn't show hand
ls5ndr collected $0.50 from pot
*** SUMMARY ***
Total pot $0.50 | Rake $0
Seat 2: IlxxxlI (button) folded before Flop (didn't bet)
Seat 3: v0landito (small blind) folded before Flop
Seat 4: ls5ndr (big blind) collected ($0.50)
Seat 5: Xiniay folded before Flop (didn't bet)
Seat 6: 38979 folded before Flop (didn't bet)

PokerStars Hand #771313955: Hold'em No Limit ($0.25/$0.50 USD) - 2016/11/09 19:22:24 ET
Table 'WPN_1341348958' 6-max  Seat #3 is the button
Seat 1: Dikmann ($27.36 in chips)
Seat 2: v0landito ($30.87 in chips)
Seat 3: IlxxxlI ($24.29 in chips)
Seat 4: Xiniay ($22.88 in chips)
Seat 6: Karas321 ($20.31 in chips)
Xiniay: posts small blind $0.25
Karas321: posts big blind $0.50
*** HOLE CARDS ***
Dealt to IlxxxlI [Ts Qs]
Dikmann: folds
v0landito: folds
IlxxxlI: raises $1 to $1.50
Xiniay: folds
Karas321: folds
Uncalled bet ($1.00) returned to IlxxxlI
IlxxxlI: doesn't show hand
IlxxxlI collected $1.25 from pot
*** SUMMARY ***
Total pot $1.25 | Rake $0
Seat 1: Dikmann folded before Flop (didn't bet)
Seat 2: v0landito folded before Flop (didn't bet)
Seat 3: IlxxxlI (button) collected ($1.25)
Seat 4: Xiniay (small blind) folded before Flop
Seat 6: Karas321 (big blind) folded before Flop

PokerStars Hand #771313835: Hold'em No Limit ($0.25/$0.50 USD) - 2016/11/09 19:22:06 ET
Table 'WPN_3421571163' 6-max  Seat #2 is the button
Seat 1: IlxxxlI ($20.38 in chips)
Seat 2: ls5ndr ($50.00 in chips)
Seat 3: Xiniay ($46.41 in chips)
Seat 4: saidafrente ($54.52 in chips)
Seat 6: v0landito ($96.05 in chips)
Xiniay: posts small blind $0.25
saidafrente: posts big blind $0.50
*** HOLE CARDS ***
Dealt to IlxxxlI [Qc 4h]
v0landito: folds
IlxxxlI: folds
ls5ndr: raises $0.50 to $1
Xiniay: folds
saidafrente: calls $0.50
*** FLOP *** [5c Jc Kh]
saidafrente: checks
ls5ndr: bets $1.50
saidafrente: folds
Uncalled bet ($1.50) returned to ls5ndr
ls5ndr: doesn't show hand
ls5ndr collected $2.14 from pot
*** SUMMARY ***
Total pot $2.25 | Rake $0.11
Board [5c Jc Kh]
Seat 1: IlxxxlI folded before Flop (didn't bet)
Seat 2: ls5ndr (button) collected ($2.14)
Seat 3: Xiniay (small blind) folded before Flop
Seat 4: saidafrente (big blind) folded on the Flop
Seat 6: v0landito folded before Flop (didn't bet)

PokerStars Hand #771313802: Hold'em No Limit ($0.25/$0.50 USD) - 2016/11/09 19:22:02 ET
Table 'WPN_2355604438' 6-max  Seat #3 is the button
Seat 1: CertifiedG ($50.75 in chips)
Seat 2: IlxxxlI ($20.00 in chips)
Seat 3: Karas321 ($21.00 in chips)
Seat 4: Xiniay ($41.00 in chips)
Seat 5: illoke ($63.29 in chips)
Seat 6: dellindi ($55.03 in chips)
Xiniay: posts small blind $0.25
illoke: posts big blind $0.50
*** HOLE CARDS ***
Dealt to IlxxxlI [Ks 6d]
dellindi: folds
CertifiedG: folds
IlxxxlI: folds
Karas321: folds
Xiniay: folds
Uncalled bet ($0.25) returned to illoke
illoke: doesn't show hand
illoke collected $0.50 from pot
*** SUMMARY ***
Total pot $0.50 | Rake $0
Seat 1: CertifiedG folded before Flop (didn't bet)
Seat 2: IlxxxlI folded before Flop (didn't bet)
Seat 3: Karas321 (button) folded before Flop (didn't bet)
Seat 4: Xiniay (small blind) folded before Flop
Seat 5: illoke (big blind) collected ($0.50)
Seat 6: dellindi folded before Flop (didn't bet)

PokerStars Hand #771313637: Hold'em No Limit ($0.25/$0.50 USD) - 2016/11/09 19:21:37 ET
Table 'WPN_3421571163' 6-max  Seat #1 is the button
Seat 1: IlxxxlI ($20.38 in chips)
Seat 2: ls5ndr ($50.00 in chips)
Seat 3: Xiniay ($46.16 in chips)
Seat 4: saidafrente ($54.52 in chips)
Seat 6: v0landito ($96.05 in chips)
ls5ndr: posts small blind $0.25
Xiniay: posts big blind $0.50
*** HOLE CARDS ***
Dealt to IlxxxlI [5h 7s]
saidafrente: folds
v0landito: folds
IlxxxlI: folds
ls5ndr: folds
Uncalled bet ($0.25) returned to Xiniay
Xiniay: doesn't show hand
Xiniay collected $0.50 from pot
*** SUMMARY ***
Total pot $0.50 | Rake $0
Seat 1: IlxxxlI (button) folded before Flop (didn't bet)
Seat 2: ls5ndr (small blind) folded before Flop
Seat 3: Xiniay (big blind) collected ($0.50)
Seat 4: saidafrente folded before Flop (didn't bet)
Seat 6: v0landito folded before Flop (didn't bet)

PokerStars Hand #771313565: Hold'em No Limit ($0.25/$0.50 USD) - 2016/11/09 19:21:27 ET
Table 'WPN_2355604438' 6-max  Seat #2 is the button
Seat 1: CertifiedG ($50.00 in chips)
Seat 2: IlxxxlI ($20.00 in chips)
Seat 3: Karas321 ($21.25 in chips)
Seat 4: Xiniay ($41.50 in chips)
Seat 5: illoke ($63.29 in chips)
Seat 6: dellindi ($55.03 in chips)
Karas321: posts small blind $0.25
Xiniay: posts big blind $0.50
*** HOLE CARDS ***
Dealt to IlxxxlI [2d 5c]
illoke: folds
dellindi: folds
CertifiedG: raises $0.75 to $1.25
IlxxxlI: folds
Karas321: folds
Xiniay: folds
Uncalled bet ($0.75) returned to CertifiedG
CertifiedG: doesn't show hand
CertifiedG collected $1.25 from pot
*** SUMMARY ***
Total pot $1.25 | Rake $0
Seat 1: CertifiedG collected ($1.25)
Seat 2: IlxxxlI (button) folded before Flop (didn't bet)
Seat 3: Karas321 (small blind) folded before Flop
Seat 4: Xiniay (big blind) folded before Flop
Seat 5: illoke folded before Flop (didn't bet)
Seat 6: dellindi folded before Flop (didn't bet)

PokerStars Hand #771313570: Hold'em No Limit ($0.25/$0.50 USD) - 2016/11/09 19:21:27 ET
Table 'WPN_1341348958' 6-max  Seat #2 is the button
Seat 1: Dikmann ($25.27 in chips)
Seat 2: v0landito ($30.87 in chips)
Seat 3: IlxxxlI ($24.54 in chips)
Seat 4: Xiniay ($23.88 in chips)
Seat 6: Karas321 ($21.31 in chips)
IlxxxlI: posts small blind $0.25
Xiniay: posts big blind $0.50
*** HOLE CARDS ***
Dealt to IlxxxlI [As 2c]
Karas321: raises $0.50 to $1
Dikmann: calls $1
v0landito: folds
IlxxxlI: folds
Xiniay: calls $0.50
*** FLOP *** [3s 2h 8h]
Xiniay: checks
Karas321: checks
Dikmann: bets $1.54
Xiniay: folds
Karas321: folds
Uncalled bet ($1.54) returned to Dikmann
Dikmann: doesn't show hand
Dikmann collected $3.09 from pot
*** SUMMARY ***
Total pot $3.25 | Rake $0.16
Board [3s 2h 8h]
Seat 1: Dikmann collected ($3.09)
Seat 2: v0landito (button) folded before Flop (didn't bet)
Seat 3: IlxxxlI (small blind) folded before Flop
Seat 4: Xiniay (big blind) folded on the Flop
Seat 6: Karas321 folded on the Flop

PokerStars Hand #771313435: Hold'em No Limit ($0.25/$0.50 USD) - 2016/11/09 19:21:08 ET
Table 'WPN_3421571163' 6-max  Seat #6 is the button
Seat 1: IlxxxlI ($20.63 in chips)
Seat 2: ls5ndr ($50.00 in chips)
Seat 3: Xiniay ($45.41 in chips)
Seat 4: saidafrente ($54.52 in chips)
Seat 6: v0landito ($96.05 in chips)
IlxxxlI: posts small blind $0.25
ls5ndr: posts big blind $0.50
*** HOLE CARDS ***
Dealt to IlxxxlI [7h Ac]
Xiniay: raises $1 to $1.50
saidafrente: folds
v0landito: folds
IlxxxlI: folds
ls5ndr: folds
Uncalled bet ($1.00) returned to Xiniay
Xiniay: doesn't show hand
Xiniay collected $1.25 from pot
*** SUMMARY ***
Total pot $1.25 | Rake $0
Seat 1: IlxxxlI (small blind) folded before Flop
Seat 2: ls5ndr (big blind) folded before Flop
Seat 3: Xiniay collected ($1.25)
Seat 4: saidafrente folded before Flop (didn't bet)
Seat 6: v0landito (button) folded before Flop (didn't bet)

PokerStars Hand #771313361: Hold'em No Limit ($0.50/$1.00 USD) - 2016/11/09 19:20:58 ET
Table 'WPN_2128003642' 6-max  Seat #2 is the button
Seat 1: v0landito ($281.29 in chips)
Seat 2: IlxxxlI ($40.00 in chips)
Seat 3: dellindi ($145.30 in chips)
Seat 4: illoke ($105.94 in chips)
Seat 5: 38979 ($173.35 in chips)
Seat 6: gust ($41.50 in chips)
dellindi: posts small blind $0.50
illoke: posts big blind $1
*** HOLE CARDS ***
Dealt to IlxxxlI [5s 8s]
38979: folds
gust: folds
v0landito: folds
IlxxxlI: folds
dellindi: raises $2 to $3
illoke: calls $2
*** FLOP *** [Jh 9d Jc]
dellindi: checks
illoke: checks
*** TURN *** [Jh 9d Jc] [8c]
dellindi: bets $2.85
illoke: raises $4.15 to $7
dellindi: calls $4.15
*** RIVER *** [Jh 9d Jc 8c] [Ah]
dellindi: checks
illoke: bets $6.33
dellindi: calls $6.33
*** SHOW DOWN ***
dellindi: mucks hand
illoke: shows [2s Js] (Three Of Kind of Js)
illoke collected $31.03 from pot
*** SUMMARY ***
Total pot $32.66 | Rake $1.63
Board [Jh 9d Jc 8c Ah]
Seat 1: v0landito folded before Flop (didn't bet)
Seat 2: IlxxxlI (button) folded before Flop (didn't bet)
Seat 3: dellindi (small blind) mucked
Seat 4: illoke (big blind) showed [2s Js] and won ($31.03) with Three Of Kind of Js
Seat 5: 38979 folded before Flop (didn't bet)
Seat 6: gust folded before Flop (didn't bet)

PokerStars Hand #771313333: Hold'em No Limit ($0.25/$0.50 USD) - 2016/11/09 19:20:55 ET
Table 'WPN_2355604438' 6-max  Seat #1 is the button
Seat 1: CertifiedG ($50.00 in chips)
Seat 2: IlxxxlI ($20.25 in chips)
Seat 3: Karas321 ($20.00 in chips)
Seat 4: Xiniay ($41.50 in chips)
Seat 5: illoke ($63.29 in chips)
Seat 6: dellindi ($55.03 in chips)
IlxxxlI: posts small blind $0.25
Karas321: posts big blind $0.50
*** HOLE CARDS ***
Dealt to IlxxxlI [3h 7d]
Xiniay: folds
illoke: folds
dellindi: folds
CertifiedG: raises $0.62 to $1.12
IlxxxlI: folds
Karas321: calls $0.62
*** FLOP *** [4h 7c 5c]
Karas321: bets $1.58
CertifiedG: folds
Uncalled bet ($1.58) returned to Karas321
Karas321: doesn't show hand
Karas321 collected $2.37 from pot
*** SUMMARY ***
Total pot $2.49 | Rake $0.12
Board [4h 7c 5c]
Seat 1: CertifiedG (button) folded on the Flop
Seat 2: IlxxxlI (small blind) folded before Flop
Seat 3: Karas321 (big blind) collected ($2.37)
Seat 4: Xiniay folded before Flop (didn't bet)
Seat 5: illoke folded before Flop (didn't bet)
Seat 6: dellindi folded before Flop (didn't bet)

PokerStars Hand #771313217: Hold'em No Limit ($0.25/$0.50 USD) - 2016/11/09 19:20:39 ET
Table 'WPN_3219946394' 6-max  Seat #6 is the button
Seat 2: IlxxxlI ($21.73 in chips)
Seat 3: v0landito ($53.03 in chips)
Seat 4: ls5ndr ($50.00 in chips)
Seat 5: Xiniay ($73.48 in chips)
Seat 6: 38979 ($92.79 in chips)
IlxxxlI: posts small blind $0.25
v0landito: posts big blind $0.50
*** HOLE CARDS ***
Dealt to IlxxxlI [4d Kd]
ls5ndr: folds
Xiniay: folds
38979: raises $1 to $1.50
IlxxxlI: folds
v0landito: raises $4.50 to $6
38979: calls $4.50
*** FLOP *** [9h 8h 5d]
v0landito: bets $3.88
38979: raises $8.12 to $12
v0landito: calls $8.12
*** TURN *** [9h 8h 5d] [4s]
v0landito: bets $35.03 and is all-in
38979: folds
Uncalled bet ($35.03) returned to v0landito
v0landito: doesn't show hand
v0landito collected $34.44 from pot
*** SUMMARY ***
Total pot $36.25 | Rake $1.81
Board [9h 8h 5d 4s]
Seat 2: IlxxxlI (small blind) folded before Flop
Seat 3: v0landito (big blind) collected ($34.44)
Seat 4: ls5ndr folded before Flop (didn't bet)
Seat 5: Xiniay folded before Flop (didn't bet)
Seat 6: 38979 (button) folded on the Turn

PokerStars Hand #771313189: Hold'em No Limit ($0.25/$0.50 USD) - 2016/11/09 19:20:34 ET
Table 'WPN_2355604438' 6-max  Seat #6 is the button
Seat 1: CertifiedG ($50.00 in chips)
Seat 2: IlxxxlI ($20.00 in chips)
Seat 3: Karas321 ($20.00 in chips)
Seat 4: Xiniay ($41.50 in chips)
Seat 5: illoke ($63.29 in chips)
Seat 6: dellindi ($55.03 in chips)
CertifiedG: posts small blind $0.25
IlxxxlI: posts big blind $0.50
*** HOLE CARDS ***
Dealt to IlxxxlI [2d 5h]
Karas321: folds
Xiniay: folds
illoke: folds
dellindi: folds
CertifiedG: folds
Uncalled bet ($0.25) returned to IlxxxlI
IlxxxlI: doesn't show hand
IlxxxlI collected $0.50 from pot
*** SUMMARY ***
Total pot $0.50 | Rake $0
Seat 1: CertifiedG (small blind) folded before Flop
Seat 2: IlxxxlI (big blind) collected ($0.50)
Seat 3: Karas321 folded before Flop (didn't bet)
Seat 4: Xiniay folded before Flop (didn't bet)
Seat 5: illoke folded before Flop (didn't bet)
Seat 6: dellindi (button) folded before Flop (didn't bet)

PokerStars Hand #771313184: Hold'em No Limit ($0.25/$0.50 USD) - 2016/11/09 19:20:33 ET
Table 'WPN_1341348958' 6-max  Seat #1 is the button
Seat 1: Dikmann ($25.27 in chips)
Seat 2: v0landito ($31.12 in chips)
Seat 3: IlxxxlI ($22.02 in chips)
Seat 4: Xiniay ($26.41 in chips)
Seat 6: Karas321 ($21.31 in chips)
v0landito: posts small blind $0.25
IlxxxlI: posts big blind $0.50
*** HOLE CARDS ***
Dealt to IlxxxlI [Ad 7d]
Xiniay: raises $1 to $1.50
Karas321: folds
Dikmann: folds
v0landito: folds
IlxxxlI: calls $1
*** FLOP *** [Ac 2s 4s]
IlxxxlI: checks
Xiniay: bets $1.03
IlxxxlI: calls $1.03
*** TURN *** [Ac 2s 4s] [Td]
IlxxxlI: checks
Xiniay: checks
*** RIVER *** [Ac 2s 4s Td] [3c]
IlxxxlI: bets $1.16
Xiniay: folds
Uncalled bet ($1.16) returned to IlxxxlI
IlxxxlI: doesn't show hand
IlxxxlI collected $5.05 from pot
*** SUMMARY ***
Total pot $5.31 | Rake $0.26
Board [Ac 2s 4s Td 3c]
Seat 1: Dikmann (button) folded before Flop (didn't bet)
Seat 2: v0landito (small blind) folded before Flop
Seat 3: IlxxxlI (big blind) collected ($5.05)
Seat 4: Xiniay folded on the River
Seat 6: Karas321 folded before Flop (didn't bet)

PokerStars Hand #771313162: Hold'em No Limit ($0.50/$1.00 USD) - 2016/11/09 19:20:31 ET
Table 'WPN_2128003642' 6-max  Seat #1 is the button
Seat 1: v0landito ($281.29 in chips)
Seat 2: IlxxxlI ($40.00 in chips)
Seat 3: dellindi ($144.80 in chips)
Seat 4: illoke ($105.94 in chips)
Seat 5: 38979 ($173.35 in chips)
Seat 6: gust ($41.50 in chips)
IlxxxlI: posts small blind $0.50
dellindi: posts big blind $1
*** HOLE CARDS ***
Dealt to IlxxxlI [2d Jc]
illoke: folds
38979: folds
gust: folds
v0landito: folds
IlxxxlI: folds
Uncalled bet ($0.50) returned to dellindi
dellindi: doesn't show hand
dellindi collected $1 from pot
*** SUMMARY ***
Total pot $1 | Rake $0
Seat 1: v0landito (button) folded before Flop (didn't bet)
Seat 2: IlxxxlI (small blind) folded before Flop
Seat 3: dellindi (big blind) collected ($1)
Seat 4: illoke folded before Flop (didn't bet)
Seat 5: 38979 folded before Flop (didn't bet)
Seat 6: gust folded before Flop (didn't bet)

PokerStars Hand #771313034: Hold'em No Limit ($0.25/$0.50 USD) - 2016/11/09 19:20:11 ET
Table 'WPN_2355604438' 6-max  Seat #5 is the button
Seat 1: CertifiedG ($50.00 in chips)
Seat 2: IlxxxlI ($20.00 in chips)
Seat 3: Karas321 ($20.00 in chips)
Seat 4: Xiniay ($41.50 in chips)
Seat 5: illoke ($63.29 in chips)
Seat 6: dellindi ($54.53 in chips)
dellindi: posts small blind $0.25
CertifiedG: posts big blind $0.50
*** HOLE CARDS ***
Dealt to IlxxxlI [3s Ac]
IlxxxlI: folds
Karas321: folds
Xiniay: folds
illoke: folds
dellindi: raises $1 to $1.50
CertifiedG: folds
Uncalled bet ($1.00) returned to dellindi
dellindi: doesn't show hand
dellindi collected $1 from pot
*** SUMMARY ***
Total pot $1 | Rake $0
Seat 1: CertifiedG (big blind) folded before Flop
Seat 2: IlxxxlI folded before Flop (didn't bet)
Seat 3: Karas321 folded before Flop (didn't bet)
Seat 4: Xiniay folded before Flop (didn't bet)
Seat 5: illoke (button) folded before Flop (didn't bet)
Seat 6: dellindi (small blind) collected ($1)

PokerStars Hand #771313009: Hold'em No Limit ($0.25/$0.50 USD) - 2016/11/09 19:20:07 ET
Table 'WPN_3219946394' 6-max  Seat #5 is the button
Seat 2: IlxxxlI ($21.48 in chips)
Seat 3: v0landito ($53.03 in chips)
Seat 4: ls5ndr ($50.00 in chips)
Seat 5: Xiniay ($73.48 in chips)
Seat 6: 38979 ($93.04 in chips)
38979: posts small blind $0.25
IlxxxlI: posts big blind $0.50
*** HOLE CARDS ***
Dealt to IlxxxlI [Qd Ts]
v0landito: folds
ls5ndr: folds
Xiniay: folds
38979: folds
Uncalled bet ($0.25) returned to IlxxxlI
IlxxxlI: doesn't show hand
IlxxxlI collected $0.50 from pot
*** SUMMARY ***
Total pot $0.50 | Rake $0
Seat 2: IlxxxlI collected ($0.50)
Seat 3: v0landito folded before Flop (didn't bet)
Seat 4: ls5ndr folded before Flop (didn't bet)
Seat 5: Xiniay (button) folded before Flop (didn't bet)
Seat 6: 38979 (small blind) folded before Flop

PokerStars Hand #771312965: Hold'em No Limit ($0.25/$0.50 USD) - 2016/11/09 19:20:00 ET
Table 'WPN_2355604438' 6-max  Seat #4 is the button
Seat 2: IlxxxlI ($20.00 in chips)
Seat 3: Karas321 ($20.00 in chips)
Seat 4: Xiniay ($41.50 in chips)
Seat 5: illoke ($63.54 in chips)
Seat 6: dellindi ($54.28 in chips)
illoke: posts small blind $0.25
dellindi: posts big blind $0.50
*** HOLE CARDS ***
Dealt to IlxxxlI [4s Kd]
IlxxxlI: folds
Karas321: folds
Xiniay: folds
illoke: folds
Uncalled bet ($0.25) returned to dellindi
dellindi: doesn't show hand
dellindi collected $0.50 from pot
*** SUMMARY ***
Total pot $0.50 | Rake $0
Seat 2: IlxxxlI folded before Flop (didn't bet)
Seat 3: Karas321 folded before Flop (didn't bet)
Seat 4: Xiniay (button) folded before Flop (didn't bet)
Seat 5: illoke (small blind) folded before Flop
Seat 6: dellindi (big blind) collected ($0.50)

PokerStars Hand #771312878: Hold'em No Limit ($0.50/$1.00 USD) - 2016/11/09 19:19:49 ET
Table 'WPN_2128003642' 6-max  Seat #6 is the button
Seat 1: v0landito ($281.79 in chips)
Seat 2: IlxxxlI ($40.00 in chips)
Seat 3: dellindi ($144.80 in chips)
Seat 4: illoke ($105.94 in chips)
Seat 5: 38979 ($173.35 in chips)
Seat 6: gust ($40.00 in chips)
v0landito: posts small blind $0.50
IlxxxlI: posts big blind $1
*** HOLE CARDS ***
Dealt to IlxxxlI [5h 4c]
dellindi: folds
illoke: folds
38979: folds
gust: raises $1 to $2
v0landito: folds
IlxxxlI: folds
Uncalled bet ($1.00) returned to gust
gust: doesn't show hand
gust collected $2.50 from pot
*** SUMMARY ***
Total pot $2.50 | Rake $0
Seat 1: v0landito (small blind) folded before Flop
Seat 2: IlxxxlI (big blind) folded before Flop
Seat 3: dellindi folded before Flop (didn't bet)
Seat 4: illoke folded before Flop (didn't bet)
Seat 5: 38979 folded before Flop (didn't bet)
Seat 6: gust (button) collected ($2.50)

PokerStars Hand #771312854: Hold'em No Limit ($0.25/$0.50 USD) - 2016/11/09 19:19:45 ET
Table 'WPN_1341348958' 6-max  Seat #6 is the button
Seat 1: Dikmann ($23.44 in chips)
Seat 2: v0landito ($31.62 in chips)
Seat 3: IlxxxlI ($22.02 in chips)
Seat 4: Xiniay ($27.91 in chips)
Seat 6: Karas321 ($21.31 in chips)
Dikmann: posts small blind $0.25
v0landito: posts big blind $0.50
*** HOLE CARDS ***
Dealt to IlxxxlI [4s 4h]
IlxxxlI: folds
Xiniay: raises $1 to $1.50
Karas321: folds
Dikmann: calls $1.25
v0landito: folds
*** FLOP *** [Jh 7h 8h]
Dikmann: bets $0.50
Xiniay: folds
Uncalled bet ($0.50) returned to Dikmann
Dikmann: doesn't show hand
Dikmann collected $3.33 from pot
*** SUMMARY ***
Total pot $3.50 | Rake $0.17
Board [Jh 7h 8h]
Seat 1: Dikmann (small blind) collected ($3.33)
Seat 2: v0landito (big blind) folded before Flop
Seat 3: IlxxxlI folded before Flop (didn't bet)
Seat 4: Xiniay folded on the Flop
Seat 6: Karas321 (button) folded before Flop (didn't bet)

PokerStars Hand #771312767: Hold'em No Limit ($0.25/$0.50 USD) - 2016/11/09 19:19:30 ET
Table 'WPN_2355604438' 6-max  Seat #3 is the button
Seat 2: IlxxxlI ($20.00 in chips)
Seat 3: Karas321 ($20.00 in chips)
Seat 4: Xiniay ($41.75 in chips)
Seat 5: illoke ($64.04 in chips)
Seat 6: dellindi ($53.53 in chips)
Xiniay: posts small blind $0.25
illoke: posts big blind $0.50
*** HOLE CARDS ***
Dealt to IlxxxlI [Kh 7s]
dellindi: raises $1 to $1.50
IlxxxlI: folds
Karas321: folds
Xiniay: folds
illoke: folds
Uncalled bet ($1.00) returned to dellindi
dellindi: doesn't show hand
dellindi collected $1.25 from pot
*** SUMMARY ***
Total pot $1.25 | Rake $0
Seat 2: IlxxxlI folded before Flop (didn't bet)
Seat 3: Karas321 (button) folded before Flop (didn't bet)
Seat 4: Xiniay (small blind) folded before Flop
Seat 5: illoke (big blind) folded before Flop
Seat 6: dellindi collected ($1.25)

PokerStars Hand #771312579: Hold'em No Limit ($0.25/$0.50 USD) - 2016/11/09 19:19:04 ET
Table 'WPN_3219946394' 6-max  Seat #4 is the button
Seat 1: illoke ($63.59 in chips)
Seat 2: IlxxxlI ($23.23 in chips)
Seat 3: v0landito ($53.03 in chips)
Seat 4: ls5ndr ($50.00 in chips)
Seat 5: Xiniay ($73.73 in chips)
Seat 6: 38979 ($91.04 in chips)
Xiniay: posts small blind $0.25
38979: posts big blind $0.50
*** HOLE CARDS ***
Dealt to IlxxxlI [Ts Ac]
illoke: folds
IlxxxlI: raises $1.25 to $1.75
v0landito: folds
ls5ndr: folds
Xiniay: folds
38979: raises $3.25 to $5
IlxxxlI: folds
Uncalled bet ($3.25) returned to 38979
38979: doesn't show hand
38979 collected $3.75 from pot
*** SUMMARY ***
Total pot $3.75 | Rake $0
Seat 1: illoke folded before Flop (didn't bet)
Seat 2: IlxxxlI folded before Flop
Seat 3: v0landito folded before Flop (didn't bet)
Seat 4: ls5ndr (button) folded before Flop (didn't bet)
Seat 5: Xiniay (small blind) folded before Flop
Seat 6: 38979 (big blind) collected ($3.75)

PokerStars Hand #771312561: Hold'em No Limit ($0.25/$0.50 USD) - 2016/11/09 19:19:03 ET
Table 'WPN_3421571163' 6-max  Seat #5 is the button
Seat 1: IlxxxlI ($21.13 in chips)
Seat 3: Xiniay ($45.41 in chips)
Seat 4: saidafrente ($45.08 in chips)
Seat 5: Kryuk13 ($56.36 in chips)
Seat 6: v0landito ($106.01 in chips)
v0landito: posts small blind $0.25
IlxxxlI: posts big blind $0.50
*** HOLE CARDS ***
Dealt to IlxxxlI [4s Qh]
Xiniay: folds
saidafrente: raises $1 to $1.50
Kryuk13: folds
v0landito: raises $4.50 to $6
IlxxxlI: folds
saidafrente: calls $4.50
*** FLOP *** [As 5s 4c]
v0landito: bets $3.96
saidafrente: calls $3.96
*** TURN *** [As 5s 4c] [Kd]
v0landito: checks
saidafrente: checks
*** RIVER *** [As 5s 4c Kd] [7s]
v0landito: checks
saidafrente: checks
*** SHOW DOWN ***
saidafrente: shows [6h Ah] (One pair of As)
v0landito: mucks hand
saidafrente collected $19.40 from pot
*** SUMMARY ***
Total pot $20.42 | Rake $1.02
Board [As 5s 4c Kd 7s]
Seat 1: IlxxxlI (big blind) folded before Flop
Seat 3: Xiniay folded before Flop (didn't bet)
Seat 4: saidafrente showed [6h Ah] and won ($19.40) with One pair of As
Seat 5: Kryuk13 (button) folded before Flop (didn't bet)
Seat 6: v0landito (small blind) mucked

PokerStars Hand #771312424: Hold'em No Limit ($0.25/$0.50 USD) - 2016/11/09 19:18:46 ET
Table 'WPN_1341348958' 6-max  Seat #4 is the button
Seat 1: Dikmann ($24.94 in chips)
Seat 2: v0landito ($30.03 in chips)
Seat 3: IlxxxlI ($22.02 in chips)
Seat 4: Xiniay ($27.91 in chips)
Seat 6: Karas321 ($21.56 in chips)
Karas321: posts small blind $0.25
Dikmann: posts big blind $0.50
*** HOLE CARDS ***
Dealt to IlxxxlI [4c 9s]
v0landito: raises $1 to $1.50
IlxxxlI: folds
Xiniay: folds
Karas321: folds
Dikmann: calls $1
*** FLOP *** [3d Jh 4s]
Dikmann: checks
v0landito: bets $1.55
Dikmann: folds
Uncalled bet ($1.55) returned to v0landito
v0landito: doesn't show hand
v0landito collected $3.09 from pot
*** SUMMARY ***
Total pot $3.25 | Rake $0.16
Board [3d Jh 4s]
Seat 1: Dikmann (big blind) folded on the Flop
Seat 2: v0landito collected ($3.09)
Seat 3: IlxxxlI folded before Flop (didn't bet)
Seat 4: Xiniay (button) folded before Flop (didn't bet)
Seat 6: Karas321 (small blind) folded before Flop

PokerStars Hand #771312331: Hold'em No Limit ($0.25/$0.50 USD) - 2016/11/09 19:18:31 ET
Table 'WPN_2355604438' 6-max  Seat #2 is the button
Seat 2: IlxxxlI ($20.00 in chips)
Seat 3: Karas321 ($20.00 in chips)
Seat 4: Xiniay ($39.97 in chips)
Seat 5: illoke ($64.04 in chips)
Seat 6: dellindi ($53.53 in chips)
Karas321: posts small blind $0.25
Xiniay: posts big blind $0.50
*** HOLE CARDS ***
Dealt to IlxxxlI [Ks 6s]
illoke: folds
dellindi: folds
IlxxxlI: raises $0.50 to $1
Karas321: folds
Xiniay: calls $0.50
*** FLOP *** [9h 8h 8d]
Xiniay: checks
IlxxxlI: bets $0.71
Xiniay: calls $0.71
*** TURN *** [9h 8h 8d] [Qc]
Xiniay: checks
IlxxxlI: checks
*** RIVER *** [9h 8h 8d Qc] [Qd]
Xiniay: checks
IlxxxlI: checks
*** SHOW DOWN ***
IlxxxlI: mucks hand
Xiniay: shows [Jh Ah] (Two pairs. Qs and 8s)
Xiniay collected $3.49 from pot
*** SUMMARY ***
Total pot $3.67 | Rake $0.18
Board [9h 8h 8d Qc Qd]
Seat 2: IlxxxlI (button) mucked
Seat 3: Karas321 (small blind) folded before Flop
Seat 4: Xiniay (big blind) showed [Jh Ah] and won ($3.49) with Two pairs. Qs and 8s
Seat 5: illoke folded before Flop (didn't bet)
Seat 6: dellindi folded before Flop (didn't bet)

PokerStars Hand #771312261: Hold'em No Limit ($0.25/$0.50 USD) - 2016/11/09 19:18:19 ET
Table 'WPN_3219946394' 6-max  Seat #3 is the button
Seat 1: illoke ($63.59 in chips)
Seat 2: IlxxxlI ($23.23 in chips)
Seat 3: v0landito ($53.03 in chips)
Seat 4: ls5ndr ($50.25 in chips)
Seat 5: Xiniay ($74.23 in chips)
Seat 6: 38979 ($90.29 in chips)
ls5ndr: posts small blind $0.25
Xiniay: posts big blind $0.50
*** HOLE CARDS ***
Dealt to IlxxxlI [3h Ts]
38979: raises $1 to $1.50
illoke: folds
IlxxxlI: folds
v0landito: folds
ls5ndr: folds
Xiniay: folds
Uncalled bet ($1.00) returned to 38979
38979: doesn't show hand
38979 collected $1.25 from pot
*** SUMMARY ***
Total pot $1.25 | Rake $0
Seat 1: illoke folded before Flop (didn't bet)
Seat 2: IlxxxlI folded before Flop (didn't bet)
Seat 3: v0landito (button) folded before Flop (didn't bet)
Seat 4: ls5ndr (small blind) folded before Flop
Seat 5: Xiniay (big blind) folded before Flop
Seat 6: 38979 collected ($1.25)

PokerStars Hand #771312212: Hold'em No Limit ($0.25/$0.50 USD) - 2016/11/09 19:18:12 ET
Table 'WPN_2355604438' 6-max  Seat #6 is the button
Seat 2: IlxxxlI ($20.00 in chips)
Seat 3: Karas321 ($20.00 in chips)
Seat 4: Xiniay ($39.97 in chips)
Seat 5: illoke ($63.29 in chips)
Seat 6: dellindi ($53.53 in chips)
IlxxxlI: posts small blind $0.25
Karas321: posts big blind $0.50
*** HOLE CARDS ***
Dealt to IlxxxlI [Ad 9s]
Xiniay: folds
illoke: raises $1 to $1.50
dellindi: folds
IlxxxlI: folds
Karas321: folds
Uncalled bet ($1.00) returned to illoke
illoke: doesn't show hand
illoke collected $1.25 from pot
*** SUMMARY ***
Total pot $1.25 | Rake $0
Seat 2: IlxxxlI (small blind) folded before Flop
Seat 3: Karas321 (big blind) folded before Flop
Seat 4: Xiniay folded before Flop (didn't bet)
Seat 5: illoke collected ($1.25)
Seat 6: dellindi (button) folded before Flop (didn't bet)

PokerStars Hand #771312160: Hold'em No Limit ($0.50/$1.00 USD) - 2016/11/09 19:18:06 ET
Table 'WPN_2128003642' 6-max  Seat #5 is the button
Seat 1: v0landito ($278.61 in chips)
Seat 2: IlxxxlI ($40.00 in chips)
Seat 3: dellindi ($144.80 in chips)
Seat 4: illoke ($108.94 in chips)
Seat 5: 38979 ($173.35 in chips)
Seat 6: gust ($40.00 in chips)
gust: posts small blind $0.50
v0landito: posts big blind $1
*** HOLE CARDS ***
Dealt to IlxxxlI [8c Ad]
IlxxxlI: folds
dellindi: folds
illoke: raises $2 to $3
38979: folds
gust: folds
v0landito: calls $2
*** FLOP *** [Kh Ks As]
v0landito: checks
illoke: checks
*** TURN *** [Kh Ks As] [7h]
v0landito: checks
illoke: checks
*** RIVER *** [Kh Ks As 7h] [4s]
v0landito: bets $2.06
illoke: folds
Uncalled bet ($2.06) returned to v0landito
v0landito: doesn't show hand
v0landito collected $6.18 from pot
*** SUMMARY ***
Total pot $6.50 | Rake $0.32
Board [Kh Ks As 7h 4s]
Seat 1: v0landito (big blind) collected ($6.18)
Seat 2: IlxxxlI folded before Flop (didn't bet)
Seat 3: dellindi folded before Flop (didn't bet)
Seat 4: illoke folded on the River
Seat 5: 38979 (button) folded before Flop (didn't bet)
Seat 6: gust (small blind) folded before Flop

PokerStars Hand #771311940: Hold'em No Limit ($0.25/$0.50 USD) - 2016/11/09 19:17:34 ET
Table 'WPN_1341348958' 6-max  Seat #3 is the button
Seat 1: Dikmann ($24.25 in chips)
Seat 2: v0landito ($30.03 in chips)
Seat 3: IlxxxlI ($22.02 in chips)
Seat 4: Xiniay ($28.16 in chips)
Seat 5: PULISPATOLA ($29.18 in chips)
Seat 6: Karas321 ($21.56 in chips)
Xiniay: posts small blind $0.25
PULISPATOLA: posts big blind $0.50
*** HOLE CARDS ***
Dealt to IlxxxlI [Qh 4h]
Karas321: folds
Dikmann: calls $0.50
v0landito: folds
IlxxxlI: folds
Xiniay: folds
PULISPATOLA: checks
*** FLOP *** [8d Ks Ah]
PULISPATOLA: checks
Dikmann: bets $0.50
PULISPATOLA: folds
Uncalled bet ($0.50) returned to Dikmann
Dikmann: doesn't show hand
Dikmann collected $1.19 from pot
*** SUMMARY ***
Total pot $1.25 | Rake $0.06
Board [8d Ks Ah]
Seat 1: Dikmann collected ($1.19)
Seat 2: v0landito folded before Flop (didn't bet)
Seat 3: IlxxxlI (button) folded before Flop (didn't bet)
Seat 4: Xiniay (small blind) folded before Flop
Seat 5: PULISPATOLA (big blind) folded on the Flop
Seat 6: Karas321 folded before Flop (didn't bet)

PokerStars Hand #771311929: Hold'em No Limit ($0.25/$0.50 USD) - 2016/11/09 19:17:33 ET
Table 'WPN_3219946394' 6-max  Seat #2 is the button
Seat 1: illoke ($63.59 in chips)
Seat 2: IlxxxlI ($23.23 in chips)
Seat 3: v0landito ($53.28 in chips)
Seat 4: ls5ndr ($50.00 in chips)
Seat 5: Xiniay ($74.23 in chips)
Seat 6: 38979 ($90.29 in chips)
v0landito: posts small blind $0.25
ls5ndr: posts big blind $0.50
*** HOLE CARDS ***
Dealt to IlxxxlI [2c Ad]
Xiniay: folds
38979: folds
illoke: folds
IlxxxlI: folds
v0landito: folds
Uncalled bet ($0.25) returned to ls5ndr
ls5ndr: doesn't show hand
ls5ndr collected $0.50 from pot
*** SUMMARY ***
Total pot $0.50 | Rake $0
Seat 1: illoke folded before Flop (didn't bet)
Seat 2: IlxxxlI (button) folded before Flop (didn't bet)
Seat 3: v0landito (small blind) folded before Flop
Seat 4: ls5ndr (big blind) collected ($0.50)
Seat 5: Xiniay folded before Flop (didn't bet)
Seat 6: 38979 folded before Flop (didn't bet)

PokerStars Hand #771311851: Hold'em No Limit ($0.50/$1.00 USD) - 2016/11/09 19:17:22 ET
Table 'WPN_2128003642' 6-max  Seat #4 is the button
Seat 1: v0landito ($277.11 in chips)
Seat 2: IlxxxlI ($40.00 in chips)
Seat 3: dellindi ($144.80 in chips)
Seat 4: illoke ($108.94 in chips)
Seat 5: 38979 ($173.85 in chips)
Seat 6: gust ($40.00 in chips)
38979: posts small blind $0.50
gust: posts big blind $1
*** HOLE CARDS ***
Dealt to IlxxxlI [9s Ac]
v0landito: raises $2 to $3
IlxxxlI: folds
dellindi: folds
illoke: folds
38979: folds
gust: folds
Uncalled bet ($2.00) returned to v0landito
v0landito: doesn't show hand
v0landito collected $2.50 from pot
*** SUMMARY ***
Total pot $2.50 | Rake $0
Seat 1: v0landito collected ($2.50)
Seat 2: IlxxxlI folded before Flop (didn't bet)
Seat 3: dellindi folded before Flop (didn't bet)
Seat 4: illoke (button) folded before Flop (didn't bet)
Seat 5: 38979 (small blind) folded before Flop
Seat 6: gust (big blind) folded before Flop

PokerStars Hand #771311819: Hold'em No Limit ($0.25/$0.50 USD) - 2016/11/09 19:17:18 ET
Table 'WPN_3219946394' 6-max  Seat #1 is the button
Seat 1: illoke ($63.59 in chips)
Seat 2: IlxxxlI ($23.48 in chips)
Seat 3: v0landito ($53.03 in chips)
Seat 5: Xiniay ($74.23 in chips)
Seat 6: 38979 ($90.29 in chips)
IlxxxlI: posts small blind $0.25
v0landito: posts big blind $0.50
*** HOLE CARDS ***
Dealt to IlxxxlI [2h 9s]
Xiniay: folds
38979: folds
illoke: folds
IlxxxlI: folds
Uncalled bet ($0.25) returned to v0landito
v0landito: doesn't show hand
v0landito collected $0.50 from pot
*** SUMMARY ***
Total pot $0.50 | Rake $0
Seat 1: illoke (button) folded before Flop (didn't bet)
Seat 2: IlxxxlI (small blind) folded before Flop
Seat 3: v0landito (big blind) collected ($0.50)
Seat 5: Xiniay folded before Flop (didn't bet)
Seat 6: 38979 folded before Flop (didn't bet)

PokerStars Hand #771311731: Hold'em No Limit ($0.25/$0.50 USD) - 2016/11/09 19:17:06 ET
Table 'WPN_2355604438' 6-max  Seat #5 is the button
Seat 2: IlxxxlI ($20.00 in chips)
Seat 3: Karas321 ($20.00 in chips)
Seat 4: Xiniay ($39.97 in chips)
Seat 5: illoke ($63.29 in chips)
Seat 6: dellindi ($50.25 in chips)
dellindi: posts small blind $0.25
IlxxxlI: posts big blind $0.50
*** HOLE CARDS ***
Dealt to IlxxxlI [Jh Kh]
Karas321: folds
Xiniay: folds
illoke: folds
dellindi: raises $1 to $1.50
IlxxxlI: raises $2.14 to $3.64
dellindi: calls $2.14
*** FLOP *** [5c 7h 7d]
dellindi: checks
IlxxxlI: checks
*** TURN *** [5c 7h 7d] [3c]
dellindi: bets $46.61 and is all-in
IlxxxlI: folds
Uncalled bet ($46.61) returned to dellindi
dellindi: doesn't show hand
dellindi collected $6.92 from pot
*** SUMMARY ***
Total pot $7.28 | Rake $0.36
Board [5c 7h 7d 3c]
Seat 2: IlxxxlI (big blind) folded on the Turn
Seat 3: Karas321 folded before Flop (didn't bet)
Seat 4: Xiniay folded before Flop (didn't bet)
Seat 5: illoke (button) folded before Flop (didn't bet)
Seat 6: dellindi (small blind) collected ($6.92)

PokerStars Hand #771311680: Hold'em No Limit ($0.25/$0.50 USD) - 2016/11/09 19:16:57 ET
Table 'WPN_3421571163' 6-max  Seat #4 is the button
Seat 1: IlxxxlI ($21.13 in chips)
Seat 3: Xiniay ($45.41 in chips)
Seat 4: saidafrente ($51.08 in chips)
Seat 5: Kryuk13 ($56.61 in chips)
Seat 6: v0landito ($100.37 in chips)
Kryuk13: posts small blind $0.25
v0landito: posts big blind $0.50
*** HOLE CARDS ***
Dealt to IlxxxlI [Ks 4d]
IlxxxlI: folds
Xiniay: folds
saidafrente: raises $0.50 to $1
Kryuk13: folds
v0landito: calls $0.50
*** FLOP *** [Kc 7h 9c]
v0landito: checks
saidafrente: checks
*** TURN *** [Kc 7h 9c] [6c]
v0landito: bets $1.43
saidafrente: raises $3.57 to $5
v0landito: calls $3.57
*** RIVER *** [Kc 7h 9c 6c] [9d]
v0landito: checks
saidafrente: checks
*** SHOW DOWN ***
saidafrente: shows [7s Ac] (Two pairs. 9s and 7s)
v0landito: shows [Jd Kd] (Two pairs. Ks and 9s)
v0landito collected $11.64 from pot
*** SUMMARY ***
Total pot $12.25 | Rake $0.61
Board [Kc 7h 9c 6c 9d]
Seat 1: IlxxxlI folded before Flop (didn't bet)
Seat 3: Xiniay folded before Flop (didn't bet)
Seat 4: saidafrente (button) showed [7s Ac] and lost with Two pairs. 9s and 7s
Seat 5: Kryuk13 (small blind) folded before Flop
Seat 6: v0landito (big blind) showed [Jd Kd] and won ($11.64) with Two pairs. Ks and 9s

PokerStars Hand #771311529: Hold'em No Limit ($0.25/$0.50 USD) - 2016/11/09 19:16:35 ET
Table 'WPN_2355604438' 6-max  Seat #4 is the button
Seat 1: 38979 ($58.46 in chips)
Seat 2: IlxxxlI ($20.00 in chips)
Seat 3: Karas321 ($20.00 in chips)
Seat 4: Xiniay ($38.83 in chips)
Seat 5: illoke ($63.54 in chips)
Seat 6: dellindi ($51.25 in chips)
illoke: posts small blind $0.25
dellindi: posts big blind $0.50
*** HOLE CARDS ***
Dealt to IlxxxlI [3h 6s]
38979: folds
IlxxxlI: folds
Karas321: folds
Xiniay: raises $0.50 to $1
illoke: folds
dellindi: calls $0.50
*** FLOP *** [Kc Qc 3c]
dellindi: checks
Xiniay: bets $0.71
dellindi: folds
Uncalled bet ($0.71) returned to Xiniay
Xiniay: doesn't show hand
Xiniay collected $2.14 from pot
*** SUMMARY ***
Total pot $2.25 | Rake $0.11
Board [Kc Qc 3c]
Seat 1: 38979 folded before Flop (didn't bet)
Seat 2: IlxxxlI folded before Flop (didn't bet)
Seat 3: Karas321 folded before Flop (didn't bet)
Seat 4: Xiniay (button) collected ($2.14)
Seat 5: illoke (small blind) folded before Flop
Seat 6: dellindi (big blind) folded on the Flop

PokerStars Hand #771311411: Hold'em No Limit ($0.25/$0.50 USD) - 2016/11/09 19:16:20 ET
Table 'WPN_1341348958' 6-max  Seat #2 is the button
Seat 1: Dikmann ($25.00 in chips)
Seat 2: v0landito ($30.53 in chips)
Seat 3: IlxxxlI ($20.27 in chips)
Seat 4: Xiniay ($28.66 in chips)
Seat 5: PULISPATOLA ($29.18 in chips)
Seat 6: Karas321 ($21.56 in chips)
IlxxxlI: posts small blind $0.25
Xiniay: posts big blind $0.50
Dikmann: posts small blind $0.25
Dikmann: posts big blind $0.50
*** HOLE CARDS ***
Dealt to IlxxxlI [Ah Ts]
PULISPATOLA: folds
Karas321: folds
Dikmann: checks
v0landito: calls $0.50
IlxxxlI: raises $3.25 to $4
Xiniay: folds
Dikmann: folds
v0landito: folds
Uncalled bet ($3.50) returned to IlxxxlI
IlxxxlI: doesn't show hand
IlxxxlI collected $2.25 from pot
*** SUMMARY ***
Total pot $2.25 | Rake $0
Seat 1: Dikmann folded before Flop
Seat 2: v0landito (button) folded before Flop
Seat 3: IlxxxlI (small blind) collected ($2.25)
Seat 4: Xiniay (big blind) folded before Flop
Seat 5: PULISPATOLA folded before Flop (didn't bet)
Seat 6: Karas321 folded before Flop (didn't bet)

PokerStars Hand #771311373: Hold'em No Limit ($0.25/$0.50 USD) - 2016/11/09 19:16:15 ET
Table 'WPN_3421571163' 6-max  Seat #3 is the button
Seat 1: IlxxxlI ($21.13 in chips)
Seat 3: Xiniay ($45.41 in chips)
Seat 4: saidafrente ($51.33 in chips)
Seat 5: Kryuk13 ($57.11 in chips)
Seat 6: v0landito ($99.62 in chips)
saidafrente: posts small blind $0.25
Kryuk13: posts big blind $0.50
*** HOLE CARDS ***
Dealt to IlxxxlI [2h Ks]
v0landito: raises $1 to $1.50
IlxxxlI: folds
Xiniay: folds
saidafrente: folds
Kryuk13: folds
Uncalled bet ($1.00) returned to v0landito
v0landito: doesn't show hand
v0landito collected $1.25 from pot
*** SUMMARY ***
Total pot $1.25 | Rake $0
Seat 1: IlxxxlI folded before Flop (didn't bet)
Seat 3: Xiniay (button) folded before Flop (didn't bet)
Seat 4: saidafrente (small blind) folded before Flop
Seat 5: Kryuk13 (big blind) folded before Flop
Seat 6: v0landito collected ($1.25)

PokerStars Hand #771311381: Hold'em No Limit ($0.25/$0.50 USD) - 2016/11/09 19:16:14 ET
Table 'WPN_325998925' 6-max  Seat #2 is the button
Seat 2: CertifiedG ($50.00 in chips)
Seat 3: IlxxxlI ($20.00 in chips)
Seat 4: Xiniay ($90.71 in chips)
IlxxxlI: posts small blind $0.25
Xiniay: posts big blind $0.50
*** HOLE CARDS ***
Dealt to IlxxxlI [3h Th]
CertifiedG: raises $0.62 to $1.12
IlxxxlI: folds
Xiniay: folds
Uncalled bet ($0.62) returned to CertifiedG
CertifiedG: doesn't show hand
CertifiedG collected $1.25 from pot
*** SUMMARY ***
Total pot $1.25 | Rake $0
Seat 2: CertifiedG (button) collected ($1.25)
Seat 3: IlxxxlI (small blind) folded before Flop
Seat 4: Xiniay (big blind) folded before Flop

PokerStars Hand #771311366: Hold'em No Limit ($0.50/$1.00 USD) - 2016/11/09 19:16:13 ET
Table 'WPN_2128003642' 6-max  Seat #3 is the button
Seat 1: v0landito ($277.11 in chips)
Seat 2: IlxxxlI ($40.00 in chips)
Seat 3: dellindi ($146.80 in chips)
Seat 4: illoke ($106.19 in chips)
Seat 5: 38979 ($174.85 in chips)
Seat 6: gust ($40.00 in chips)
illoke: posts small blind $0.50
38979: posts big blind $1
*** HOLE CARDS ***
Dealt to IlxxxlI [2d Jd]
gust: folds
v0landito: folds
IlxxxlI: folds
dellindi: raises $1 to $2
illoke: calls $1.50
38979: folds
*** FLOP *** [7h 8c Qc]
illoke: bets $2.37
dellindi: folds
Uncalled bet ($2.37) returned to illoke
illoke: doesn't show hand
illoke collected $4.75 from pot
*** SUMMARY ***
Total pot $5 | Rake $0.25
Board [7h 8c Qc]
Seat 1: v0landito folded before Flop (didn't bet)
Seat 2: IlxxxlI folded before Flop (didn't bet)
Seat 3: dellindi (button) folded on the Flop
Seat 4: illoke (small blind) collected ($4.75)
Seat 5: 38979 (big blind) folded before Flop
Seat 6: gust folded before Flop (didn't bet)

PokerStars Hand #771311331: Hold'em No Limit ($0.25/$0.50 USD) - 2016/11/09 19:16:07 ET
Table 'WPN_3219946394' 6-max  Seat #6 is the button
Seat 1: illoke ($53.09 in chips)
Seat 2: IlxxxlI ($23.98 in chips)
Seat 3: v0landito ($53.03 in chips)
Seat 5: Xiniay ($74.23 in chips)
Seat 6: 38979 ($100.29 in chips)
illoke: posts small blind $0.25
IlxxxlI: posts big blind $0.50
*** HOLE CARDS ***
Dealt to IlxxxlI [Jc Qc]
v0landito: folds
Xiniay: folds
38979: raises $0.50 to $1
illoke: raises $3 to $4
IlxxxlI: folds
38979: raises $6 to $10
illoke: raises $43.09 to $53.09 and is all-in
38979: folds
Uncalled bet ($43.09) returned to illoke
illoke: doesn't show hand
illoke collected $20.50 from pot
*** SUMMARY ***
Total pot $20.50 | Rake $0
Seat 1: illoke (small blind) collected ($20.50)
Seat 2: IlxxxlI (big blind) folded before Flop
Seat 3: v0landito folded before Flop (didn't bet)
Seat 5: Xiniay folded before Flop (didn't bet)
Seat 6: 38979 (button) folded before Flop

PokerStars Hand #771311266: Hold'em No Limit ($0.25/$0.50 USD) - 2016/11/09 19:15:58 ET
Table 'WPN_325998925' 6-max  Seat #4 is the button
Seat 2: CertifiedG ($50.25 in chips)
Seat 3: IlxxxlI ($20.00 in chips)
Seat 4: Xiniay ($89.96 in chips)
CertifiedG: posts small blind $0.25
IlxxxlI: posts big blind $0.50
*** HOLE CARDS ***
Dealt to IlxxxlI [4s Jh]
Xiniay: raises $0.50 to $1
CertifiedG: folds
IlxxxlI: folds
Uncalled bet ($0.50) returned to Xiniay
Xiniay: doesn't show hand
Xiniay collected $1.25 from pot
*** SUMMARY ***
Total pot $1.25 | Rake $0
Seat 2: CertifiedG (small blind) folded before Flop
Seat 3: IlxxxlI (big blind) folded before Flop
Seat 4: Xiniay (button) collected ($1.25)

PokerStars Hand #771311086: Hold'em No Limit ($0.25/$0.50 USD) - 2016/11/09 19:15:32 ET
Table 'WPN_3421571163' 6-max  Seat #1 is the button
Seat 1: IlxxxlI ($21.13 in chips)
Seat 3: Xiniay ($45.66 in chips)
Seat 4: saidafrente ($51.83 in chips)
Seat 5: Kryuk13 ($57.11 in chips)
Seat 6: v0landito ($98.87 in chips)
Xiniay: posts small blind $0.25
saidafrente: posts big blind $0.50
*** HOLE CARDS ***
Dealt to IlxxxlI [Qh Kc]
Kryuk13: folds
v0landito: raises $1 to $1.50
IlxxxlI: folds
Xiniay: folds
saidafrente: folds
Uncalled bet ($1.00) returned to v0landito
v0landito: doesn't show hand
v0landito collected $1.25 from pot
*** SUMMARY ***
Total pot $1.25 | Rake $0
Seat 1: IlxxxlI (button) folded before Flop (didn't bet)
Seat 3: Xiniay (small blind) folded before Flop
Seat 4: saidafrente (big blind) folded before Flop
Seat 5: Kryuk13 folded before Flop (didn't bet)
Seat 6: v0landito collected ($1.25)

PokerStars Hand #771311060: Hold'em No Limit ($0.25/$0.50 USD) - 2016/11/09 19:15:28 ET
Table 'WPN_3219946394' 6-max  Seat #5 is the button
Seat 1: illoke ($52.84 in chips)
Seat 2: IlxxxlI ($23.98 in chips)
Seat 3: v0landito ($53.03 in chips)
Seat 5: Xiniay ($74.23 in chips)
Seat 6: 38979 ($100.54 in chips)
38979: posts small blind $0.25
illoke: posts big blind $0.50
*** HOLE CARDS ***
Dealt to IlxxxlI [5d Jd]
IlxxxlI: folds
v0landito: folds
Xiniay: folds
38979: folds
Uncalled bet ($0.25) returned to illoke
illoke: doesn't show hand
illoke collected $0.50 from pot
*** SUMMARY ***
Total pot $0.50 | Rake $0
Seat 1: illoke (big blind) collected ($0.50)
Seat 2: IlxxxlI folded before Flop (didn't bet)
Seat 3: v0landito folded before Flop (didn't bet)
Seat 5: Xiniay (button) folded before Flop (didn't bet)
Seat 6: 38979 (small blind) folded before Flop

PokerStars Hand #771311047: Hold'em No Limit ($0.25/$0.50 USD) - 2016/11/09 19:15:26 ET
Table 'WPN_2355604438' 6-max  Seat #3 is the button
Seat 1: 38979 ($58.46 in chips)
Seat 2: IlxxxlI ($20.00 in chips)
Seat 3: Karas321 ($20.75 in chips)
Seat 4: Xiniay ($39.08 in chips)
Seat 5: illoke ($62.40 in chips)
Seat 6: dellindi ($51.25 in chips)
Xiniay: posts small blind $0.25
illoke: posts big blind $0.50
*** HOLE CARDS ***
Dealt to IlxxxlI [3h 7c]
dellindi: folds
38979: folds
IlxxxlI: folds
Karas321: raises $0.50 to $1
Xiniay: folds
illoke: calls $0.50
*** FLOP *** [Qs Ac Qh]
illoke: checks
Karas321: checks
*** TURN *** [Qs Ac Qh] [Kc]
illoke: bets $1.42
Karas321: folds
Uncalled bet ($1.42) returned to illoke
illoke: doesn't show hand
illoke collected $2.14 from pot
*** SUMMARY ***
Total pot $2.25 | Rake $0.11
Board [Qs Ac Qh Kc]
Seat 1: 38979 folded before Flop (didn't bet)
Seat 2: IlxxxlI folded before Flop (didn't bet)
Seat 3: Karas321 (button) folded on the Turn
Seat 4: Xiniay (small blind) folded before Flop
Seat 5: illoke (big blind) collected ($2.14)
Seat 6: dellindi folded before Flop (didn't bet)

PokerStars Hand #771310848: Hold'em No Limit ($0.25/$0.50 USD) - 2016/11/09 19:14:58 ET
Table 'WPN_3219946394' 6-max  Seat #3 is the button
Seat 1: illoke ($52.09 in chips)
Seat 2: IlxxxlI ($23.98 in chips)
Seat 3: v0landito ($53.03 in chips)
Seat 5: Xiniay ($74.48 in chips)
Seat 6: 38979 ($101.04 in chips)
Xiniay: posts small blind $0.25
38979: posts big blind $0.50
*** HOLE CARDS ***
Dealt to IlxxxlI [6s Jc]
illoke: raises $1 to $1.50
IlxxxlI: folds
v0landito: folds
Xiniay: folds
38979: folds
Uncalled bet ($1.00) returned to illoke
illoke: doesn't show hand
illoke collected $1.25 from pot
*** SUMMARY ***
Total pot $1.25 | Rake $0
Seat 1: illoke collected ($1.25)
Seat 2: IlxxxlI folded before Flop (didn't bet)
Seat 3: v0landito (button) folded before Flop (didn't bet)
Seat 5: Xiniay (small blind) folded before Flop
Seat 6: 38979 (big blind) folded before Flop

PokerStars Hand #771310832: Hold'em No Limit ($0.25/$0.50 USD) - 2016/11/09 19:14:55 ET
Table 'WPN_2355604438' 6-max  Seat #2 is the button
Seat 1: 38979 ($58.46 in chips)
Seat 2: IlxxxlI ($20.00 in chips)
Seat 3: Karas321 ($20.25 in chips)
Seat 4: Xiniay ($39.58 in chips)
Seat 5: illoke ($62.40 in chips)
Seat 6: dellindi ($51.25 in chips)
Karas321: posts small blind $0.25
Xiniay: posts big blind $0.50
*** HOLE CARDS ***
Dealt to IlxxxlI [6d Kc]
illoke: folds
dellindi: folds
38979: folds
IlxxxlI: folds
Karas321: raises $1 to $1.50
Xiniay: folds
Uncalled bet ($1.00) returned to Karas321
Karas321: doesn't show hand
Karas321 collected $1 from pot
*** SUMMARY ***
Total pot $1 | Rake $0
Seat 1: 38979 folded before Flop (didn't bet)
Seat 2: IlxxxlI (button) folded before Flop (didn't bet)
Seat 3: Karas321 (small blind) collected ($1)
Seat 4: Xiniay (big blind) folded before Flop
Seat 5: illoke folded before Flop (didn't bet)
Seat 6: dellindi folded before Flop (didn't bet)

PokerStars Hand #771310819: Hold'em No Limit ($0.25/$0.50 USD) - 2016/11/09 19:14:52 ET
Table 'WPN_325998925' 6-max  Seat #5 is the button
Seat 3: IlxxxlI ($20.00 in chips)
Seat 4: Xiniay ($90.71 in chips)
Seat 5: illoke ($52.50 in chips)
IlxxxlI: posts small blind $0.25
Xiniay: posts big blind $0.50
*** HOLE CARDS ***
Dealt to IlxxxlI [3d 4s]
illoke: raises $0.75 to $1.25
IlxxxlI: folds
Xiniay: folds
Uncalled bet ($0.75) returned to illoke
illoke: doesn't show hand
illoke collected $1.25 from pot
*** SUMMARY ***
Total pot $1.25 | Rake $0
Seat 3: IlxxxlI (small blind) folded before Flop
Seat 4: Xiniay (big blind) folded before Flop
Seat 5: illoke (button) collected ($1.25)

PokerStars Hand #771310801: Hold'em No Limit ($0.50/$1.00 USD) - 2016/11/09 19:14:51 ET
Table 'WPN_2128003642' 6-max  Seat #2 is the button
Seat 1: v0landito ($277.11 in chips)
Seat 2: IlxxxlI ($40.00 in chips)
Seat 3: dellindi ($139.55 in chips)
Seat 4: illoke ($107.19 in chips)
Seat 5: 38979 ($181.85 in chips)
Seat 6: gust ($40.00 in chips)
dellindi: posts small blind $0.50
illoke: posts big blind $1
*** HOLE CARDS ***
Dealt to IlxxxlI [4h Ts]
38979: raises $2 to $3
gust: folds
v0landito: folds
IlxxxlI: folds
dellindi: calls $2.50
illoke: folds
*** FLOP *** [3h 3c Qc]
dellindi: checks
38979: bets $4
dellindi: calls $4
*** TURN *** [3h 3c Qc] [2c]
dellindi: checks
38979: checks
*** RIVER *** [3h 3c Qc 2c] [3d]
dellindi: bets $9.50
38979: folds
Uncalled bet ($9.50) returned to dellindi
dellindi: doesn't show hand
dellindi collected $14.25 from pot
*** SUMMARY ***
Total pot $15 | Rake $0.75
Board [3h 3c Qc 2c 3d]
Seat 1: v0landito folded before Flop (didn't bet)
Seat 2: IlxxxlI (button) folded before Flop (didn't bet)
Seat 3: dellindi (small blind) collected ($14.25)
Seat 4: illoke (big blind) folded before Flop
Seat 5: 38979 folded on the River
Seat 6: gust folded before Flop (didn't bet)

PokerStars Hand #771310782: Hold'em No Limit ($0.25/$0.50 USD) - 2016/11/09 19:14:49 ET
Table 'WPN_1341348958' 6-max  Seat #6 is the button
Seat 2: v0landito ($30.78 in chips)
Seat 3: IlxxxlI ($14.15 in chips)
Seat 4: Xiniay ($35.19 in chips)
Seat 5: PULISPATOLA ($29.18 in chips)
Seat 6: Karas321 ($21.56 in chips)
v0landito: posts small blind $0.25
IlxxxlI: posts big blind $0.50
*** HOLE CARDS ***
Dealt to IlxxxlI [Ts Ad]
Xiniay: raises $1 to $1.50
PULISPATOLA: folds
Karas321: folds
v0landito: folds
IlxxxlI: calls $1
*** FLOP *** [2h Kc Jc]
IlxxxlI: checks
Xiniay: checks
*** TURN *** [2h Kc Jc] [5s]
IlxxxlI: checks
Xiniay: bets $1.03
IlxxxlI: calls $1.03
*** RIVER *** [2h Kc Jc 5s] [Qh]
IlxxxlI: bets $4
Xiniay: calls $4
*** SHOW DOWN ***
IlxxxlI: shows [Ts Ad] (Straight to A)
Xiniay: mucks hand
IlxxxlI collected $12.65 from pot
*** SUMMARY ***
Total pot $13.31 | Rake $0.66
Board [2h Kc Jc 5s Qh]
Seat 2: v0landito (small blind) folded before Flop
Seat 3: IlxxxlI (big blind) showed [Ts Ad] and won ($12.65) with Straight to A
Seat 4: Xiniay mucked
Seat 5: PULISPATOLA folded before Flop (didn't bet)
Seat 6: Karas321 (button) folded before Flop (didn't bet)

PokerStars Hand #771310671: Hold'em No Limit ($0.25/$0.50 USD) - 2016/11/09 19:14:34 ET
Table 'WPN_2355604438' 6-max  Seat #1 is the button
Seat 1: 38979 ($58.46 in chips)
Seat 2: IlxxxlI ($20.00 in chips)
Seat 3: Karas321 ($20.00 in chips)
Seat 4: Xiniay ($39.58 in chips)
Seat 5: illoke ($62.40 in chips)
Seat 6: dellindi ($51.25 in chips)
IlxxxlI: posts small blind $0.25
Karas321: posts big blind $0.50
*** HOLE CARDS ***
Dealt to IlxxxlI [8h 2d]
Xiniay: folds
illoke: folds
dellindi: folds
38979: folds
IlxxxlI: folds
Uncalled bet ($0.25) returned to Karas321
Karas321: doesn't show hand
Karas321 collected $0.50 from pot
*** SUMMARY ***
Total pot $0.50 | Rake $0
Seat 1: 38979 (button) folded before Flop (didn't bet)
Seat 2: IlxxxlI (small blind) folded before Flop
Seat 3: Karas321 (big blind) collected ($0.50)
Seat 4: Xiniay folded before Flop (didn't bet)
Seat 5: illoke folded before Flop (didn't bet)
Seat 6: dellindi folded before Flop (didn't bet)

PokerStars Hand #771310584: Hold'em No Limit ($0.25/$0.50 USD) - 2016/11/09 19:14:18 ET
Table 'WPN_3421571163' 6-max  Seat #6 is the button
Seat 1: IlxxxlI ($20.00 in chips)
Seat 3: Xiniay ($46.91 in chips)
Seat 4: saidafrente ($51.83 in chips)
Seat 5: Kryuk13 ($57.11 in chips)
Seat 6: v0landito ($98.87 in chips)
IlxxxlI: posts small blind $0.25
Xiniay: posts big blind $0.50
*** HOLE CARDS ***
Dealt to IlxxxlI [2h Ac]
saidafrente: folds
Kryuk13: folds
v0landito: folds
IlxxxlI: raises $0.75 to $1.25
Xiniay: calls $0.75
*** FLOP *** [8d 8s Jd]
IlxxxlI: checks
Xiniay: checks
*** TURN *** [8d 8s Jd] [6c]
IlxxxlI: bets $0.55
Xiniay: folds
Uncalled bet ($0.55) returned to IlxxxlI
IlxxxlI: doesn't show hand
IlxxxlI collected $2.38 from pot
*** SUMMARY ***
Total pot $2.50 | Rake $0.12
Board [8d 8s Jd 6c]
Seat 1: IlxxxlI (small blind) collected ($2.38)
Seat 3: Xiniay (big blind) folded on the Turn
Seat 4: saidafrente folded before Flop (didn't bet)
Seat 5: Kryuk13 folded before Flop (didn't bet)
Seat 6: v0landito (button) folded before Flop (didn't bet)

PokerStars Hand #771310406: Hold'em No Limit ($0.50/$1.00 USD) - 2016/11/09 19:13:53 ET
Table 'WPN_2128003642' 6-max  Seat #1 is the button
Seat 1: v0landito ($277.11 in chips)
Seat 2: IlxxxlI ($40.00 in chips)
Seat 3: dellindi ($133.52 in chips)
Seat 4: illoke ($110.19 in chips)
Seat 5: 38979 ($184.85 in chips)
Seat 6: gust ($40.00 in chips)
IlxxxlI: posts small blind $0.50
dellindi: posts big blind $1
*** HOLE CARDS ***
Dealt to IlxxxlI [3c 6d]
illoke: raises $2 to $3
38979: calls $3
gust: folds
v0landito: folds
IlxxxlI: folds
dellindi: calls $2
*** FLOP *** [Jd 7c 7s]
dellindi: checks
illoke: checks
38979: checks
*** TURN *** [Jd 7c 7s] [4h]
dellindi: bets $6.02
illoke: folds
38979: folds
Uncalled bet ($6.02) returned to dellindi
dellindi: doesn't show hand
dellindi collected $9.03 from pot
*** SUMMARY ***
Total pot $9.50 | Rake $0.47
Board [Jd 7c 7s 4h]
Seat 1: v0landito (button) folded before Flop (didn't bet)
Seat 2: IlxxxlI (small blind) folded before Flop
Seat 3: dellindi (big blind) collected ($9.03)
Seat 4: illoke folded on the Turn
Seat 5: 38979 folded on the Turn
Seat 6: gust folded before Flop (didn't bet)

PokerStars Hand #771310332: Hold'em No Limit ($0.25/$0.50 USD) - 2016/11/09 19:13:41 ET
Table 'WPN_1341348958' 6-max  Seat #5 is the button
Seat 2: v0landito ($29.31 in chips)
Seat 3: IlxxxlI ($14.15 in chips)
Seat 4: Xiniay ($35.19 in chips)
Seat 5: PULISPATOLA ($29.18 in chips)
Seat 6: Karas321 ($23.19 in chips)
Karas321: posts small blind $0.25
v0landito: posts big blind $0.50
*** HOLE CARDS ***
Dealt to IlxxxlI [7d 8h]
IlxxxlI: folds
Xiniay: folds
PULISPATOLA: folds
Karas321: raises $0.50 to $1
v0landito: calls $0.50
*** FLOP *** [6d 2c 9h]
Karas321: bets $0.63
v0landito: calls $0.63
*** TURN *** [6d 2c 9h] [Th]
Karas321: checks
v0landito: bets $2.07
Karas321: folds
Uncalled bet ($2.07) returned to v0landito
v0landito: doesn't show hand
v0landito collected $3.10 from pot
*** SUMMARY ***
Total pot $3.26 | Rake $0.16
Board [6d 2c 9h Th]
Seat 2: v0landito (big blind) collected ($3.10)
Seat 3: IlxxxlI folded before Flop (didn't bet)
Seat 4: Xiniay folded before Flop (didn't bet)
Seat 5: PULISPATOLA (button) folded before Flop (didn't bet)
Seat 6: Karas321 (small blind) folded on the Turn

PokerStars Hand #771310325: Hold'em No Limit ($0.25/$0.50 USD) - 2016/11/09 19:13:40 ET
Table 'WPN_2355604438' 6-max  Seat #6 is the button
Seat 1: 38979 ($58.71 in chips)
Seat 2: IlxxxlI ($20.00 in chips)
Seat 3: Karas321 ($20.00 in chips)
Seat 4: Xiniay ($39.58 in chips)
Seat 5: illoke ($62.40 in chips)
Seat 6: dellindi ($49.25 in chips)
38979: posts small blind $0.25
IlxxxlI: posts big blind $0.50
*** HOLE CARDS ***
Dealt to IlxxxlI [9s 5s]
Karas321: raises $0.75 to $1.25
Xiniay: folds
illoke: folds
dellindi: raises $3 to $4.25
38979: folds
IlxxxlI: folds
Karas321: folds
Uncalled bet ($3.00) returned to dellindi
dellindi: doesn't show hand
dellindi collected $3.25 from pot
*** SUMMARY ***
Total pot $3.25 | Rake $0
Seat 1: 38979 (small blind) folded before Flop
Seat 2: IlxxxlI (big blind) folded before Flop
Seat 3: Karas321 folded before Flop
Seat 4: Xiniay folded before Flop (didn't bet)
Seat 5: illoke folded before Flop (didn't bet)
Seat 6: dellindi (button) collected ($3.25)

PokerStars Hand #771310118: Hold'em No Limit ($0.50/$1.00 USD) - 2016/11/09 19:13:08 ET
Table 'WPN_2128003642' 6-max  Seat #6 is the button
Seat 1: v0landito ($277.61 in chips)
Seat 2: IlxxxlI ($40.00 in chips)
Seat 3: dellindi ($133.52 in chips)
Seat 4: illoke ($110.19 in chips)
Seat 5: 38979 ($183.35 in chips)
Seat 6: gust ($40.00 in chips)
v0landito: posts small blind $0.50
IlxxxlI: posts big blind $1
*** HOLE CARDS ***
Dealt to IlxxxlI [4h 9s]
dellindi: folds
illoke: folds
38979: raises $2 to $3
gust: folds
v0landito: folds
IlxxxlI: folds
Uncalled bet ($2.00) returned to 38979
38979: doesn't show hand
38979 collected $2.50 from pot
*** SUMMARY ***
Total pot $2.50 | Rake $0
Seat 1: v0landito (small blind) folded before Flop
Seat 2: IlxxxlI (big blind) folded before Flop
Seat 3: dellindi folded before Flop (didn't bet)
Seat 4: illoke folded before Flop (didn't bet)
Seat 5: 38979 collected ($2.50)
Seat 6: gust (button) folded before Flop (didn't bet)

PokerStars Hand #771310107: Hold'em No Limit ($0.25/$0.50 USD) - 2016/11/09 19:13:06 ET
Table 'WPN_2355604438' 6-max  Seat #5 is the button
Seat 1: 38979 ($58.46 in chips)
Seat 2: IlxxxlI ($20.00 in chips)
Seat 3: Karas321 ($20.00 in chips)
Seat 4: Xiniay ($39.58 in chips)
Seat 5: illoke ($62.40 in chips)
Seat 6: dellindi ($49.50 in chips)
dellindi: posts small blind $0.25
38979: posts big blind $0.50
*** HOLE CARDS ***
Dealt to IlxxxlI [8c 2s]
IlxxxlI: folds
Karas321: folds
Xiniay: folds
illoke: folds
dellindi: folds
Uncalled bet ($0.25) returned to 38979
38979: doesn't show hand
38979 collected $0.50 from pot
*** SUMMARY ***
Total pot $0.50 | Rake $0
Seat 1: 38979 (big blind) collected ($0.50)
Seat 2: IlxxxlI folded before Flop (didn't bet)
Seat 3: Karas321 folded before Flop (didn't bet)
Seat 4: Xiniay folded before Flop (didn't bet)
Seat 5: illoke (button) folded before Flop (didn't bet)
Seat 6: dellindi (small blind) folded before Flop

PokerStars Hand #771310009: Hold'em No Limit ($0.25/$0.50 USD) - 2016/11/09 19:12:50 ET
Table 'WPN_3219946394' 6-max  Seat #2 is the button
Seat 1: illoke ($52.09 in chips)
Seat 2: IlxxxlI ($23.98 in chips)
Seat 3: v0landito ($53.28 in chips)
Seat 4: dudu777 ($21.08 in chips)
Seat 5: Xiniay ($55.27 in chips)
Seat 6: 38979 ($101.04 in chips)
v0landito: posts small blind $0.25
dudu777: posts big blind $0.50
*** HOLE CARDS ***
Dealt to IlxxxlI [3d 8c]
Xiniay: raises $1 to $1.50
38979: folds
illoke: folds
IlxxxlI: folds
v0landito: folds
dudu777: calls $1
*** FLOP *** [6d 4h Th]
dudu777: checks
Xiniay: bets $1.54
dudu777: calls $1.54
*** TURN *** [6d 4h Th] [Qd]
dudu777: bets $18.04 and is all-in
Xiniay: calls $18.04
*** RIVER *** [6d 4h Th Qd] [6h]
*** SHOW DOWN ***
dudu777: shows [Qs 4s] (Two pairs. Qs and 6s)
Xiniay: shows [Td Ts] (Full House (10/6))
Xiniay collected $40.29 from pot
*** SUMMARY ***
Total pot $42.41 | Rake $2.12
Board [6d 4h Th Qd 6h]
Seat 1: illoke folded before Flop (didn't bet)
Seat 2: IlxxxlI (button) folded before Flop (didn't bet)
Seat 3: v0landito (small blind) folded before Flop
Seat 4: dudu777 (big blind) showed [Qs 4s] and lost with Two pairs. Qs and 6s
Seat 5: Xiniay showed [Td Ts] and won ($40.29) with Full House (10/6)
Seat 6: 38979 folded before Flop (didn't bet)

PokerStars Hand #771309987: Hold'em No Limit ($0.25/$0.50 USD) - 2016/11/09 19:12:47 ET
Table 'WPN_2355604438' 6-max  Seat #4 is the button
Seat 2: IlxxxlI ($20.00 in chips)
Seat 3: Karas321 ($20.00 in chips)
Seat 4: Xiniay ($39.58 in chips)
Seat 5: illoke ($61.90 in chips)
Seat 6: dellindi ($50.00 in chips)
illoke: posts small blind $0.25
dellindi: posts big blind $0.50
*** HOLE CARDS ***
Dealt to IlxxxlI [Qs 4s]
IlxxxlI: folds
Karas321: folds
Xiniay: folds
illoke: raises $1 to $1.50
dellindi: folds
Uncalled bet ($1.00) returned to illoke
illoke: doesn't show hand
illoke collected $1 from pot
*** SUMMARY ***
Total pot $1 | Rake $0
Seat 2: IlxxxlI folded before Flop (didn't bet)
Seat 3: Karas321 folded before Flop (didn't bet)
Seat 4: Xiniay (button) folded before Flop (didn't bet)
Seat 5: illoke (small blind) collected ($1)
Seat 6: dellindi (big blind) folded before Flop

PokerStars Hand #771309972: Hold'em No Limit ($0.25/$0.50 USD) - 2016/11/09 19:12:44 ET
Table 'WPN_3421571163' 6-max  Seat #5 is the button
Seat 1: IlxxxlI ($20.75 in chips)
Seat 2: thebestvd ($46.95 in chips)
Seat 3: Xiniay ($46.91 in chips)
Seat 4: saidafrente ($51.83 in chips)
Seat 5: Kryuk13 ($53.66 in chips)
Seat 6: v0landito ($99.12 in chips)
v0landito: posts small blind $0.25
IlxxxlI: posts big blind $0.50
*** HOLE CARDS ***
Dealt to IlxxxlI [9s 6s]
thebestvd: folds
Xiniay: folds
saidafrente: folds
Kryuk13: raises $1 to $1.50
v0landito: folds
IlxxxlI: calls $1
*** FLOP *** [4d Kd 6c]
IlxxxlI: checks
Kryuk13: bets $2.06
IlxxxlI: calls $2.06
*** TURN *** [4d Kd 6c] [Js]
IlxxxlI: checks
Kryuk13: bets $3.50
IlxxxlI: folds
Uncalled bet ($3.50) returned to Kryuk13
Kryuk13: doesn't show hand
Kryuk13 collected $7.01 from pot
*** SUMMARY ***
Total pot $7.37 | Rake $0.36
Board [4d Kd 6c Js]
Seat 1: IlxxxlI (big blind) folded on the Turn
Seat 2: thebestvd folded before Flop (didn't bet)
Seat 3: Xiniay folded before Flop (didn't bet)
Seat 4: saidafrente folded before Flop (didn't bet)
Seat 5: Kryuk13 (button) collected ($7.01)
Seat 6: v0landito (small blind) folded before Flop

PokerStars Hand #771309931: Hold'em No Limit ($0.25/$0.50 USD) - 2016/11/09 19:12:39 ET
Table 'WPN_1341348958' 6-max  Seat #4 is the button
Seat 1: Dikmann ($10.66 in chips)
Seat 2: v0landito ($29.31 in chips)
Seat 3: IlxxxlI ($14.15 in chips)
Seat 4: Xiniay ($35.19 in chips)
Seat 5: PULISPATOLA ($29.68 in chips)
Seat 6: Karas321 ($13.12 in chips)
PULISPATOLA: posts small blind $0.25
Karas321: posts big blind $0.50
*** HOLE CARDS ***
Dealt to IlxxxlI [6h Qc]
Dikmann: calls $0.50
v0landito: folds
IlxxxlI: folds
Xiniay: folds
PULISPATOLA: calls $0.25
Karas321: raises $12.62 to $13.12 and is all-in
Dikmann: calls $10.16 and is all-in
PULISPATOLA: folds
Uncalled bet ($2.46) returned to Karas321
*** FLOP *** [6c 6d Td]
*** TURN *** [6c 6d Td] [2s]
*** RIVER *** [6c 6d Td 2s] [Qd]
*** SHOW DOWN ***
Dikmann: shows [As Jh] (One pair of 6s)
Karas321: shows [2h 2d] (Full House (2/6))
Karas321 collected $20.73 from pot
*** SUMMARY ***
Total pot $21.82 | Rake $1.09
Board [6c 6d Td 2s Qd]
Seat 1: Dikmann showed [As Jh] and lost with One pair of 6s
Seat 2: v0landito folded before Flop (didn't bet)
Seat 3: IlxxxlI folded before Flop (didn't bet)
Seat 4: Xiniay (button) folded before Flop (didn't bet)
Seat 5: PULISPATOLA (small blind) folded before Flop
Seat 6: Karas321 (big blind) showed [2h 2d] and won ($20.73) with Full House (2/6)

PokerStars Hand #771309829: Hold'em No Limit ($0.50/$1.00 USD) - 2016/11/09 19:12:23 ET
Table 'WPN_2128003642' 6-max  Seat #5 is the button
Seat 1: v0landito ($278.61 in chips)
Seat 2: IlxxxlI ($40.00 in chips)
Seat 3: dellindi ($132.02 in chips)
Seat 4: illoke ($110.19 in chips)
Seat 5: 38979 ($183.35 in chips)
Seat 6: gust ($40.50 in chips)
gust: posts small blind $0.50
v0landito: posts big blind $1
*** HOLE CARDS ***
Dealt to IlxxxlI [Jh Kc]
IlxxxlI: folds
dellindi: raises $2 to $3
illoke: folds
38979: folds
gust: folds
v0landito: folds
Uncalled bet ($2.00) returned to dellindi
dellindi: doesn't show hand
dellindi collected $2.50 from pot
*** SUMMARY ***
Total pot $2.50 | Rake $0
Seat 1: v0landito (big blind) folded before Flop
Seat 2: IlxxxlI folded before Flop (didn't bet)
Seat 3: dellindi collected ($2.50)
Seat 4: illoke folded before Flop (didn't bet)
Seat 5: 38979 (button) folded before Flop (didn't bet)
Seat 6: gust (small blind) folded before Flop

PokerStars Hand #771309796: Hold'em No Limit ($0.25/$0.50 USD) - 2016/11/09 19:12:16 ET
Table 'WPN_2355604438' 6-max  Seat #3 is the button
Seat 2: IlxxxlI ($20.00 in chips)
Seat 3: Karas321 ($20.00 in chips)
Seat 4: Xiniay ($39.83 in chips)
Seat 5: illoke ($61.65 in chips)
Seat 6: dellindi ($45.97 in chips)
Xiniay: posts small blind $0.25
illoke: posts big blind $0.50
*** HOLE CARDS ***
Dealt to IlxxxlI [5c 3h]
dellindi: folds
IlxxxlI: folds
Karas321: folds
Xiniay: folds
Uncalled bet ($0.25) returned to illoke
illoke: doesn't show hand
illoke collected $0.50 from pot
*** SUMMARY ***
Total pot $0.50 | Rake $0
Seat 2: IlxxxlI folded before Flop (didn't bet)
Seat 3: Karas321 (button) folded before Flop (didn't bet)
Seat 4: Xiniay (small blind) folded before Flop
Seat 5: illoke (big blind) collected ($0.50)
Seat 6: dellindi folded before Flop (didn't bet)

PokerStars Hand #771309764: Hold'em No Limit ($0.25/$0.50 USD) - 2016/11/09 19:12:12 ET
Table 'WPN_3421571163' 6-max  Seat #4 is the button
Seat 1: IlxxxlI ($20.75 in chips)
Seat 2: thebestvd ($46.20 in chips)
Seat 3: Xiniay ($46.91 in chips)
Seat 4: saidafrente ($51.83 in chips)
Seat 5: Kryuk13 ($53.91 in chips)
Seat 6: v0landito ($99.62 in chips)
Kryuk13: posts small blind $0.25
v0landito: posts big blind $0.50
*** HOLE CARDS ***
Dealt to IlxxxlI [Td 8d]
IlxxxlI: folds
thebestvd: raises $2.50 to $3
Xiniay: folds
saidafrente: folds
Kryuk13: folds
v0landito: folds
Uncalled bet ($2.50) returned to thebestvd
thebestvd: doesn't show hand
thebestvd collected $1.25 from pot
*** SUMMARY ***
Total pot $1.25 | Rake $0
Seat 1: IlxxxlI folded before Flop (didn't bet)
Seat 2: thebestvd collected ($1.25)
Seat 3: Xiniay folded before Flop (didn't bet)
Seat 4: saidafrente (button) folded before Flop (didn't bet)
Seat 5: Kryuk13 (small blind) folded before Flop
Seat 6: v0landito (big blind) folded before Flop

PokerStars Hand #771309594: Hold'em No Limit ($0.50/$1.00 USD) - 2016/11/09 19:11:47 ET
Table 'WPN_2128003642' 6-max  Seat #4 is the button
Seat 1: v0landito ($278.61 in chips)
Seat 2: IlxxxlI ($40.00 in chips)
Seat 3: dellindi ($130.52 in chips)
Seat 4: illoke ($110.19 in chips)
Seat 5: 38979 ($183.85 in chips)
Seat 6: gust ($41.50 in chips)
38979: posts small blind $0.50
gust: posts big blind $1
*** HOLE CARDS ***
Dealt to IlxxxlI [8s 9c]
v0landito: folds
IlxxxlI: folds
dellindi: raises $2 to $3
illoke: folds
38979: folds
gust: folds
Uncalled bet ($2.00) returned to dellindi
dellindi: doesn't show hand
dellindi collected $2.50 from pot
*** SUMMARY ***
Total pot $2.50 | Rake $0
Seat 1: v0landito folded before Flop (didn't bet)
Seat 2: IlxxxlI folded before Flop (didn't bet)
Seat 3: dellindi collected ($2.50)
Seat 4: illoke (button) folded before Flop (didn't bet)
Seat 5: 38979 (small blind) folded before Flop
Seat 6: gust (big blind) folded before Flop

PokerStars Hand #771309561: Hold'em No Limit ($0.25/$0.50 USD) - 2016/11/09 19:11:40 ET
Table 'WPN_3421571163' 6-max  Seat #3 is the button
Seat 1: IlxxxlI ($20.75 in chips)
Seat 2: thebestvd ($46.20 in chips)
Seat 3: Xiniay ($46.16 in chips)
Seat 4: saidafrente ($52.08 in chips)
Seat 5: Kryuk13 ($54.41 in chips)
Seat 6: v0landito ($99.62 in chips)
saidafrente: posts small blind $0.25
Kryuk13: posts big blind $0.50
*** HOLE CARDS ***
Dealt to IlxxxlI [5d As]
v0landito: folds
IlxxxlI: folds
thebestvd: folds
Xiniay: raises $0.50 to $1
saidafrente: folds
Kryuk13: folds
Uncalled bet ($0.50) returned to Xiniay
Xiniay: doesn't show hand
Xiniay collected $1.25 from pot
*** SUMMARY ***
Total pot $1.25 | Rake $0
Seat 1: IlxxxlI folded before Flop (didn't bet)
Seat 2: thebestvd folded before Flop (didn't bet)
Seat 3: Xiniay (button) collected ($1.25)
Seat 4: saidafrente (small blind) folded before Flop
Seat 5: Kryuk13 (big blind) folded before Flop
Seat 6: v0landito folded before Flop (didn't bet)

PokerStars Hand #771309553: Hold'em No Limit ($0.25/$0.50 USD) - 2016/11/09 19:11:37 ET
Table 'WPN_1341348958' 6-max  Seat #3 is the button
Seat 1: Dikmann ($10.66 in chips)
Seat 2: v0landito ($29.31 in chips)
Seat 3: IlxxxlI ($14.15 in chips)
Seat 4: Xiniay ($36.69 in chips)
Seat 5: PULISPATOLA ($28.33 in chips)
Seat 6: Karas321 ($13.12 in chips)
Xiniay: posts small blind $0.25
PULISPATOLA: posts big blind $0.50
*** HOLE CARDS ***
Dealt to IlxxxlI [6d 3c]
Karas321: folds
Dikmann: folds
v0landito: folds
IlxxxlI: folds
Xiniay: raises $1 to $1.50
PULISPATOLA: calls $1
*** FLOP *** [3d 2d Qh]
Xiniay: checks
PULISPATOLA: bets $1.90
Xiniay: folds
Uncalled bet ($1.90) returned to PULISPATOLA
PULISPATOLA: doesn't show hand
PULISPATOLA collected $2.85 from pot
*** SUMMARY ***
Total pot $3 | Rake $0.15
Board [3d 2d Qh]
Seat 1: Dikmann folded before Flop (didn't bet)
Seat 2: v0landito folded before Flop (didn't bet)
Seat 3: IlxxxlI (button) folded before Flop (didn't bet)
Seat 4: Xiniay (small blind) folded on the Flop
Seat 5: PULISPATOLA (big blind) collected ($2.85)
Seat 6: Karas321 folded before Flop (didn't bet)

PokerStars Hand #771309513: Hold'em No Limit ($0.25/$0.50 USD) - 2016/11/09 19:11:31 ET
Table 'WPN_2355604438' 6-max  Seat #2 is the button
Seat 2: IlxxxlI ($20.00 in chips)
Seat 3: Karas321 ($20.00 in chips)
Seat 4: Xiniay ($40.33 in chips)
Seat 5: illoke ($57.98 in chips)
Seat 6: dellindi ($49.25 in chips)
Karas321: posts small blind $0.25
Xiniay: posts big blind $0.50
*** HOLE CARDS ***
Dealt to IlxxxlI [9h 7c]
illoke: raises $1 to $1.50
dellindi: calls $1.50
IlxxxlI: folds
Karas321: folds
Xiniay: folds
*** FLOP *** [Qd Ah 5h]
illoke: bets $1.78
dellindi: calls $1.78
*** TURN *** [Qd Ah 5h] [7d]
illoke: bets $3.47
dellindi: folds
Uncalled bet ($3.47) returned to illoke
illoke: doesn't show hand
illoke collected $6.95 from pot
*** SUMMARY ***
Total pot $7.31 | Rake $0.36
Board [Qd Ah 5h 7d]
Seat 2: IlxxxlI (button) folded before Flop (didn't bet)
Seat 3: Karas321 (small blind) folded before Flop
Seat 4: Xiniay (big blind) folded before Flop
Seat 5: illoke collected ($6.95)
Seat 6: dellindi folded on the Turn

PokerStars Hand #771309402: Hold'em No Limit ($0.25/$0.50 USD) - 2016/11/09 19:11:12 ET
Table 'WPN_3219946394' 6-max  Seat #1 is the button
Seat 1: illoke ($52.09 in chips)
Seat 2: IlxxxlI ($22.14 in chips)
Seat 3: v0landito ($55.32 in chips)
Seat 4: dudu777 ($21.08 in chips)
Seat 5: Xiniay ($55.27 in chips)
Seat 6: 38979 ($101.04 in chips)
IlxxxlI: posts small blind $0.25
v0landito: posts big blind $0.50
*** HOLE CARDS ***
Dealt to IlxxxlI [Js Ks]
dudu777: folds
Xiniay: folds
38979: folds
illoke: folds
IlxxxlI: raises $0.75 to $1.25
v0landito: calls $0.75
*** FLOP *** [Qh 6h 7d]
IlxxxlI: bets $0.79
v0landito: calls $0.79
*** TURN *** [Qh 6h 7d] [4s]
IlxxxlI: checks
v0landito: checks
*** RIVER *** [Qh 6h 7d 4s] [7s]
IlxxxlI: checks
v0landito: checks
*** SHOW DOWN ***
IlxxxlI: shows [Js Ks] (One pair of 7s)
v0landito: mucks hand
IlxxxlI collected $3.88 from pot
*** SUMMARY ***
Total pot $4.08 | Rake $0.20
Board [Qh 6h 7d 4s 7s]
Seat 1: illoke (button) folded before Flop (didn't bet)
Seat 2: IlxxxlI (small blind) showed [Js Ks] and won ($3.88) with One pair of 7s
Seat 3: v0landito (big blind) mucked
Seat 4: dudu777 folded before Flop (didn't bet)
Seat 5: Xiniay folded before Flop (didn't bet)
Seat 6: 38979 folded before Flop (didn't bet)

PokerStars Hand #771309391: Hold'em No Limit ($0.50/$1.00 USD) - 2016/11/09 19:11:11 ET
Table 'WPN_2128003642' 6-max  Seat #3 is the button
Seat 1: v0landito ($278.61 in chips)
Seat 2: IlxxxlI ($40.00 in chips)
Seat 3: dellindi ($130.52 in chips)
Seat 4: illoke ($110.69 in chips)
Seat 5: 38979 ($184.85 in chips)
Seat 6: gust ($40.00 in chips)
illoke: posts small blind $0.50
38979: posts big blind $1
*** HOLE CARDS ***
Dealt to IlxxxlI [7d 6c]
gust: raises $1 to $2
v0landito: folds
IlxxxlI: folds
dellindi: folds
illoke: folds
38979: folds
Uncalled bet ($1.00) returned to gust
gust: doesn't show hand
gust collected $2.50 from pot
*** SUMMARY ***
Total pot $2.50 | Rake $0
Seat 1: v0landito folded before Flop (didn't bet)
Seat 2: IlxxxlI folded before Flop (didn't bet)
Seat 3: dellindi (button) folded before Flop (didn't bet)
Seat 4: illoke (small blind) folded before Flop
Seat 5: 38979 (big blind) folded before Flop
Seat 6: gust collected ($2.50)

PokerStars Hand #771309398: Hold'em No Limit ($0.25/$0.50 USD) - 2016/11/09 19:11:11 ET
Table 'WPN_2355604438' 6-max  Seat #6 is the button
Seat 2: IlxxxlI ($20.25 in chips)
Seat 3: Karas321 ($20.00 in chips)
Seat 4: Xiniay ($39.93 in chips)
Seat 5: illoke ($57.98 in chips)
Seat 6: dellindi ($48.50 in chips)
IlxxxlI: posts small blind $0.25
Karas321: posts big blind $0.50
*** HOLE CARDS ***
Dealt to IlxxxlI [6c 8s]
Xiniay: folds
illoke: folds
dellindi: raises $1 to $1.50
IlxxxlI: folds
Karas321: folds
Uncalled bet ($1.00) returned to dellindi
dellindi: doesn't show hand
dellindi collected $1.25 from pot
*** SUMMARY ***
Total pot $1.25 | Rake $0
Seat 2: IlxxxlI (small blind) folded before Flop
Seat 3: Karas321 (big blind) folded before Flop
Seat 4: Xiniay folded before Flop (didn't bet)
Seat 5: illoke folded before Flop (didn't bet)
Seat 6: dellindi (button) collected ($1.25)

PokerStars Hand #771309349: Hold'em No Limit ($0.25/$0.50 USD) - 2016/11/09 19:11:06 ET
Table 'WPN_3421571163' 6-max  Seat #2 is the button
Seat 1: IlxxxlI ($20.75 in chips)
Seat 2: thebestvd ($46.20 in chips)
Seat 3: Xiniay ($46.41 in chips)
Seat 4: saidafrente ($52.58 in chips)
Seat 5: Kryuk13 ($54.41 in chips)
Seat 6: v0landito ($98.87 in chips)
Xiniay: posts small blind $0.25
saidafrente: posts big blind $0.50
*** HOLE CARDS ***
Dealt to IlxxxlI [7c Ad]
Kryuk13: folds
v0landito: raises $1 to $1.50
IlxxxlI: folds
thebestvd: folds
Xiniay: folds
saidafrente: folds
Uncalled bet ($1.00) returned to v0landito
v0landito: doesn't show hand
v0landito collected $1.25 from pot
*** SUMMARY ***
Total pot $1.25 | Rake $0
Seat 1: IlxxxlI folded before Flop (didn't bet)
Seat 2: thebestvd (button) folded before Flop (didn't bet)
Seat 3: Xiniay (small blind) folded before Flop
Seat 4: saidafrente (big blind) folded before Flop
Seat 5: Kryuk13 folded before Flop (didn't bet)
Seat 6: v0landito collected ($1.25)

PokerStars Hand #771309276: Hold'em No Limit ($0.25/$0.50 USD) - 2016/11/09 19:10:53 ET
Table 'WPN_2355604438' 6-max  Seat #5 is the button
Seat 2: IlxxxlI ($20.00 in chips)
Seat 3: Karas321 ($20.00 in chips)
Seat 4: Xiniay ($39.93 in chips)
Seat 5: illoke ($57.98 in chips)
Seat 6: dellindi ($48.75 in chips)
dellindi: posts small blind $0.25
IlxxxlI: posts big blind $0.50
*** HOLE CARDS ***
Dealt to IlxxxlI [Qh Ts]
Karas321: folds
Xiniay: folds
illoke: folds
dellindi: folds
Uncalled bet ($0.25) returned to IlxxxlI
IlxxxlI: doesn't show hand
IlxxxlI collected $0.50 from pot
*** SUMMARY ***
Total pot $0.50 | Rake $0
Seat 2: IlxxxlI (big blind) collected ($0.50)
Seat 3: Karas321 folded before Flop (didn't bet)
Seat 4: Xiniay folded before Flop (didn't bet)
Seat 5: illoke (button) folded before Flop (didn't bet)
Seat 6: dellindi (small blind) folded before Flop

PokerStars Hand #771309110: Hold'em No Limit ($0.25/$0.50 USD) - 2016/11/09 19:10:26 ET
Table 'WPN_3421571163' 6-max  Seat #1 is the button
Seat 1: IlxxxlI ($20.00 in chips)
Seat 2: thebestvd ($46.45 in chips)
Seat 3: Xiniay ($46.91 in chips)
Seat 4: saidafrente ($52.58 in chips)
Seat 5: Kryuk13 ($54.41 in chips)
Seat 6: v0landito ($98.87 in chips)
thebestvd: posts small blind $0.25
Xiniay: posts big blind $0.50
*** HOLE CARDS ***
Dealt to IlxxxlI [Kc 9h]
saidafrente: folds
Kryuk13: folds
v0landito: folds
IlxxxlI: raises $1 to $1.50
thebestvd: folds
Xiniay: folds
Uncalled bet ($1.00) returned to IlxxxlI
IlxxxlI: doesn't show hand
IlxxxlI collected $1.25 from pot
*** SUMMARY ***
Total pot $1.25 | Rake $0
Seat 1: IlxxxlI (button) collected ($1.25)
Seat 2: thebestvd (small blind) folded before Flop
Seat 3: Xiniay (big blind) folded before Flop
Seat 4: saidafrente folded before Flop (didn't bet)
Seat 5: Kryuk13 folded before Flop (didn't bet)
Seat 6: v0landito folded before Flop (didn't bet)

PokerStars Hand #771309034: Hold'em No Limit ($0.25/$0.50 USD) - 2016/11/09 19:10:13 ET
Table 'WPN_1341348958' 6-max  Seat #2 is the button
Seat 1: Dikmann ($12.23 in chips)
Seat 2: v0landito ($26.70 in chips)
Seat 3: IlxxxlI ($14.40 in chips)
Seat 4: Xiniay ($37.19 in chips)
Seat 5: PULISPATOLA ($28.83 in chips)
Seat 6: Karas321 ($13.12 in chips)
IlxxxlI: posts small blind $0.25
Xiniay: posts big blind $0.50
*** HOLE CARDS ***
Dealt to IlxxxlI [6s Th]
PULISPATOLA: calls $0.50
Karas321: folds
Dikmann: calls $0.50
v0landito: calls $0.50
IlxxxlI: folds
Xiniay: checks
*** FLOP *** [5c As 6c]
Xiniay: checks
PULISPATOLA: checks
Dikmann: bets $1.07
v0landito: raises $2.43 to $3.50
Xiniay: folds
PULISPATOLA: folds
Dikmann: folds
Uncalled bet ($2.43) returned to v0landito
v0landito: doesn't show hand
v0landito collected $4.18 from pot
*** SUMMARY ***
Total pot $4.39 | Rake $0.21
Board [5c As 6c]
Seat 1: Dikmann folded on the Flop
Seat 2: v0landito (button) collected ($4.18)
Seat 3: IlxxxlI (small blind) folded before Flop
Seat 4: Xiniay (big blind) folded on the Flop
Seat 5: PULISPATOLA folded on the Flop
Seat 6: Karas321 folded before Flop (didn't bet)

PokerStars Hand #771308975: Hold'em No Limit ($0.25/$0.50 USD) - 2016/11/09 19:10:03 ET
Table 'WPN_3219946394' 6-max  Seat #6 is the button
Seat 1: illoke ($52.34 in chips)
Seat 2: IlxxxlI ($22.64 in chips)
Seat 3: v0landito ($55.32 in chips)
Seat 4: dudu777 ($23.08 in chips)
Seat 5: Xiniay ($52.52 in chips)
Seat 6: 38979 ($101.04 in chips)
illoke: posts small blind $0.25
IlxxxlI: posts big blind $0.50
*** HOLE CARDS ***
Dealt to IlxxxlI [Qd Jc]
v0landito: folds
dudu777: raises $1.50 to $2
Xiniay: raises $4.50 to $6.50
38979: folds
illoke: folds
IlxxxlI: folds
dudu777: folds
Uncalled bet ($4.50) returned to Xiniay
Xiniay: doesn't show hand
Xiniay collected $4.75 from pot
*** SUMMARY ***
Total pot $4.75 | Rake $0
Seat 1: illoke (small blind) folded before Flop
Seat 2: IlxxxlI (big blind) folded before Flop
Seat 3: v0landito folded before Flop (didn't bet)
Seat 4: dudu777 folded before Flop
Seat 5: Xiniay collected ($4.75)
Seat 6: 38979 (button) folded before Flop (didn't bet)

PokerStars Hand #771308972: Hold'em No Limit ($0.25/$0.50 USD) - 2016/11/09 19:10:03 ET
Table 'WPN_3421571163' 6-max  Seat #6 is the button
Seat 1: IlxxxlI ($20.00 in chips)
Seat 2: thebestvd ($46.95 in chips)
Seat 3: Xiniay ($46.91 in chips)
Seat 4: saidafrente ($51.83 in chips)
Seat 5: Kryuk13 ($54.41 in chips)
Seat 6: v0landito ($98.87 in chips)
IlxxxlI: posts small blind $0.25
thebestvd: posts big blind $0.50
*** HOLE CARDS ***
Dealt to IlxxxlI [3c Ac]
Xiniay: folds
saidafrente: raises $1 to $1.50
Kryuk13: folds
v0landito: folds
IlxxxlI: folds
thebestvd: folds
Uncalled bet ($1.00) returned to saidafrente
saidafrente: doesn't show hand
saidafrente collected $1.25 from pot
*** SUMMARY ***
Total pot $1.25 | Rake $0
Seat 1: IlxxxlI (small blind) folded before Flop
Seat 2: thebestvd (big blind) folded before Flop
Seat 3: Xiniay folded before Flop (didn't bet)
Seat 4: saidafrente collected ($1.25)
Seat 5: Kryuk13 folded before Flop (didn't bet)
Seat 6: v0landito (button) folded before Flop (didn't bet)

PokerStars Hand #771308961: Hold'em No Limit ($0.50/$1.00 USD) - 2016/11/09 19:10:01 ET
Table 'WPN_2128003642' 6-max  Seat #2 is the button
Seat 1: v0landito ($278.61 in chips)
Seat 2: IlxxxlI ($40.00 in chips)
Seat 3: dellindi ($133.52 in chips)
Seat 4: illoke ($111.69 in chips)
Seat 5: 38979 ($181.20 in chips)
Seat 6: gust ($40.00 in chips)
dellindi: posts small blind $0.50
illoke: posts big blind $1
*** HOLE CARDS ***
Dealt to IlxxxlI [9c Kh]
38979: raises $2 to $3
gust: folds
v0landito: folds
IlxxxlI: folds
dellindi: calls $2.50
illoke: folds
*** FLOP *** [Qc 5c 6s]
dellindi: checks
38979: bets $4
dellindi: folds
Uncalled bet ($4.00) returned to 38979
38979: doesn't show hand
38979 collected $6.65 from pot
*** SUMMARY ***
Total pot $7 | Rake $0.35
Board [Qc 5c 6s]
Seat 1: v0landito folded before Flop (didn't bet)
Seat 2: IlxxxlI (button) folded before Flop (didn't bet)
Seat 3: dellindi (small blind) folded on the Flop
Seat 4: illoke (big blind) folded before Flop
Seat 5: 38979 collected ($6.65)
Seat 6: gust folded before Flop (didn't bet)

PokerStars Hand #771308636: Hold'em No Limit ($0.25/$0.50 USD) - 2016/11/09 19:09:07 ET
Table 'WPN_3421571163' 6-max  Seat #5 is the button
Seat 1: IlxxxlI ($20.75 in chips)
Seat 2: thebestvd ($46.95 in chips)
Seat 3: Xiniay ($46.91 in chips)
Seat 4: saidafrente ($51.83 in chips)
Seat 5: Kryuk13 ($50.75 in chips)
Seat 6: v0landito ($99.12 in chips)
v0landito: posts small blind $0.25
IlxxxlI: posts big blind $0.50
*** HOLE CARDS ***
Dealt to IlxxxlI [Ks Kc]
thebestvd: folds
Xiniay: folds
saidafrente: folds
Kryuk13: raises $1 to $1.50
v0landito: folds
IlxxxlI: raises $2.30 to $3.80
Kryuk13: calls $2.30
*** FLOP *** [Td Ah 9s]
IlxxxlI: checks
Kryuk13: bets $4.97
IlxxxlI: folds
Uncalled bet ($4.97) returned to Kryuk13
Kryuk13: doesn't show hand
Kryuk13 collected $7.46 from pot
*** SUMMARY ***
Total pot $7.85 | Rake $0.39
Board [Td Ah 9s]
Seat 1: IlxxxlI (big blind) folded on the Flop
Seat 2: thebestvd folded before Flop (didn't bet)
Seat 3: Xiniay folded before Flop (didn't bet)
Seat 4: saidafrente folded before Flop (didn't bet)
Seat 5: Kryuk13 (button) collected ($7.46)
Seat 6: v0landito (small blind) folded before Flop

PokerStars Hand #771308588: Hold'em No Limit ($0.50/$1.00 USD) - 2016/11/09 19:09:01 ET
Table 'WPN_2128003642' 6-max  Seat #1 is the button
Seat 1: v0landito ($278.61 in chips)
Seat 2: IlxxxlI ($40.00 in chips)
Seat 3: dellindi ($136.52 in chips)
Seat 4: illoke ($108.51 in chips)
Seat 5: 38979 ($181.20 in chips)
Seat 6: gust ($40.00 in chips)
IlxxxlI: posts small blind $0.50
dellindi: posts big blind $1
*** HOLE CARDS ***
Dealt to IlxxxlI [Js Ts]
illoke: raises $2 to $3
38979: folds
gust: folds
v0landito: folds
IlxxxlI: folds
dellindi: calls $2
*** FLOP *** [Th Qs 7c]
dellindi: checks
illoke: bets $3.09
dellindi: folds
Uncalled bet ($3.09) returned to illoke
illoke: doesn't show hand
illoke collected $6.18 from pot
*** SUMMARY ***
Total pot $6.50 | Rake $0.32
Board [Th Qs 7c]
Seat 1: v0landito (button) folded before Flop (didn't bet)
Seat 2: IlxxxlI (small blind) folded before Flop
Seat 3: dellindi (big blind) folded on the Flop
Seat 4: illoke collected ($6.18)
Seat 5: 38979 folded before Flop (didn't bet)
Seat 6: gust folded before Flop (didn't bet)

PokerStars Hand #771308581: Hold'em No Limit ($0.25/$0.50 USD) - 2016/11/09 19:08:59 ET
Table 'WPN_1341348958' 6-max  Seat #1 is the button
Seat 1: Dikmann ($12.23 in chips)
Seat 2: v0landito ($27.20 in chips)
Seat 3: IlxxxlI ($17.82 in chips)
Seat 4: Xiniay ($37.19 in chips)
Seat 5: PULISPATOLA ($25.27 in chips)
Seat 6: Karas321 ($13.12 in chips)
v0landito: posts small blind $0.25
IlxxxlI: posts big blind $0.50
*** HOLE CARDS ***
Dealt to IlxxxlI [Qd Tc]
Xiniay: folds
PULISPATOLA: calls $0.50
Karas321: folds
Dikmann: folds
v0landito: calls $0.25
IlxxxlI: raises $1.50 to $2
PULISPATOLA: calls $1.50
v0landito: folds
*** FLOP *** [9s 8d 2s]
IlxxxlI: bets $1.42
PULISPATOLA: raises $21.85 to $23.27 and is all-in
IlxxxlI: folds
Uncalled bet ($21.85) returned to PULISPATOLA
PULISPATOLA: doesn't show hand
PULISPATOLA collected $6.98 from pot
*** SUMMARY ***
Total pot $7.34 | Rake $0.36
Board [9s 8d 2s]
Seat 1: Dikmann (button) folded before Flop (didn't bet)
Seat 2: v0landito (small blind) folded before Flop
Seat 3: IlxxxlI (big blind) folded on the Flop
Seat 4: Xiniay folded before Flop (didn't bet)
Seat 5: PULISPATOLA collected ($6.98)
Seat 6: Karas321 folded before Flop (didn't bet)

PokerStars Hand #771308362: Hold'em No Limit ($0.25/$0.50 USD) - 2016/11/09 19:08:27 ET
Table 'WPN_3219946394' 6-max  Seat #5 is the button
Seat 1: illoke ($52.84 in chips)
Seat 2: IlxxxlI ($22.64 in chips)
Seat 3: v0landito ($51.64 in chips)
Seat 4: dudu777 ($23.08 in chips)
Seat 5: Xiniay ($55.81 in chips)
Seat 6: 38979 ($101.29 in chips)
38979: posts small blind $0.25
illoke: posts big blind $0.50
*** HOLE CARDS ***
Dealt to IlxxxlI [4c Jh]
IlxxxlI: folds
v0landito: raises $1 to $1.50
dudu777: folds
Xiniay: calls $1.50
38979: folds
illoke: folds
*** FLOP *** [9h 6c Kd]
v0landito: bets $1.79
Xiniay: calls $1.79
*** TURN *** [9h 6c Kd] [5d]
v0landito: bets $3.49
Xiniay: folds
Uncalled bet ($3.49) returned to v0landito
v0landito: doesn't show hand
v0landito collected $6.97 from pot
*** SUMMARY ***
Total pot $7.33 | Rake $0.36
Board [9h 6c Kd 5d]
Seat 1: illoke (big blind) folded before Flop
Seat 2: IlxxxlI folded before Flop (didn't bet)
Seat 3: v0landito collected ($6.97)
Seat 4: dudu777 folded before Flop (didn't bet)
Seat 5: Xiniay (button) folded on the Turn
Seat 6: 38979 (small blind) folded before Flop

PokerStars Hand #771308351: Hold'em No Limit ($0.25/$0.50 USD) - 2016/11/09 19:08:25 ET
Table 'WPN_3421571163' 6-max  Seat #4 is the button
Seat 1: IlxxxlI ($20.00 in chips)
Seat 2: thebestvd ($46.95 in chips)
Seat 3: Xiniay ($46.91 in chips)
Seat 4: saidafrente ($51.83 in chips)
Seat 5: Kryuk13 ($51.00 in chips)
Seat 6: v0landito ($99.62 in chips)
Kryuk13: posts small blind $0.25
v0landito: posts big blind $0.50
*** HOLE CARDS ***
Dealt to IlxxxlI [Ad Kc]
IlxxxlI: raises $1.25 to $1.75
thebestvd: folds
Xiniay: folds
saidafrente: folds
Kryuk13: folds
v0landito: folds
Uncalled bet ($1.25) returned to IlxxxlI
IlxxxlI: doesn't show hand
IlxxxlI collected $1.25 from pot
*** SUMMARY ***
Total pot $1.25 | Rake $0
Seat 1: IlxxxlI collected ($1.25)
Seat 2: thebestvd folded before Flop (didn't bet)
Seat 3: Xiniay folded before Flop (didn't bet)
Seat 4: saidafrente (button) folded before Flop (didn't bet)
Seat 5: Kryuk13 (small blind) folded before Flop
Seat 6: v0landito (big blind) folded before Flop

PokerStars Hand #771308229: Hold'em No Limit ($0.25/$0.50 USD) - 2016/11/09 19:08:06 ET
Table 'WPN_1341348958' 6-max  Seat #6 is the button
Seat 1: Dikmann ($12.48 in chips)
Seat 2: v0landito ($25.95 in chips)
Seat 3: IlxxxlI ($17.82 in chips)
Seat 4: Xiniay ($37.19 in chips)
Seat 5: PULISPATOLA ($25.27 in chips)
Seat 6: Karas321 ($14.12 in chips)
Dikmann: posts small blind $0.25
v0landito: posts big blind $0.50
*** HOLE CARDS ***
Dealt to IlxxxlI [5d 7h]
IlxxxlI: folds
Xiniay: folds
PULISPATOLA: folds
Karas321: raises $0.50 to $1
Dikmann: folds
v0landito: raises $24.95 to $25.95 and is all-in
Karas321: folds
Uncalled bet ($24.95) returned to v0landito
v0landito: doesn't show hand
v0landito collected $2.25 from pot
*** SUMMARY ***
Total pot $2.25 | Rake $0
Seat 1: Dikmann (small blind) folded before Flop
Seat 2: v0landito (big blind) collected ($2.25)
Seat 3: IlxxxlI folded before Flop (didn't bet)
Seat 4: Xiniay folded before Flop (didn't bet)
Seat 5: PULISPATOLA folded before Flop (didn't bet)
Seat 6: Karas321 (button) folded before Flop

PokerStars Hand #771308214: Hold'em No Limit ($0.50/$1.00 USD) - 2016/11/09 19:08:01 ET
Table 'WPN_2128003642' 6-max  Seat #6 is the button
Seat 1: v0landito ($277.61 in chips)
Seat 2: IlxxxlI ($40.00 in chips)
Seat 4: illoke ($108.51 in chips)
Seat 5: 38979 ($181.20 in chips)
Seat 6: gust ($40.00 in chips)
v0landito: posts small blind $0.50
IlxxxlI: posts big blind $1
*** HOLE CARDS ***
Dealt to IlxxxlI [Kc 4d]
illoke: folds
38979: folds
gust: folds
v0landito: raises $2 to $3
IlxxxlI: folds
Uncalled bet ($2.00) returned to v0landito
v0landito: doesn't show hand
v0landito collected $2 from pot
*** SUMMARY ***
Total pot $2 | Rake $0
Seat 1: v0landito (small blind) collected ($2)
Seat 2: IlxxxlI (big blind) folded before Flop
Seat 4: illoke folded before Flop (didn't bet)
Seat 5: 38979 folded before Flop (didn't bet)
Seat 6: gust (button) folded before Flop (didn't bet)

PokerStars Hand #771308149: Hold'em No Limit ($0.25/$0.50 USD) - 2016/11/09 19:07:51 ET
Table 'WPN_3421571163' 6-max  Seat #3 is the button
Seat 1: IlxxxlI ($20.00 in chips)
Seat 2: thebestvd ($46.95 in chips)
Seat 3: Xiniay ($46.91 in chips)
Seat 4: saidafrente ($51.33 in chips)
Seat 5: Kryuk13 ($51.50 in chips)
Seat 6: v0landito ($99.62 in chips)
saidafrente: posts small blind $0.25
Kryuk13: posts big blind $0.50
*** HOLE CARDS ***
Dealt to IlxxxlI [9s 6d]
v0landito: folds
IlxxxlI: folds
thebestvd: folds
Xiniay: folds
saidafrente: raises $1 to $1.50
Kryuk13: folds
Uncalled bet ($1.00) returned to saidafrente
saidafrente: doesn't show hand
saidafrente collected $1 from pot
*** SUMMARY ***
Total pot $1 | Rake $0
Seat 1: IlxxxlI folded before Flop (didn't bet)
Seat 2: thebestvd folded before Flop (didn't bet)
Seat 3: Xiniay (button) folded before Flop (didn't bet)
Seat 4: saidafrente (small blind) collected ($1)
Seat 5: Kryuk13 (big blind) folded before Flop
Seat 6: v0landito folded before Flop (didn't bet)

PokerStars Hand #771308002: Hold'em No Limit ($0.25/$0.50 USD) - 2016/11/09 19:07:30 ET
Table 'WPN_3219946394' 6-max  Seat #4 is the button
Seat 1: illoke ($52.84 in chips)
Seat 2: IlxxxlI ($22.64 in chips)
Seat 3: v0landito ($51.64 in chips)
Seat 4: dudu777 ($23.08 in chips)
Seat 5: Xiniay ($54.46 in chips)
Seat 6: 38979 ($102.79 in chips)
Xiniay: posts small blind $0.25
38979: posts big blind $0.50
*** HOLE CARDS ***
Dealt to IlxxxlI [Jh 6h]
illoke: folds
IlxxxlI: folds
v0landito: folds
dudu777: folds
Xiniay: raises $1 to $1.50
38979: calls $1
*** FLOP *** [4s Qh 9h]
Xiniay: bets $0.95
38979: folds
Uncalled bet ($0.95) returned to Xiniay
Xiniay: doesn't show hand
Xiniay collected $2.85 from pot
*** SUMMARY ***
Total pot $3 | Rake $0.15
Board [4s Qh 9h]
Seat 1: illoke folded before Flop (didn't bet)
Seat 2: IlxxxlI folded before Flop (didn't bet)
Seat 3: v0landito folded before Flop (didn't bet)
Seat 4: dudu777 (button) folded before Flop (didn't bet)
Seat 5: Xiniay (small blind) collected ($2.85)
Seat 6: 38979 (big blind) folded on the Flop

PokerStars Hand #771307990: Hold'em No Limit ($0.25/$0.50 USD) - 2016/11/09 19:07:27 ET
Table 'WPN_1341348958' 6-max  Seat #5 is the button
Seat 1: Dikmann ($12.23 in chips)
Seat 2: v0landito ($25.95 in chips)
Seat 3: IlxxxlI ($17.82 in chips)
Seat 4: Xiniay ($37.19 in chips)
Seat 5: PULISPATOLA ($25.27 in chips)
Seat 6: Karas321 ($14.37 in chips)
Karas321: posts small blind $0.25
Dikmann: posts big blind $0.50
*** HOLE CARDS ***
Dealt to IlxxxlI [4h Ts]
v0landito: folds
IlxxxlI: folds
Xiniay: folds
PULISPATOLA: folds
Karas321: folds
Uncalled bet ($0.25) returned to Dikmann
Dikmann: doesn't show hand
Dikmann collected $0.50 from pot
*** SUMMARY ***
Total pot $0.50 | Rake $0
Seat 1: Dikmann (big blind) collected ($0.50)
Seat 2: v0landito folded before Flop (didn't bet)
Seat 3: IlxxxlI folded before Flop (didn't bet)
Seat 4: Xiniay folded before Flop (didn't bet)
Seat 5: PULISPATOLA (button) folded before Flop (didn't bet)
Seat 6: Karas321 (small blind) folded before Flop

PokerStars Hand #771307652: Hold'em No Limit ($0.25/$0.50 USD) - 2016/11/09 19:06:45 ET
Table 'WPN_1341348958' 6-max  Seat #4 is the button
Seat 1: Dikmann ($12.23 in chips)
Seat 2: v0landito ($25.20 in chips)
Seat 3: IlxxxlI ($17.82 in chips)
Seat 4: Xiniay ($37.19 in chips)
Seat 5: PULISPATOLA ($25.52 in chips)
Seat 6: Karas321 ($14.87 in chips)
PULISPATOLA: posts small blind $0.25
Karas321: posts big blind $0.50
*** HOLE CARDS ***
Dealt to IlxxxlI [3c 8h]
Dikmann: folds
v0landito: raises $1 to $1.50
IlxxxlI: folds
Xiniay: folds
PULISPATOLA: folds
Karas321: folds
Uncalled bet ($1.00) returned to v0landito
v0landito: doesn't show hand
v0landito collected $1.25 from pot
*** SUMMARY ***
Total pot $1.25 | Rake $0
Seat 1: Dikmann folded before Flop (didn't bet)
Seat 2: v0landito collected ($1.25)
Seat 3: IlxxxlI folded before Flop (didn't bet)
Seat 4: Xiniay (button) folded before Flop (didn't bet)
Seat 5: PULISPATOLA (small blind) folded before Flop
Seat 6: Karas321 (big blind) folded before Flop

PokerStars Hand #771307659: Hold'em No Limit ($0.25/$0.50 USD) - 2016/11/09 19:06:36 ET
Table 'WPN_3421571163' 6-max  Seat #2 is the button
Seat 1: IlxxxlI ($22.03 in chips)
Seat 2: thebestvd ($46.95 in chips)
Seat 3: Xiniay ($47.16 in chips)
Seat 4: saidafrente ($49.25 in chips)
Seat 5: Kryuk13 ($51.50 in chips)
Seat 6: v0landito ($99.62 in chips)
Xiniay: posts small blind $0.25
saidafrente: posts big blind $0.50
*** HOLE CARDS ***
Dealt to IlxxxlI [Tc Kh]
Kryuk13: folds
v0landito: folds
IlxxxlI: raises $0.70 to $1.20
thebestvd: folds
Xiniay: folds
saidafrente: calls $0.70
*** FLOP *** [7s 6s 3s]
saidafrente: checks
IlxxxlI: checks
*** TURN *** [7s 6s 3s] [Qh]
saidafrente: checks
IlxxxlI: bets $0.84
saidafrente: calls $0.84
*** RIVER *** [7s 6s 3s Qh] [3h]
saidafrente: checks
IlxxxlI: checks
*** SHOW DOWN ***
IlxxxlI: shows [Tc Kh] (One pair of 3s)
saidafrente: shows [Qd Js] (Two pairs. Qs and 3s)
saidafrente collected $4.12 from pot
*** SUMMARY ***
Total pot $4.33 | Rake $0.21
Board [7s 6s 3s Qh 3h]
Seat 1: IlxxxlI showed [Tc Kh] and lost with One pair of 3s
Seat 2: thebestvd (button) folded before Flop (didn't bet)
Seat 3: Xiniay (small blind) folded before Flop
Seat 4: saidafrente (big blind) showed [Qd Js] and won ($4.12) with Two pairs. Qs and 3s
Seat 5: Kryuk13 folded before Flop (didn't bet)
Seat 6: v0landito folded before Flop (didn't bet)

PokerStars Hand #771307479: Hold'em No Limit ($0.25/$0.50 USD) - 2016/11/09 19:06:11 ET
Table 'WPN_3219946394' 6-max  Seat #3 is the button
Seat 1: illoke ($52.84 in chips)
Seat 2: IlxxxlI ($22.64 in chips)
Seat 3: v0landito ($50.50 in chips)
Seat 4: dudu777 ($23.33 in chips)
Seat 5: Xiniay ($55.46 in chips)
Seat 6: 38979 ($102.79 in chips)
dudu777: posts small blind $0.25
Xiniay: posts big blind $0.50
*** HOLE CARDS ***
Dealt to IlxxxlI [7c 6h]
38979: folds
illoke: folds
IlxxxlI: folds
v0landito: raises $0.50 to $1
dudu777: folds
Xiniay: calls $0.50
*** FLOP *** [6d Jc Js]
Xiniay: checks
v0landito: bets $1.07
Xiniay: folds
Uncalled bet ($1.07) returned to v0landito
v0landito: doesn't show hand
v0landito collected $2.14 from pot
*** SUMMARY ***
Total pot $2.25 | Rake $0.11
Board [6d Jc Js]
Seat 1: illoke folded before Flop (didn't bet)
Seat 2: IlxxxlI folded before Flop (didn't bet)
Seat 3: v0landito (button) collected ($2.14)
Seat 4: dudu777 (small blind) folded before Flop
Seat 5: Xiniay (big blind) folded on the Flop
Seat 6: 38979 folded before Flop (didn't bet)

PokerStars Hand #771307354: Hold'em No Limit ($0.25/$0.50 USD) - 2016/11/09 19:05:47 ET
Table 'WPN_3421571163' 6-max  Seat #1 is the button
Seat 1: IlxxxlI ($22.03 in chips)
Seat 2: thebestvd ($47.20 in chips)
Seat 3: Xiniay ($46.91 in chips)
Seat 5: Kryuk13 ($51.50 in chips)
Seat 6: v0landito ($99.62 in chips)
thebestvd: posts small blind $0.25
Xiniay: posts big blind $0.50
*** HOLE CARDS ***
Dealt to IlxxxlI [Qs 7h]
Kryuk13: folds
v0landito: folds
IlxxxlI: folds
thebestvd: folds
Uncalled bet ($0.25) returned to Xiniay
Xiniay: doesn't show hand
Xiniay collected $0.50 from pot
*** SUMMARY ***
Total pot $0.50 | Rake $0
Seat 1: IlxxxlI (button) folded before Flop (didn't bet)
Seat 2: thebestvd (small blind) folded before Flop
Seat 3: Xiniay (big blind) collected ($0.50)
Seat 5: Kryuk13 folded before Flop (didn't bet)
Seat 6: v0landito folded before Flop (didn't bet)

PokerStars Hand #771307257: Hold'em No Limit ($0.25/$0.50 USD) - 2016/11/09 19:05:31 ET
Table 'WPN_3219946394' 6-max  Seat #2 is the button
Seat 1: illoke ($54.34 in chips)
Seat 2: IlxxxlI ($20.39 in chips)
Seat 3: v0landito ($50.75 in chips)
Seat 4: dudu777 ($23.83 in chips)
Seat 5: Xiniay ($55.46 in chips)
Seat 6: 38979 ($102.79 in chips)
v0landito: posts small blind $0.25
dudu777: posts big blind $0.50
*** HOLE CARDS ***
Dealt to IlxxxlI [Ah Jc]
Xiniay: folds
38979: folds
illoke: raises $1 to $1.50
IlxxxlI: raises $2.14 to $3.64
v0landito: folds
dudu777: folds
illoke: folds
Uncalled bet ($2.14) returned to IlxxxlI
IlxxxlI: doesn't show hand
IlxxxlI collected $3.75 from pot
*** SUMMARY ***
Total pot $3.75 | Rake $0
Seat 1: illoke folded before Flop
Seat 2: IlxxxlI (button) collected ($3.75)
Seat 3: v0landito (small blind) folded before Flop
Seat 4: dudu777 (big blind) folded before Flop
Seat 5: Xiniay folded before Flop (didn't bet)
Seat 6: 38979 folded before Flop (didn't bet)

PokerStars Hand #771307054: Hold'em No Limit ($0.25/$0.50 USD) - 2016/11/09 19:05:01 ET
Table 'WPN_3421571163' 6-max  Seat #6 is the button
Seat 1: IlxxxlI ($22.28 in chips)
Seat 2: thebestvd ($45.95 in chips)
Seat 3: Xiniay ($46.91 in chips)
Seat 5: Kryuk13 ($51.50 in chips)
Seat 6: v0landito ($100.62 in chips)
IlxxxlI: posts small blind $0.25
thebestvd: posts big blind $0.50
*** HOLE CARDS ***
Dealt to IlxxxlI [Th 6d]
Xiniay: folds
Kryuk13: folds
v0landito: raises $0.50 to $1
IlxxxlI: folds
thebestvd: raises $8 to $9
v0landito: folds
Uncalled bet ($8.00) returned to thebestvd
thebestvd: doesn't show hand
thebestvd collected $2.25 from pot
*** SUMMARY ***
Total pot $2.25 | Rake $0
Seat 1: IlxxxlI (small blind) folded before Flop
Seat 2: thebestvd (big blind) collected ($2.25)
Seat 3: Xiniay folded before Flop (didn't bet)
Seat 5: Kryuk13 folded before Flop (didn't bet)
Seat 6: v0landito (button) folded before Flop

PokerStars Hand #771307001: Hold'em No Limit ($0.25/$0.50 USD) - 2016/11/09 19:04:53 ET
Table 'WPN_1341348958' 6-max  Seat #3 is the button
Seat 1: Dikmann ($9.50 in chips)
Seat 2: v0landito ($25.20 in chips)
Seat 3: IlxxxlI ($17.82 in chips)
Seat 4: Xiniay ($39.69 in chips)
Seat 5: PULISPATOLA ($26.02 in chips)
Seat 6: Karas321 ($14.87 in chips)
Xiniay: posts small blind $0.25
PULISPATOLA: posts big blind $0.50
*** HOLE CARDS ***
Dealt to IlxxxlI [Kd 7s]
Karas321: folds
Dikmann: calls $0.50
v0landito: folds
IlxxxlI: folds
Xiniay: raises $1.50 to $2
PULISPATOLA: folds
Dikmann: calls $1.50
*** FLOP *** [8h Jh Qc]
Xiniay: checks
Dikmann: checks
*** TURN *** [8h Jh Qc] [3s]
Xiniay: checks
Dikmann: bets $0.50
Xiniay: calls $0.50
*** RIVER *** [8h Jh Qc 3s] [7h]
Xiniay: checks
Dikmann: bets $1.74
Xiniay: folds
Uncalled bet ($1.74) returned to Dikmann
Dikmann: doesn't show hand
Dikmann collected $5.23 from pot
*** SUMMARY ***
Total pot $5.50 | Rake $0.27
Board [8h Jh Qc 3s 7h]
Seat 1: Dikmann collected ($5.23)
Seat 2: v0landito folded before Flop (didn't bet)
Seat 3: IlxxxlI (button) folded before Flop (didn't bet)
Seat 4: Xiniay (small blind) folded on the River
Seat 5: PULISPATOLA (big blind) folded before Flop
Seat 6: Karas321 folded before Flop (didn't bet)

PokerStars Hand #771306897: Hold'em No Limit ($0.25/$0.50 USD) - 2016/11/09 19:04:37 ET
Table 'WPN_3421571163' 6-max  Seat #5 is the button
Seat 1: IlxxxlI ($22.78 in chips)
Seat 2: thebestvd ($45.20 in chips)
Seat 3: Xiniay ($46.91 in chips)
Seat 5: Kryuk13 ($51.50 in chips)
Seat 6: v0landito ($100.87 in chips)
v0landito: posts small blind $0.25
IlxxxlI: posts big blind $0.50
*** HOLE CARDS ***
Dealt to IlxxxlI [4d 7h]
thebestvd: raises $2.50 to $3
Xiniay: folds
Kryuk13: folds
v0landito: folds
IlxxxlI: folds
Uncalled bet ($2.50) returned to thebestvd
thebestvd: doesn't show hand
thebestvd collected $1.25 from pot
*** SUMMARY ***
Total pot $1.25 | Rake $0
Seat 1: IlxxxlI (big blind) folded before Flop
Seat 2: thebestvd collected ($1.25)
Seat 3: Xiniay folded before Flop (didn't bet)
Seat 5: Kryuk13 (button) folded before Flop (didn't bet)
Seat 6: v0landito (small blind) folded before Flop

PokerStars Hand #771306797: Hold'em No Limit ($0.25/$0.50 USD) - 2016/11/09 19:04:19 ET
Table 'WPN_3421571163' 6-max  Seat #3 is the button
Seat 1: IlxxxlI ($22.78 in chips)
Seat 2: thebestvd ($45.20 in chips)
Seat 3: Xiniay ($46.91 in chips)
Seat 5: Kryuk13 ($51.75 in chips)
Seat 6: v0landito ($100.62 in chips)
Kryuk13: posts small blind $0.25
v0landito: posts big blind $0.50
*** HOLE CARDS ***
Dealt to IlxxxlI [Qc 5c]
IlxxxlI: folds
thebestvd: folds
Xiniay: folds
Kryuk13: folds
Uncalled bet ($0.25) returned to v0landito
v0landito: doesn't show hand
v0landito collected $0.50 from pot
*** SUMMARY ***
Total pot $0.50 | Rake $0
Seat 1: IlxxxlI folded before Flop (didn't bet)
Seat 2: thebestvd folded before Flop (didn't bet)
Seat 3: Xiniay (button) folded before Flop (didn't bet)
Seat 5: Kryuk13 (small blind) folded before Flop
Seat 6: v0landito (big blind) collected ($0.50)

PokerStars Hand #771306760: Hold'em No Limit ($0.25/$0.50 USD) - 2016/11/09 19:04:12 ET
Table 'WPN_3219946394' 6-max  Seat #1 is the button
Seat 1: illoke ($54.34 in chips)
Seat 2: IlxxxlI ($20.64 in chips)
Seat 3: v0landito ($51.25 in chips)
Seat 4: dudu777 ($24.33 in chips)
Seat 5: Xiniay ($54.21 in chips)
Seat 6: 38979 ($102.79 in chips)
IlxxxlI: posts small blind $0.25
v0landito: posts big blind $0.50
*** HOLE CARDS ***
Dealt to IlxxxlI [Qh 7h]
dudu777: calls $0.50
Xiniay: raises $1.50 to $2
38979: folds
illoke: folds
IlxxxlI: folds
v0landito: folds
dudu777: folds
Uncalled bet ($1.50) returned to Xiniay
Xiniay: doesn't show hand
Xiniay collected $1.75 from pot
*** SUMMARY ***
Total pot $1.75 | Rake $0
Seat 1: illoke (button) folded before Flop (didn't bet)
Seat 2: IlxxxlI (small blind) folded before Flop
Seat 3: v0landito (big blind) folded before Flop
Seat 4: dudu777 folded before Flop
Seat 5: Xiniay collected ($1.75)
Seat 6: 38979 folded before Flop (didn't bet)

PokerStars Hand #771306654: Hold'em No Limit ($0.25/$0.50 USD) - 2016/11/09 19:03:56 ET
Table 'WPN_1341348958' 6-max  Seat #2 is the button
Seat 1: Dikmann ($10.00 in chips)
Seat 2: v0landito ($25.20 in chips)
Seat 3: IlxxxlI ($18.07 in chips)
Seat 4: Xiniay ($40.19 in chips)
Seat 5: PULISPATOLA ($26.02 in chips)
Seat 6: Karas321 ($13.62 in chips)
IlxxxlI: posts small blind $0.25
Xiniay: posts big blind $0.50
Dikmann: posts big blind $0.50
*** HOLE CARDS ***
Dealt to IlxxxlI [6s Qs]
PULISPATOLA: folds
Karas321: raises $1 to $1.50
Dikmann: folds
v0landito: folds
IlxxxlI: folds
Xiniay: folds
Uncalled bet ($1.00) returned to Karas321
Karas321: doesn't show hand
Karas321 collected $1.75 from pot
*** SUMMARY ***
Total pot $1.75 | Rake $0
Seat 1: Dikmann folded before Flop
Seat 2: v0landito (button) folded before Flop (didn't bet)
Seat 3: IlxxxlI (small blind) folded before Flop
Seat 4: Xiniay (big blind) folded before Flop
Seat 5: PULISPATOLA folded before Flop (didn't bet)
Seat 6: Karas321 collected ($1.75)

PokerStars Hand #771306614: Hold'em No Limit ($0.25/$0.50 USD) - 2016/11/09 19:03:50 ET
Table 'WPN_3421571163' 6-max  Seat #2 is the button
Seat 1: IlxxxlI ($22.78 in chips)
Seat 2: thebestvd ($45.20 in chips)
Seat 3: Xiniay ($47.16 in chips)
Seat 5: Kryuk13 ($52.25 in chips)
Seat 6: v0landito ($99.87 in chips)
Xiniay: posts small blind $0.25
Kryuk13: posts big blind $0.50
*** HOLE CARDS ***
Dealt to IlxxxlI [Jh Tc]
v0landito: raises $1 to $1.50
IlxxxlI: folds
thebestvd: folds
Xiniay: folds
Kryuk13: folds
Uncalled bet ($1.00) returned to v0landito
v0landito: doesn't show hand
v0landito collected $1.25 from pot
*** SUMMARY ***
Total pot $1.25 | Rake $0
Seat 1: IlxxxlI folded before Flop (didn't bet)
Seat 2: thebestvd (button) folded before Flop (didn't bet)
Seat 3: Xiniay (small blind) folded before Flop
Seat 5: Kryuk13 (big blind) folded before Flop
Seat 6: v0landito collected ($1.25)

PokerStars Hand #771306454: Hold'em No Limit ($0.25/$0.50 USD) - 2016/11/09 19:03:23 ET
Table 'WPN_3421571163' 6-max  Seat #1 is the button
Seat 1: IlxxxlI ($22.78 in chips)
Seat 2: thebestvd ($44.70 in chips)
Seat 3: Xiniay ($47.66 in chips)
Seat 5: Kryuk13 ($52.25 in chips)
Seat 6: v0landito ($99.87 in chips)
thebestvd: posts small blind $0.25
Xiniay: posts big blind $0.50
*** HOLE CARDS ***
Dealt to IlxxxlI [2h 4h]
Kryuk13: folds
v0landito: folds
IlxxxlI: folds
thebestvd: raises $2.50 to $3
Xiniay: folds
Uncalled bet ($2.50) returned to thebestvd
thebestvd: doesn't show hand
thebestvd collected $1 from pot
*** SUMMARY ***
Total pot $1 | Rake $0
Seat 1: IlxxxlI (button) folded before Flop (didn't bet)
Seat 2: thebestvd (small blind) collected ($1)
Seat 3: Xiniay (big blind) folded before Flop
Seat 5: Kryuk13 folded before Flop (didn't bet)
Seat 6: v0landito folded before Flop (didn't bet)

PokerStars Hand #771306391: Hold'em No Limit ($0.25/$0.50 USD) - 2016/11/09 19:03:15 ET
Table 'WPN_1341348958' 6-max  Seat #6 is the button
Seat 2: v0landito ($25.45 in chips)
Seat 3: IlxxxlI ($19.07 in chips)
Seat 4: Xiniay ($40.19 in chips)
Seat 5: PULISPATOLA ($26.02 in chips)
Seat 6: Karas321 ($12.48 in chips)
v0landito: posts small blind $0.25
IlxxxlI: posts big blind $0.50
*** HOLE CARDS ***
Dealt to IlxxxlI [9h Th]
Xiniay: folds
PULISPATOLA: folds
Karas321: raises $0.50 to $1
v0landito: folds
IlxxxlI: calls $0.50
*** FLOP *** [8c Kc 2s]
IlxxxlI: checks
Karas321: bets $1.07
IlxxxlI: folds
Uncalled bet ($1.07) returned to Karas321
Karas321: doesn't show hand
Karas321 collected $2.14 from pot
*** SUMMARY ***
Total pot $2.25 | Rake $0.11
Board [8c Kc 2s]
Seat 2: v0landito (small blind) folded before Flop
Seat 3: IlxxxlI (big blind) folded on the Flop
Seat 4: Xiniay folded before Flop (didn't bet)
Seat 5: PULISPATOLA folded before Flop (didn't bet)
Seat 6: Karas321 (button) collected ($2.14)

PokerStars Hand #771306301: Hold'em No Limit ($0.25/$0.50 USD) - 2016/11/09 19:02:58 ET
Table 'WPN_3421571163' 6-max  Seat #6 is the button
Seat 1: IlxxxlI ($23.03 in chips)
Seat 2: thebestvd ($45.20 in chips)
Seat 3: Xiniay ($47.66 in chips)
Seat 5: Kryuk13 ($51.50 in chips)
Seat 6: v0landito ($99.87 in chips)
IlxxxlI: posts small blind $0.25
thebestvd: posts big blind $0.50
*** HOLE CARDS ***
Dealt to IlxxxlI [2c 9s]
Xiniay: folds
Kryuk13: raises $1 to $1.50
v0landito: folds
IlxxxlI: folds
thebestvd: folds
Uncalled bet ($1.00) returned to Kryuk13
Kryuk13: doesn't show hand
Kryuk13 collected $1.25 from pot
*** SUMMARY ***
Total pot $1.25 | Rake $0
Seat 1: IlxxxlI (small blind) folded before Flop
Seat 2: thebestvd (big blind) folded before Flop
Seat 3: Xiniay folded before Flop (didn't bet)
Seat 5: Kryuk13 collected ($1.25)
Seat 6: v0landito (button) folded before Flop (didn't bet)

PokerStars Hand #771306279: Hold'em No Limit ($0.25/$0.50 USD) - 2016/11/09 19:02:54 ET
Table 'WPN_3219946394' 6-max  Seat #6 is the button
Seat 1: illoke ($56.84 in chips)
Seat 2: IlxxxlI ($21.14 in chips)
Seat 3: v0landito ($51.25 in chips)
Seat 4: dudu777 ($21.60 in chips)
Seat 5: Xiniay ($54.21 in chips)
Seat 6: 38979 ($102.79 in chips)
illoke: posts small blind $0.25
IlxxxlI: posts big blind $0.50
*** HOLE CARDS ***
Dealt to IlxxxlI [6c 5s]
v0landito: folds
dudu777: raises $2 to $2.50
Xiniay: folds
38979: folds
illoke: calls $2.25
IlxxxlI: folds
*** FLOP *** [2h 8h Qd]
illoke: checks
dudu777: bets $19.10 and is all-in
illoke: folds
Uncalled bet ($19.10) returned to dudu777
dudu777: doesn't show hand
dudu777 collected $5.23 from pot
*** SUMMARY ***
Total pot $5.50 | Rake $0.27
Board [2h 8h Qd]
Seat 1: illoke (small blind) folded on the Flop
Seat 2: IlxxxlI (big blind) folded before Flop
Seat 3: v0landito folded before Flop (didn't bet)
Seat 4: dudu777 collected ($5.23)
Seat 5: Xiniay folded before Flop (didn't bet)
Seat 6: 38979 (button) folded before Flop (didn't bet)

PokerStars Hand #771306045: Hold'em No Limit ($0.25/$0.50 USD) - 2016/11/09 19:02:15 ET
Table 'WPN_3219946394' 6-max  Seat #5 is the button
Seat 1: illoke ($57.34 in chips)
Seat 2: IlxxxlI ($21.14 in chips)
Seat 3: v0landito ($51.25 in chips)
Seat 4: dudu777 ($20.85 in chips)
Seat 5: Xiniay ($54.21 in chips)
Seat 6: 38979 ($103.04 in chips)
38979: posts small blind $0.25
illoke: posts big blind $0.50
*** HOLE CARDS ***
Dealt to IlxxxlI [Jd 8h]
IlxxxlI: folds
v0landito: folds
dudu777: raises $2 to $2.50
Xiniay: folds
38979: folds
illoke: folds
Uncalled bet ($2.00) returned to dudu777
dudu777: doesn't show hand
dudu777 collected $1.25 from pot
*** SUMMARY ***
Total pot $1.25 | Rake $0
Seat 1: illoke (big blind) folded before Flop
Seat 2: IlxxxlI folded before Flop (didn't bet)
Seat 3: v0landito folded before Flop (didn't bet)
Seat 4: dudu777 collected ($1.25)
Seat 5: Xiniay (button) folded before Flop (didn't bet)
Seat 6: 38979 (small blind) folded before Flop

PokerStars Hand #771305908: Hold'em No Limit ($0.25/$0.50 USD) - 2016/11/09 19:01:51 ET
Table 'WPN_3421571163' 6-max  Seat #5 is the button
Seat 1: IlxxxlI ($20.39 in chips)
Seat 2: thebestvd ($45.20 in chips)
Seat 3: Xiniay ($47.66 in chips)
Seat 5: Kryuk13 ($51.50 in chips)
Seat 6: v0landito ($102.80 in chips)
v0landito: posts small blind $0.25
IlxxxlI: posts big blind $0.50
*** HOLE CARDS ***
Dealt to IlxxxlI [Kd Js]
thebestvd: folds
Xiniay: folds
Kryuk13: folds
v0landito: raises $1 to $1.50
IlxxxlI: calls $1
*** FLOP *** [Kh Jd Ah]
v0landito: bets $1.43
IlxxxlI: raises $3.34 to $4.77
v0landito: folds
Uncalled bet ($3.34) returned to IlxxxlI
IlxxxlI: doesn't show hand
IlxxxlI collected $5.57 from pot
*** SUMMARY ***
Total pot $5.86 | Rake $0.29
Board [Kh Jd Ah]
Seat 1: IlxxxlI (big blind) collected ($5.57)
Seat 2: thebestvd folded before Flop (didn't bet)
Seat 3: Xiniay folded before Flop (didn't bet)
Seat 5: Kryuk13 (button) folded before Flop (didn't bet)
Seat 6: v0landito (small blind) folded on the Flop

PokerStars Hand #771305876: Hold'em No Limit ($0.25/$0.50 USD) - 2016/11/09 19:01:45 ET
Table 'WPN_3219946394' 6-max  Seat #4 is the button
Seat 1: illoke ($57.34 in chips)
Seat 2: IlxxxlI ($21.14 in chips)
Seat 3: v0landito ($51.25 in chips)
Seat 4: dudu777 ($20.85 in chips)
Seat 5: Xiniay ($54.46 in chips)
Seat 6: 38979 ($102.79 in chips)
Xiniay: posts small blind $0.25
38979: posts big blind $0.50
*** HOLE CARDS ***
Dealt to IlxxxlI [Qs 2c]
illoke: folds
IlxxxlI: folds
v0landito: folds
dudu777: folds
Xiniay: folds
Uncalled bet ($0.25) returned to 38979
38979: doesn't show hand
38979 collected $0.50 from pot
*** SUMMARY ***
Total pot $0.50 | Rake $0
Seat 1: illoke folded before Flop (didn't bet)
Seat 2: IlxxxlI folded before Flop (didn't bet)
Seat 3: v0landito folded before Flop (didn't bet)
Seat 4: dudu777 (button) folded before Flop (didn't bet)
Seat 5: Xiniay (small blind) folded before Flop
Seat 6: 38979 (big blind) collected ($0.50)

PokerStars Hand #771305789: Hold'em No Limit ($0.25/$0.50 USD) - 2016/11/09 19:01:31 ET
Table 'WPN_1341348958' 6-max  Seat #5 is the button
Seat 2: v0landito ($25.95 in chips)
Seat 3: IlxxxlI ($19.07 in chips)
Seat 4: Xiniay ($30.26 in chips)
Seat 5: PULISPATOLA ($36.26 in chips)
Seat 6: Karas321 ($12.73 in chips)
Karas321: posts small blind $0.25
v0landito: posts big blind $0.50
*** HOLE CARDS ***
Dealt to IlxxxlI [4h 7c]
IlxxxlI: folds
Xiniay: raises $1 to $1.50
PULISPATOLA: calls $1.50
Karas321: folds
v0landito: folds
*** FLOP *** [Tc 3d 8s]
Xiniay: bets $1.19
PULISPATOLA: raises $2.38 to $3.57
Xiniay: calls $2.38
*** TURN *** [Tc 3d 8s] [9s]
Xiniay: checks
PULISPATOLA: bets $5.17
Xiniay: raises $20.02 to $25.19 and is all-in
PULISPATOLA: folds
Uncalled bet ($20.02) returned to Xiniay
Xiniay: doesn't show hand
Xiniay collected $20.17 from pot
*** SUMMARY ***
Total pot $21.23 | Rake $1.06
Board [Tc 3d 8s 9s]
Seat 2: v0landito (big blind) folded before Flop
Seat 3: IlxxxlI folded before Flop (didn't bet)
Seat 4: Xiniay collected ($20.17)
Seat 5: PULISPATOLA (button) folded on the Turn
Seat 6: Karas321 (small blind) folded before Flop

PokerStars Hand #771305670: Hold'em No Limit ($0.25/$0.50 USD) - 2016/11/09 19:01:08 ET
Table 'WPN_3219946394' 6-max  Seat #3 is the button
Seat 1: illoke ($56.59 in chips)
Seat 2: IlxxxlI ($21.14 in chips)
Seat 3: v0landito ($51.25 in chips)
Seat 4: dudu777 ($21.10 in chips)
Seat 5: Xiniay ($54.96 in chips)
Seat 6: 38979 ($102.79 in chips)
dudu777: posts small blind $0.25
Xiniay: posts big blind $0.50
*** HOLE CARDS ***
Dealt to IlxxxlI [Js 3h]
38979: folds
illoke: raises $1 to $1.50
IlxxxlI: folds
v0landito: folds
dudu777: folds
Xiniay: folds
Uncalled bet ($1.00) returned to illoke
illoke: doesn't show hand
illoke collected $1.25 from pot
*** SUMMARY ***
Total pot $1.25 | Rake $0
Seat 1: illoke collected ($1.25)
Seat 2: IlxxxlI folded before Flop (didn't bet)
Seat 3: v0landito (button) folded before Flop (didn't bet)
Seat 4: dudu777 (small blind) folded before Flop
Seat 5: Xiniay (big blind) folded before Flop
Seat 6: 38979 folded before Flop (didn't bet)

PokerStars Hand #771305621: Hold'em No Limit ($0.25/$0.50 USD) - 2016/11/09 19:01:00 ET
Table 'WPN_1341348958' 6-max  Seat #4 is the button
Seat 2: v0landito ($25.95 in chips)
Seat 3: IlxxxlI ($19.07 in chips)
Seat 4: Xiniay ($30.26 in chips)
Seat 5: PULISPATOLA ($36.51 in chips)
Seat 6: Karas321 ($12.48 in chips)
PULISPATOLA: posts small blind $0.25
Karas321: posts big blind $0.50
*** HOLE CARDS ***
Dealt to IlxxxlI [8h Jc]
v0landito: folds
IlxxxlI: folds
Xiniay: folds
PULISPATOLA: folds
Uncalled bet ($0.25) returned to Karas321
Karas321: doesn't show hand
Karas321 collected $0.50 from pot
*** SUMMARY ***
Total pot $0.50 | Rake $0
Seat 2: v0landito folded before Flop (didn't bet)
Seat 3: IlxxxlI folded before Flop (didn't bet)
Seat 4: Xiniay (button) folded before Flop (didn't bet)
Seat 5: PULISPATOLA (small blind) folded before Flop
Seat 6: Karas321 (big blind) collected ($0.50)

PokerStars Hand #771305485: Hold'em No Limit ($0.25/$0.50 USD) - 2016/11/09 19:00:36 ET
Table 'WPN_1341348958' 6-max  Seat #3 is the button
Seat 1: AARON81 ($37.59 in chips)
Seat 2: v0landito ($25.95 in chips)
Seat 3: IlxxxlI ($19.07 in chips)
Seat 4: Xiniay ($30.51 in chips)
Seat 5: PULISPATOLA ($36.26 in chips)
Seat 6: Karas321 ($12.48 in chips)
Xiniay: posts small blind $0.25
PULISPATOLA: posts big blind $0.50
*** HOLE CARDS ***
Dealt to IlxxxlI [7d 3s]
Karas321: folds
AARON81: folds
v0landito: folds
IlxxxlI: folds
Xiniay: folds
Uncalled bet ($0.25) returned to PULISPATOLA
PULISPATOLA: doesn't show hand
PULISPATOLA collected $0.50 from pot
*** SUMMARY ***
Total pot $0.50 | Rake $0
Seat 1: AARON81 folded before Flop (didn't bet)
Seat 2: v0landito folded before Flop (didn't bet)
Seat 3: IlxxxlI (button) folded before Flop (didn't bet)
Seat 4: Xiniay (small blind) folded before Flop
Seat 5: PULISPATOLA (big blind) collected ($0.50)
Seat 6: Karas321 folded before Flop (didn't bet)

PokerStars Hand #771305486: Hold'em No Limit ($0.50/$1.00 USD) - 2016/11/09 19:00:36 ET
Table 'WPN_179260045' 6-max  Seat #6 is the button
Seat 2: St3p04ka ($39.00 in chips)
Seat 3: mboggs1 ($100.00 in chips)
Seat 4: illoke ($106.09 in chips)
Seat 5: IlxxxlI ($77.00 in chips)
Seat 6: v0landito ($101.00 in chips)
St3p04ka: posts small blind $0.50
mboggs1: posts big blind $1
*** HOLE CARDS ***
Dealt to IlxxxlI [6s 8d]
illoke: folds
IlxxxlI: folds
v0landito: raises $1 to $2
St3p04ka: folds
mboggs1: calls $1
*** FLOP *** [4h 2h Qc]
mboggs1: checks
v0landito: checks
*** TURN *** [4h 2h Qc] [5h]
mboggs1: bets $2.14
v0landito: folds
Uncalled bet ($2.14) returned to mboggs1
mboggs1: doesn't show hand
mboggs1 collected $4.28 from pot
*** SUMMARY ***
Total pot $4.50 | Rake $0.22
Board [4h 2h Qc 5h]
Seat 2: St3p04ka (small blind) folded before Flop
Seat 3: mboggs1 (big blind) collected ($4.28)
Seat 4: illoke folded before Flop (didn't bet)
Seat 5: IlxxxlI folded before Flop (didn't bet)
Seat 6: v0landito (button) folded on the Turn

PokerStars Hand #771305352: Hold'em No Limit ($0.25/$0.50 USD) - 2016/11/09 19:00:11 ET
Table 'WPN_3219946394' 6-max  Seat #2 is the button
Seat 1: illoke ($56.59 in chips)
Seat 2: IlxxxlI ($20.00 in chips)
Seat 3: v0landito ($51.50 in chips)
Seat 4: dudu777 ($22.10 in chips)
Seat 5: Xiniay ($54.96 in chips)
Seat 6: 38979 ($102.79 in chips)
v0landito: posts small blind $0.25
dudu777: posts big blind $0.50
*** HOLE CARDS ***
Dealt to IlxxxlI [6h Qh]
Xiniay: folds
38979: folds
illoke: folds
IlxxxlI: raises $0.50 to $1
v0landito: folds
dudu777: calls $0.50
*** FLOP *** [2d Ac 3h]
dudu777: checks
IlxxxlI: bets $1.07
dudu777: folds
Uncalled bet ($1.07) returned to IlxxxlI
IlxxxlI: doesn't show hand
IlxxxlI collected $2.14 from pot
*** SUMMARY ***
Total pot $2.25 | Rake $0.11
Board [2d Ac 3h]
Seat 1: illoke folded before Flop (didn't bet)
Seat 2: IlxxxlI (button) collected ($2.14)
Seat 3: v0landito (small blind) folded before Flop
Seat 4: dudu777 (big blind) folded on the Flop
Seat 5: Xiniay folded before Flop (didn't bet)
Seat 6: 38979 folded before Flop (didn't bet)

PokerStars Hand #771305239: Hold'em No Limit ($0.25/$0.50 USD) - 2016/11/09 18:59:50 ET
Table 'WPN_1341348958' 6-max  Seat #2 is the button
Seat 1: AARON81 ($37.59 in chips)
Seat 2: v0landito ($25.20 in chips)
Seat 3: IlxxxlI ($19.32 in chips)
Seat 4: Xiniay ($31.01 in chips)
Seat 6: Karas321 ($12.48 in chips)
IlxxxlI: posts small blind $0.25
Xiniay: posts big blind $0.50
*** HOLE CARDS ***
Dealt to IlxxxlI [9h 7h]
Karas321: folds
AARON81: folds
v0landito: raises $0.50 to $1
IlxxxlI: folds
Xiniay: folds
Uncalled bet ($0.50) returned to v0landito
v0landito: doesn't show hand
v0landito collected $1.25 from pot
*** SUMMARY ***
Total pot $1.25 | Rake $0
Seat 1: AARON81 folded before Flop (didn't bet)
Seat 2: v0landito (button) collected ($1.25)
Seat 3: IlxxxlI (small blind) folded before Flop
Seat 4: Xiniay (big blind) folded before Flop
Seat 6: Karas321 folded before Flop (didn't bet)

PokerStars Hand #771305114: Hold'em No Limit ($0.25/$0.50 USD) - 2016/11/09 18:59:26 ET
Table 'WPN_1341348958' 6-max  Seat #1 is the button
Seat 1: AARON81 ($37.59 in chips)
Seat 2: v0landito ($25.45 in chips)
Seat 3: IlxxxlI ($19.07 in chips)
Seat 4: Xiniay ($31.01 in chips)
Seat 6: Karas321 ($12.48 in chips)
v0landito: posts small blind $0.25
IlxxxlI: posts big blind $0.50
*** HOLE CARDS ***
Dealt to IlxxxlI [6c 4d]
Xiniay: folds
Karas321: folds
AARON81: folds
v0landito: folds
Uncalled bet ($0.25) returned to IlxxxlI
IlxxxlI: doesn't show hand
IlxxxlI collected $0.50 from pot
*** SUMMARY ***
Total pot $0.50 | Rake $0
Seat 1: AARON81 (button) folded before Flop (didn't bet)
Seat 2: v0landito (small blind) folded before Flop
Seat 3: IlxxxlI (big blind) collected ($0.50)
Seat 4: Xiniay folded before Flop (didn't bet)
Seat 6: Karas321 folded before Flop (didn't bet)

PokerStars Hand #771305064: Hold'em No Limit ($0.25/$0.50 USD) - 2016/11/09 18:59:14 ET
Table 'WPN_3219946394' 6-max  Seat #1 is the button
Seat 1: illoke ($57.84 in chips)
Seat 2: IlxxxlI ($20.25 in chips)
Seat 3: v0landito ($50.00 in chips)
Seat 4: dudu777 ($22.10 in chips)
Seat 5: Xiniay ($54.96 in chips)
Seat 6: 38979 ($102.79 in chips)
IlxxxlI: posts small blind $0.25
v0landito: posts big blind $0.50
*** HOLE CARDS ***
Dealt to IlxxxlI [Jd Qs]
dudu777: folds
Xiniay: folds
38979: folds
illoke: raises $0.75 to $1.25
IlxxxlI: folds
v0landito: raises $4.25 to $5.50
illoke: folds
Uncalled bet ($4.25) returned to v0landito
v0landito: doesn't show hand
v0landito collected $2.75 from pot
*** SUMMARY ***
Total pot $2.75 | Rake $0
Seat 1: illoke (button) folded before Flop
Seat 2: IlxxxlI (small blind) folded before Flop
Seat 3: v0landito (big blind) collected ($2.75)
Seat 4: dudu777 folded before Flop (didn't bet)
Seat 5: Xiniay folded before Flop (didn't bet)
Seat 6: 38979 folded before Flop (didn't bet)

PokerStars Hand #771304899: Hold'em No Limit ($0.50/$1.00 USD) - 2016/11/09 18:58:43 ET
Table 'WPN_179260045' 6-max  Seat #4 is the button
Seat 1: BigBlat ($91.10 in chips)
Seat 4: illoke ($101.00 in chips)
Seat 5: IlxxxlI ($77.50 in chips)
Seat 6: v0landito ($100.00 in chips)
IlxxxlI: posts small blind $0.50
v0landito: posts big blind $1
*** HOLE CARDS ***
Dealt to IlxxxlI [3h 7h]
BigBlat: folds
illoke: raises $1.50 to $2.50
IlxxxlI: folds
v0landito: calls $1.50
*** FLOP *** [6c 5s 4d]
v0landito: bets $2.62
illoke: calls $2.62
*** TURN *** [6c 5s 4d] [Jd]
v0landito: checks
illoke: bets $3.40
v0landito: folds
Uncalled bet ($3.40) returned to illoke
illoke: doesn't show hand
illoke collected $10.21 from pot
*** SUMMARY ***
Total pot $10.74 | Rake $0.53
Board [6c 5s 4d Jd]
Seat 1: BigBlat folded before Flop (didn't bet)
Seat 4: illoke (button) collected ($10.21)
Seat 5: IlxxxlI (small blind) folded before Flop
Seat 6: v0landito (big blind) folded on the Turn

PokerStars Hand #771304889: Hold'em No Limit ($0.25/$0.50 USD) - 2016/11/09 18:58:40 ET
Table 'WPN_3219946394' 6-max  Seat #6 is the button
Seat 1: illoke ($58.09 in chips)
Seat 2: IlxxxlI ($20.00 in chips)
Seat 3: v0landito ($50.00 in chips)
Seat 4: dudu777 ($22.10 in chips)
Seat 5: Xiniay ($54.96 in chips)
Seat 6: 38979 ($102.79 in chips)
illoke: posts small blind $0.25
IlxxxlI: posts big blind $0.50
*** HOLE CARDS ***
Dealt to IlxxxlI [Qh 7d]
v0landito: folds
dudu777: folds
Xiniay: folds
38979: folds
illoke: folds
Uncalled bet ($0.25) returned to IlxxxlI
IlxxxlI: doesn't show hand
IlxxxlI collected $0.50 from pot
*** SUMMARY ***
Total pot $0.50 | Rake $0
Seat 1: illoke (small blind) folded before Flop
Seat 2: IlxxxlI (big blind) collected ($0.50)
Seat 3: v0landito folded before Flop (didn't bet)
Seat 4: dudu777 folded before Flop (didn't bet)
Seat 5: Xiniay folded before Flop (didn't bet)
Seat 6: 38979 (button) folded before Flop (didn't bet)

PokerStars Hand #771304579: Hold'em No Limit ($0.25/$0.50 USD) - 2016/11/09 18:57:43 ET
Table 'WPN_1341348958' 6-max  Seat #6 is the button
Seat 1: AARON81 ($38.09 in chips)
Seat 2: v0landito ($25.00 in chips)
Seat 3: IlxxxlI ($19.07 in chips)
Seat 4: Xiniay ($31.01 in chips)
Seat 5: PULISPATOLA ($36.26 in chips)
Seat 6: Karas321 ($12.48 in chips)
AARON81: posts small blind $0.25
v0landito: posts big blind $0.50
*** HOLE CARDS ***
Dealt to IlxxxlI [6s 5c]
IlxxxlI: folds
Xiniay: folds
PULISPATOLA: folds
Karas321: folds
AARON81: calls $0.25
v0landito: checks
*** FLOP *** [2s 7d Qh]
AARON81: checks
v0landito: checks
*** TURN *** [2s 7d Qh] [2d]
AARON81: checks
v0landito: checks
*** RIVER *** [2s 7d Qh 2d] [4d]
AARON81: checks
v0landito: checks
*** SHOW DOWN ***
AARON81: mucks hand
v0landito: shows [Jc 4h] (Two pairs. 4s and 2s)
v0landito collected $0.95 from pot
*** SUMMARY ***
Total pot $1 | Rake $0.05
Board [2s 7d Qh 2d 4d]
Seat 1: AARON81 (small blind) mucked
Seat 2: v0landito (big blind) showed [Jc 4h] and won ($0.95) with Two pairs. 4s and 2s
Seat 3: IlxxxlI folded before Flop (didn't bet)
Seat 4: Xiniay folded before Flop (didn't bet)
Seat 5: PULISPATOLA folded before Flop (didn't bet)
Seat 6: Karas321 (button) folded before Flop (didn't bet)

PokerStars Hand #771304493: Hold'em No Limit ($0.50/$1.00 USD) - 2016/11/09 18:57:26 ET
Table 'WPN_179260045' 6-max  Seat #3 is the button
Seat 1: BigBlat ($91.10 in chips)
Seat 3: 38979 ($102.50 in chips)
Seat 4: illoke ($101.50 in chips)
Seat 5: IlxxxlI ($40.00 in chips)
Seat 6: v0landito ($103.68 in chips)
illoke: posts small blind $0.50
IlxxxlI: posts big blind $1
*** HOLE CARDS ***
Dealt to IlxxxlI [Ac As]
v0landito: raises $2 to $3
BigBlat: folds
38979: folds
illoke: folds
IlxxxlI: raises $4.59 to $7.59
v0landito: calls $4.59
*** FLOP *** [8d 5h 5d]
IlxxxlI: bets $6
v0landito: calls $6
*** TURN *** [8d 5h 5d] [Th]
IlxxxlI: bets $26.41 and is all-in
v0landito: calls $26.41
*** RIVER *** [8d 5h 5d Th] [2s]
*** SHOW DOWN ***
IlxxxlI: shows [Ac As] (Two pairs. As and 5s)
v0landito: shows [6h Ah] (One pair of 5s)
IlxxxlI collected $77.50 from pot
*** SUMMARY ***
Total pot $80.50 | Rake $3
Board [8d 5h 5d Th 2s]
Seat 1: BigBlat folded before Flop (didn't bet)
Seat 3: 38979 (button) folded before Flop (didn't bet)
Seat 4: illoke (small blind) folded before Flop
Seat 5: IlxxxlI (big blind) showed [Ac As] and won ($77.50) with Two pairs. As and 5s
Seat 6: v0landito showed [6h Ah] and lost with One pair of 5s

PokerStars Hand #771304460: Hold'em No Limit ($0.25/$0.50 USD) - 2016/11/09 18:57:19 ET
Table 'WPN_3219946394' 6-max  Seat #5 is the button
Seat 1: illoke ($58.59 in chips)
Seat 2: IlxxxlI ($20.00 in chips)
Seat 3: v0landito ($50.00 in chips)
Seat 4: dudu777 ($18.42 in chips)
Seat 5: Xiniay ($54.96 in chips)
Seat 6: 38979 ($103.04 in chips)
38979: posts small blind $0.25
illoke: posts big blind $0.50
*** HOLE CARDS ***
Dealt to IlxxxlI [Jh Td]
IlxxxlI: folds
v0landito: raises $1 to $1.50
dudu777: calls $1.50
Xiniay: folds
38979: folds
illoke: folds
*** FLOP *** [3c Jc Ts]
v0landito: bets $1.79
dudu777: calls $1.79
*** TURN *** [3c Jc Ts] [Ah]
v0landito: checks
dudu777: bets $4.64
v0landito: folds
Uncalled bet ($4.64) returned to dudu777
dudu777: doesn't show hand
dudu777 collected $6.97 from pot
*** SUMMARY ***
Total pot $7.33 | Rake $0.36
Board [3c Jc Ts Ah]
Seat 1: illoke (big blind) folded before Flop
Seat 2: IlxxxlI folded before Flop (didn't bet)
Seat 3: v0landito folded on the Turn
Seat 4: dudu777 collected ($6.97)
Seat 5: Xiniay (button) folded before Flop (didn't bet)
Seat 6: 38979 (small blind) folded before Flop

PokerStars Hand #771304402: Hold'em No Limit ($0.50/$1.00 USD) - 2016/11/09 18:57:07 ET
Table 'WPN_179260045' 6-max  Seat #1 is the button
Seat 1: BigBlat ($91.10 in chips)
Seat 3: 38979 ($103.00 in chips)
Seat 4: illoke ($101.00 in chips)
Seat 5: IlxxxlI ($40.00 in chips)
Seat 6: v0landito ($103.68 in chips)
38979: posts small blind $0.50
illoke: posts big blind $1
*** HOLE CARDS ***
Dealt to IlxxxlI [Js 6c]
IlxxxlI: folds
v0landito: folds
BigBlat: folds
38979: folds
Uncalled bet ($0.50) returned to illoke
illoke: doesn't show hand
illoke collected $1 from pot
*** SUMMARY ***
Total pot $1 | Rake $0
Seat 1: BigBlat (button) folded before Flop (didn't bet)
Seat 3: 38979 (small blind) folded before Flop
Seat 4: illoke (big blind) collected ($1)
Seat 5: IlxxxlI folded before Flop (didn't bet)
Seat 6: v0landito folded before Flop (didn't bet)

PokerStars Hand #771304287: Hold'em No Limit ($0.25/$0.50 USD) - 2016/11/09 18:56:48 ET
Table 'WPN_3219946394' 6-max  Seat #4 is the button
Seat 1: illoke ($58.59 in chips)
Seat 2: IlxxxlI ($20.00 in chips)
Seat 3: v0landito ($50.00 in chips)
Seat 4: dudu777 ($18.42 in chips)
Seat 5: Xiniay ($55.21 in chips)
Seat 6: 38979 ($102.79 in chips)
Xiniay: posts small blind $0.25
38979: posts big blind $0.50
*** HOLE CARDS ***
Dealt to IlxxxlI [8c 3s]
illoke: folds
IlxxxlI: folds
v0landito: folds
dudu777: folds
Xiniay: folds
Uncalled bet ($0.25) returned to 38979
38979: doesn't show hand
38979 collected $0.50 from pot
*** SUMMARY ***
Total pot $0.50 | Rake $0
Seat 1: illoke folded before Flop (didn't bet)
Seat 2: IlxxxlI folded before Flop (didn't bet)
Seat 3: v0landito folded before Flop (didn't bet)
Seat 4: dudu777 (button) folded before Flop (didn't bet)
Seat 5: Xiniay (small blind) folded before Flop
Seat 6: 38979 (big blind) collected ($0.50)

PokerStars Hand #771304274: Hold'em No Limit ($0.25/$0.50 USD) - 2016/11/09 18:56:46 ET
Table 'WPN_1341348958' 6-max  Seat #5 is the button
Seat 1: AARON81 ($39.09 in chips)
Seat 3: IlxxxlI ($19.07 in chips)
Seat 4: Xiniay ($28.92 in chips)
Seat 5: PULISPATOLA ($37.26 in chips)
Seat 6: Karas321 ($12.73 in chips)
Karas321: posts small blind $0.25
AARON81: posts big blind $0.50
*** HOLE CARDS ***
Dealt to IlxxxlI [3c 4d]
IlxxxlI: folds
Xiniay: raises $0.50 to $1
PULISPATOLA: calls $1
Karas321: folds
AARON81: calls $0.50
*** FLOP *** [3d 5h 5s]
AARON81: checks
Xiniay: bets $1.03
PULISPATOLA: folds
AARON81: folds
Uncalled bet ($1.03) returned to Xiniay
Xiniay: doesn't show hand
Xiniay collected $3.09 from pot
*** SUMMARY ***
Total pot $3.25 | Rake $0.16
Board [3d 5h 5s]
Seat 1: AARON81 (big blind) folded on the Flop
Seat 3: IlxxxlI folded before Flop (didn't bet)
Seat 4: Xiniay collected ($3.09)
Seat 5: PULISPATOLA (button) folded on the Flop
Seat 6: Karas321 (small blind) folded before Flop

PokerStars Hand #771304179: Hold'em No Limit ($0.50/$1.00 USD) - 2016/11/09 18:56:26 ET
Table 'WPN_179260045' 6-max  Seat #6 is the button
Seat 1: BigBlat ($89.30 in chips)
Seat 3: 38979 ($105.00 in chips)
Seat 4: illoke ($101.00 in chips)
Seat 5: IlxxxlI ($40.00 in chips)
Seat 6: v0landito ($103.68 in chips)
BigBlat: posts small blind $0.50
38979: posts big blind $1
*** HOLE CARDS ***
Dealt to IlxxxlI [Ah 8d]
illoke: folds
IlxxxlI: folds
v0landito: folds
BigBlat: raises $1 to $2
38979: calls $1
*** FLOP *** [Qs 9d 3c]
BigBlat: bets $2.53
38979: folds
Uncalled bet ($2.53) returned to BigBlat
BigBlat: doesn't show hand
BigBlat collected $3.80 from pot
*** SUMMARY ***
Total pot $4 | Rake $0.20
Board [Qs 9d 3c]
Seat 1: BigBlat (small blind) collected ($3.80)
Seat 3: 38979 (big blind) folded on the Flop
Seat 4: illoke folded before Flop (didn't bet)
Seat 5: IlxxxlI folded before Flop (didn't bet)
Seat 6: v0landito (button) folded before Flop (didn't bet)

PokerStars Hand #771304130: Hold'em No Limit ($0.25/$0.50 USD) - 2016/11/09 18:56:15 ET
Table 'WPN_3219946394' 6-max  Seat #3 is the button
Seat 1: illoke ($58.59 in chips)
Seat 2: IlxxxlI ($20.00 in chips)
Seat 3: v0landito ($50.00 in chips)
Seat 4: dudu777 ($18.67 in chips)
Seat 5: Xiniay ($54.96 in chips)
Seat 6: 38979 ($102.79 in chips)
dudu777: posts small blind $0.25
Xiniay: posts big blind $0.50
*** HOLE CARDS ***
Dealt to IlxxxlI [Qh 7c]
38979: folds
illoke: folds
IlxxxlI: folds
v0landito: folds
dudu777: folds
Uncalled bet ($0.25) returned to Xiniay
Xiniay: doesn't show hand
Xiniay collected $0.50 from pot
*** SUMMARY ***
Total pot $0.50 | Rake $0
Seat 1: illoke folded before Flop (didn't bet)
Seat 2: IlxxxlI folded before Flop (didn't bet)
Seat 3: v0landito (button) folded before Flop (didn't bet)
Seat 4: dudu777 (small blind) folded before Flop
Seat 5: Xiniay (big blind) collected ($0.50)
Seat 6: 38979 folded before Flop (didn't bet)

PokerStars Hand #771303940: Hold'em No Limit ($0.25/$0.50 USD) - 2016/11/09 18:55:38 ET
Table 'WPN_3219946394' 6-max  Seat #2 is the button
Seat 1: illoke ($58.59 in chips)
Seat 2: IlxxxlI ($20.00 in chips)
Seat 3: v0landito ($50.00 in chips)
Seat 4: dudu777 ($16.92 in chips)
Seat 5: Xiniay ($56.46 in chips)
Seat 6: 38979 ($102.79 in chips)
v0landito: posts small blind $0.25
dudu777: posts big blind $0.50
*** HOLE CARDS ***
Dealt to IlxxxlI [7d 3d]
Xiniay: raises $1 to $1.50
38979: folds
illoke: folds
IlxxxlI: folds
v0landito: folds
dudu777: raises $15.42 to $16.92 and is all-in
Xiniay: folds
Uncalled bet ($15.42) returned to dudu777
dudu777: doesn't show hand
dudu777 collected $3.25 from pot
*** SUMMARY ***
Total pot $3.25 | Rake $0
Seat 1: illoke folded before Flop (didn't bet)
Seat 2: IlxxxlI (button) folded before Flop (didn't bet)
Seat 3: v0landito (small blind) folded before Flop
Seat 4: dudu777 (big blind) collected ($3.25)
Seat 5: Xiniay folded before Flop
Seat 6: 38979 folded before Flop (didn't bet)

PokerStars Hand #771303873: Hold'em No Limit ($0.25/$0.50 USD) - 2016/11/09 18:55:23 ET
Table 'WPN_1341348958' 6-max  Seat #4 is the button
Seat 1: AARON81 ($39.09 in chips)
Seat 3: IlxxxlI ($19.07 in chips)
Seat 4: Xiniay ($28.87 in chips)
Seat 5: PULISPATOLA ($37.20 in chips)
Seat 6: Karas321 ($13.23 in chips)
PULISPATOLA: posts small blind $0.25
Karas321: posts big blind $0.50
*** HOLE CARDS ***
Dealt to IlxxxlI [Th 7c]
AARON81: folds
IlxxxlI: folds
Xiniay: raises $0.50 to $1
PULISPATOLA: calls $0.75
Karas321: folds
*** FLOP *** [As Qd 6h]
PULISPATOLA: checks
Xiniay: bets $0.79
PULISPATOLA: calls $0.79
*** TURN *** [As Qd 6h] [6s]
PULISPATOLA: checks
Xiniay: checks
*** RIVER *** [As Qd 6h 6s] [8c]
PULISPATOLA: bets $1.94
Xiniay: calls $1.94
*** SHOW DOWN ***
Xiniay: shows [9s Ah] (Two pairs. As and 6s)
PULISPATOLA: shows [Ad 5s] (Two pairs. As and 6s)
Xiniay collected $3.78 from pot
PULISPATOLA collected $3.79 from pot
*** SUMMARY ***
Total pot $7.96 | Rake $0.39
Board [As Qd 6h 6s 8c]
Seat 1: AARON81 folded before Flop (didn't bet)
Seat 3: IlxxxlI folded before Flop (didn't bet)
Seat 4: Xiniay (button) showed [9s Ah] and won ($3.78) with Two pairs. As and 6s
Seat 5: PULISPATOLA (small blind) showed [Ad 5s] and won ($3.79) with Two pairs. As and 6s
Seat 6: Karas321 (big blind) folded before Flop

PokerStars Hand #771303831: Hold'em No Limit ($0.50/$1.00 USD) - 2016/11/09 18:55:16 ET
Table 'WPN_179260045' 6-max  Seat #5 is the button
Seat 1: BigBlat ($48.30 in chips)
Seat 2: GautamaBuddha ($100.99 in chips)
Seat 4: illoke ($101.00 in chips)
Seat 5: IlxxxlI ($43.50 in chips)
Seat 6: v0landito ($104.18 in chips)
v0landito: posts small blind $0.50
BigBlat: posts big blind $1
*** HOLE CARDS ***
Dealt to IlxxxlI [9h Qh]
GautamaBuddha: folds
illoke: folds
IlxxxlI: raises $2 to $3
v0landito: folds
BigBlat: raises $6 to $9
IlxxxlI: calls $6
*** FLOP *** [8d 4h Th]
BigBlat: bets $8.79
IlxxxlI: raises $8.79 to $17.58
BigBlat: raises $21.72 to $39.30 and is all-in
IlxxxlI: calls $16.92 and is all-in
Uncalled bet ($4.80) returned to BigBlat
*** TURN *** [8d 4h Th] [6s]
*** RIVER *** [8d 4h Th 6s] [Tc]
*** SHOW DOWN ***
BigBlat: shows [Ah Kh] (One pair of 10s (kicker A))
IlxxxlI: shows [9h Qh] (One pair of 10s)
BigBlat collected $84.50 from pot
*** SUMMARY ***
Total pot $87.50 | Rake $3
Board [8d 4h Th 6s Tc]
Seat 1: BigBlat (big blind) showed [Ah Kh] and won ($84.50) with One pair of 10s (kicker A)
Seat 2: GautamaBuddha folded before Flop (didn't bet)
Seat 4: illoke folded before Flop (didn't bet)
Seat 5: IlxxxlI (button) showed [9h Qh] and lost with One pair of 10s
Seat 6: v0landito (small blind) folded before Flop

PokerStars Hand #771303743: Hold'em No Limit ($0.25/$0.50 USD) - 2016/11/09 18:54:59 ET
Table 'WPN_3219946394' 6-max  Seat #1 is the button
Seat 1: illoke ($58.59 in chips)
Seat 2: IlxxxlI ($20.00 in chips)
Seat 3: v0landito ($50.00 in chips)
Seat 4: dudu777 ($16.17 in chips)
Seat 5: Xiniay ($56.46 in chips)
Seat 6: 38979 ($102.79 in chips)
IlxxxlI: posts small blind $0.25
v0landito: posts big blind $0.50
*** HOLE CARDS ***
Dealt to IlxxxlI [Tc 6d]
dudu777: raises $1 to $1.50
Xiniay: folds
38979: folds
illoke: folds
IlxxxlI: folds
v0landito: folds
Uncalled bet ($1.00) returned to dudu777
dudu777: doesn't show hand
dudu777 collected $1.25 from pot
*** SUMMARY ***
Total pot $1.25 | Rake $0
Seat 1: illoke (button) folded before Flop (didn't bet)
Seat 2: IlxxxlI (small blind) folded before Flop
Seat 3: v0landito (big blind) folded before Flop
Seat 4: dudu777 collected ($1.25)
Seat 5: Xiniay folded before Flop (didn't bet)
Seat 6: 38979 folded before Flop (didn't bet)

PokerStars Hand #771303719: Hold'em No Limit ($0.25/$0.50 USD) - 2016/11/09 18:54:56 ET
Table 'WPN_1341348958' 6-max  Seat #3 is the button
Seat 1: AARON81 ($39.09 in chips)
Seat 3: IlxxxlI ($19.07 in chips)
Seat 4: Xiniay ($28.37 in chips)
Seat 5: PULISPATOLA ($37.70 in chips)
Seat 6: Karas321 ($13.23 in chips)
Xiniay: posts small blind $0.25
PULISPATOLA: posts big blind $0.50
*** HOLE CARDS ***
Dealt to IlxxxlI [3h 4c]
Karas321: folds
AARON81: folds
IlxxxlI: folds
Xiniay: raises $0.50 to $1
PULISPATOLA: folds
Uncalled bet ($0.50) returned to Xiniay
Xiniay: doesn't show hand
Xiniay collected $1 from pot
*** SUMMARY ***
Total pot $1 | Rake $0
Seat 1: AARON81 folded before Flop (didn't bet)
Seat 3: IlxxxlI (button) folded before Flop (didn't bet)
Seat 4: Xiniay (small blind) collected ($1)
Seat 5: PULISPATOLA (big blind) folded before Flop
Seat 6: Karas321 folded before Flop (didn't bet)

PokerStars Hand #771303641: Hold'em No Limit ($0.25/$0.50 USD) - 2016/11/09 18:54:42 ET
Table 'WPN_1341348958' 6-max  Seat #1 is the button
Seat 1: AARON81 ($39.09 in chips)
Seat 3: IlxxxlI ($19.32 in chips)
Seat 4: Xiniay ($28.12 in chips)
Seat 5: PULISPATOLA ($37.70 in chips)
Seat 6: Karas321 ($13.23 in chips)
IlxxxlI: posts small blind $0.25
Xiniay: posts big blind $0.50
*** HOLE CARDS ***
Dealt to IlxxxlI [5c 8h]
PULISPATOLA: folds
Karas321: folds
AARON81: folds
IlxxxlI: folds
Uncalled bet ($0.25) returned to Xiniay
Xiniay: doesn't show hand
Xiniay collected $0.50 from pot
*** SUMMARY ***
Total pot $0.50 | Rake $0
Seat 1: AARON81 (button) folded before Flop (didn't bet)
Seat 3: IlxxxlI (small blind) folded before Flop
Seat 4: Xiniay (big blind) collected ($0.50)
Seat 5: PULISPATOLA folded before Flop (didn't bet)
Seat 6: Karas321 folded before Flop (didn't bet)

PokerStars Hand #771303588: Hold'em No Limit ($0.25/$0.50 USD) - 2016/11/09 18:54:33 ET
Table 'WPN_3219946394' 6-max  Seat #6 is the button
Seat 1: illoke ($58.09 in chips)
Seat 2: IlxxxlI ($20.00 in chips)
Seat 4: dudu777 ($16.17 in chips)
Seat 5: Xiniay ($56.46 in chips)
Seat 6: 38979 ($102.79 in chips)
illoke: posts small blind $0.25
IlxxxlI: posts big blind $0.50
*** HOLE CARDS ***
Dealt to IlxxxlI [4h Qs]
dudu777: folds
Xiniay: folds
38979: folds
illoke: raises $1 to $1.50
IlxxxlI: folds
Uncalled bet ($1.00) returned to illoke
illoke: doesn't show hand
illoke collected $1 from pot
*** SUMMARY ***
Total pot $1 | Rake $0
Seat 1: illoke (small blind) collected ($1)
Seat 2: IlxxxlI (big blind) folded before Flop
Seat 4: dudu777 folded before Flop (didn't bet)
Seat 5: Xiniay folded before Flop (didn't bet)
Seat 6: 38979 (button) folded before Flop (didn't bet)

PokerStars Hand #771303517: Hold'em No Limit ($0.50/$1.00 USD) - 2016/11/09 18:54:19 ET
Table 'WPN_179260045' 6-max  Seat #4 is the button
Seat 1: BigBlat ($48.30 in chips)
Seat 2: GautamaBuddha ($100.99 in chips)
Seat 4: illoke ($103.50 in chips)
Seat 5: IlxxxlI ($40.00 in chips)
Seat 6: v0landito ($105.18 in chips)
IlxxxlI: posts small blind $0.50
v0landito: posts big blind $1
*** HOLE CARDS ***
Dealt to IlxxxlI [Jh Kc]
BigBlat: folds
GautamaBuddha: folds
illoke: raises $1.50 to $2.50
IlxxxlI: raises $3.88 to $6.38
v0landito: folds
illoke: folds
Uncalled bet ($3.88) returned to IlxxxlI
IlxxxlI: doesn't show hand
IlxxxlI collected $6 from pot
*** SUMMARY ***
Total pot $6 | Rake $0
Seat 1: BigBlat folded before Flop (didn't bet)
Seat 2: GautamaBuddha folded before Flop (didn't bet)
Seat 4: illoke (button) folded before Flop
Seat 5: IlxxxlI (small blind) collected ($6)
Seat 6: v0landito (big blind) folded before Flop

PokerStars Hand #771303515: Hold'em No Limit ($0.25/$0.50 USD) - 2016/11/09 18:54:19 ET
Table 'WPN_3219946394' 6-max  Seat #5 is the button
Seat 1: illoke ($58.59 in chips)
Seat 2: IlxxxlI ($20.00 in chips)
Seat 4: dudu777 ($16.17 in chips)
Seat 5: Xiniay ($56.46 in chips)
Seat 6: 38979 ($102.29 in chips)
38979: posts small blind $0.25
illoke: posts big blind $0.50
*** HOLE CARDS ***
Dealt to IlxxxlI [As 5d]
IlxxxlI: folds
dudu777: folds
Xiniay: folds
38979: raises $1 to $1.50
illoke: folds
Uncalled bet ($1.00) returned to 38979
38979: doesn't show hand
38979 collected $1 from pot
*** SUMMARY ***
Total pot $1 | Rake $0
Seat 1: illoke (big blind) folded before Flop
Seat 2: IlxxxlI folded before Flop (didn't bet)
Seat 4: dudu777 folded before Flop (didn't bet)
Seat 5: Xiniay (button) folded before Flop (didn't bet)
Seat 6: 38979 (small blind) collected ($1)

PokerStars Hand #771303416: Hold'em No Limit ($0.25/$0.50 USD) - 2016/11/09 18:54:01 ET
Table 'WPN_1341348958' 6-max  Seat #6 is the button
Seat 1: AARON81 ($40.09 in chips)
Seat 3: IlxxxlI ($18.42 in chips)
Seat 4: Xiniay ($28.12 in chips)
Seat 5: PULISPATOLA ($37.70 in chips)
Seat 6: Karas321 ($13.23 in chips)
AARON81: posts small blind $0.25
IlxxxlI: posts big blind $0.50
*** HOLE CARDS ***
Dealt to IlxxxlI [4h 5s]
Xiniay: folds
PULISPATOLA: folds
Karas321: folds
AARON81: calls $0.25
IlxxxlI: checks
*** FLOP *** [2s Js 5c]
AARON81: bets $0.50
IlxxxlI: calls $0.50
*** TURN *** [2s Js 5c] [7s]
AARON81: checks
IlxxxlI: checks
*** RIVER *** [2s Js 5c 7s] [8h]
AARON81: checks
IlxxxlI: checks
*** SHOW DOWN ***
AARON81: mucks hand
IlxxxlI: shows [4h 5s] (One pair of 5s)
IlxxxlI collected $1.90 from pot
*** SUMMARY ***
Total pot $2 | Rake $0.10
Board [2s Js 5c 7s 8h]
Seat 1: AARON81 (small blind) mucked
Seat 3: IlxxxlI (big blind) showed [4h 5s] and won ($1.90) with One pair of 5s
Seat 4: Xiniay folded before Flop (didn't bet)
Seat 5: PULISPATOLA folded before Flop (didn't bet)
Seat 6: Karas321 (button) folded before Flop (didn't bet)

PokerStars Hand #771303265: Hold'em No Limit ($0.25/$0.50 USD) - 2016/11/09 18:53:35 ET
Table 'WPN_1341348958' 6-max  Seat #5 is the button
Seat 1: AARON81 ($39.84 in chips)
Seat 3: IlxxxlI ($18.42 in chips)
Seat 4: Xiniay ($28.12 in chips)
Seat 5: PULISPATOLA ($37.70 in chips)
Seat 6: Karas321 ($13.48 in chips)
Karas321: posts small blind $0.25
AARON81: posts big blind $0.50
*** HOLE CARDS ***
Dealt to IlxxxlI [3d 8c]
IlxxxlI: folds
Xiniay: folds
PULISPATOLA: folds
Karas321: folds
Uncalled bet ($0.25) returned to AARON81
AARON81: doesn't show hand
AARON81 collected $0.50 from pot
*** SUMMARY ***
Total pot $0.50 | Rake $0
Seat 1: AARON81 (big blind) collected ($0.50)
Seat 3: IlxxxlI folded before Flop (didn't bet)
Seat 4: Xiniay folded before Flop (didn't bet)
Seat 5: PULISPATOLA (button) folded before Flop (didn't bet)
Seat 6: Karas321 (small blind) folded before Flop

PokerStars Hand #771303263: Hold'em No Limit ($0.50/$1.00 USD) - 2016/11/09 18:53:33 ET
Table 'WPN_179260045' 6-max  Seat #2 is the button
Seat 1: BigBlat ($48.30 in chips)
Seat 2: GautamaBuddha ($100.99 in chips)
Seat 4: illoke ($102.50 in chips)
Seat 5: IlxxxlI ($40.00 in chips)
Seat 6: v0landito ($105.18 in chips)
illoke: posts small blind $0.50
IlxxxlI: posts big blind $1
*** HOLE CARDS ***
Dealt to IlxxxlI [6c 9h]
v0landito: folds
BigBlat: folds
GautamaBuddha: folds
illoke: raises $2 to $3
IlxxxlI: folds
Uncalled bet ($2.00) returned to illoke
illoke: doesn't show hand
illoke collected $2 from pot
*** SUMMARY ***
Total pot $2 | Rake $0
Seat 1: BigBlat folded before Flop (didn't bet)
Seat 2: GautamaBuddha (button) folded before Flop (didn't bet)
Seat 4: illoke (small blind) collected ($2)
Seat 5: IlxxxlI (big blind) folded before Flop
Seat 6: v0landito folded before Flop (didn't bet)

PokerStars Hand #771303179: Hold'em No Limit ($0.25/$0.50 USD) - 2016/11/09 18:53:20 ET
Table 'WPN_3219946394' 6-max  Seat #4 is the button
Seat 1: illoke ($50.75 in chips)
Seat 2: IlxxxlI ($20.00 in chips)
Seat 4: dudu777 ($24.08 in chips)
Seat 5: Xiniay ($56.71 in chips)
Seat 6: 38979 ($102.79 in chips)
Xiniay: posts small blind $0.25
38979: posts big blind $0.50
*** HOLE CARDS ***
Dealt to IlxxxlI [Ac 7s]
illoke: raises $1 to $1.50
IlxxxlI: folds
dudu777: calls $1.50
Xiniay: folds
38979: folds
*** FLOP *** [2c 8s Kc]
illoke: bets $1.78
dudu777: calls $1.78
*** TURN *** [2c 8s Kc] [3d]
illoke: bets $4.63
dudu777: calls $4.63
*** RIVER *** [2c 8s Kc 3d] [Jh]
illoke: checks
dudu777: checks
*** SHOW DOWN ***
illoke: shows [Jd As] (One pair of Js)
dudu777: mucks hand
illoke collected $15.75 from pot
*** SUMMARY ***
Total pot $16.57 | Rake $0.82
Board [2c 8s Kc 3d Jh]
Seat 1: illoke showed [Jd As] and won ($15.75) with One pair of Js
Seat 2: IlxxxlI folded before Flop (didn't bet)
Seat 4: dudu777 (button) mucked
Seat 5: Xiniay (small blind) folded before Flop
Seat 6: 38979 (big blind) folded before Flop

PokerStars Hand #771303136: Hold'em No Limit ($0.25/$0.50 USD) - 2016/11/09 18:53:13 ET
Table 'WPN_1341348958' 6-max  Seat #4 is the button
Seat 1: AARON81 ($39.09 in chips)
Seat 3: IlxxxlI ($18.42 in chips)
Seat 4: Xiniay ($28.12 in chips)
Seat 5: PULISPATOLA ($37.95 in chips)
Seat 6: Karas321 ($13.98 in chips)
PULISPATOLA: posts small blind $0.25
Karas321: posts big blind $0.50
*** HOLE CARDS ***
Dealt to IlxxxlI [Ks 5s]
AARON81: raises $1 to $1.50
IlxxxlI: folds
Xiniay: folds
PULISPATOLA: folds
Karas321: folds
Uncalled bet ($1.00) returned to AARON81
AARON81: doesn't show hand
AARON81 collected $1.25 from pot
*** SUMMARY ***
Total pot $1.25 | Rake $0
Seat 1: AARON81 collected ($1.25)
Seat 3: IlxxxlI folded before Flop (didn't bet)
Seat 4: Xiniay (button) folded before Flop (didn't bet)
Seat 5: PULISPATOLA (small blind) folded before Flop
Seat 6: Karas321 (big blind) folded before Flop

PokerStars Hand #771302937: Hold'em No Limit ($0.25/$0.50 USD) - 2016/11/09 18:52:36 ET
Table 'WPN_3219946394' 6-max  Seat #2 is the button
Seat 1: illoke ($50.75 in chips)
Seat 2: IlxxxlI ($20.00 in chips)
Seat 4: dudu777 ($22.25 in chips)
Seat 5: Xiniay ($57.21 in chips)
Seat 6: 38979 ($102.79 in chips)
dudu777: posts small blind $0.25
Xiniay: posts big blind $0.50
*** HOLE CARDS ***
Dealt to IlxxxlI [5d 5c]
38979: folds
illoke: folds
IlxxxlI: raises $1 to $1.50
dudu777: calls $1.25
Xiniay: folds
*** FLOP *** [7h 4h 2h]
dudu777: checks
IlxxxlI: checks
*** TURN *** [7h 4h 2h] [As]
dudu777: bets $2.22
IlxxxlI: folds
Uncalled bet ($2.22) returned to dudu777
dudu777: doesn't show hand
dudu777 collected $3.33 from pot
*** SUMMARY ***
Total pot $3.50 | Rake $0.17
Board [7h 4h 2h As]
Seat 1: illoke folded before Flop (didn't bet)
Seat 2: IlxxxlI (button) folded on the Turn
Seat 4: dudu777 (small blind) collected ($3.33)
Seat 5: Xiniay (big blind) folded before Flop
Seat 6: 38979 folded before Flop (didn't bet)

PokerStars Hand #771302908: Hold'em No Limit ($0.50/$1.00 USD) - 2016/11/09 18:52:32 ET
Table 'WPN_179260045' 6-max  Seat #1 is the button
Seat 1: BigBlat ($40.30 in chips)
Seat 2: GautamaBuddha ($107.99 in chips)
Seat 4: illoke ($103.50 in chips)
Seat 5: IlxxxlI ($40.00 in chips)
Seat 6: v0landito ($105.18 in chips)
GautamaBuddha: posts small blind $0.50
illoke: posts big blind $1
*** HOLE CARDS ***
Dealt to IlxxxlI [6h 8h]
IlxxxlI: folds
v0landito: folds
BigBlat: raises $1 to $2
GautamaBuddha: raises $5 to $7
illoke: folds
BigBlat: raises $33.30 to $40.30 and is all-in
GautamaBuddha: folds
Uncalled bet ($33.30) returned to BigBlat
BigBlat: doesn't show hand
BigBlat collected $15 from pot
*** SUMMARY ***
Total pot $15 | Rake $0
Seat 1: BigBlat (button) collected ($15)
Seat 2: GautamaBuddha (small blind) folded before Flop
Seat 4: illoke (big blind) folded before Flop
Seat 5: IlxxxlI folded before Flop (didn't bet)
Seat 6: v0landito folded before Flop (didn't bet)

PokerStars Hand #771302710: Hold'em No Limit ($0.25/$0.50 USD) - 2016/11/09 18:51:58 ET
Table 'WPN_1341348958' 6-max  Seat #3 is the button
Seat 1: AARON81 ($39.09 in chips)
Seat 2: 38979 ($25.65 in chips)
Seat 3: IlxxxlI ($18.42 in chips)
Seat 4: Xiniay ($30.57 in chips)
Seat 5: PULISPATOLA ($35.74 in chips)
Seat 6: Karas321 ($13.98 in chips)
Xiniay: posts small blind $0.25
PULISPATOLA: posts big blind $0.50
*** HOLE CARDS ***
Dealt to IlxxxlI [6s 9c]
Karas321: folds
AARON81: folds
38979: folds
IlxxxlI: folds
Xiniay: raises $1 to $1.50
PULISPATOLA: calls $1
*** FLOP *** [7h 8c 5s]
Xiniay: bets $0.95
PULISPATOLA: calls $0.95
*** TURN *** [7h 8c 5s] [8d]
Xiniay: checks
PULISPATOLA: bets $2.33
Xiniay: folds
Uncalled bet ($2.33) returned to PULISPATOLA
PULISPATOLA: doesn't show hand
PULISPATOLA collected $4.66 from pot
*** SUMMARY ***
Total pot $4.90 | Rake $0.24
Board [7h 8c 5s 8d]
Seat 1: AARON81 folded before Flop (didn't bet)
Seat 2: 38979 folded before Flop (didn't bet)
Seat 3: IlxxxlI (button) folded before Flop (didn't bet)
Seat 4: Xiniay (small blind) folded on the Turn
Seat 5: PULISPATOLA (big blind) collected ($4.66)
Seat 6: Karas321 folded before Flop (didn't bet)

PokerStars Hand #771302682: Hold'em No Limit ($0.50/$1.00 USD) - 2016/11/09 18:51:53 ET
Table 'WPN_179260045' 6-max  Seat #6 is the button
Seat 1: BigBlat ($40.80 in chips)
Seat 2: GautamaBuddha ($108.99 in chips)
Seat 4: illoke ($103.50 in chips)
Seat 5: IlxxxlI ($40.00 in chips)
Seat 6: v0landito ($103.68 in chips)
BigBlat: posts small blind $0.50
GautamaBuddha: posts big blind $1
*** HOLE CARDS ***
Dealt to IlxxxlI [4d 7h]
illoke: folds
IlxxxlI: folds
v0landito: raises $1 to $2
BigBlat: folds
GautamaBuddha: folds
Uncalled bet ($1.00) returned to v0landito
v0landito: doesn't show hand
v0landito collected $2.50 from pot
*** SUMMARY ***
Total pot $2.50 | Rake $0
Seat 1: BigBlat (small blind) folded before Flop
Seat 2: GautamaBuddha (big blind) folded before Flop
Seat 4: illoke folded before Flop (didn't bet)
Seat 5: IlxxxlI folded before Flop (didn't bet)
Seat 6: v0landito (button) collected ($2.50)

PokerStars Hand #771302575: Hold'em No Limit ($0.25/$0.50 USD) - 2016/11/09 18:51:32 ET
Table 'WPN_1341348958' 6-max  Seat #2 is the button
Seat 1: AARON81 ($38.34 in chips)
Seat 2: 38979 ($25.65 in chips)
Seat 3: IlxxxlI ($18.67 in chips)
Seat 4: Xiniay ($31.07 in chips)
Seat 5: PULISPATOLA ($35.74 in chips)
Seat 6: Karas321 ($13.98 in chips)
IlxxxlI: posts small blind $0.25
Xiniay: posts big blind $0.50
*** HOLE CARDS ***
Dealt to IlxxxlI [4c Ad]
PULISPATOLA: folds
Karas321: folds
AARON81: raises $1 to $1.50
38979: folds
IlxxxlI: folds
Xiniay: folds
Uncalled bet ($1.00) returned to AARON81
AARON81: doesn't show hand
AARON81 collected $1.25 from pot
*** SUMMARY ***
Total pot $1.25 | Rake $0
Seat 1: AARON81 collected ($1.25)
Seat 2: 38979 (button) folded before Flop (didn't bet)
Seat 3: IlxxxlI (small blind) folded before Flop
Seat 4: Xiniay (big blind) folded before Flop
Seat 5: PULISPATOLA folded before Flop (didn't bet)
Seat 6: Karas321 folded before Flop (didn't bet)

PokerStars Hand #771302539: Hold'em No Limit ($0.50/$1.00 USD) - 2016/11/09 18:51:26 ET
Table 'WPN_179260045' 6-max  Seat #5 is the button
Seat 1: BigBlat ($41.80 in chips)
Seat 2: GautamaBuddha ($107.49 in chips)
Seat 4: illoke ($103.50 in chips)
Seat 5: IlxxxlI ($40.00 in chips)
Seat 6: v0landito ($104.18 in chips)
v0landito: posts small blind $0.50
BigBlat: posts big blind $1
*** HOLE CARDS ***
Dealt to IlxxxlI [6h As]
GautamaBuddha: raises $1.50 to $2.50
illoke: folds
IlxxxlI: folds
v0landito: folds
BigBlat: folds
Uncalled bet ($1.50) returned to GautamaBuddha
GautamaBuddha: doesn't show hand
GautamaBuddha collected $2.50 from pot
*** SUMMARY ***
Total pot $2.50 | Rake $0
Seat 1: BigBlat (big blind) folded before Flop
Seat 2: GautamaBuddha collected ($2.50)
Seat 4: illoke folded before Flop (didn't bet)
Seat 5: IlxxxlI (button) folded before Flop (didn't bet)
Seat 6: v0landito (small blind) folded before Flop

PokerStars Hand #771302373: Hold'em No Limit ($0.25/$0.50 USD) - 2016/11/09 18:50:56 ET
Table 'WPN_3219946394' 6-max  Seat #6 is the button
Seat 1: illoke ($50.25 in chips)
Seat 2: IlxxxlI ($20.75 in chips)
Seat 3: saidafrente ($46.57 in chips)
Seat 5: Xiniay ($57.21 in chips)
Seat 6: 38979 ($102.79 in chips)
illoke: posts small blind $0.25
IlxxxlI: posts big blind $0.50
*** HOLE CARDS ***
Dealt to IlxxxlI [Kc 5h]
saidafrente: folds
Xiniay: folds
38979: folds
illoke: raises $1 to $1.50
IlxxxlI: folds
Uncalled bet ($1.00) returned to illoke
illoke: doesn't show hand
illoke collected $1 from pot
*** SUMMARY ***
Total pot $1 | Rake $0
Seat 1: illoke (small blind) collected ($1)
Seat 2: IlxxxlI (big blind) folded before Flop
Seat 3: saidafrente folded before Flop (didn't bet)
Seat 5: Xiniay folded before Flop (didn't bet)
Seat 6: 38979 (button) folded before Flop (didn't bet)

PokerStars Hand #771302302: Hold'em No Limit ($0.25/$0.50 USD) - 2016/11/09 18:50:43 ET
Table 'WPN_1341348958' 6-max  Seat #1 is the button
Seat 1: AARON81 ($38.34 in chips)
Seat 2: 38979 ($25.90 in chips)
Seat 3: IlxxxlI ($19.67 in chips)
Seat 5: PULISPATOLA ($34.60 in chips)
Seat 6: Karas321 ($13.98 in chips)
38979: posts small blind $0.25
IlxxxlI: posts big blind $0.50
*** HOLE CARDS ***
Dealt to IlxxxlI [8s 9c]
PULISPATOLA: raises $0.50 to $1
Karas321: folds
AARON81: folds
38979: folds
IlxxxlI: calls $0.50
*** FLOP *** [2c Kc 6h]
IlxxxlI: checks
PULISPATOLA: bets $1.07
IlxxxlI: folds
Uncalled bet ($1.07) returned to PULISPATOLA
PULISPATOLA: doesn't show hand
PULISPATOLA collected $2.14 from pot
*** SUMMARY ***
Total pot $2.25 | Rake $0.11
Board [2c Kc 6h]
Seat 1: AARON81 (button) folded before Flop (didn't bet)
Seat 2: 38979 (small blind) folded before Flop
Seat 3: IlxxxlI (big blind) folded on the Flop
Seat 5: PULISPATOLA collected ($2.14)
Seat 6: Karas321 folded before Flop (didn't bet)

PokerStars Hand #771302149: Hold'em No Limit ($0.25/$0.50 USD) - 2016/11/09 18:50:14 ET
Table 'WPN_3219946394' 6-max  Seat #5 is the button
Seat 1: illoke ($50.75 in chips)
Seat 2: IlxxxlI ($20.75 in chips)
Seat 3: saidafrente ($45.82 in chips)
Seat 5: Xiniay ($57.21 in chips)
Seat 6: 38979 ($103.04 in chips)
38979: posts small blind $0.25
illoke: posts big blind $0.50
*** HOLE CARDS ***
Dealt to IlxxxlI [3c 8s]
IlxxxlI: folds
saidafrente: raises $1 to $1.50
Xiniay: folds
38979: folds
illoke: folds
Uncalled bet ($1.00) returned to saidafrente
saidafrente: doesn't show hand
saidafrente collected $1.25 from pot
*** SUMMARY ***
Total pot $1.25 | Rake $0
Seat 1: illoke (big blind) folded before Flop
Seat 2: IlxxxlI folded before Flop (didn't bet)
Seat 3: saidafrente collected ($1.25)
Seat 5: Xiniay (button) folded before Flop (didn't bet)
Seat 6: 38979 (small blind) folded before Flop

PokerStars Hand #771302058: Hold'em No Limit ($0.25/$0.50 USD) - 2016/11/09 18:49:57 ET
Table 'WPN_1341348958' 6-max  Seat #6 is the button
Seat 1: AARON81 ($39.34 in chips)
Seat 2: 38979 ($25.00 in chips)
Seat 3: IlxxxlI ($19.67 in chips)
Seat 5: PULISPATOLA ($34.60 in chips)
Seat 6: Karas321 ($13.98 in chips)
AARON81: posts small blind $0.25
38979: posts big blind $0.50
*** HOLE CARDS ***
Dealt to IlxxxlI [Kc 5h]
IlxxxlI: folds
PULISPATOLA: folds
Karas321: folds
AARON81: calls $0.25
38979: checks
*** FLOP *** [6c 3h 6d]
AARON81: bets $0.50
38979: calls $0.50
*** TURN *** [6c 3h 6d] [7d]
AARON81: checks
38979: bets $1.50
AARON81: folds
Uncalled bet ($1.50) returned to 38979
38979: doesn't show hand
38979 collected $1.90 from pot
*** SUMMARY ***
Total pot $2 | Rake $0.10
Board [6c 3h 6d 7d]
Seat 1: AARON81 (small blind) folded on the Turn
Seat 2: 38979 (big blind) collected ($1.90)
Seat 3: IlxxxlI folded before Flop (didn't bet)
Seat 5: PULISPATOLA folded before Flop (didn't bet)
Seat 6: Karas321 (button) folded before Flop (didn't bet)

PokerStars Hand #771302038: Hold'em No Limit ($0.25/$0.50 USD) - 2016/11/09 18:49:53 ET
Table 'WPN_3219946394' 6-max  Seat #3 is the button
Seat 1: illoke ($50.75 in chips)
Seat 2: IlxxxlI ($20.75 in chips)
Seat 3: saidafrente ($45.82 in chips)
Seat 5: Xiniay ($57.46 in chips)
Seat 6: 38979 ($102.79 in chips)
Xiniay: posts small blind $0.25
38979: posts big blind $0.50
*** HOLE CARDS ***
Dealt to IlxxxlI [8h Th]
illoke: folds
IlxxxlI: folds
saidafrente: folds
Xiniay: folds
Uncalled bet ($0.25) returned to 38979
38979: doesn't show hand
38979 collected $0.50 from pot
*** SUMMARY ***
Total pot $0.50 | Rake $0
Seat 1: illoke folded before Flop (didn't bet)
Seat 2: IlxxxlI folded before Flop (didn't bet)
Seat 3: saidafrente (button) folded before Flop (didn't bet)
Seat 5: Xiniay (small blind) folded before Flop
Seat 6: 38979 (big blind) collected ($0.50)

PokerStars Hand #771301981: Hold'em No Limit ($0.50/$1.00 USD) - 2016/11/09 18:49:43 ET
Table 'WPN_179260045' 6-max  Seat #4 is the button
Seat 1: BigBlat ($43.80 in chips)
Seat 2: GautamaBuddha ($107.49 in chips)
Seat 3: 38979 ($105.00 in chips)
Seat 4: illoke ($105.50 in chips)
Seat 5: IlxxxlI ($40.00 in chips)
Seat 6: v0landito ($100.00 in chips)
IlxxxlI: posts small blind $0.50
v0landito: posts big blind $1
*** HOLE CARDS ***
Dealt to IlxxxlI [Qs 6c]
BigBlat: raises $1 to $2
GautamaBuddha: folds
38979: folds
illoke: calls $2
IlxxxlI: folds
v0landito: calls $1
*** FLOP *** [Js Ac Tc]
v0landito: checks
BigBlat: checks
illoke: checks
*** TURN *** [Js Ac Tc] [Qc]
v0landito: checks
BigBlat: checks
illoke: checks
*** RIVER *** [Js Ac Tc Qc] [Kh]
v0landito: bets $98 and is all-in
BigBlat: folds
illoke: folds
Uncalled bet ($98.00) returned to v0landito
v0landito: doesn't show hand
v0landito collected $6.18 from pot
*** SUMMARY ***
Total pot $6.50 | Rake $0.32
Board [Js Ac Tc Qc Kh]
Seat 1: BigBlat folded on the River
Seat 2: GautamaBuddha folded before Flop (didn't bet)
Seat 3: 38979 folded before Flop (didn't bet)
Seat 4: illoke (button) folded on the River
Seat 5: IlxxxlI (small blind) folded before Flop
Seat 6: v0landito (big blind) collected ($6.18)

PokerStars Hand #771301931: Hold'em No Limit ($0.25/$0.50 USD) - 2016/11/09 18:49:32 ET
Table 'WPN_1341348958' 6-max  Seat #5 is the button
Seat 1: AARON81 ($39.09 in chips)
Seat 3: IlxxxlI ($19.67 in chips)
Seat 5: PULISPATOLA ($34.60 in chips)
Seat 6: Karas321 ($14.23 in chips)
Karas321: posts small blind $0.25
AARON81: posts big blind $0.50
*** HOLE CARDS ***
Dealt to IlxxxlI [7c As]
IlxxxlI: folds
PULISPATOLA: folds
Karas321: folds
Uncalled bet ($0.25) returned to AARON81
AARON81: doesn't show hand
AARON81 collected $0.50 from pot
*** SUMMARY ***
Total pot $0.50 | Rake $0
Seat 1: AARON81 (big blind) collected ($0.50)
Seat 3: IlxxxlI folded before Flop (didn't bet)
Seat 5: PULISPATOLA (button) folded before Flop (didn't bet)
Seat 6: Karas321 (small blind) folded before Flop

PokerStars Hand #771301831: Hold'em No Limit ($0.25/$0.50 USD) - 2016/11/09 18:49:13 ET
Table 'WPN_1341348958' 6-max  Seat #3 is the button
Seat 1: AARON81 ($39.09 in chips)
Seat 3: IlxxxlI ($19.67 in chips)
Seat 5: PULISPATOLA ($34.85 in chips)
Seat 6: Karas321 ($13.98 in chips)
PULISPATOLA: posts small blind $0.25
Karas321: posts big blind $0.50
*** HOLE CARDS ***
Dealt to IlxxxlI [9c 8s]
AARON81: folds
IlxxxlI: folds
PULISPATOLA: folds
Uncalled bet ($0.25) returned to Karas321
Karas321: doesn't show hand
Karas321 collected $0.50 from pot
*** SUMMARY ***
Total pot $0.50 | Rake $0
Seat 1: AARON81 folded before Flop (didn't bet)
Seat 3: IlxxxlI (button) folded before Flop (didn't bet)
Seat 5: PULISPATOLA (small blind) folded before Flop
Seat 6: Karas321 (big blind) collected ($0.50)

PokerStars Hand #771301715: Hold'em No Limit ($0.25/$0.50 USD) - 2016/11/09 18:48:53 ET
Table 'WPN_1341348958' 6-max  Seat #1 is the button
Seat 1: AARON81 ($38.34 in chips)
Seat 3: IlxxxlI ($19.92 in chips)
Seat 5: PULISPATOLA ($35.35 in chips)
Seat 6: Karas321 ($13.98 in chips)
IlxxxlI: posts small blind $0.25
PULISPATOLA: posts big blind $0.50
*** HOLE CARDS ***
Dealt to IlxxxlI [7c Td]
Karas321: folds
AARON81: raises $1 to $1.50
IlxxxlI: folds
PULISPATOLA: folds
Uncalled bet ($1.00) returned to AARON81
AARON81: doesn't show hand
AARON81 collected $1.25 from pot
*** SUMMARY ***
Total pot $1.25 | Rake $0
Seat 1: AARON81 (button) collected ($1.25)
Seat 3: IlxxxlI (small blind) folded before Flop
Seat 5: PULISPATOLA (big blind) folded before Flop
Seat 6: Karas321 folded before Flop (didn't bet)

PokerStars Hand #771301685: Hold'em No Limit ($0.25/$0.50 USD) - 2016/11/09 18:48:49 ET
Table 'WPN_3219946394' 6-max  Seat #1 is the button
Seat 1: illoke ($50.00 in chips)
Seat 2: IlxxxlI ($20.25 in chips)
Seat 3: saidafrente ($46.57 in chips)
Seat 4: odel_nadel ($123.02 in chips)
Seat 6: 38979 ($102.79 in chips)
IlxxxlI: posts small blind $0.25
saidafrente: posts big blind $0.50
*** HOLE CARDS ***
Dealt to IlxxxlI [Kh Jh]
odel_nadel: folds
38979: folds
illoke: folds
IlxxxlI: raises $0.75 to $1.25
saidafrente: folds
Uncalled bet ($0.75) returned to IlxxxlI
IlxxxlI: doesn't show hand
IlxxxlI collected $1 from pot
*** SUMMARY ***
Total pot $1 | Rake $0
Seat 1: illoke (button) folded before Flop (didn't bet)
Seat 2: IlxxxlI (small blind) collected ($1)
Seat 3: saidafrente (big blind) folded before Flop
Seat 4: odel_nadel folded before Flop (didn't bet)
Seat 6: 38979 folded before Flop (didn't bet)

PokerStars Hand #771301691: Hold'em No Limit ($0.50/$1.00 USD) - 2016/11/09 18:48:49 ET
Table 'WPN_179260045' 6-max  Seat #3 is the button
Seat 1: BigBlat ($45.80 in chips)
Seat 2: GautamaBuddha ($107.49 in chips)
Seat 3: 38979 ($101.50 in chips)
Seat 4: illoke ($106.00 in chips)
Seat 5: IlxxxlI ($40.00 in chips)
Seat 6: v0landito ($100.00 in chips)
illoke: posts small blind $0.50
IlxxxlI: posts big blind $1
*** HOLE CARDS ***
Dealt to IlxxxlI [Tc 2c]
v0landito: folds
BigBlat: raises $1 to $2
GautamaBuddha: folds
38979: raises $6 to $8
illoke: folds
IlxxxlI: folds
BigBlat: folds
Uncalled bet ($6.00) returned to 38979
38979: doesn't show hand
38979 collected $5.50 from pot
*** SUMMARY ***
Total pot $5.50 | Rake $0
Seat 1: BigBlat folded before Flop
Seat 2: GautamaBuddha folded before Flop (didn't bet)
Seat 3: 38979 (button) collected ($5.50)
Seat 4: illoke (small blind) folded before Flop
Seat 5: IlxxxlI (big blind) folded before Flop
Seat 6: v0landito folded before Flop (didn't bet)

PokerStars Hand #771301593: Hold'em No Limit ($0.25/$0.50 USD) - 2016/11/09 18:48:29 ET
Table 'WPN_1341348958' 6-max  Seat #6 is the button
Seat 1: AARON81 ($38.59 in chips)
Seat 3: IlxxxlI ($20.42 in chips)
Seat 5: PULISPATOLA ($34.60 in chips)
Seat 6: Karas321 ($13.98 in chips)
AARON81: posts small blind $0.25
IlxxxlI: posts big blind $0.50
*** HOLE CARDS ***
Dealt to IlxxxlI [6h 9c]
PULISPATOLA: raises $0.50 to $1
Karas321: folds
AARON81: folds
IlxxxlI: folds
Uncalled bet ($0.50) returned to PULISPATOLA
PULISPATOLA: doesn't show hand
PULISPATOLA collected $1.25 from pot
*** SUMMARY ***
Total pot $1.25 | Rake $0
Seat 1: AARON81 (small blind) folded before Flop
Seat 3: IlxxxlI folded before Flop
Seat 5: PULISPATOLA collected ($1.25)
Seat 6: Karas321 (button) folded before Flop (didn't bet)

PokerStars Hand #771301534: Hold'em No Limit ($0.25/$0.50 USD) - 2016/11/09 18:48:20 ET
Table 'WPN_3219946394' 6-max  Seat #6 is the button
Seat 1: illoke ($50.25 in chips)
Seat 2: IlxxxlI ($20.75 in chips)
Seat 3: saidafrente ($46.57 in chips)
Seat 4: odel_nadel ($123.02 in chips)
Seat 6: 38979 ($102.04 in chips)
illoke: posts small blind $0.25
IlxxxlI: posts big blind $0.50
*** HOLE CARDS ***
Dealt to IlxxxlI [Th 5s]
saidafrente: folds
odel_nadel: folds
38979: raises $0.50 to $1
illoke: folds
IlxxxlI: folds
Uncalled bet ($0.50) returned to 38979
38979: doesn't show hand
38979 collected $1.25 from pot
*** SUMMARY ***
Total pot $1.25 | Rake $0
Seat 1: illoke (small blind) folded before Flop
Seat 2: IlxxxlI (big blind) folded before Flop
Seat 3: saidafrente folded before Flop (didn't bet)
Seat 4: odel_nadel folded before Flop (didn't bet)
Seat 6: 38979 (button) collected ($1.25)

PokerStars Hand #771301274: Hold'em No Limit ($0.25/$0.50 USD) - 2016/11/09 18:47:33 ET
Table 'WPN_1341348958' 6-max  Seat #5 is the button
Seat 1: AARON81 ($43.01 in chips)
Seat 2: odel_nadel ($25.00 in chips)
Seat 3: IlxxxlI ($20.42 in chips)
Seat 5: PULISPATOLA ($34.60 in chips)
Seat 6: Karas321 ($10.00 in chips)
Karas321: posts small blind $0.25
AARON81: posts big blind $0.50
*** HOLE CARDS ***
Dealt to IlxxxlI [5h 6c]
odel_nadel: folds
IlxxxlI: folds
PULISPATOLA: folds
Karas321: raises $0.50 to $1
AARON81: calls $0.50
*** FLOP *** [Ad Qd 2c]
Karas321: bets $0.95
AARON81: calls $0.95
*** TURN *** [Ad Qd 2c] [As]
Karas321: checks
AARON81: checks
*** RIVER *** [Ad Qd 2c As] [8h]
Karas321: bets $2.47
AARON81: calls $2.47
*** SHOW DOWN ***
AARON81: mucks hand
Karas321: shows [4d Ac] (Three Of Kind of As)
Karas321 collected $8.40 from pot
*** SUMMARY ***
Total pot $8.84 | Rake $0.44
Board [Ad Qd 2c As 8h]
Seat 1: AARON81 (big blind) mucked
Seat 2: odel_nadel folded before Flop (didn't bet)
Seat 3: IlxxxlI folded before Flop (didn't bet)
Seat 5: PULISPATOLA (button) folded before Flop (didn't bet)
Seat 6: Karas321 (small blind) showed [4d Ac] and won ($8.40) with Three Of Kind of As

PokerStars Hand #771301185: Hold'em No Limit ($0.25/$0.50 USD) - 2016/11/09 18:47:14 ET
Table 'WPN_1341348958' 6-max  Seat #3 is the button
Seat 1: AARON81 ($42.26 in chips)
Seat 2: odel_nadel ($25.00 in chips)
Seat 3: IlxxxlI ($20.42 in chips)
Seat 5: PULISPATOLA ($34.85 in chips)
Seat 6: Karas321 ($10.00 in chips)
PULISPATOLA: posts small blind $0.25
Karas321: posts big blind $0.50
*** HOLE CARDS ***
Dealt to IlxxxlI [6d 9d]
AARON81: raises $1 to $1.50
odel_nadel: folds
IlxxxlI: folds
PULISPATOLA: folds
Karas321: folds
Uncalled bet ($1.00) returned to AARON81
AARON81: doesn't show hand
AARON81 collected $1.25 from pot
*** SUMMARY ***
Total pot $1.25 | Rake $0
Seat 1: AARON81 collected ($1.25)
Seat 2: odel_nadel folded before Flop (didn't bet)
Seat 3: IlxxxlI (button) folded before Flop (didn't bet)
Seat 5: PULISPATOLA (small blind) folded before Flop
Seat 6: Karas321 (big blind) folded before Flop

PokerStars Hand #771301132: Hold'em No Limit ($0.25/$0.50 USD) - 2016/11/09 18:47:05 ET
Table 'WPN_3219946394' 6-max  Seat #4 is the button
Seat 1: illoke ($50.75 in chips)
Seat 2: IlxxxlI ($20.75 in chips)
Seat 3: saidafrente ($46.57 in chips)
Seat 4: odel_nadel ($113.09 in chips)
Seat 6: 38979 ($112.54 in chips)
38979: posts small blind $0.25
illoke: posts big blind $0.50
*** HOLE CARDS ***
Dealt to IlxxxlI [9d 6c]
IlxxxlI: folds
saidafrente: folds
odel_nadel: raises $0.50 to $1
38979: raises $4 to $5
illoke: folds
odel_nadel: calls $4
*** FLOP *** [Ah Td 4h]
38979: bets $5.50
odel_nadel: calls $5.50
*** TURN *** [Ah Td 4h] [9s]
38979: checks
odel_nadel: checks
*** RIVER *** [Ah Td 4h 9s] [5d]
38979: checks
odel_nadel: checks
*** SHOW DOWN ***
odel_nadel: shows [Jh Ts] (One pair of 10s)
38979: mucks hand
odel_nadel collected $20.43 from pot
*** SUMMARY ***
Total pot $21.50 | Rake $1.07
Board [Ah Td 4h 9s 5d]
Seat 1: illoke (big blind) folded before Flop
Seat 2: IlxxxlI folded before Flop (didn't bet)
Seat 3: saidafrente folded before Flop (didn't bet)
Seat 4: odel_nadel (button) showed [Jh Ts] and won ($20.43) with One pair of 10s
Seat 6: 38979 (small blind) mucked

PokerStars Hand #771300985: Hold'em No Limit ($0.25/$0.50 USD) - 2016/11/09 18:46:35 ET
Table 'WPN_3219946394' 6-max  Seat #3 is the button
Seat 1: illoke ($50.00 in chips)
Seat 2: IlxxxlI ($20.75 in chips)
Seat 3: saidafrente ($46.57 in chips)
Seat 4: odel_nadel ($113.34 in chips)
Seat 6: 38979 ($113.04 in chips)
odel_nadel: posts small blind $0.25
38979: posts big blind $0.50
*** HOLE CARDS ***
Dealt to IlxxxlI [4d 6c]
illoke: raises $1 to $1.50
IlxxxlI: folds
saidafrente: folds
odel_nadel: folds
38979: folds
Uncalled bet ($1.00) returned to illoke
illoke: doesn't show hand
illoke collected $1.25 from pot
*** SUMMARY ***
Total pot $1.25 | Rake $0
Seat 1: illoke collected ($1.25)
Seat 2: IlxxxlI folded before Flop (didn't bet)
Seat 3: saidafrente (button) folded before Flop (didn't bet)
Seat 4: odel_nadel (small blind) folded before Flop
Seat 6: 38979 (big blind) folded before Flop

PokerStars Hand #771300931: Hold'em No Limit ($0.25/$0.50 USD) - 2016/11/09 18:46:25 ET
Table 'WPN_1341348958' 6-max  Seat #2 is the button
Seat 1: AARON81 ($42.26 in chips)
Seat 2: odel_nadel ($25.00 in chips)
Seat 3: IlxxxlI ($20.67 in chips)
Seat 5: PULISPATOLA ($33.71 in chips)
Seat 6: Karas321 ($10.00 in chips)
IlxxxlI: posts small blind $0.25
PULISPATOLA: posts big blind $0.50
*** HOLE CARDS ***
Dealt to IlxxxlI [9d Kc]
Karas321: folds
AARON81: folds
odel_nadel: raises $0.50 to $1
IlxxxlI: folds
PULISPATOLA: calls $0.50
*** FLOP *** [Qh 7s Qd]
PULISPATOLA: checks
odel_nadel: checks
*** TURN *** [Qh 7s Qd] [5d]
PULISPATOLA: bets $1.07
odel_nadel: folds
Uncalled bet ($1.07) returned to PULISPATOLA
PULISPATOLA: doesn't show hand
PULISPATOLA collected $2.14 from pot
*** SUMMARY ***
Total pot $2.25 | Rake $0.11
Board [Qh 7s Qd 5d]
Seat 1: AARON81 folded before Flop (didn't bet)
Seat 2: odel_nadel (button) folded on the Turn
Seat 3: IlxxxlI (small blind) folded before Flop
Seat 5: PULISPATOLA (big blind) collected ($2.14)
Seat 6: Karas321 folded before Flop (didn't bet)

PokerStars Hand #771300843: Hold'em No Limit ($0.25/$0.50 USD) - 2016/11/09 18:46:06 ET
Table 'WPN_3219946394' 6-max  Seat #2 is the button
Seat 1: illoke ($50.00 in chips)
Seat 2: IlxxxlI ($20.00 in chips)
Seat 3: saidafrente ($46.82 in chips)
Seat 4: odel_nadel ($113.84 in chips)
Seat 6: 38979 ($113.04 in chips)
saidafrente: posts small blind $0.25
odel_nadel: posts big blind $0.50
*** HOLE CARDS ***
Dealt to IlxxxlI [Jh Ah]
38979: folds
illoke: folds
IlxxxlI: raises $1 to $1.50
saidafrente: folds
odel_nadel: folds
Uncalled bet ($1.00) returned to IlxxxlI
IlxxxlI: doesn't show hand
IlxxxlI collected $1.25 from pot
*** SUMMARY ***
Total pot $1.25 | Rake $0
Seat 1: illoke folded before Flop (didn't bet)
Seat 2: IlxxxlI (button) collected ($1.25)
Seat 3: saidafrente (small blind) folded before Flop
Seat 4: odel_nadel (big blind) folded before Flop
Seat 6: 38979 folded before Flop (didn't bet)

PokerStars Hand #771300705: Hold'em No Limit ($0.25/$0.50 USD) - 2016/11/09 18:45:40 ET
Table 'WPN_1341348958' 6-max  Seat #1 is the button
Seat 1: AARON81 ($42.26 in chips)
Seat 2: odel_nadel ($25.00 in chips)
Seat 3: IlxxxlI ($10.75 in chips)
Seat 5: PULISPATOLA ($33.71 in chips)
Seat 6: Karas321 ($10.75 in chips)
odel_nadel: posts small blind $0.25
IlxxxlI: posts big blind $0.50
*** HOLE CARDS ***
Dealt to IlxxxlI [Th Td]
PULISPATOLA: folds
Karas321: raises $0.50 to $1
AARON81: folds
odel_nadel: folds
IlxxxlI: raises $9.75 to $10.75 and is all-in
Karas321: calls $9.75 and is all-in
*** FLOP *** [2d 3c 8h]
*** TURN *** [2d 3c 8h] [9c]
*** RIVER *** [2d 3c 8h 9c] [4s]
*** SHOW DOWN ***
IlxxxlI: shows [Th Td] (One pair of 10s)
Karas321: shows [Js Ac] (High card A)
IlxxxlI collected $20.67 from pot
*** SUMMARY ***
Total pot $21.75 | Rake $1.08
Board [2d 3c 8h 9c 4s]
Seat 1: AARON81 (button) folded before Flop (didn't bet)
Seat 2: odel_nadel (small blind) folded before Flop
Seat 3: IlxxxlI (big blind) showed [Th Td] and won ($20.67) with One pair of 10s
Seat 5: PULISPATOLA folded before Flop (didn't bet)
Seat 6: Karas321 showed [Js Ac] and lost with High card A

PokerStars Hand #771300552: Hold'em No Limit ($0.25/$0.50 USD) - 2016/11/09 18:45:12 ET
Table 'WPN_1341348958' 6-max  Seat #6 is the button
Seat 1: AARON81 ($42.51 in chips)
Seat 2: odel_nadel ($25.00 in chips)
Seat 3: IlxxxlI ($10.75 in chips)
Seat 5: PULISPATOLA ($33.71 in chips)
Seat 6: Karas321 ($10.00 in chips)
AARON81: posts small blind $0.25
odel_nadel: posts big blind $0.50
*** HOLE CARDS ***
Dealt to IlxxxlI [3d 9d]
IlxxxlI: folds
PULISPATOLA: folds
Karas321: raises $0.50 to $1
AARON81: folds
odel_nadel: folds
Uncalled bet ($0.50) returned to Karas321
Karas321: doesn't show hand
Karas321 collected $1.25 from pot
*** SUMMARY ***
Total pot $1.25 | Rake $0
Seat 1: AARON81 (small blind) folded before Flop
Seat 2: odel_nadel (big blind) folded before Flop
Seat 3: IlxxxlI folded before Flop (didn't bet)
Seat 5: PULISPATOLA folded before Flop (didn't bet)
Seat 6: Karas321 (button) collected ($1.25)

PokerStars Hand #771300382: Hold'em No Limit ($0.25/$0.50 USD) - 2016/11/09 18:44:40 ET
Table 'WPN_1341348958' 6-max  Seat #5 is the button
Seat 1: AARON81 ($42.26 in chips)
Seat 2: odel_nadel ($25.00 in chips)
Seat 3: IlxxxlI ($10.75 in chips)
Seat 5: PULISPATOLA ($33.71 in chips)
Seat 6: Karas321 ($10.00 in chips)
Karas321: posts small blind $0.25
AARON81: posts big blind $0.50
*** HOLE CARDS ***
Dealt to IlxxxlI [6h Qd]
odel_nadel: folds
IlxxxlI: folds
PULISPATOLA: folds
Karas321: folds
Uncalled bet ($0.25) returned to AARON81
AARON81: doesn't show hand
AARON81 collected $0.50 from pot
*** SUMMARY ***
Total pot $0.50 | Rake $0
Seat 1: AARON81 (big blind) collected ($0.50)
Seat 2: odel_nadel folded before Flop (didn't bet)
Seat 3: IlxxxlI folded before Flop (didn't bet)
Seat 5: PULISPATOLA (button) folded before Flop (didn't bet)
Seat 6: Karas321 (small blind) folded before Flop

PokerStars Hand #771300338: Hold'em No Limit ($0.25/$0.50 USD) - 2016/11/09 18:44:31 ET
Table 'WPN_3219946394' 6-max  Seat #1 is the button
Seat 1: illoke ($50.00 in chips)
Seat 2: IlxxxlI ($20.25 in chips)
Seat 3: saidafrente ($47.32 in chips)
Seat 4: odel_nadel ($113.84 in chips)
Seat 6: 38979 ($103.32 in chips)
IlxxxlI: posts small blind $0.25
saidafrente: posts big blind $0.50
*** HOLE CARDS ***
Dealt to IlxxxlI [Ts Ah]
odel_nadel: folds
38979: raises $1 to $1.50
illoke: raises $3 to $4.50
IlxxxlI: folds
saidafrente: folds
38979: raises $5.50 to $10
illoke: calls $5.50
*** FLOP *** [Th 5d Kh]
38979: checks
illoke: checks
*** TURN *** [Th 5d Kh] [Ac]
38979: bets $6.57
illoke: folds
Uncalled bet ($6.57) returned to 38979
38979: doesn't show hand
38979 collected $19.72 from pot
*** SUMMARY ***
Total pot $20.75 | Rake $1.03
Board [Th 5d Kh Ac]
Seat 1: illoke (button) folded on the Turn
Seat 2: IlxxxlI (small blind) folded before Flop
Seat 3: saidafrente (big blind) folded before Flop
Seat 4: odel_nadel folded before Flop (didn't bet)
Seat 6: 38979 collected ($19.72)

PokerStars Hand #771300049: Hold'em No Limit ($0.25/$0.50 USD) - 2016/11/09 18:43:42 ET
Table 'WPN_3219946394' 6-max  Seat #6 is the button
Seat 1: illoke ($50.00 in chips)
Seat 2: IlxxxlI ($20.75 in chips)
Seat 3: saidafrente ($46.57 in chips)
Seat 4: odel_nadel ($113.84 in chips)
Seat 6: 38979 ($103.32 in chips)
illoke: posts small blind $0.25
IlxxxlI: posts big blind $0.50
*** HOLE CARDS ***
Dealt to IlxxxlI [9h 4d]
saidafrente: raises $1 to $1.50
odel_nadel: folds
38979: folds
illoke: folds
IlxxxlI: folds
Uncalled bet ($1.00) returned to saidafrente
saidafrente: doesn't show hand
saidafrente collected $1.25 from pot
*** SUMMARY ***
Total pot $1.25 | Rake $0
Seat 1: illoke (small blind) folded before Flop
Seat 2: IlxxxlI (big blind) folded before Flop
Seat 3: saidafrente collected ($1.25)
Seat 4: odel_nadel folded before Flop (didn't bet)
Seat 6: 38979 (button) folded before Flop (didn't bet)

PokerStars Hand #771299862: Hold'em No Limit ($0.25/$0.50 USD) - 2016/11/09 18:43:07 ET
Table 'WPN_3219946394' 6-max  Seat #4 is the button
Seat 1: illoke ($50.00 in chips)
Seat 2: IlxxxlI ($20.75 in chips)
Seat 3: saidafrente ($46.57 in chips)
Seat 4: odel_nadel ($113.09 in chips)
Seat 6: 38979 ($103.57 in chips)
38979: posts small blind $0.25
illoke: posts big blind $0.50
*** HOLE CARDS ***
Dealt to IlxxxlI [Qs 3h]
IlxxxlI: folds
saidafrente: folds
odel_nadel: raises $0.50 to $1
38979: folds
illoke: folds
Uncalled bet ($0.50) returned to odel_nadel
odel_nadel: doesn't show hand
odel_nadel collected $1.25 from pot
*** SUMMARY ***
Total pot $1.25 | Rake $0
Seat 1: illoke (big blind) folded before Flop
Seat 2: IlxxxlI folded before Flop (didn't bet)
Seat 3: saidafrente folded before Flop (didn't bet)
Seat 4: odel_nadel (button) collected ($1.25)
Seat 6: 38979 (small blind) folded before Flop

PokerStars Hand #771299745: Hold'em No Limit ($0.25/$0.50 USD) - 2016/11/09 18:42:46 ET
Table 'WPN_1341348958' 6-max  Seat #3 is the button
Seat 1: AARON81 ($43.76 in chips)
Seat 2: odel_nadel ($25.96 in chips)
Seat 3: IlxxxlI ($10.75 in chips)
Seat 5: PULISPATOLA ($27.31 in chips)
Seat 6: Karas321 ($10.00 in chips)
PULISPATOLA: posts small blind $0.25
Karas321: posts big blind $0.50
*** HOLE CARDS ***
Dealt to IlxxxlI [Jd 5h]
AARON81: raises $1 to $1.50
odel_nadel: calls $1.50
IlxxxlI: folds
PULISPATOLA: calls $1.25
Karas321: folds
*** FLOP *** [Td Qh Kc]
PULISPATOLA: checks
AARON81: checks
odel_nadel: bets $3.50
PULISPATOLA: calls $3.50
AARON81: folds
*** TURN *** [Td Qh Kc] [Kd]
PULISPATOLA: checks
odel_nadel: checks
*** RIVER *** [Td Qh Kc Kd] [3h]
PULISPATOLA: bets $22.31 and is all-in
odel_nadel: folds
Uncalled bet ($22.31) returned to PULISPATOLA
PULISPATOLA: doesn't show hand
PULISPATOLA collected $11.40 from pot
*** SUMMARY ***
Total pot $12 | Rake $0.60
Board [Td Qh Kc Kd 3h]
Seat 1: AARON81 folded on the Flop
Seat 2: odel_nadel folded on the River
Seat 3: IlxxxlI (button) folded before Flop (didn't bet)
Seat 5: PULISPATOLA (small blind) collected ($11.40)
Seat 6: Karas321 (big blind) folded before Flop

PokerStars Hand #771299737: Hold'em No Limit ($0.25/$0.50 USD) - 2016/11/09 18:42:45 ET
Table 'WPN_3219946394' 6-max  Seat #3 is the button
Seat 2: IlxxxlI ($20.00 in chips)
Seat 3: saidafrente ($46.57 in chips)
Seat 4: odel_nadel ($113.34 in chips)
Seat 6: 38979 ($104.07 in chips)
odel_nadel: posts small blind $0.25
38979: posts big blind $0.50
*** HOLE CARDS ***
Dealt to IlxxxlI [Qd Ad]
IlxxxlI: raises $0.70 to $1.20
saidafrente: folds
odel_nadel: folds
38979: folds
Uncalled bet ($0.70) returned to IlxxxlI
IlxxxlI: doesn't show hand
IlxxxlI collected $1.25 from pot
*** SUMMARY ***
Total pot $1.25 | Rake $0
Seat 2: IlxxxlI collected ($1.25)
Seat 3: saidafrente (button) folded before Flop (didn't bet)
Seat 4: odel_nadel (small blind) folded before Flop
Seat 6: 38979 (big blind) folded before Flop

PokerStars Hand #771299595: Hold'em No Limit ($0.25/$0.50 USD) - 2016/11/09 18:42:20 ET
Table 'WPN_1341348958' 6-max  Seat #2 is the button
Seat 1: AARON81 ($43.76 in chips)
Seat 2: odel_nadel ($25.96 in chips)
Seat 3: IlxxxlI ($10.25 in chips)
Seat 5: PULISPATOLA ($27.81 in chips)
IlxxxlI: posts small blind $0.25
PULISPATOLA: posts big blind $0.50
*** HOLE CARDS ***
Dealt to IlxxxlI [Ac Jh]
AARON81: folds
odel_nadel: folds
IlxxxlI: raises $0.75 to $1.25
PULISPATOLA: folds
Uncalled bet ($0.75) returned to IlxxxlI
IlxxxlI: doesn't show hand
IlxxxlI collected $1 from pot
*** SUMMARY ***
Total pot $1 | Rake $0
Seat 1: AARON81 folded before Flop (didn't bet)
Seat 2: odel_nadel (button) folded before Flop (didn't bet)
Seat 3: IlxxxlI (small blind) collected ($1)
Seat 5: PULISPATOLA folded before Flop

PokerStars Hand #771299443: Hold'em No Limit ($0.25/$0.50 USD) - 2016/11/09 18:41:53 ET
Table 'WPN_1341348958' 6-max  Seat #1 is the button
Seat 1: AARON81 ($43.76 in chips)
Seat 2: odel_nadel ($26.21 in chips)
Seat 3: IlxxxlI ($10.00 in chips)
Seat 5: PULISPATOLA ($27.81 in chips)
odel_nadel: posts small blind $0.25
IlxxxlI: posts big blind $0.50
*** HOLE CARDS ***
Dealt to IlxxxlI [2c 6d]
PULISPATOLA: folds
AARON81: folds
odel_nadel: folds
Uncalled bet ($0.25) returned to IlxxxlI
IlxxxlI: doesn't show hand
IlxxxlI collected $0.50 from pot
*** SUMMARY ***
Total pot $0.50 | Rake $0
Seat 1: AARON81 (button) folded before Flop (didn't bet)
Seat 2: odel_nadel (small blind) folded before Flop
Seat 3: IlxxxlI (big blind) collected ($0.50)
Seat 5: PULISPATOLA folded before Flop (didn't bet)

PokerStars Hand #771299403: Hold'em No Limit ($0.25/$0.50 USD) - 2016/11/09 18:41:45 ET
Table 'WPN_3421571163' 6-max  Seat #2 is the button
Seat 1: Karas321 ($20.00 in chips)
Seat 2: IlxxxlI ($20.39 in chips)
Seat 5: 38979 ($51.00 in chips)
Seat 6: v0landito ($96.75 in chips)
38979: posts small blind $0.25
v0landito: posts big blind $0.50
*** HOLE CARDS ***
Dealt to IlxxxlI [4s 8c]
Karas321: folds
IlxxxlI: folds
38979: folds
Uncalled bet ($0.25) returned to v0landito
v0landito: doesn't show hand
v0landito collected $0.50 from pot
*** SUMMARY ***
Total pot $0.50 | Rake $0
Seat 1: Karas321 folded before Flop (didn't bet)
Seat 2: IlxxxlI (button) folded before Flop (didn't bet)
Seat 5: 38979 (small blind) folded before Flop
Seat 6: v0landito (big blind) collected ($0.50)

PokerStars Hand #771299365: Hold'em No Limit ($0.25/$0.50 USD) - 2016/11/09 18:41:40 ET
Table 'WPN_3219946394' 6-max  Seat #2 is the button
Seat 2: IlxxxlI ($20.00 in chips)
Seat 3: saidafrente ($55.07 in chips)
Seat 4: odel_nadel ($105.69 in chips)
Seat 6: 38979 ($104.07 in chips)
saidafrente: posts small blind $0.25
odel_nadel: posts big blind $0.50
*** HOLE CARDS ***
Dealt to IlxxxlI [4d Kc]
38979: folds
IlxxxlI: folds
saidafrente: raises $1 to $1.50
odel_nadel: calls $1
*** FLOP *** [8s Qs Js]
saidafrente: bets $2
odel_nadel: calls $2
*** TURN *** [8s Qs Js] [6c]
saidafrente: checks
odel_nadel: bets $5
saidafrente: calls $5
*** RIVER *** [8s Qs Js 6c] [Td]
saidafrente: checks
odel_nadel: checks
*** SHOW DOWN ***
saidafrente: mucks hand
odel_nadel: shows [8c Jh] (Two pairs. Js and 8s)
odel_nadel collected $16.15 from pot
*** SUMMARY ***
Total pot $17 | Rake $0.85
Board [8s Qs Js 6c Td]
Seat 2: IlxxxlI (button) folded before Flop (didn't bet)
Seat 3: saidafrente (small blind) mucked
Seat 4: odel_nadel (big blind) showed [8c Jh] and won ($16.15) with Two pairs. Js and 8s
Seat 6: 38979 folded before Flop (didn't bet)

PokerStars Hand #771299276: Hold'em No Limit ($0.25/$0.50 USD) - 2016/11/09 18:41:24 ET
Table 'WPN_3421571163' 6-max  Seat #1 is the button
Seat 1: Karas321 ($20.00 in chips)
Seat 2: IlxxxlI ($20.64 in chips)
Seat 5: 38979 ($50.75 in chips)
Seat 6: v0landito ($96.75 in chips)
IlxxxlI: posts small blind $0.25
38979: posts big blind $0.50
*** HOLE CARDS ***
Dealt to IlxxxlI [4s 9c]
v0landito: folds
Karas321: folds
IlxxxlI: folds
Uncalled bet ($0.25) returned to 38979
38979: doesn't show hand
38979 collected $0.50 from pot
*** SUMMARY ***
Total pot $0.50 | Rake $0
Seat 1: Karas321 (button) folded before Flop (didn't bet)
Seat 2: IlxxxlI (small blind) folded before Flop
Seat 5: 38979 collected ($0.50)
Seat 6: v0landito folded before Flop (didn't bet)

PokerStars Hand #771299248: Hold'em No Limit ($0.25/$0.50 USD) - 2016/11/09 18:41:17 ET
Table 'WPN_3219946394' 6-max  Seat #6 is the button
Seat 2: IlxxxlI ($20.25 in chips)
Seat 3: saidafrente ($55.57 in chips)
Seat 4: odel_nadel ($104.94 in chips)
Seat 6: 38979 ($104.07 in chips)
IlxxxlI: posts small blind $0.25
saidafrente: posts big blind $0.50
*** HOLE CARDS ***
Dealt to IlxxxlI [Jc 2s]
odel_nadel: raises $1 to $1.50
38979: folds
IlxxxlI: folds
saidafrente: folds
Uncalled bet ($1.00) returned to odel_nadel
odel_nadel: doesn't show hand
odel_nadel collected $1.25 from pot
*** SUMMARY ***
Total pot $1.25 | Rake $0
Seat 2: IlxxxlI (small blind) folded before Flop
Seat 3: saidafrente (big blind) folded before Flop
Seat 4: odel_nadel collected ($1.25)
Seat 6: 38979 (button) folded before Flop (didn't bet)

PokerStars Hand #771299213: Hold'em No Limit ($0.25/$0.50 USD) - 2016/11/09 18:41:10 ET
Table 'WPN_1341348958' 6-max  Seat #5 is the button
Seat 1: AARON81 ($44.76 in chips)
Seat 2: odel_nadel ($26.71 in chips)
Seat 3: IlxxxlI ($10.00 in chips)
Seat 5: PULISPATOLA ($26.43 in chips)
AARON81: posts small blind $0.25
odel_nadel: posts big blind $0.50
*** HOLE CARDS ***
Dealt to IlxxxlI [8d 6h]
IlxxxlI: folds
PULISPATOLA: raises $0.50 to $1
AARON81: calls $0.75
odel_nadel: folds
*** FLOP *** [8h 9c 5d]
AARON81: checks
PULISPATOLA: bets $1.19
AARON81: folds
Uncalled bet ($1.19) returned to PULISPATOLA
PULISPATOLA: doesn't show hand
PULISPATOLA collected $2.38 from pot
*** SUMMARY ***
Total pot $2.50 | Rake $0.12
Board [8h 9c 5d]
Seat 1: AARON81 (small blind) folded on the Flop
Seat 2: odel_nadel (big blind) folded before Flop
Seat 3: IlxxxlI folded before Flop (didn't bet)
Seat 5: PULISPATOLA (button) collected ($2.38)

PokerStars Hand #771299153: Hold'em No Limit ($0.25/$0.50 USD) - 2016/11/09 18:41:02 ET
Table 'WPN_3219946394' 6-max  Seat #4 is the button
Seat 2: IlxxxlI ($20.00 in chips)
Seat 3: saidafrente ($55.57 in chips)
Seat 4: odel_nadel ($104.94 in chips)
Seat 6: 38979 ($104.32 in chips)
38979: posts small blind $0.25
IlxxxlI: posts big blind $0.50
*** HOLE CARDS ***
Dealt to IlxxxlI [8c Ah]
saidafrente: folds
odel_nadel: folds
38979: folds
Uncalled bet ($0.25) returned to IlxxxlI
IlxxxlI: doesn't show hand
IlxxxlI collected $0.50 from pot
*** SUMMARY ***
Total pot $0.50 | Rake $0
Seat 2: IlxxxlI collected ($0.50)
Seat 3: saidafrente folded before Flop (didn't bet)
Seat 4: odel_nadel (button) folded before Flop (didn't bet)
Seat 6: 38979 (small blind) folded before Flop

PokerStars Hand #771299053: Hold'em No Limit ($0.25/$0.50 USD) - 2016/11/09 18:40:44 ET
Table 'WPN_1341348958' 6-max  Seat #3 is the button
Seat 1: AARON81 ($45.26 in chips)
Seat 2: odel_nadel ($26.71 in chips)
Seat 3: IlxxxlI ($10.00 in chips)
Seat 5: PULISPATOLA ($25.93 in chips)
PULISPATOLA: posts small blind $0.25
AARON81: posts big blind $0.50
*** HOLE CARDS ***
Dealt to IlxxxlI [Jh 3h]
odel_nadel: folds
IlxxxlI: folds
PULISPATOLA: raises $1 to $1.50
AARON81: folds
Uncalled bet ($1.00) returned to PULISPATOLA
PULISPATOLA: doesn't show hand
PULISPATOLA collected $1 from pot
*** SUMMARY ***
Total pot $1 | Rake $0
Seat 1: AARON81 (big blind) folded before Flop
Seat 2: odel_nadel folded before Flop (didn't bet)
Seat 3: IlxxxlI (button) folded before Flop (didn't bet)
Seat 5: PULISPATOLA (small blind) collected ($1)

PokerStars Hand #771299029: Hold'em No Limit ($0.25/$0.50 USD) - 2016/11/09 18:40:41 ET
Table 'WPN_3421571163' 6-max  Seat #6 is the button
Seat 1: Karas321 ($20.00 in chips)
Seat 2: IlxxxlI ($21.14 in chips)
Seat 4: Zaychik033 ($82.03 in chips)
Seat 5: 38979 ($50.75 in chips)
Seat 6: v0landito ($96.00 in chips)
Karas321: posts small blind $0.25
IlxxxlI: posts big blind $0.50
*** HOLE CARDS ***
Dealt to IlxxxlI [6c 4h]
Zaychik033: folds
38979: folds
v0landito: raises $0.50 to $1
Karas321: folds
IlxxxlI: folds
Uncalled bet ($0.50) returned to v0landito
v0landito: doesn't show hand
v0landito collected $1.25 from pot
*** SUMMARY ***
Total pot $1.25 | Rake $0
Seat 1: Karas321 (small blind) folded before Flop
Seat 2: IlxxxlI (big blind) folded before Flop
Seat 4: Zaychik033 folded before Flop (didn't bet)
Seat 5: 38979 folded before Flop (didn't bet)
Seat 6: v0landito (button) collected ($1.25)

PokerStars Hand #771298900: Hold'em No Limit ($0.25/$0.50 USD) - 2016/11/09 18:40:17 ET
Table 'WPN_3219946394' 6-max  Seat #3 is the button
Seat 1: iGash ($70.01 in chips)
Seat 2: IlxxxlI ($20.00 in chips)
Seat 3: saidafrente ($55.57 in chips)
Seat 4: odel_nadel ($105.19 in chips)
Seat 6: 38979 ($104.82 in chips)
odel_nadel: posts small blind $0.25
38979: posts big blind $0.50
*** HOLE CARDS ***
Dealt to IlxxxlI [7h 7s]
iGash: raises $1 to $1.50
IlxxxlI: folds
saidafrente: folds
odel_nadel: folds
38979: folds
Uncalled bet ($1.00) returned to iGash
iGash: doesn't show hand
iGash collected $1.25 from pot
*** SUMMARY ***
Total pot $1.25 | Rake $0
Seat 1: iGash collected ($1.25)
Seat 2: IlxxxlI folded before Flop (didn't bet)
Seat 3: saidafrente (button) folded before Flop (didn't bet)
Seat 4: odel_nadel (small blind) folded before Flop
Seat 6: 38979 folded before Flop

PokerStars Hand #771298869: Hold'em No Limit ($0.25/$0.50 USD) - 2016/11/09 18:40:12 ET
Table 'WPN_3421571163' 6-max  Seat #5 is the button
Seat 1: Karas321 ($20.00 in chips)
Seat 2: IlxxxlI ($21.14 in chips)
Seat 4: Zaychik033 ($82.03 in chips)
Seat 5: 38979 ($50.00 in chips)
Seat 6: v0landito ($96.25 in chips)
v0landito: posts small blind $0.25
Karas321: posts big blind $0.50
*** HOLE CARDS ***
Dealt to IlxxxlI [5h Ks]
IlxxxlI: folds
Zaychik033: folds
38979: raises $0.50 to $1
v0landito: folds
Karas321: folds
Uncalled bet ($0.50) returned to 38979
38979: doesn't show hand
38979 collected $1.25 from pot
*** SUMMARY ***
Total pot $1.25 | Rake $0
Seat 1: Karas321 (big blind) folded before Flop
Seat 2: IlxxxlI folded before Flop (didn't bet)
Seat 4: Zaychik033 folded before Flop (didn't bet)
Seat 5: 38979 (button) collected ($1.25)
Seat 6: v0landito (small blind) folded before Flop

Game started
Game ID: 771298781 0.25/0.50 (PRR) Gorgons (Short) (Hold'em)
Seat 2 is the button
Seat 1: AARON81 (44.36).
Seat 2: odel_nadel (26.71).
Seat 3: IlxxxlI (10).
Seat 4: Xiniay (31.07).
Player IlxxxlI has small blind (0.25)
Player Xiniay is timed out.
Player Xiniay sitting out
Player AARON81 has big blind (0.50)
Player IlxxxlI received card: [7s]
Player IlxxxlI received card: [5s]
Player odel_nadel folds
Player IlxxxlI calls (0.25)
Player AARON81 checks
*** FLOP ***: [Ac Qc Qs]
Player IlxxxlI bets (0.50)
Player AARON81 raises (1.50)
Player IlxxxlI folds
Uncalled bet (1) returned to AARON81
Player AARON81 mucks cards
------ Summary ------
Pot: 1.90. Rake 0.08. JP fee 0.02
Board: [Ac Qc Qs]
*Player AARON81 mucks (does not show cards). Bets: 1. Collects: 1.90. Wins: 0.90.
Player odel_nadel does not show cards.Bets: 0. Collects: 0. Wins: 0.
Player IlxxxlI does not show cards.Bets: 1. Collects: 0. Loses: 1.
Player Xiniay does not show cards.Bets: 0. Collects: 0. Wins: 0.
Game ended at: 2016/11/9 22:40:41

PokerStars Hand #771298525: Hold'em No Limit ($0.25/$0.50 USD) - 2016/11/09 18:39:10 ET
Table 'WPN_3219946394' 6-max  Seat #2 is the button
Seat 1: iGash ($70.01 in chips)
Seat 2: IlxxxlI ($20.00 in chips)
Seat 3: saidafrente ($55.82 in chips)
Seat 4: odel_nadel ($104.94 in chips)
Seat 5: Xiniay ($57.96 in chips)
Seat 6: 38979 ($104.82 in chips)
saidafrente: posts small blind $0.25
odel_nadel: posts big blind $0.50
*** HOLE CARDS ***
Dealt to IlxxxlI [9h 2c]
Xiniay: folds
38979: folds
iGash: folds
IlxxxlI: folds
saidafrente: folds
Uncalled bet ($0.25) returned to odel_nadel
odel_nadel: doesn't show hand
odel_nadel collected $0.50 from pot
*** SUMMARY ***
Total pot $0.50 | Rake $0
Seat 1: iGash folded before Flop (didn't bet)
Seat 2: IlxxxlI (button) folded before Flop (didn't bet)
Seat 3: saidafrente (small blind) folded before Flop
Seat 4: odel_nadel (big blind) collected ($0.50)
Seat 5: Xiniay folded before Flop (didn't bet)
Seat 6: 38979 folded before Flop (didn't bet)

PokerStars Hand #771298408: Hold'em No Limit ($0.25/$0.50 USD) - 2016/11/09 18:38:49 ET
Table 'WPN_325998925' 6-max  Seat #5 is the button
Seat 1: brasinsh7 ($30.97 in chips)
Seat 2: AbstractSun ($50.00 in chips)
Seat 3: IlxxxlI ($29.47 in chips)
Seat 5: Zaychik033 ($50.00 in chips)
Seat 6: COTHREEO3 ($89.36 in chips)
COTHREEO3: posts small blind $0.25
brasinsh7: posts big blind $0.50
*** HOLE CARDS ***
Dealt to IlxxxlI [4h Js]
AbstractSun: folds
IlxxxlI: folds
Zaychik033: raises $0.75 to $1.25
COTHREEO3: calls $1
brasinsh7: folds
*** FLOP *** [Ac 5s Jc]
COTHREEO3: checks
Zaychik033: bets $2.25
COTHREEO3: folds
Uncalled bet ($2.25) returned to Zaychik033
Zaychik033: doesn't show hand
Zaychik033 collected $2.85 from pot
*** SUMMARY ***
Total pot $3 | Rake $0.15
Board [Ac 5s Jc]
Seat 1: brasinsh7 (big blind) folded before Flop
Seat 2: AbstractSun folded before Flop (didn't bet)
Seat 3: IlxxxlI folded before Flop (didn't bet)
Seat 5: Zaychik033 (button) collected ($2.85)
Seat 6: COTHREEO3 (small blind) folded on the Flop

PokerStars Hand #771298392: Hold'em No Limit ($0.25/$0.50 USD) - 2016/11/09 18:38:46 ET
Table 'WPN_1341348958' 6-max  Seat #1 is the button
Seat 1: AARON81 ($43.22 in chips)
Seat 2: odel_nadel ($26.96 in chips)
Seat 3: IlxxxlI ($10.00 in chips)
Seat 4: Xiniay ($31.07 in chips)
Seat 5: PULISPATOLA ($25.93 in chips)
odel_nadel: posts small blind $0.25
IlxxxlI: posts big blind $0.50
*** HOLE CARDS ***
Dealt to IlxxxlI [6c 9c]
Xiniay: folds
PULISPATOLA: folds
AARON81: raises $0.50 to $1
odel_nadel: folds
IlxxxlI: calls $0.50
*** FLOP *** [Qc Kd 8s]
IlxxxlI: checks
AARON81: bets $1
IlxxxlI: folds
Uncalled bet ($1.00) returned to AARON81
AARON81: doesn't show hand
AARON81 collected $2.14 from pot
*** SUMMARY ***
Total pot $2.25 | Rake $0.11
Board [Qc Kd 8s]
Seat 1: AARON81 (button) collected ($2.14)
Seat 2: odel_nadel (small blind) folded before Flop
Seat 3: IlxxxlI (big blind) folded on the Flop
Seat 4: Xiniay folded before Flop (didn't bet)
Seat 5: PULISPATOLA folded before Flop (didn't bet)

PokerStars Hand #771298055: Hold'em No Limit ($0.25/$0.50 USD) - 2016/11/09 18:37:49 ET
Table 'WPN_3219946394' 6-max  Seat #1 is the button
Seat 1: iGash ($70.01 in chips)
Seat 2: IlxxxlI ($20.00 in chips)
Seat 3: saidafrente ($49.43 in chips)
Seat 4: odel_nadel ($110.19 in chips)
Seat 5: Xiniay ($57.96 in chips)
Seat 6: 38979 ($106.32 in chips)
IlxxxlI: posts small blind $0.25
saidafrente: posts big blind $0.50
*** HOLE CARDS ***
Dealt to IlxxxlI [4c Jd]
odel_nadel: raises $1 to $1.50
Xiniay: folds
38979: calls $1.50
iGash: folds
IlxxxlI: folds
saidafrente: calls $1
*** FLOP *** [Td 2h 7h]
saidafrente: checks
odel_nadel: bets $3.75
38979: folds
saidafrente: calls $3.75
*** TURN *** [Td 2h 7h] [7s]
saidafrente: checks
odel_nadel: checks
*** RIVER *** [Td 2h 7h 7s] [2d]
saidafrente: bets $7.15
odel_nadel: folds
Uncalled bet ($7.15) returned to saidafrente
saidafrente: doesn't show hand
saidafrente collected $11.64 from pot
*** SUMMARY ***
Total pot $12.25 | Rake $0.61
Board [Td 2h 7h 7s 2d]
Seat 1: iGash (button) folded before Flop (didn't bet)
Seat 2: IlxxxlI (small blind) folded before Flop
Seat 3: saidafrente (big blind) collected ($11.64)
Seat 4: odel_nadel folded on the River
Seat 5: Xiniay folded before Flop (didn't bet)
Seat 6: 38979 folded on the Flop

PokerStars Hand #771297955: Hold'em No Limit ($0.25/$0.50 USD) - 2016/11/09 18:37:34 ET
Table 'WPN_3421571163' 6-max  Seat #4 is the button
Seat 2: IlxxxlI ($20.00 in chips)
Seat 3: Xiniay ($22.67 in chips)
Seat 4: Zaychik033 ($82.03 in chips)
Seat 5: 38979 ($50.00 in chips)
Seat 6: v0landito ($97.25 in chips)
38979: posts small blind $0.25
v0landito: posts big blind $0.50
*** HOLE CARDS ***
Dealt to IlxxxlI [Ah Ts]
IlxxxlI: raises $0.50 to $1
Xiniay: folds
Zaychik033: folds
38979: folds
v0landito: calls $0.50
*** FLOP *** [3s Td 3h]
v0landito: checks
IlxxxlI: bets $1.07
v0landito: folds
Uncalled bet ($1.07) returned to IlxxxlI
IlxxxlI: doesn't show hand
IlxxxlI collected $2.14 from pot
*** SUMMARY ***
Total pot $2.25 | Rake $0.11
Board [3s Td 3h]
Seat 2: IlxxxlI collected ($2.14)
Seat 3: Xiniay folded before Flop (didn't bet)
Seat 4: Zaychik033 (button) folded before Flop (didn't bet)
Seat 5: 38979 (small blind) folded before Flop
Seat 6: v0landito (big blind) folded on the Flop

PokerStars Hand #771297890: Hold'em No Limit ($0.25/$0.50 USD) - 2016/11/09 18:37:22 ET
Table 'WPN_325998925' 6-max  Seat #3 is the button
Seat 1: brasinsh7 ($30.97 in chips)
Seat 2: AbstractSun ($50.00 in chips)
Seat 3: IlxxxlI ($22.33 in chips)
Seat 5: Zaychik033 ($50.00 in chips)
Seat 6: COTHREEO3 ($89.86 in chips)
Zaychik033: posts small blind $0.25
COTHREEO3: posts big blind $0.50
*** HOLE CARDS ***
Dealt to IlxxxlI [Qh Ah]
brasinsh7: folds
AbstractSun: raises $1 to $1.50
IlxxxlI: raises $2.14 to $3.64
Zaychik033: folds
COTHREEO3: folds
AbstractSun: calls $2.14
*** FLOP *** [Ks 6d Kd]
AbstractSun: checks
IlxxxlI: bets $3.50
AbstractSun: calls $3.50
*** TURN *** [Ks 6d Kd] [5h]
AbstractSun: checks
IlxxxlI: checks
*** RIVER *** [Ks 6d Kd 5h] [Ad]
AbstractSun: checks
IlxxxlI: checks
*** SHOW DOWN ***
AbstractSun: mucks hand
IlxxxlI: shows [Qh Ah] (Two pairs. As and Ks)
IlxxxlI collected $14.28 from pot
*** SUMMARY ***
Total pot $15.03 | Rake $0.75
Board [Ks 6d Kd 5h Ad]
Seat 1: brasinsh7 folded before Flop (didn't bet)
Seat 2: AbstractSun mucked
Seat 3: IlxxxlI (button) showed [Qh Ah] and won ($14.28) with Two pairs. As and Ks
Seat 5: Zaychik033 (big blind) folded before Flop
Seat 6: COTHREEO3 folded before Flop

PokerStars Hand #771297792: Hold'em No Limit ($0.25/$0.50 USD) - 2016/11/09 18:37:05 ET
Table 'WPN_3219946394' 6-max  Seat #6 is the button
Seat 1: iGash ($70.26 in chips)
Seat 2: IlxxxlI ($20.00 in chips)
Seat 3: saidafrente ($49.43 in chips)
Seat 4: odel_nadel ($111.69 in chips)
Seat 5: Xiniay ($57.96 in chips)
Seat 6: 38979 ($104.25 in chips)
iGash: posts small blind $0.25
IlxxxlI: posts big blind $0.50
*** HOLE CARDS ***
Dealt to IlxxxlI [5s Tc]
saidafrente: folds
odel_nadel: raises $1 to $1.50
Xiniay: folds
38979: calls $1.50
iGash: folds
IlxxxlI: folds
*** FLOP *** [7h 2s Kh]
odel_nadel: checks
38979: bets $2
odel_nadel: folds
Uncalled bet ($2.00) returned to 38979
38979: doesn't show hand
38979 collected $3.57 from pot
*** SUMMARY ***
Total pot $3.75 | Rake $0.18
Board [7h 2s Kh]
Seat 1: iGash (small blind) folded before Flop
Seat 2: IlxxxlI (big blind) folded before Flop
Seat 3: saidafrente folded before Flop (didn't bet)
Seat 4: odel_nadel folded on the Flop
Seat 5: Xiniay folded before Flop (didn't bet)
Seat 6: 38979 (button) collected ($3.57)

PokerStars Hand #771297793: Hold'em No Limit ($0.25/$0.50 USD) - 2016/11/09 18:37:05 ET
Table 'WPN_3421571163' 6-max  Seat #3 is the button
Seat 2: IlxxxlI ($20.00 in chips)
Seat 3: Xiniay ($21.92 in chips)
Seat 4: Zaychik033 ($82.28 in chips)
Seat 5: 38979 ($50.00 in chips)
Seat 6: v0landito ($97.25 in chips)
Zaychik033: posts small blind $0.25
38979: posts big blind $0.50
*** HOLE CARDS ***
Dealt to IlxxxlI [6s Jc]
v0landito: folds
IlxxxlI: folds
Xiniay: raises $0.50 to $1
Zaychik033: folds
38979: folds
Uncalled bet ($0.50) returned to Xiniay
Xiniay: doesn't show hand
Xiniay collected $1.25 from pot
*** SUMMARY ***
Total pot $1.25 | Rake $0
Seat 2: IlxxxlI folded before Flop (didn't bet)
Seat 3: Xiniay (button) collected ($1.25)
Seat 4: Zaychik033 (small blind) folded before Flop
Seat 5: 38979 (big blind) folded before Flop
Seat 6: v0landito folded before Flop (didn't bet)

PokerStars Hand #771297785: Hold'em No Limit ($0.25/$0.50 USD) - 2016/11/09 18:37:02 ET
Table 'WPN_1341348958' 6-max  Seat #5 is the button
Seat 1: AARON81 ($43.47 in chips)
Seat 2: odel_nadel ($27.46 in chips)
Seat 3: IlxxxlI ($10.00 in chips)
Seat 4: Xiniay ($33.57 in chips)
Seat 5: PULISPATOLA ($22.96 in chips)
AARON81: posts small blind $0.25
odel_nadel: posts big blind $0.50
*** HOLE CARDS ***
Dealt to IlxxxlI [4s 5d]
IlxxxlI: folds
Xiniay: raises $0.50 to $1
PULISPATOLA: raises $1.50 to $2.50
AARON81: folds
odel_nadel: folds
Xiniay: calls $1.50
*** FLOP *** [Kd 3h 8d]
Xiniay: checks
PULISPATOLA: bets $1.82
Xiniay: folds
Uncalled bet ($1.82) returned to PULISPATOLA
PULISPATOLA: doesn't show hand
PULISPATOLA collected $5.47 from pot
*** SUMMARY ***
Total pot $5.75 | Rake $0.28
Board [Kd 3h 8d]
Seat 1: AARON81 (small blind) folded before Flop
Seat 2: odel_nadel (big blind) folded before Flop
Seat 3: IlxxxlI folded before Flop (didn't bet)
Seat 4: Xiniay folded on the Flop
Seat 5: PULISPATOLA (button) collected ($5.47)

PokerStars Hand #771297615: Hold'em No Limit ($0.25/$0.50 USD) - 2016/11/09 18:36:34 ET
Table 'WPN_3421571163' 6-max  Seat #2 is the button
Seat 2: IlxxxlI ($20.00 in chips)
Seat 3: Xiniay ($21.42 in chips)
Seat 4: Zaychik033 ($82.78 in chips)
Seat 5: 38979 ($50.00 in chips)
Seat 6: v0landito ($97.25 in chips)
Xiniay: posts small blind $0.25
Zaychik033: posts big blind $0.50
*** HOLE CARDS ***
Dealt to IlxxxlI [3d Jd]
38979: folds
v0landito: folds
IlxxxlI: folds
Xiniay: raises $1 to $1.50
Zaychik033: folds
Uncalled bet ($1.00) returned to Xiniay
Xiniay: doesn't show hand
Xiniay collected $1 from pot
*** SUMMARY ***
Total pot $1 | Rake $0
Seat 2: IlxxxlI (button) folded before Flop (didn't bet)
Seat 3: Xiniay (small blind) collected ($1)
Seat 4: Zaychik033 (big blind) folded before Flop
Seat 5: 38979 folded before Flop (didn't bet)
Seat 6: v0landito folded before Flop (didn't bet)

PokerStars Hand #771297465: Hold'em No Limit ($0.25/$0.50 USD) - 2016/11/09 18:36:08 ET
Table 'WPN_325998925' 6-max  Seat #2 is the button
Seat 1: brasinsh7 ($30.97 in chips)
Seat 2: AbstractSun ($50.00 in chips)
Seat 3: IlxxxlI ($22.58 in chips)
Seat 4: Xiniay ($97.98 in chips)
Seat 5: Zaychik033 ($50.00 in chips)
Seat 6: COTHREEO3 ($89.86 in chips)
IlxxxlI: posts small blind $0.25
Xiniay: posts big blind $0.50
*** HOLE CARDS ***
Dealt to IlxxxlI [Kd 2c]
Zaychik033: folds
COTHREEO3: folds
brasinsh7: folds
AbstractSun: raises $0.75 to $1.25
IlxxxlI: folds
Xiniay: raises $3 to $4.25
AbstractSun: folds
Uncalled bet ($3.00) returned to Xiniay
Xiniay: doesn't show hand
Xiniay collected $2.75 from pot
*** SUMMARY ***
Total pot $2.75 | Rake $0
Seat 1: brasinsh7 folded before Flop (didn't bet)
Seat 2: AbstractSun (button) folded before Flop
Seat 3: IlxxxlI (small blind) folded before Flop
Seat 4: Xiniay (big blind) collected ($2.75)
Seat 5: Zaychik033 folded before Flop (didn't bet)
Seat 6: COTHREEO3 folded before Flop (didn't bet)

PokerStars Hand #771297403: Hold'em No Limit ($0.25/$0.50 USD) - 2016/11/09 18:35:55 ET
Table 'WPN_325998925' 6-max  Seat #1 is the button
Seat 1: brasinsh7 ($30.97 in chips)
Seat 2: AbstractSun ($50.25 in chips)
Seat 3: IlxxxlI ($22.33 in chips)
Seat 4: Xiniay ($97.98 in chips)
Seat 5: Zaychik033 ($50.00 in chips)
Seat 6: COTHREEO3 ($89.86 in chips)
AbstractSun: posts small blind $0.25
IlxxxlI: posts big blind $0.50
*** HOLE CARDS ***
Dealt to IlxxxlI [Qh 9d]
Xiniay: folds
Zaychik033: folds
COTHREEO3: folds
brasinsh7: folds
AbstractSun: folds
Uncalled bet ($0.25) returned to IlxxxlI
IlxxxlI: doesn't show hand
IlxxxlI collected $0.50 from pot
*** SUMMARY ***
Total pot $0.50 | Rake $0
Seat 1: brasinsh7 (button) folded before Flop (didn't bet)
Seat 2: AbstractSun (small blind) folded before Flop
Seat 3: IlxxxlI (big blind) collected ($0.50)
Seat 4: Xiniay folded before Flop (didn't bet)
Seat 5: Zaychik033 folded before Flop (didn't bet)
Seat 6: COTHREEO3 folded before Flop (didn't bet)

PokerStars Hand #771297262: Hold'em No Limit ($0.25/$0.50 USD) - 2016/11/09 18:35:31 ET
Table 'WPN_1341348958' 6-max  Seat #4 is the button
Seat 1: AARON81 ($43.97 in chips)
Seat 2: odel_nadel ($27.46 in chips)
Seat 3: IlxxxlI ($10.00 in chips)
Seat 4: Xiniay ($30.06 in chips)
Seat 5: PULISPATOLA ($26.33 in chips)
PULISPATOLA: posts small blind $0.25
AARON81: posts big blind $0.50
*** HOLE CARDS ***
Dealt to IlxxxlI [7s Kc]
odel_nadel: folds
IlxxxlI: folds
Xiniay: raises $0.50 to $1
PULISPATOLA: calls $0.75
AARON81: folds
*** FLOP *** [3s 8d 2s]
PULISPATOLA: checks
Xiniay: bets $0.79
PULISPATOLA: raises $1.58 to $2.37
Xiniay: calls $1.58
*** TURN *** [3s 8d 2s] [Ac]
PULISPATOLA: checks
Xiniay: checks
*** RIVER *** [3s 8d 2s Ac] [Tc]
PULISPATOLA: checks
Xiniay: checks
*** SHOW DOWN ***
Xiniay: shows [Ts 6s] (One pair of 10s)
PULISPATOLA: mucks hand
Xiniay collected $6.88 from pot
*** SUMMARY ***
Total pot $7.24 | Rake $0.36
Board [3s 8d 2s Ac Tc]
Seat 1: AARON81 folded before Flop
Seat 2: odel_nadel folded before Flop (didn't bet)
Seat 3: IlxxxlI folded before Flop (didn't bet)
Seat 4: Xiniay (button) showed [Ts 6s] and won ($6.88) with One pair of 10s
Seat 5: PULISPATOLA (small blind) mucked

PokerStars Hand #771297235: Hold'em No Limit ($0.25/$0.50 USD) - 2016/11/09 18:35:26 ET
Table 'WPN_3219946394' 6-max  Seat #5 is the button
Seat 1: iGash ($85.22 in chips)
Seat 2: IlxxxlI ($20.00 in chips)
Seat 3: saidafrente ($49.43 in chips)
Seat 4: odel_nadel ($111.69 in chips)
Seat 5: Xiniay ($44.25 in chips)
Seat 6: 38979 ($104.50 in chips)
38979: posts small blind $0.25
iGash: posts big blind $0.50
*** HOLE CARDS ***
Dealt to IlxxxlI [6h 4h]
IlxxxlI: folds
saidafrente: folds
odel_nadel: folds
Xiniay: raises $0.50 to $1
38979: folds
iGash: raises $2 to $3
Xiniay: calls $2
*** FLOP *** [2c 5d 2s]
iGash: bets $3.96
Xiniay: calls $3.96
*** TURN *** [2c 5d 2s] [Ad]
iGash: bets $8
Xiniay: calls $8
*** RIVER *** [2c 5d 2s Ad] [7h]
iGash: checks
Xiniay: bets $9.55
iGash: folds
Uncalled bet ($9.55) returned to Xiniay
Xiniay: doesn't show hand
Xiniay collected $28.67 from pot
*** SUMMARY ***
Total pot $30.17 | Rake $1.50
Board [2c 5d 2s Ad 7h]
Seat 1: iGash (big blind) folded on the River
Seat 2: IlxxxlI folded before Flop (didn't bet)
Seat 3: saidafrente folded before Flop (didn't bet)
Seat 4: odel_nadel folded before Flop (didn't bet)
Seat 5: Xiniay (button) collected ($28.67)
Seat 6: 38979 (small blind) folded before Flop

PokerStars Hand #771297133: Hold'em No Limit ($0.25/$0.50 USD) - 2016/11/09 18:35:06 ET
Table 'WPN_3219946394' 6-max  Seat #4 is the button
Seat 1: iGash ($85.22 in chips)
Seat 2: IlxxxlI ($20.00 in chips)
Seat 3: saidafrente ($49.43 in chips)
Seat 4: odel_nadel ($111.69 in chips)
Seat 5: Xiniay ($43.75 in chips)
Seat 6: 38979 ($105.00 in chips)
Xiniay: posts small blind $0.25
38979: posts big blind $0.50
*** HOLE CARDS ***
Dealt to IlxxxlI [2s Qd]
iGash: folds
IlxxxlI: folds
saidafrente: folds
odel_nadel: folds
Xiniay: raises $1 to $1.50
38979: folds
Uncalled bet ($1.00) returned to Xiniay
Xiniay: doesn't show hand
Xiniay collected $1 from pot
*** SUMMARY ***
Total pot $1 | Rake $0
Seat 1: iGash folded before Flop (didn't bet)
Seat 2: IlxxxlI folded before Flop (didn't bet)
Seat 3: saidafrente folded before Flop (didn't bet)
Seat 4: odel_nadel (button) folded before Flop (didn't bet)
Seat 5: Xiniay (small blind) collected ($1)
Seat 6: 38979 (big blind) folded before Flop

PokerStars Hand #771297120: Hold'em No Limit ($0.25/$0.50 USD) - 2016/11/09 18:35:03 ET
Table 'WPN_325998925' 6-max  Seat #6 is the button
Seat 1: brasinsh7 ($33.47 in chips)
Seat 2: AbstractSun ($50.75 in chips)
Seat 3: IlxxxlI ($22.33 in chips)
Seat 4: Xiniay ($97.98 in chips)
Seat 5: Zaychik033 ($50.00 in chips)
Seat 6: COTHREEO3 ($87.13 in chips)
brasinsh7: posts small blind $0.25
AbstractSun: posts big blind $0.50
*** HOLE CARDS ***
Dealt to IlxxxlI [2h Kd]
IlxxxlI: folds
Xiniay: folds
Zaychik033: folds
COTHREEO3: raises $1 to $1.50
brasinsh7: calls $1.25
AbstractSun: folds
*** FLOP *** [4d 3h Qs]
brasinsh7: checks
COTHREEO3: bets $1
brasinsh7: calls $1
*** TURN *** [4d 3h Qs] [As]
brasinsh7: checks
COTHREEO3: bets $4
brasinsh7: folds
Uncalled bet ($4.00) returned to COTHREEO3
COTHREEO3: doesn't show hand
COTHREEO3 collected $5.23 from pot
*** SUMMARY ***
Total pot $5.50 | Rake $0.27
Board [4d 3h Qs As]
Seat 1: brasinsh7 (small blind) folded on the Turn
Seat 2: AbstractSun (big blind) folded before Flop
Seat 3: IlxxxlI folded before Flop (didn't bet)
Seat 4: Xiniay folded before Flop (didn't bet)
Seat 5: Zaychik033 folded before Flop (didn't bet)
Seat 6: COTHREEO3 (button) collected ($5.23)

PokerStars Hand #771297034: Hold'em No Limit ($0.25/$0.50 USD) - 2016/11/09 18:34:49 ET
Table 'WPN_1341348958' 6-max  Seat #3 is the button
Seat 1: AARON81 ($43.22 in chips)
Seat 2: odel_nadel ($27.46 in chips)
Seat 3: IlxxxlI ($10.00 in chips)
Seat 4: Xiniay ($30.31 in chips)
Seat 5: PULISPATOLA ($26.83 in chips)
Seat 6: 38979 ($25.00 in chips)
Xiniay: posts small blind $0.25
PULISPATOLA: posts big blind $0.50
*** HOLE CARDS ***
Dealt to IlxxxlI [9s 2d]
38979: folds
AARON81: raises $1 to $1.50
odel_nadel: folds
IlxxxlI: folds
Xiniay: folds
PULISPATOLA: folds
Uncalled bet ($1.00) returned to AARON81
AARON81: doesn't show hand
AARON81 collected $1.25 from pot
*** SUMMARY ***
Total pot $1.25 | Rake $0
Seat 1: AARON81 collected ($1.25)
Seat 2: odel_nadel folded before Flop (didn't bet)
Seat 3: IlxxxlI (button) folded before Flop (didn't bet)
Seat 4: Xiniay (small blind) folded before Flop
Seat 5: PULISPATOLA (big blind) folded before Flop
Seat 6: 38979 folded before Flop (didn't bet)

PokerStars Hand #771297010: Hold'em No Limit ($0.25/$0.50 USD) - 2016/11/09 18:34:45 ET
Table 'WPN_3219946394' 6-max  Seat #3 is the button
Seat 1: iGash ($85.22 in chips)
Seat 2: IlxxxlI ($20.00 in chips)
Seat 3: saidafrente ($49.43 in chips)
Seat 4: odel_nadel ($111.94 in chips)
Seat 5: Xiniay ($44.25 in chips)
Seat 6: 38979 ($104.25 in chips)
odel_nadel: posts small blind $0.25
Xiniay: posts big blind $0.50
*** HOLE CARDS ***
Dealt to IlxxxlI [Td 4d]
38979: raises $1 to $1.50
iGash: folds
IlxxxlI: folds
saidafrente: folds
odel_nadel: folds
Xiniay: folds
Uncalled bet ($1.00) returned to 38979
38979: doesn't show hand
38979 collected $1.25 from pot
*** SUMMARY ***
Total pot $1.25 | Rake $0
Seat 1: iGash folded before Flop (didn't bet)
Seat 2: IlxxxlI folded before Flop (didn't bet)
Seat 3: saidafrente (button) folded before Flop (didn't bet)
Seat 4: odel_nadel (small blind) folded before Flop
Seat 5: Xiniay (big blind) folded before Flop
Seat 6: 38979 collected ($1.25)

PokerStars Hand #771296940: Hold'em No Limit ($0.25/$0.50 USD) - 2016/11/09 18:34:32 ET
Table 'WPN_3219946394' 6-max  Seat #2 is the button
Seat 1: iGash ($85.22 in chips)
Seat 2: IlxxxlI ($20.00 in chips)
Seat 3: saidafrente ($49.68 in chips)
Seat 4: odel_nadel ($111.69 in chips)
Seat 5: Xiniay ($44.25 in chips)
Seat 6: 38979 ($104.25 in chips)
saidafrente: posts small blind $0.25
odel_nadel: posts big blind $0.50
*** HOLE CARDS ***
Dealt to IlxxxlI [5s 7c]
Xiniay: folds
38979: folds
iGash: folds
IlxxxlI: folds
saidafrente: folds
Uncalled bet ($0.25) returned to odel_nadel
odel_nadel: doesn't show hand
odel_nadel collected $0.50 from pot
*** SUMMARY ***
Total pot $0.50 | Rake $0
Seat 1: iGash folded before Flop (didn't bet)
Seat 2: IlxxxlI (button) folded before Flop (didn't bet)
Seat 3: saidafrente (small blind) folded before Flop
Seat 4: odel_nadel (big blind) collected ($0.50)
Seat 5: Xiniay folded before Flop (didn't bet)
Seat 6: 38979 folded before Flop (didn't bet)

PokerStars Hand #771296796: Hold'em No Limit ($0.25/$0.50 USD) - 2016/11/09 18:34:06 ET
Table 'WPN_1341348958' 6-max  Seat #2 is the button
Seat 1: AARON81 ($43.22 in chips)
Seat 2: odel_nadel ($27.46 in chips)
Seat 3: IlxxxlI ($10.25 in chips)
Seat 4: Xiniay ($30.06 in chips)
Seat 5: PULISPATOLA ($26.83 in chips)
Seat 6: 38979 ($25.00 in chips)
IlxxxlI: posts small blind $0.25
Xiniay: posts big blind $0.50
*** HOLE CARDS ***
Dealt to IlxxxlI [8h 5s]
PULISPATOLA: folds
38979: folds
AARON81: folds
odel_nadel: folds
IlxxxlI: folds
Uncalled bet ($0.25) returned to Xiniay
Xiniay: doesn't show hand
Xiniay collected $0.50 from pot
*** SUMMARY ***
Total pot $0.50 | Rake $0
Seat 1: AARON81 folded before Flop (didn't bet)
Seat 2: odel_nadel (button) folded before Flop (didn't bet)
Seat 3: IlxxxlI (small blind) folded before Flop
Seat 4: Xiniay (big blind) collected ($0.50)
Seat 5: PULISPATOLA folded before Flop (didn't bet)
Seat 6: 38979 folded before Flop (didn't bet)

PokerStars Hand #771296762: Hold'em No Limit ($0.25/$0.50 USD) - 2016/11/09 18:33:59 ET
Table 'WPN_3219946394' 6-max  Seat #1 is the button
Seat 1: iGash ($85.22 in chips)
Seat 2: IlxxxlI ($20.00 in chips)
Seat 3: saidafrente ($50.18 in chips)
Seat 4: odel_nadel ($111.69 in chips)
Seat 5: Xiniay ($44.25 in chips)
Seat 6: 38979 ($103.50 in chips)
IlxxxlI: posts small blind $0.25
saidafrente: posts big blind $0.50
*** HOLE CARDS ***
Dealt to IlxxxlI [Kd 2d]
odel_nadel: folds
Xiniay: folds
38979: raises $1 to $1.50
iGash: folds
IlxxxlI: folds
saidafrente: folds
Uncalled bet ($1.00) returned to 38979
38979: doesn't show hand
38979 collected $1.25 from pot
*** SUMMARY ***
Total pot $1.25 | Rake $0
Seat 1: iGash (button) folded before Flop (didn't bet)
Seat 2: IlxxxlI (small blind) folded before Flop
Seat 3: saidafrente (big blind) folded before Flop
Seat 4: odel_nadel folded before Flop (didn't bet)
Seat 5: Xiniay folded before Flop (didn't bet)
Seat 6: 38979 collected ($1.25)

PokerStars Hand #771296727: Hold'em No Limit ($0.25/$0.50 USD) - 2016/11/09 18:33:54 ET
Table 'WPN_3981802040' 6-max  Seat #6 is the button
Seat 1: saidafrente ($27.93 in chips)
Seat 2: Karas321 ($20.00 in chips)
Seat 3: aleks0v ($96.39 in chips)
Seat 4: IlxxxlI ($23.86 in chips)
Seat 5: IampokerKidd ($61.30 in chips)
Seat 6: Xiniay ($74.94 in chips)
saidafrente: posts small blind $0.25
Karas321: posts big blind $0.50
*** HOLE CARDS ***
Dealt to IlxxxlI [9h 6h]
aleks0v: folds
IlxxxlI: folds
IampokerKidd: folds
Xiniay: raises $0.50 to $1
saidafrente: folds
Karas321: folds
Uncalled bet ($0.50) returned to Xiniay
Xiniay: doesn't show hand
Xiniay collected $1.25 from pot
*** SUMMARY ***
Total pot $1.25 | Rake $0
Seat 1: saidafrente (small blind) folded before Flop
Seat 2: Karas321 (big blind) folded before Flop
Seat 3: aleks0v folded before Flop (didn't bet)
Seat 4: IlxxxlI folded before Flop (didn't bet)
Seat 5: IampokerKidd folded before Flop (didn't bet)
Seat 6: Xiniay (button) collected ($1.25)

PokerStars Hand #771296711: Hold'em No Limit ($0.25/$0.50 USD) - 2016/11/09 18:33:52 ET
Table 'WPN_3421571163' 6-max  Seat #6 is the button
Seat 2: IlxxxlI ($20.00 in chips)
Seat 3: Xiniay ($71.42 in chips)
Seat 4: Zaychik033 ($82.78 in chips)
Seat 5: 38979 ($50.00 in chips)
Seat 6: v0landito ($50.00 in chips)
IlxxxlI: posts small blind $0.25
Xiniay: posts big blind $0.50
*** HOLE CARDS ***
Dealt to IlxxxlI [9d 7h]
Zaychik033: folds
38979: folds
v0landito: raises $0.50 to $1
IlxxxlI: folds
Xiniay: calls $0.50
*** FLOP *** [9c 3c Jd]
Xiniay: checks
v0landito: bets $1.07
Xiniay: raises $3.21 to $4.28
v0landito: raises $6.72 to $11
Xiniay: calls $6.72
*** TURN *** [9c 3c Jd] [7d]
Xiniay: checks
v0landito: bets $11.52
Xiniay: calls $11.52
*** RIVER *** [9c 3c Jd 7d] [Ah]
Xiniay: checks
v0landito: bets $26.48 and is all-in
Xiniay: calls $26.48
*** SHOW DOWN ***
Xiniay: shows [Th Jh] (One pair of Js)
v0landito: shows [Js 9s] (Two pairs. Js and 9s)
v0landito collected $97.25 from pot
*** SUMMARY ***
Total pot $100.25 | Rake $3
Board [9c 3c Jd 7d Ah]
Seat 2: IlxxxlI (small blind) folded before Flop
Seat 3: Xiniay (big blind) showed [Th Jh] and lost with One pair of Js
Seat 4: Zaychik033 folded before Flop (didn't bet)
Seat 5: 38979 folded before Flop (didn't bet)
Seat 6: v0landito (button) showed [Js 9s] and won ($97.25) with Two pairs. Js and 9s

PokerStars Hand #771296627: Hold'em No Limit ($0.25/$0.50 USD) - 2016/11/09 18:33:39 ET
Table 'WPN_325998925' 6-max  Seat #5 is the button
Seat 1: brasinsh7 ($27.93 in chips)
Seat 2: AbstractSun ($50.75 in chips)
Seat 3: IlxxxlI ($22.33 in chips)
Seat 4: Xiniay ($103.87 in chips)
Seat 5: Zaychik033 ($50.00 in chips)
Seat 6: COTHREEO3 ($87.38 in chips)
COTHREEO3: posts small blind $0.25
brasinsh7: posts big blind $0.50
*** HOLE CARDS ***
Dealt to IlxxxlI [7c Ks]
AbstractSun: folds
IlxxxlI: folds
Xiniay: raises $1 to $1.50
Zaychik033: folds
COTHREEO3: folds
brasinsh7: calls $1
*** FLOP *** [7d Kc 7h]
brasinsh7: checks
Xiniay: bets $1.03
brasinsh7: calls $1.03
*** TURN *** [7d Kc 7h] [Td]
brasinsh7: bets $3.36
Xiniay: calls $3.36
*** RIVER *** [7d Kc 7h Td] [8s]
brasinsh7: bets $7.62
Xiniay: folds
Uncalled bet ($7.62) returned to brasinsh7
brasinsh7: doesn't show hand
brasinsh7 collected $11.43 from pot
*** SUMMARY ***
Total pot $12.03 | Rake $0.60
Board [7d Kc 7h Td 8s]
Seat 1: brasinsh7 (big blind) collected ($11.43)
Seat 2: AbstractSun folded before Flop (didn't bet)
Seat 3: IlxxxlI folded before Flop (didn't bet)
Seat 4: Xiniay folded on the River
Seat 5: Zaychik033 (button) folded before Flop (didn't bet)
Seat 6: COTHREEO3 (small blind) folded before Flop

PokerStars Hand #771296598: Hold'em No Limit ($0.25/$0.50 USD) - 2016/11/09 18:33:33 ET
Table 'WPN_3981802040' 6-max  Seat #5 is the button
Seat 1: saidafrente ($28.43 in chips)
Seat 3: aleks0v ($96.39 in chips)
Seat 4: IlxxxlI ($23.86 in chips)
Seat 5: IampokerKidd ($60.55 in chips)
Seat 6: Xiniay ($75.19 in chips)
Xiniay: posts small blind $0.25
saidafrente: posts big blind $0.50
*** HOLE CARDS ***
Dealt to IlxxxlI [3c Ts]
aleks0v: folds
IlxxxlI: folds
IampokerKidd: raises $1 to $1.50
Xiniay: folds
saidafrente: folds
Uncalled bet ($1.00) returned to IampokerKidd
IampokerKidd: doesn't show hand
IampokerKidd collected $1.25 from pot
*** SUMMARY ***
Total pot $1.25 | Rake $0
Seat 1: saidafrente (big blind) folded before Flop
Seat 3: aleks0v folded before Flop (didn't bet)
Seat 4: IlxxxlI folded before Flop (didn't bet)
Seat 5: IampokerKidd (button) collected ($1.25)
Seat 6: Xiniay (small blind) folded before Flop

PokerStars Hand #771296588: Hold'em No Limit ($0.25/$0.50 USD) - 2016/11/09 18:33:31 ET
Table 'WPN_1341348958' 6-max  Seat #1 is the button
Seat 1: AARON81 ($43.22 in chips)
Seat 2: odel_nadel ($27.71 in chips)
Seat 3: IlxxxlI ($10.00 in chips)
Seat 4: Xiniay ($30.06 in chips)
Seat 5: PULISPATOLA ($26.83 in chips)
Seat 6: 38979 ($25.00 in chips)
odel_nadel: posts small blind $0.25
IlxxxlI: posts big blind $0.50
*** HOLE CARDS ***
Dealt to IlxxxlI [6c 2c]
Xiniay: folds
PULISPATOLA: folds
38979: folds
AARON81: folds
odel_nadel: folds
Uncalled bet ($0.25) returned to IlxxxlI
IlxxxlI: doesn't show hand
IlxxxlI collected $0.50 from pot
*** SUMMARY ***
Total pot $0.50 | Rake $0
Seat 1: AARON81 (button) folded before Flop (didn't bet)
Seat 2: odel_nadel (small blind) folded before Flop
Seat 3: IlxxxlI (big blind) collected ($0.50)
Seat 4: Xiniay folded before Flop (didn't bet)
Seat 5: PULISPATOLA folded before Flop (didn't bet)
Seat 6: 38979 folded before Flop (didn't bet)

PokerStars Hand #771296516: Hold'em No Limit ($0.25/$0.50 USD) - 2016/11/09 18:33:20 ET
Table 'WPN_3421571163' 6-max  Seat #5 is the button
Seat 2: IlxxxlI ($20.00 in chips)
Seat 3: Xiniay ($71.42 in chips)
Seat 4: Zaychik033 ($82.03 in chips)
Seat 5: 38979 ($50.00 in chips)
Seat 6: v0landito ($50.00 in chips)
v0landito: posts small blind $0.25
IlxxxlI: posts big blind $0.50
*** HOLE CARDS ***
Dealt to IlxxxlI [Qc 3s]
Xiniay: folds
Zaychik033: raises $0.75 to $1.25
38979: folds
v0landito: folds
IlxxxlI: folds
Uncalled bet ($0.75) returned to Zaychik033
Zaychik033: doesn't show hand
Zaychik033 collected $1.25 from pot
*** SUMMARY ***
Total pot $1.25 | Rake $0
Seat 2: IlxxxlI (big blind) folded before Flop
Seat 3: Xiniay folded before Flop (didn't bet)
Seat 4: Zaychik033 collected ($1.25)
Seat 5: 38979 (button) folded before Flop (didn't bet)
Seat 6: v0landito (small blind) folded before Flop

PokerStars Hand #771296475: Hold'em No Limit ($0.25/$0.50 USD) - 2016/11/09 18:33:14 ET
Table 'WPN_3219946394' 6-max  Seat #6 is the button
Seat 1: iGash ($85.47 in chips)
Seat 2: IlxxxlI ($20.00 in chips)
Seat 3: saidafrente ($50.18 in chips)
Seat 4: odel_nadel ($111.69 in chips)
Seat 5: Xiniay ($43.50 in chips)
Seat 6: 38979 ($103.50 in chips)
iGash: posts small blind $0.25
IlxxxlI: posts big blind $0.50
*** HOLE CARDS ***
Dealt to IlxxxlI [Js 2h]
saidafrente: folds
odel_nadel: folds
Xiniay: raises $1 to $1.50
38979: folds
iGash: folds
IlxxxlI: folds
Uncalled bet ($1.00) returned to Xiniay
Xiniay: doesn't show hand
Xiniay collected $1.25 from pot
*** SUMMARY ***
Total pot $1.25 | Rake $0
Seat 1: iGash (small blind) folded before Flop
Seat 2: IlxxxlI (big blind) folded before Flop
Seat 3: saidafrente folded before Flop (didn't bet)
Seat 4: odel_nadel folded before Flop (didn't bet)
Seat 5: Xiniay collected ($1.25)
Seat 6: 38979 (button) folded before Flop (didn't bet)

PokerStars Hand #771296445: Hold'em No Limit ($0.25/$0.50 USD) - 2016/11/09 18:33:05 ET
Table 'WPN_1341348958' 6-max  Seat #6 is the button
Seat 1: AARON81 ($43.47 in chips)
Seat 2: odel_nadel ($28.21 in chips)
Seat 3: IlxxxlI ($10.00 in chips)
Seat 4: Xiniay ($29.31 in chips)
Seat 5: PULISPATOLA ($26.83 in chips)
Seat 6: 38979 ($25.00 in chips)
AARON81: posts small blind $0.25
odel_nadel: posts big blind $0.50
*** HOLE CARDS ***
Dealt to IlxxxlI [3d Ad]
IlxxxlI: folds
Xiniay: raises $0.50 to $1
PULISPATOLA: folds
38979: folds
AARON81: folds
odel_nadel: folds
Uncalled bet ($0.50) returned to Xiniay
Xiniay: doesn't show hand
Xiniay collected $1.25 from pot
*** SUMMARY ***
Total pot $1.25 | Rake $0
Seat 1: AARON81 (small blind) folded before Flop
Seat 2: odel_nadel (big blind) folded before Flop
Seat 3: IlxxxlI folded before Flop (didn't bet)
Seat 4: Xiniay collected ($1.25)
Seat 5: PULISPATOLA folded before Flop (didn't bet)
Seat 6: 38979 (button) folded before Flop (didn't bet)

PokerStars Hand #771296397: Hold'em No Limit ($0.25/$0.50 USD) - 2016/11/09 18:32:56 ET
Table 'WPN_325998925' 6-max  Seat #4 is the button
Seat 1: brasinsh7 ($27.93 in chips)
Seat 2: AbstractSun ($50.75 in chips)
Seat 3: IlxxxlI ($22.33 in chips)
Seat 4: Xiniay ($103.87 in chips)
Seat 5: Zaychik033 ($50.00 in chips)
Seat 6: COTHREEO3 ($86.03 in chips)
Zaychik033: posts small blind $0.25
COTHREEO3: posts big blind $0.50
*** HOLE CARDS ***
Dealt to IlxxxlI [5s Ad]
brasinsh7: folds
AbstractSun: folds
IlxxxlI: folds
Xiniay: folds
Zaychik033: calls $0.25
COTHREEO3: raises $1 to $1.50
Zaychik033: calls $1
*** FLOP *** [2c 4d 3s]
Zaychik033: checks
COTHREEO3: bets $1
Zaychik033: folds
Uncalled bet ($1.00) returned to COTHREEO3
COTHREEO3: doesn't show hand
COTHREEO3 collected $2.85 from pot
*** SUMMARY ***
Total pot $3 | Rake $0.15
Board [2c 4d 3s]
Seat 1: brasinsh7 folded before Flop (didn't bet)
Seat 2: AbstractSun folded before Flop (didn't bet)
Seat 3: IlxxxlI folded before Flop (didn't bet)
Seat 4: Xiniay (button) folded before Flop (didn't bet)
Seat 5: Zaychik033 (small blind) folded on the Flop
Seat 6: COTHREEO3 (big blind) collected ($2.85)

PokerStars Hand #771296321: Hold'em No Limit ($0.25/$0.50 USD) - 2016/11/09 18:32:43 ET
Table 'WPN_3219946394' 6-max  Seat #5 is the button
Seat 1: iGash ($85.22 in chips)
Seat 2: IlxxxlI ($20.00 in chips)
Seat 3: saidafrente ($50.18 in chips)
Seat 4: odel_nadel ($111.69 in chips)
Seat 5: Xiniay ($43.50 in chips)
Seat 6: 38979 ($103.75 in chips)
38979: posts small blind $0.25
iGash: posts big blind $0.50
*** HOLE CARDS ***
Dealt to IlxxxlI [8c 3s]
IlxxxlI: folds
saidafrente: folds
odel_nadel: folds
Xiniay: folds
38979: folds
Uncalled bet ($0.25) returned to iGash
iGash: doesn't show hand
iGash collected $0.50 from pot
*** SUMMARY ***
Total pot $0.50 | Rake $0
Seat 1: iGash (big blind) collected ($0.50)
Seat 2: IlxxxlI folded before Flop (didn't bet)
Seat 3: saidafrente folded before Flop (didn't bet)
Seat 4: odel_nadel folded before Flop (didn't bet)
Seat 5: Xiniay (button) folded before Flop (didn't bet)
Seat 6: 38979 (small blind) folded before Flop

PokerStars Hand #771296280: Hold'em No Limit ($0.25/$0.50 USD) - 2016/11/09 18:32:38 ET
Table 'WPN_3421571163' 6-max  Seat #4 is the button
Seat 1: legenda99 ($63.36 in chips)
Seat 2: IlxxxlI ($20.00 in chips)
Seat 3: Xiniay ($71.42 in chips)
Seat 4: Zaychik033 ($81.28 in chips)
Seat 5: 38979 ($50.00 in chips)
Seat 6: v0landito ($50.00 in chips)
38979: posts small blind $0.25
v0landito: posts big blind $0.50
*** HOLE CARDS ***
Dealt to IlxxxlI [2d Th]
legenda99: folds
IlxxxlI: folds
Xiniay: folds
Zaychik033: raises $0.75 to $1.25
38979: folds
v0landito: folds
Uncalled bet ($0.75) returned to Zaychik033
Zaychik033: doesn't show hand
Zaychik033 collected $1.25 from pot
*** SUMMARY ***
Total pot $1.25 | Rake $0
Seat 1: legenda99 folded before Flop (didn't bet)
Seat 2: IlxxxlI folded before Flop (didn't bet)
Seat 3: Xiniay folded before Flop (didn't bet)
Seat 4: Zaychik033 (button) collected ($1.25)
Seat 5: 38979 (small blind) folded before Flop
Seat 6: v0landito (big blind) folded before Flop

PokerStars Hand #771296261: Hold'em No Limit ($0.25/$0.50 USD) - 2016/11/09 18:32:34 ET
Table 'WPN_1341348958' 6-max  Seat #5 is the button
Seat 1: AARON81 ($43.22 in chips)
Seat 2: odel_nadel ($28.21 in chips)
Seat 3: IlxxxlI ($10.00 in chips)
Seat 4: Xiniay ($29.31 in chips)
Seat 5: PULISPATOLA ($26.83 in chips)
Seat 6: 38979 ($25.00 in chips)
38979: posts small blind $0.25
AARON81: posts big blind $0.50
*** HOLE CARDS ***
Dealt to IlxxxlI [3c Kd]
odel_nadel: folds
IlxxxlI: folds
Xiniay: folds
PULISPATOLA: folds
38979: folds
Uncalled bet ($0.25) returned to AARON81
AARON81: doesn't show hand
AARON81 collected $0.50 from pot
*** SUMMARY ***
Total pot $0.50 | Rake $0
Seat 1: AARON81 (big blind) collected ($0.50)
Seat 2: odel_nadel folded before Flop (didn't bet)
Seat 3: IlxxxlI folded before Flop (didn't bet)
Seat 4: Xiniay folded before Flop (didn't bet)
Seat 5: PULISPATOLA (button) folded before Flop (didn't bet)
Seat 6: 38979 (small blind) folded before Flop

PokerStars Hand #771296179: Hold'em No Limit ($0.25/$0.50 USD) - 2016/11/09 18:32:19 ET
Table 'WPN_325998925' 6-max  Seat #3 is the button
Seat 1: brasinsh7 ($27.93 in chips)
Seat 2: AbstractSun ($50.00 in chips)
Seat 3: IlxxxlI ($22.33 in chips)
Seat 4: Xiniay ($104.12 in chips)
Seat 5: Zaychik033 ($50.00 in chips)
Seat 6: COTHREEO3 ($86.03 in chips)
Xiniay: posts small blind $0.25
Zaychik033: posts big blind $0.50
*** HOLE CARDS ***
Dealt to IlxxxlI [As 5d]
COTHREEO3: folds
brasinsh7: folds
AbstractSun: raises $1 to $1.50
IlxxxlI: folds
Xiniay: folds
Zaychik033: folds
Uncalled bet ($1.00) returned to AbstractSun
AbstractSun: doesn't show hand
AbstractSun collected $1.25 from pot
*** SUMMARY ***
Total pot $1.25 | Rake $0
Seat 1: brasinsh7 folded before Flop (didn't bet)
Seat 2: AbstractSun collected ($1.25)
Seat 3: IlxxxlI (button) folded before Flop (didn't bet)
Seat 4: Xiniay (small blind) folded before Flop
Seat 5: Zaychik033 (big blind) folded before Flop
Seat 6: COTHREEO3 folded before Flop (didn't bet)

PokerStars Hand #771296154: Hold'em No Limit ($0.25/$0.50 USD) - 2016/11/09 18:32:15 ET
Table 'WPN_3421571163' 6-max  Seat #3 is the button
Seat 1: legenda99 ($63.36 in chips)
Seat 2: IlxxxlI ($20.00 in chips)
Seat 3: Xiniay ($71.42 in chips)
Seat 4: Zaychik033 ($80.78 in chips)
Seat 5: 38979 ($50.00 in chips)
Zaychik033: posts small blind $0.25
38979: posts big blind $0.50
*** HOLE CARDS ***
Dealt to IlxxxlI [8h 4c]
legenda99: folds
IlxxxlI: folds
Xiniay: folds
Zaychik033: raises $0.75 to $1.25
38979: folds
Uncalled bet ($0.75) returned to Zaychik033
Zaychik033: doesn't show hand
Zaychik033 collected $1 from pot
*** SUMMARY ***
Total pot $1 | Rake $0
Seat 1: legenda99 folded before Flop (didn't bet)
Seat 2: IlxxxlI folded before Flop (didn't bet)
Seat 3: Xiniay (button) folded before Flop (didn't bet)
Seat 4: Zaychik033 (small blind) collected ($1)
Seat 5: 38979 (big blind) folded before Flop

PokerStars Hand #771296065: Hold'em No Limit ($0.25/$0.50 USD) - 2016/11/09 18:31:57 ET
Table 'WPN_3981802040' 6-max  Seat #4 is the button
Seat 1: saidafrente ($37.56 in chips)
Seat 3: aleks0v ($87.46 in chips)
Seat 4: IlxxxlI ($23.86 in chips)
Seat 5: IampokerKidd ($60.80 in chips)
Seat 6: Xiniay ($75.69 in chips)
IampokerKidd: posts small blind $0.25
Xiniay: posts big blind $0.50
*** HOLE CARDS ***
Dealt to IlxxxlI [8s 6s]
saidafrente: raises $1 to $1.50
aleks0v: raises $3 to $4.50
IlxxxlI: folds
IampokerKidd: folds
Xiniay: folds
saidafrente: calls $3
*** FLOP *** [Td 2s Ts]
saidafrente: checks
aleks0v: bets $4.63
saidafrente: calls $4.63
*** TURN *** [Td 2s Ts] [5c]
saidafrente: checks
aleks0v: bets $6.02
saidafrente: folds
Uncalled bet ($6.02) returned to aleks0v
aleks0v: doesn't show hand
aleks0v collected $18.06 from pot
*** SUMMARY ***
Total pot $19.01 | Rake $0.95
Board [Td 2s Ts 5c]
Seat 1: saidafrente folded on the Turn
Seat 3: aleks0v collected ($18.06)
Seat 4: IlxxxlI (button) folded before Flop (didn't bet)
Seat 5: IampokerKidd (small blind) folded before Flop
Seat 6: Xiniay (big blind) folded before Flop

PokerStars Hand #771296048: Hold'em No Limit ($0.25/$0.50 USD) - 2016/11/09 18:31:54 ET
Table 'WPN_3219946394' 6-max  Seat #4 is the button
Seat 1: iGash ($85.22 in chips)
Seat 2: IlxxxlI ($20.00 in chips)
Seat 3: saidafrente ($50.18 in chips)
Seat 4: odel_nadel ($107.69 in chips)
Seat 5: Xiniay ($47.00 in chips)
Seat 6: 38979 ($104.25 in chips)
Xiniay: posts small blind $0.25
38979: posts big blind $0.50
*** HOLE CARDS ***
Dealt to IlxxxlI [As 9h]
iGash: folds
IlxxxlI: folds
saidafrente: folds
odel_nadel: raises $0.50 to $1
Xiniay: raises $2.50 to $3.50
38979: folds
odel_nadel: raises $7.50 to $11
Xiniay: folds
Uncalled bet ($7.50) returned to odel_nadel
odel_nadel: doesn't show hand
odel_nadel collected $7.50 from pot
*** SUMMARY ***
Total pot $7.50 | Rake $0
Seat 1: iGash folded before Flop (didn't bet)
Seat 2: IlxxxlI folded before Flop (didn't bet)
Seat 3: saidafrente folded before Flop (didn't bet)
Seat 4: odel_nadel (button) collected ($7.50)
Seat 5: Xiniay (small blind) folded before Flop
Seat 6: 38979 (big blind) folded before Flop

PokerStars Hand #771295937: Hold'em No Limit ($0.25/$0.50 USD) - 2016/11/09 18:31:34 ET
Table 'WPN_3219946394' 6-max  Seat #3 is the button
Seat 1: iGash ($84.47 in chips)
Seat 2: IlxxxlI ($20.00 in chips)
Seat 3: saidafrente ($50.18 in chips)
Seat 4: odel_nadel ($107.94 in chips)
Seat 5: Xiniay ($47.50 in chips)
Seat 6: 38979 ($104.25 in chips)
odel_nadel: posts small blind $0.25
Xiniay: posts big blind $0.50
*** HOLE CARDS ***
Dealt to IlxxxlI [4c 3c]
38979: folds
iGash: raises $1 to $1.50
IlxxxlI: folds
saidafrente: folds
odel_nadel: folds
Xiniay: folds
Uncalled bet ($1.00) returned to iGash
iGash: doesn't show hand
iGash collected $1.25 from pot
*** SUMMARY ***
Total pot $1.25 | Rake $0
Seat 1: iGash collected ($1.25)
Seat 2: IlxxxlI folded before Flop (didn't bet)
Seat 3: saidafrente (button) folded before Flop (didn't bet)
Seat 4: odel_nadel (small blind) folded before Flop
Seat 5: Xiniay (big blind) folded before Flop
Seat 6: 38979 folded before Flop (didn't bet)

PokerStars Hand #771295939: Hold'em No Limit ($0.25/$0.50 USD) - 2016/11/09 18:31:34 ET
Table 'WPN_3981802040' 6-max  Seat #3 is the button
Seat 1: saidafrente ($37.56 in chips)
Seat 3: aleks0v ($87.46 in chips)
Seat 4: IlxxxlI ($24.11 in chips)
Seat 5: IampokerKidd ($60.55 in chips)
IlxxxlI: posts small blind $0.25
IampokerKidd: posts big blind $0.50
*** HOLE CARDS ***
Dealt to IlxxxlI [6c Qh]
saidafrente: folds
aleks0v: folds
IlxxxlI: folds
Uncalled bet ($0.25) returned to IampokerKidd
IampokerKidd: doesn't show hand
IampokerKidd collected $0.50 from pot
*** SUMMARY ***
Total pot $0.50 | Rake $0
Seat 1: saidafrente folded before Flop (didn't bet)
Seat 3: aleks0v (button) folded before Flop (didn't bet)
Seat 4: IlxxxlI (small blind) folded before Flop
Seat 5: IampokerKidd (big blind) collected ($0.50)

PokerStars Hand #771295842: Hold'em No Limit ($0.25/$0.50 USD) - 2016/11/09 18:31:17 ET
Table 'WPN_3421571163' 6-max  Seat #2 is the button
Seat 1: legenda99 ($61.29 in chips)
Seat 2: IlxxxlI ($20.00 in chips)
Seat 3: Xiniay ($71.67 in chips)
Seat 4: Zaychik033 ($81.28 in chips)
Xiniay: posts small blind $0.25
Zaychik033: posts big blind $0.50
*** HOLE CARDS ***
Dealt to IlxxxlI [Qs Js]
legenda99: raises $1 to $1.50
IlxxxlI: calls $1.50
Xiniay: folds
Zaychik033: folds
*** FLOP *** [Kd 3h 7h]
legenda99: checks
IlxxxlI: checks
*** TURN *** [Kd 3h 7h] [6d]
legenda99: bets $2.50
IlxxxlI: folds
Uncalled bet ($2.50) returned to legenda99
legenda99: doesn't show hand
legenda99 collected $3.57 from pot
*** SUMMARY ***
Total pot $3.75 | Rake $0.18
Board [Kd 3h 7h 6d]
Seat 1: legenda99 collected ($3.57)
Seat 2: IlxxxlI (button) folded on the Turn
Seat 3: Xiniay (small blind) folded before Flop
Seat 4: Zaychik033 (big blind) folded before Flop

PokerStars Hand #771295834: Hold'em No Limit ($0.25/$0.50 USD) - 2016/11/09 18:31:16 ET
Table 'WPN_1341348958' 6-max  Seat #4 is the button
Seat 1: AARON81 ($43.22 in chips)
Seat 2: odel_nadel ($28.21 in chips)
Seat 3: IlxxxlI ($10.00 in chips)
Seat 4: Xiniay ($25.92 in chips)
Seat 5: PULISPATOLA ($27.08 in chips)
Seat 6: 38979 ($25.00 in chips)
PULISPATOLA: posts small blind $0.25
38979: posts big blind $0.50
*** HOLE CARDS ***
Dealt to IlxxxlI [3d 2h]
AARON81: folds
odel_nadel: folds
IlxxxlI: folds
Xiniay: raises $0.50 to $1
PULISPATOLA: folds
38979: calls $0.50
*** FLOP *** [Kh 6c 2d]
38979: checks
Xiniay: bets $0.71
38979: raises $1.79 to $2.50
Xiniay: calls $1.79
*** TURN *** [Kh 6c 2d] [Kd]
38979: checks
Xiniay: checks
*** RIVER *** [Kh 6c 2d Kd] [Th]
38979: checks
Xiniay: bets $6.50
38979: folds
Uncalled bet ($6.50) returned to Xiniay
Xiniay: doesn't show hand
Xiniay collected $6.89 from pot
*** SUMMARY ***
Total pot $7.25 | Rake $0.36
Board [Kh 6c 2d Kd Th]
Seat 1: AARON81 folded before Flop (didn't bet)
Seat 2: odel_nadel folded before Flop (didn't bet)
Seat 3: IlxxxlI folded before Flop (didn't bet)
Seat 4: Xiniay (button) collected ($6.89)
Seat 5: PULISPATOLA (small blind) folded before Flop
Seat 6: 38979 (big blind) folded on the River

PokerStars Hand #771295786: Hold'em No Limit ($0.25/$0.50 USD) - 2016/11/09 18:31:06 ET
Table 'WPN_3219946394' 6-max  Seat #2 is the button
Seat 1: iGash ($84.47 in chips)
Seat 2: IlxxxlI ($20.00 in chips)
Seat 3: saidafrente ($50.43 in chips)
Seat 4: odel_nadel ($107.69 in chips)
Seat 5: Xiniay ($47.50 in chips)
Seat 6: 38979 ($104.25 in chips)
saidafrente: posts small blind $0.25
odel_nadel: posts big blind $0.50
*** HOLE CARDS ***
Dealt to IlxxxlI [Jc 6d]
Xiniay: folds
38979: folds
iGash: folds
IlxxxlI: folds
saidafrente: folds
Uncalled bet ($0.25) returned to odel_nadel
odel_nadel: doesn't show hand
odel_nadel collected $0.50 from pot
*** SUMMARY ***
Total pot $0.50 | Rake $0
Seat 1: iGash folded before Flop (didn't bet)
Seat 2: IlxxxlI (button) folded before Flop (didn't bet)
Seat 3: saidafrente (small blind) folded before Flop
Seat 4: odel_nadel (big blind) collected ($0.50)
Seat 5: Xiniay folded before Flop (didn't bet)
Seat 6: 38979 folded before Flop (didn't bet)

PokerStars Hand #771295737: Hold'em No Limit ($0.25/$0.50 USD) - 2016/11/09 18:30:58 ET
Table 'WPN_325998925' 6-max  Seat #2 is the button
Seat 1: brasinsh7 ($28.93 in chips)
Seat 2: AbstractSun ($50.00 in chips)
Seat 3: IlxxxlI ($20.00 in chips)
Seat 4: Xiniay ($104.62 in chips)
Seat 5: Zaychik033 ($50.00 in chips)
Seat 6: COTHREEO3 ($87.03 in chips)
IlxxxlI: posts small blind $0.25
Xiniay: posts big blind $0.50
*** HOLE CARDS ***
Dealt to IlxxxlI [Jh Th]
Zaychik033: folds
COTHREEO3: calls $0.50
brasinsh7: calls $0.50
AbstractSun: folds
IlxxxlI: calls $0.25
Xiniay: checks
*** FLOP *** [Qc 6h Jd]
IlxxxlI: checks
Xiniay: checks
COTHREEO3: bets $0.50
brasinsh7: calls $0.50
IlxxxlI: calls $0.50
Xiniay: folds
*** TURN *** [Qc 6h Jd] [2c]
IlxxxlI: checks
COTHREEO3: checks
brasinsh7: checks
*** RIVER *** [Qc 6h Jd 2c] [Td]
IlxxxlI: bets $2.22
COTHREEO3: folds
brasinsh7: folds
Uncalled bet ($2.22) returned to IlxxxlI
IlxxxlI: doesn't show hand
IlxxxlI collected $3.33 from pot
*** SUMMARY ***
Total pot $3.50 | Rake $0.17
Board [Qc 6h Jd 2c Td]
Seat 1: brasinsh7 folded on the River
Seat 2: AbstractSun (button) folded before Flop (didn't bet)
Seat 3: IlxxxlI (small blind) collected ($3.33)
Seat 4: Xiniay (big blind) folded on the Flop
Seat 5: Zaychik033 folded before Flop (didn't bet)
Seat 6: COTHREEO3 folded on the River

PokerStars Hand #771295722: Hold'em No Limit ($0.25/$0.50 USD) - 2016/11/09 18:30:56 ET
Table 'WPN_1341348958' 6-max  Seat #3 is the button
Seat 1: AARON81 ($42.47 in chips)
Seat 2: odel_nadel ($28.21 in chips)
Seat 3: IlxxxlI ($10.00 in chips)
Seat 4: Xiniay ($26.17 in chips)
Seat 5: PULISPATOLA ($27.58 in chips)
Xiniay: posts small blind $0.25
PULISPATOLA: posts big blind $0.50
*** HOLE CARDS ***
Dealt to IlxxxlI [9d Qs]
AARON81: raises $0.50 to $1
odel_nadel: folds
IlxxxlI: folds
Xiniay: folds
PULISPATOLA: folds
Uncalled bet ($0.50) returned to AARON81
AARON81: doesn't show hand
AARON81 collected $1.25 from pot
*** SUMMARY ***
Total pot $1.25 | Rake $0
Seat 1: AARON81 collected ($1.25)
Seat 2: odel_nadel folded before Flop (didn't bet)
Seat 3: IlxxxlI (button) folded before Flop (didn't bet)
Seat 4: Xiniay (small blind) folded before Flop
Seat 5: PULISPATOLA (big blind) folded before Flop

PokerStars Hand #771295612: Hold'em No Limit ($0.25/$0.50 USD) - 2016/11/09 18:30:34 ET
Table 'WPN_3219946394' 6-max  Seat #1 is the button
Seat 1: iGash ($83.72 in chips)
Seat 2: IlxxxlI ($20.00 in chips)
Seat 3: saidafrente ($50.93 in chips)
Seat 4: odel_nadel ($107.69 in chips)
Seat 5: Xiniay ($47.50 in chips)
Seat 6: 38979 ($104.25 in chips)
IlxxxlI: posts small blind $0.25
saidafrente: posts big blind $0.50
*** HOLE CARDS ***
Dealt to IlxxxlI [Qd 7c]
odel_nadel: folds
Xiniay: folds
38979: folds
iGash: raises $1 to $1.50
IlxxxlI: folds
saidafrente: folds
Uncalled bet ($1.00) returned to iGash
iGash: doesn't show hand
iGash collected $1.25 from pot
*** SUMMARY ***
Total pot $1.25 | Rake $0
Seat 1: iGash (button) collected ($1.25)
Seat 2: IlxxxlI (small blind) folded before Flop
Seat 3: saidafrente (big blind) folded before Flop
Seat 4: odel_nadel folded before Flop (didn't bet)
Seat 5: Xiniay folded before Flop (didn't bet)
Seat 6: 38979 folded before Flop (didn't bet)

PokerStars Hand #771295591: Hold'em No Limit ($0.25/$0.50 USD) - 2016/11/09 18:30:31 ET
Table 'WPN_3421571163' 6-max  Seat #1 is the button
Seat 1: legenda99 ($57.54 in chips)
Seat 2: IlxxxlI ($20.00 in chips)
Seat 3: Xiniay ($75.17 in chips)
Seat 4: Zaychik033 ($81.28 in chips)
IlxxxlI: posts small blind $0.25
Xiniay: posts big blind $0.50
*** HOLE CARDS ***
Dealt to IlxxxlI [Qh 7h]
Zaychik033: folds
legenda99: raises $0.50 to $1
IlxxxlI: folds
Xiniay: raises $2.50 to $3.50
legenda99: raises $5.50 to $9
Xiniay: folds
Uncalled bet ($5.50) returned to legenda99
legenda99: doesn't show hand
legenda99 collected $7.25 from pot
*** SUMMARY ***
Total pot $7.25 | Rake $0
Seat 1: legenda99 (button) collected ($7.25)
Seat 2: IlxxxlI (small blind) folded before Flop
Seat 3: Xiniay (big blind) folded before Flop
Seat 4: Zaychik033 folded before Flop (didn't bet)

PokerStars Hand #771295582: Hold'em No Limit ($0.25/$0.50 USD) - 2016/11/09 18:30:29 ET
Table 'WPN_3981802040' 6-max  Seat #1 is the button
Seat 1: saidafrente ($37.56 in chips)
Seat 2: 38979 ($50.50 in chips)
Seat 3: aleks0v ($87.96 in chips)
Seat 4: IlxxxlI ($20.00 in chips)
Seat 5: IampokerKidd ($64.32 in chips)
38979: posts small blind $0.25
aleks0v: posts big blind $0.50
*** HOLE CARDS ***
Dealt to IlxxxlI [9c Ac]
IlxxxlI: raises $1.25 to $1.75
IampokerKidd: calls $1.75
saidafrente: folds
38979: folds
aleks0v: folds
*** FLOP *** [Kd 7h 3c]
IlxxxlI: checks
IampokerKidd: checks
*** TURN *** [Kd 7h 3c] [4s]
IlxxxlI: checks
IampokerKidd: bets $2.02
IlxxxlI: raises $3.98 to $6
IampokerKidd: folds
Uncalled bet ($3.98) returned to IlxxxlI
IlxxxlI: doesn't show hand
IlxxxlI collected $7.88 from pot
*** SUMMARY ***
Total pot $8.29 | Rake $0.41
Board [Kd 7h 3c 4s]
Seat 1: saidafrente (button) folded before Flop (didn't bet)
Seat 2: 38979 (small blind) folded before Flop
Seat 3: aleks0v (big blind) folded before Flop
Seat 4: IlxxxlI collected ($7.88)
Seat 5: IampokerKidd folded on the Turn

PokerStars Hand #771295519: Hold'em No Limit ($0.25/$0.50 USD) - 2016/11/09 18:30:18 ET
Table 'WPN_1341348958' 6-max  Seat #2 is the button
Seat 1: AARON81 ($42.47 in chips)
Seat 2: odel_nadel ($28.21 in chips)
Seat 3: IlxxxlI ($10.00 in chips)
Seat 4: Xiniay ($25.42 in chips)
Seat 5: PULISPATOLA ($28.08 in chips)
IlxxxlI: posts small blind $0.25
Xiniay: posts big blind $0.50
*** HOLE CARDS ***
Dealt to IlxxxlI [9h 4h]
PULISPATOLA: calls $0.50
AARON81: folds
odel_nadel: folds
IlxxxlI: folds
Xiniay: raises $1.50 to $2
PULISPATOLA: folds
Uncalled bet ($1.50) returned to Xiniay
Xiniay: doesn't show hand
Xiniay collected $1.25 from pot
*** SUMMARY ***
Total pot $1.25 | Rake $0
Seat 1: AARON81 folded before Flop (didn't bet)
Seat 2: odel_nadel (button) folded before Flop (didn't bet)
Seat 3: IlxxxlI (small blind) folded before Flop
Seat 4: Xiniay (big blind) collected ($1.25)
Seat 5: PULISPATOLA folded before Flop

PokerStars Hand #771295450: Hold'em No Limit ($0.25/$0.50 USD) - 2016/11/09 18:30:07 ET
Table 'WPN_3981802040' 6-max  Seat #5 is the button
Seat 1: saidafrente ($37.81 in chips)
Seat 2: 38979 ($51.00 in chips)
Seat 3: aleks0v ($87.96 in chips)
Seat 4: IlxxxlI ($20.00 in chips)
Seat 5: IampokerKidd ($63.57 in chips)
saidafrente: posts small blind $0.25
38979: posts big blind $0.50
*** HOLE CARDS ***
Dealt to IlxxxlI [3s 9d]
aleks0v: folds
IlxxxlI: folds
IampokerKidd: raises $1 to $1.50
saidafrente: folds
38979: folds
Uncalled bet ($1.00) returned to IampokerKidd
IampokerKidd: doesn't show hand
IampokerKidd collected $1.25 from pot
*** SUMMARY ***
Total pot $1.25 | Rake $0
Seat 1: saidafrente (small blind) folded before Flop
Seat 2: 38979 (big blind) folded before Flop
Seat 3: aleks0v folded before Flop (didn't bet)
Seat 4: IlxxxlI folded before Flop (didn't bet)
Seat 5: IampokerKidd (button) collected ($1.25)

PokerStars Hand #771295433: Hold'em No Limit ($0.25/$0.50 USD) - 2016/11/09 18:30:03 ET
Table 'WPN_3219946394' 6-max  Seat #6 is the button
Seat 1: iGash ($83.97 in chips)
Seat 2: IlxxxlI ($20.00 in chips)
Seat 3: saidafrente ($50.93 in chips)
Seat 4: odel_nadel ($107.69 in chips)
Seat 5: Xiniay ($47.50 in chips)
Seat 6: 38979 ($103.50 in chips)
iGash: posts small blind $0.25
IlxxxlI: posts big blind $0.50
*** HOLE CARDS ***
Dealt to IlxxxlI [8d 3s]
saidafrente: folds
odel_nadel: folds
Xiniay: folds
38979: raises $1 to $1.50
iGash: folds
IlxxxlI: folds
Uncalled bet ($1.00) returned to 38979
38979: doesn't show hand
38979 collected $1.25 from pot
*** SUMMARY ***
Total pot $1.25 | Rake $0
Seat 1: iGash (small blind) folded before Flop
Seat 2: IlxxxlI (big blind) folded before Flop
Seat 3: saidafrente folded before Flop (didn't bet)
Seat 4: odel_nadel folded before Flop (didn't bet)
Seat 5: Xiniay folded before Flop (didn't bet)
Seat 6: 38979 (button) collected ($1.25)

PokerStars Hand #771295390: Hold'em No Limit ($0.25/$0.50 USD) - 2016/11/09 18:29:57 ET
Table 'WPN_3421571163' 6-max  Seat #4 is the button
Seat 1: legenda99 ($57.79 in chips)
Seat 2: IlxxxlI ($20.00 in chips)
Seat 3: Xiniay ($75.17 in chips)
Seat 4: Zaychik033 ($79.91 in chips)
legenda99: posts small blind $0.25
IlxxxlI: posts big blind $0.50
*** HOLE CARDS ***
Dealt to IlxxxlI [Kd Qs]
Xiniay: folds
Zaychik033: raises $0.75 to $1.25
legenda99: folds
IlxxxlI: calls $0.75
*** FLOP *** [2d Ah 3c]
IlxxxlI: checks
Zaychik033: bets $0.87
IlxxxlI: folds
Uncalled bet ($0.87) returned to Zaychik033
Zaychik033: doesn't show hand
Zaychik033 collected $2.62 from pot
*** SUMMARY ***
Total pot $2.75 | Rake $0.13
Board [2d Ah 3c]
Seat 1: legenda99 (small blind) folded before Flop
Seat 2: IlxxxlI (big blind) folded on the Flop
Seat 3: Xiniay folded before Flop (didn't bet)
Seat 4: Zaychik033 (button) collected ($2.62)

PokerStars Hand #771295214: Hold'em No Limit ($0.25/$0.50 USD) - 2016/11/09 18:29:25 ET
Table 'WPN_3219946394' 6-max  Seat #5 is the button
Seat 1: iGash ($84.47 in chips)
Seat 2: IlxxxlI ($20.00 in chips)
Seat 3: saidafrente ($50.93 in chips)
Seat 4: odel_nadel ($106.94 in chips)
Seat 5: Xiniay ($47.50 in chips)
Seat 6: 38979 ($103.75 in chips)
38979: posts small blind $0.25
iGash: posts big blind $0.50
*** HOLE CARDS ***
Dealt to IlxxxlI [Th 7h]
IlxxxlI: folds
saidafrente: folds
odel_nadel: raises $1 to $1.50
Xiniay: folds
38979: folds
iGash: folds
Uncalled bet ($1.00) returned to odel_nadel
odel_nadel: doesn't show hand
odel_nadel collected $1.25 from pot
*** SUMMARY ***
Total pot $1.25 | Rake $0
Seat 1: iGash (big blind) folded before Flop
Seat 2: IlxxxlI folded before Flop (didn't bet)
Seat 3: saidafrente folded before Flop (didn't bet)
Seat 4: odel_nadel collected ($1.25)
Seat 5: Xiniay (button) folded before Flop (didn't bet)
Seat 6: 38979 (small blind) folded before Flop

PokerStars Hand #771295190: Hold'em No Limit ($0.25/$0.50 USD) - 2016/11/09 18:29:21 ET
Table 'WPN_3981802040' 6-max  Seat #4 is the button
Seat 1: saidafrente ($36.06 in chips)
Seat 2: 38979 ($52.50 in chips)
Seat 3: aleks0v ($87.96 in chips)
Seat 4: IlxxxlI ($20.00 in chips)
Seat 5: IampokerKidd ($63.82 in chips)
IampokerKidd: posts small blind $0.25
saidafrente: posts big blind $0.50
*** HOLE CARDS ***
Dealt to IlxxxlI [As 5c]
38979: raises $1 to $1.50
aleks0v: folds
IlxxxlI: folds
IampokerKidd: folds
saidafrente: raises $5 to $6.50
38979: folds
Uncalled bet ($5.00) returned to saidafrente
saidafrente: doesn't show hand
saidafrente collected $3.25 from pot
*** SUMMARY ***
Total pot $3.25 | Rake $0
Seat 1: saidafrente collected ($3.25)
Seat 2: 38979 folded before Flop
Seat 3: aleks0v folded before Flop (didn't bet)
Seat 4: IlxxxlI (button) folded before Flop (didn't bet)
Seat 5: IampokerKidd (small blind) folded before Flop

PokerStars Hand #771295198: Hold'em No Limit ($0.25/$0.50 USD) - 2016/11/09 18:29:21 ET
Table 'WPN_325998925' 6-max  Seat #1 is the button
Seat 1: brasinsh7 ($30.18 in chips)
Seat 2: AbstractSun ($50.00 in chips)
Seat 3: IlxxxlI ($20.00 in chips)
Seat 4: Xiniay ($104.62 in chips)
Seat 5: Zaychik033 ($50.00 in chips)
Seat 6: COTHREEO3 ($81.79 in chips)
AbstractSun: posts small blind $0.25
IlxxxlI: posts big blind $0.50
*** HOLE CARDS ***
Dealt to IlxxxlI [Jh 8h]
Xiniay: folds
Zaychik033: raises $0.75 to $1.25
COTHREEO3: calls $1.25
brasinsh7: calls $1.25
AbstractSun: folds
IlxxxlI: calls $0.75
*** FLOP *** [9d 2c Kh]
IlxxxlI: checks
Zaychik033: bets $1.66
COTHREEO3: calls $1.66
brasinsh7: folds
IlxxxlI: folds
*** TURN *** [9d 2c Kh] [9h]
Zaychik033: checks
COTHREEO3: bets $5
Zaychik033: folds
Uncalled bet ($5.00) returned to COTHREEO3
COTHREEO3: doesn't show hand
COTHREEO3 collected $8.15 from pot
*** SUMMARY ***
Total pot $8.57 | Rake $0.42
Board [9d 2c Kh 9h]
Seat 1: brasinsh7 (button) folded on the Flop
Seat 2: AbstractSun (small blind) folded before Flop
Seat 3: IlxxxlI (big blind) folded on the Flop
Seat 4: Xiniay folded before Flop (didn't bet)
Seat 5: Zaychik033 folded on the Turn
Seat 6: COTHREEO3 collected ($8.15)

PokerStars Hand #771295021: Hold'em No Limit ($0.25/$0.50 USD) - 2016/11/09 18:28:53 ET
Table 'WPN_3981802040' 6-max  Seat #3 is the button
Seat 1: saidafrente ($36.06 in chips)
Seat 2: 38979 ($51.75 in chips)
Seat 3: aleks0v ($87.96 in chips)
Seat 4: IlxxxlI ($20.00 in chips)
Seat 5: IampokerKidd ($64.32 in chips)
Seat 6: Xiniay ($75.69 in chips)
IlxxxlI: posts small blind $0.25
IampokerKidd: posts big blind $0.50
*** HOLE CARDS ***
Dealt to IlxxxlI [4c 8c]
Xiniay: folds
saidafrente: folds
38979: raises $1 to $1.50
aleks0v: folds
IlxxxlI: folds
IampokerKidd: folds
Uncalled bet ($1.00) returned to 38979
38979: doesn't show hand
38979 collected $1.25 from pot
*** SUMMARY ***
Total pot $1.25 | Rake $0
Seat 1: saidafrente folded before Flop (didn't bet)
Seat 2: 38979 collected ($1.25)
Seat 3: aleks0v (button) folded before Flop (didn't bet)
Seat 4: IlxxxlI (small blind) folded before Flop
Seat 5: IampokerKidd (big blind) folded before Flop
Seat 6: Xiniay folded before Flop (didn't bet)

PokerStars Hand #771294995: Hold'em No Limit ($0.25/$0.50 USD) - 2016/11/09 18:28:48 ET
Table 'WPN_3421571163' 6-max  Seat #3 is the button
Seat 1: legenda99 ($57.04 in chips)
Seat 2: IlxxxlI ($20.00 in chips)
Seat 3: Xiniay ($75.17 in chips)
Seat 4: Zaychik033 ($80.16 in chips)
Seat 5: 38979 ($50.00 in chips)
Zaychik033: posts small blind $0.25
38979: posts big blind $0.50
*** HOLE CARDS ***
Dealt to IlxxxlI [3h Qs]
legenda99: raises $1 to $1.50
IlxxxlI: folds
Xiniay: folds
Zaychik033: folds
38979: folds
Uncalled bet ($1.00) returned to legenda99
legenda99: doesn't show hand
legenda99 collected $1.25 from pot
*** SUMMARY ***
Total pot $1.25 | Rake $0
Seat 1: legenda99 collected ($1.25)
Seat 2: IlxxxlI folded before Flop (didn't bet)
Seat 3: Xiniay (button) folded before Flop (didn't bet)
Seat 4: Zaychik033 (small blind) folded before Flop
Seat 5: 38979 (big blind) folded before Flop

PokerStars Hand #771294985: Hold'em No Limit ($0.25/$0.50 USD) - 2016/11/09 18:28:45 ET
Table 'WPN_325998925' 6-max  Seat #6 is the button
Seat 1: brasinsh7 ($31.68 in chips)
Seat 2: AbstractSun ($50.46 in chips)
Seat 3: IlxxxlI ($20.00 in chips)
Seat 4: Xiniay ($104.62 in chips)
Seat 5: Zaychik033 ($50.00 in chips)
Seat 6: COTHREEO3 ($79.96 in chips)
brasinsh7: posts small blind $0.25
AbstractSun: posts big blind $0.50
*** HOLE CARDS ***
Dealt to IlxxxlI [5d 9s]
IlxxxlI: folds
Xiniay: folds
Zaychik033: folds
COTHREEO3: raises $1 to $1.50
brasinsh7: calls $1.25
AbstractSun: folds
*** FLOP *** [As Qd 5s]
brasinsh7: checks
COTHREEO3: bets $1.50
brasinsh7: folds
Uncalled bet ($1.50) returned to COTHREEO3
COTHREEO3: doesn't show hand
COTHREEO3 collected $3.33 from pot
*** SUMMARY ***
Total pot $3.50 | Rake $0.17
Board [As Qd 5s]
Seat 1: brasinsh7 (small blind) folded on the Flop
Seat 2: AbstractSun (big blind) folded before Flop
Seat 3: IlxxxlI folded before Flop (didn't bet)
Seat 4: Xiniay folded before Flop (didn't bet)
Seat 5: Zaychik033 folded before Flop (didn't bet)
Seat 6: COTHREEO3 (button) collected ($3.33)

PokerStars Hand #771294982: Hold'em No Limit ($0.25/$0.50 USD) - 2016/11/09 18:28:45 ET
Table 'WPN_1341348958' 6-max  Seat #1 is the button
Seat 1: AARON81 ($42.47 in chips)
Seat 2: odel_nadel ($32.96 in chips)
Seat 3: IlxxxlI ($10.00 in chips)
Seat 4: Xiniay ($25.42 in chips)
Seat 5: PULISPATOLA ($23.33 in chips)
odel_nadel: posts small blind $0.25
IlxxxlI: posts big blind $0.50
*** HOLE CARDS ***
Dealt to IlxxxlI [Qh 6d]
Xiniay: folds
PULISPATOLA: calls $0.50
AARON81: folds
odel_nadel: raises $1.50 to $2
IlxxxlI: folds
PULISPATOLA: calls $1.50
*** FLOP *** [7h Ad 3d]
odel_nadel: bets $2.75
PULISPATOLA: calls $2.75
*** TURN *** [7h Ad 3d] [Tc]
odel_nadel: checks
PULISPATOLA: checks
*** RIVER *** [7h Ad 3d Tc] [Th]
odel_nadel: checks
PULISPATOLA: bets $6.50
odel_nadel: folds
Uncalled bet ($6.50) returned to PULISPATOLA
PULISPATOLA: doesn't show hand
PULISPATOLA collected $9.50 from pot
*** SUMMARY ***
Total pot $10 | Rake $0.50
Board [7h Ad 3d Tc Th]
Seat 1: AARON81 (button) folded before Flop (didn't bet)
Seat 2: odel_nadel (small blind) folded on the River
Seat 3: IlxxxlI (big blind) folded before Flop
Seat 4: Xiniay folded before Flop (didn't bet)
Seat 5: PULISPATOLA collected ($9.50)

PokerStars Hand #771294886: Hold'em No Limit ($0.25/$0.50 USD) - 2016/11/09 18:28:28 ET
Table 'WPN_3421571163' 6-max  Seat #2 is the button
Seat 1: legenda99 ($56.29 in chips)
Seat 2: IlxxxlI ($20.00 in chips)
Seat 3: Xiniay ($75.42 in chips)
Seat 4: Zaychik033 ($80.66 in chips)
Xiniay: posts small blind $0.25
Zaychik033: posts big blind $0.50
*** HOLE CARDS ***
Dealt to IlxxxlI [Qh 4c]
legenda99: raises $1 to $1.50
IlxxxlI: folds
Xiniay: folds
Zaychik033: folds
Uncalled bet ($1.00) returned to legenda99
legenda99: doesn't show hand
legenda99 collected $1.25 from pot
*** SUMMARY ***
Total pot $1.25 | Rake $0
Seat 1: legenda99 collected ($1.25)
Seat 2: IlxxxlI (button) folded before Flop (didn't bet)
Seat 3: Xiniay (small blind) folded before Flop
Seat 4: Zaychik033 (big blind) folded before Flop

PokerStars Hand #771294848: Hold'em No Limit ($0.25/$0.50 USD) - 2016/11/09 18:28:22 ET
Table 'WPN_3981802040' 6-max  Seat #2 is the button
Seat 1: saidafrente ($36.06 in chips)
Seat 2: 38979 ($51.75 in chips)
Seat 3: aleks0v ($88.21 in chips)
Seat 4: IlxxxlI ($20.00 in chips)
Seat 5: IampokerKidd ($64.32 in chips)
Seat 6: Xiniay ($74.94 in chips)
aleks0v: posts small blind $0.25
IlxxxlI: posts big blind $0.50
*** HOLE CARDS ***
Dealt to IlxxxlI [2c 6h]
IampokerKidd: folds
Xiniay: raises $1 to $1.50
saidafrente: folds
38979: folds
aleks0v: folds
IlxxxlI: folds
Uncalled bet ($1.00) returned to Xiniay
Xiniay: doesn't show hand
Xiniay collected $1.25 from pot
*** SUMMARY ***
Total pot $1.25 | Rake $0
Seat 1: saidafrente folded before Flop (didn't bet)
Seat 2: 38979 (button) folded before Flop (didn't bet)
Seat 3: aleks0v (small blind) folded before Flop
Seat 4: IlxxxlI (big blind) folded before Flop
Seat 5: IampokerKidd folded before Flop (didn't bet)
Seat 6: Xiniay collected ($1.25)

PokerStars Hand #771294772: Hold'em No Limit ($0.25/$0.50 USD) - 2016/11/09 18:28:04 ET
Table 'WPN_3219946394' 6-max  Seat #4 is the button
Seat 1: iGash ($84.47 in chips)
Seat 2: IlxxxlI ($20.00 in chips)
Seat 3: saidafrente ($57.43 in chips)
Seat 4: odel_nadel ($156.94 in chips)
Seat 5: Xiniay ($47.75 in chips)
Seat 6: 38979 ($50.00 in chips)
Xiniay: posts small blind $0.25
38979: posts big blind $0.50
*** HOLE CARDS ***
Dealt to IlxxxlI [8s 4s]
iGash: folds
IlxxxlI: folds
saidafrente: raises $1 to $1.50
odel_nadel: calls $1.50
Xiniay: folds
38979: raises $5 to $6.50
saidafrente: calls $5
odel_nadel: raises $9.50 to $16
38979: raises $34 to $50 and is all-in
saidafrente: folds
odel_nadel: calls $34
*** FLOP *** [9h Td 2c]
*** TURN *** [9h Td 2c] [Jh]
*** RIVER *** [9h Td 2c Jh] [3d]
*** SHOW DOWN ***
odel_nadel: shows [Kh As] (High card A)
38979: shows [Kc Ks] (One pair of Ks)
38979 collected $103.75 from pot
*** SUMMARY ***
Total pot $106.75 | Rake $3
Board [9h Td 2c Jh 3d]
Seat 1: iGash folded before Flop (didn't bet)
Seat 2: IlxxxlI folded before Flop (didn't bet)
Seat 3: saidafrente folded before Flop
Seat 4: odel_nadel (button) showed [Kh As] and lost with High card A
Seat 5: Xiniay (small blind) folded before Flop
Seat 6: 38979 (big blind) showed [Kc Ks] and won ($103.75) with One pair of Ks

PokerStars Hand #771294639: Hold'em No Limit ($0.25/$0.50 USD) - 2016/11/09 18:27:41 ET
Table 'WPN_3981802040' 6-max  Seat #1 is the button
Seat 1: saidafrente ($36.06 in chips)
Seat 2: 38979 ($52.00 in chips)
Seat 3: aleks0v ($88.71 in chips)
Seat 4: IlxxxlI ($20.00 in chips)
Seat 5: IampokerKidd ($63.57 in chips)
Seat 6: Xiniay ($74.94 in chips)
38979: posts small blind $0.25
aleks0v: posts big blind $0.50
*** HOLE CARDS ***
Dealt to IlxxxlI [4h 2s]
IlxxxlI: folds
IampokerKidd: raises $1 to $1.50
Xiniay: folds
saidafrente: folds
38979: folds
aleks0v: folds
Uncalled bet ($1.00) returned to IampokerKidd
IampokerKidd: doesn't show hand
IampokerKidd collected $1.25 from pot
*** SUMMARY ***
Total pot $1.25 | Rake $0
Seat 1: saidafrente (button) folded before Flop (didn't bet)
Seat 2: 38979 (small blind) folded before Flop
Seat 3: aleks0v (big blind) folded before Flop
Seat 4: IlxxxlI folded before Flop (didn't bet)
Seat 5: IampokerKidd collected ($1.25)
Seat 6: Xiniay folded before Flop (didn't bet)

PokerStars Hand #771294633: Hold'em No Limit ($0.25/$0.50 USD) - 2016/11/09 18:27:40 ET
Table 'WPN_3219946394' 6-max  Seat #3 is the button
Seat 1: iGash ($83.72 in chips)
Seat 2: IlxxxlI ($20.00 in chips)
Seat 3: saidafrente ($57.43 in chips)
Seat 4: odel_nadel ($157.19 in chips)
Seat 5: Xiniay ($48.25 in chips)
odel_nadel: posts small blind $0.25
Xiniay: posts big blind $0.50
*** HOLE CARDS ***
Dealt to IlxxxlI [5s 5c]
iGash: raises $1 to $1.50
IlxxxlI: folds
saidafrente: folds
odel_nadel: folds
Xiniay: folds
Uncalled bet ($1.00) returned to iGash
iGash: doesn't show hand
iGash collected $1.25 from pot
*** SUMMARY ***
Total pot $1.25 | Rake $0
Seat 1: iGash collected ($1.25)
Seat 2: IlxxxlI folded before Flop (didn't bet)
Seat 3: saidafrente (button) folded before Flop (didn't bet)
Seat 4: odel_nadel (small blind) folded before Flop
Seat 5: Xiniay (big blind) folded before Flop

PokerStars Hand #771294533: Hold'em No Limit ($0.25/$0.50 USD) - 2016/11/09 18:27:23 ET
Table 'WPN_325998925' 6-max  Seat #5 is the button
Seat 1: brasinsh7 ($32.18 in chips)
Seat 3: IlxxxlI ($20.00 in chips)
Seat 4: Xiniay ($91.01 in chips)
Seat 5: Zaychik033 ($50.00 in chips)
Seat 6: COTHREEO3 ($80.21 in chips)
COTHREEO3: posts small blind $0.25
brasinsh7: posts big blind $0.50
*** HOLE CARDS ***
Dealt to IlxxxlI [9d 8c]
IlxxxlI: folds
Xiniay: raises $1 to $1.50
Zaychik033: calls $1.50
COTHREEO3: folds
brasinsh7: folds
*** FLOP *** [Qc Kd Ac]
Xiniay: bets $1.19
Zaychik033: calls $1.19
*** TURN *** [Qc Kd Ac] [8h]
Xiniay: checks
Zaychik033: bets $2.91
Xiniay: raises $8.73 to $11.64
Zaychik033: calls $8.73
*** RIVER *** [Qc Kd Ac 8h] [5c]
Xiniay: checks
Zaychik033: checks
*** SHOW DOWN ***
Xiniay: shows [Th Js] (Straight to A)
Zaychik033: mucks hand
Xiniay collected $27.94 from pot
*** SUMMARY ***
Total pot $29.41 | Rake $1.47
Board [Qc Kd Ac 8h 5c]
Seat 1: brasinsh7 (big blind) folded before Flop
Seat 3: IlxxxlI folded before Flop (didn't bet)
Seat 4: Xiniay showed [Th Js] and won ($27.94) with Straight to A
Seat 5: Zaychik033 (button) mucked
Seat 6: COTHREEO3 (small blind) folded before Flop

PokerStars Hand #771294515: Hold'em No Limit ($0.25/$0.50 USD) - 2016/11/09 18:27:21 ET
Table 'WPN_3219946394' 6-max  Seat #2 is the button
Seat 1: iGash ($83.72 in chips)
Seat 2: IlxxxlI ($20.00 in chips)
Seat 3: saidafrente ($57.68 in chips)
Seat 4: odel_nadel ($157.69 in chips)
Seat 5: Xiniay ($47.50 in chips)
saidafrente: posts small blind $0.25
odel_nadel: posts big blind $0.50
*** HOLE CARDS ***
Dealt to IlxxxlI [Jd 6h]
Xiniay: raises $1 to $1.50
iGash: folds
IlxxxlI: folds
saidafrente: folds
odel_nadel: folds
Uncalled bet ($1.00) returned to Xiniay
Xiniay: doesn't show hand
Xiniay collected $1.25 from pot
*** SUMMARY ***
Total pot $1.25 | Rake $0
Seat 1: iGash folded before Flop (didn't bet)
Seat 2: IlxxxlI (button) folded before Flop (didn't bet)
Seat 3: saidafrente (small blind) folded before Flop
Seat 4: odel_nadel (big blind) folded before Flop
Seat 5: Xiniay collected ($1.25)

PokerStars Hand #771294487: Hold'em No Limit ($0.25/$0.50 USD) - 2016/11/09 18:27:15 ET
Table 'WPN_3981802040' 6-max  Seat #6 is the button
Seat 1: saidafrente ($36.31 in chips)
Seat 2: 38979 ($50.00 in chips)
Seat 3: aleks0v ($88.71 in chips)
Seat 4: IlxxxlI ($20.75 in chips)
Seat 5: IampokerKidd ($63.57 in chips)
Seat 6: Xiniay ($74.94 in chips)
saidafrente: posts small blind $0.25
38979: posts big blind $0.50
*** HOLE CARDS ***
Dealt to IlxxxlI [Ad Jc]
aleks0v: folds
IlxxxlI: raises $1.25 to $1.75
IampokerKidd: folds
Xiniay: folds
saidafrente: folds
38979: raises $3.25 to $5
IlxxxlI: folds
Uncalled bet ($3.25) returned to 38979
38979: doesn't show hand
38979 collected $3.75 from pot
*** SUMMARY ***
Total pot $3.75 | Rake $0
Seat 1: saidafrente (small blind) folded before Flop
Seat 2: 38979 (big blind) collected ($3.75)
Seat 3: aleks0v folded before Flop (didn't bet)
Seat 4: IlxxxlI folded before Flop
Seat 5: IampokerKidd folded before Flop (didn't bet)
Seat 6: Xiniay (button) folded before Flop (didn't bet)

PokerStars Hand #771294372: Hold'em No Limit ($0.25/$0.50 USD) - 2016/11/09 18:26:55 ET
Table 'WPN_3981802040' 6-max  Seat #5 is the button
Seat 1: saidafrente ($36.81 in chips)
Seat 3: aleks0v ($87.96 in chips)
Seat 4: IlxxxlI ($20.75 in chips)
Seat 5: IampokerKidd ($63.57 in chips)
Seat 6: Xiniay ($75.19 in chips)
Xiniay: posts small blind $0.25
saidafrente: posts big blind $0.50
*** HOLE CARDS ***
Dealt to IlxxxlI [Qd 9h]
aleks0v: raises $1 to $1.50
IlxxxlI: folds
IampokerKidd: folds
Xiniay: folds
saidafrente: folds
Uncalled bet ($1.00) returned to aleks0v
aleks0v: doesn't show hand
aleks0v collected $1.25 from pot
*** SUMMARY ***
Total pot $1.25 | Rake $0
Seat 1: saidafrente (big blind) folded before Flop
Seat 3: aleks0v collected ($1.25)
Seat 4: IlxxxlI folded before Flop (didn't bet)
Seat 5: IampokerKidd (button) folded before Flop (didn't bet)
Seat 6: Xiniay (small blind) folded before Flop

PokerStars Hand #771294371: Hold'em No Limit ($0.25/$0.50 USD) - 2016/11/09 18:26:54 ET
Table 'WPN_3219946394' 6-max  Seat #1 is the button
Seat 1: iGash ($82.97 in chips)
Seat 2: IlxxxlI ($20.00 in chips)
Seat 3: saidafrente ($58.18 in chips)
Seat 4: odel_nadel ($157.69 in chips)
Seat 5: Xiniay ($47.50 in chips)
IlxxxlI: posts small blind $0.25
saidafrente: posts big blind $0.50
*** HOLE CARDS ***
Dealt to IlxxxlI [Kh Td]
odel_nadel: folds
Xiniay: folds
iGash: raises $1 to $1.50
IlxxxlI: folds
saidafrente: folds
Uncalled bet ($1.00) returned to iGash
iGash: doesn't show hand
iGash collected $1.25 from pot
*** SUMMARY ***
Total pot $1.25 | Rake $0
Seat 1: iGash (button) collected ($1.25)
Seat 2: IlxxxlI (small blind) folded before Flop
Seat 3: saidafrente (big blind) folded before Flop
Seat 4: odel_nadel folded before Flop (didn't bet)
Seat 5: Xiniay folded before Flop (didn't bet)

PokerStars Hand #771294288: Hold'em No Limit ($0.25/$0.50 USD) - 2016/11/09 18:26:39 ET
Table 'WPN_3421571163' 6-max  Seat #1 is the button
Seat 1: legenda99 ($67.70 in chips)
Seat 2: IlxxxlI ($20.00 in chips)
Seat 3: Xiniay ($64.91 in chips)
Seat 4: Zaychik033 ($80.66 in chips)
IlxxxlI: posts small blind $0.25
Xiniay: posts big blind $0.50
*** HOLE CARDS ***
Dealt to IlxxxlI [9d 6c]
Zaychik033: folds
legenda99: raises $0.50 to $1
IlxxxlI: folds
Xiniay: raises $2.50 to $3.50
legenda99: calls $2.50
*** FLOP *** [3d Ac 4h]
Xiniay: bets $2.29
legenda99: calls $2.29
*** TURN *** [3d Ac 4h] [3h]
Xiniay: checks
legenda99: bets $5.62
Xiniay: calls $5.62
*** RIVER *** [3d Ac 4h 3h] [Jd]
Xiniay: checks
legenda99: checks
*** SHOW DOWN ***
legenda99: shows [7c 6h] (One pair of 3s)
Xiniay: shows [As 4c] (Two pairs. As and 4s)
Xiniay collected $21.92 from pot
*** SUMMARY ***
Total pot $23.07 | Rake $1.15
Board [3d Ac 4h 3h Jd]
Seat 1: legenda99 (button) showed [7c 6h] and lost with One pair of 3s
Seat 2: IlxxxlI (small blind) folded before Flop
Seat 3: Xiniay (big blind) showed [As 4c] and won ($21.92) with Two pairs. As and 4s
Seat 4: Zaychik033 folded before Flop (didn't bet)

PokerStars Hand #771294269: Hold'em No Limit ($0.25/$0.50 USD) - 2016/11/09 18:26:36 ET
Table 'WPN_3981802040' 6-max  Seat #4 is the button
Seat 1: saidafrente ($36.81 in chips)
Seat 3: aleks0v ($87.96 in chips)
Seat 4: IlxxxlI ($20.00 in chips)
Seat 5: IampokerKidd ($63.82 in chips)
Seat 6: Xiniay ($75.69 in chips)
IampokerKidd: posts small blind $0.25
Xiniay: posts big blind $0.50
*** HOLE CARDS ***
Dealt to IlxxxlI [5h 7h]
saidafrente: folds
aleks0v: folds
IlxxxlI: raises $1 to $1.50
IampokerKidd: folds
Xiniay: folds
Uncalled bet ($1.00) returned to IlxxxlI
IlxxxlI: doesn't show hand
IlxxxlI collected $1.25 from pot
*** SUMMARY ***
Total pot $1.25 | Rake $0
Seat 1: saidafrente folded before Flop (didn't bet)
Seat 3: aleks0v folded before Flop (didn't bet)
Seat 4: IlxxxlI (button) collected ($1.25)
Seat 5: IampokerKidd (small blind) folded before Flop
Seat 6: Xiniay (big blind) folded before Flop

PokerStars Hand #771294206: Hold'em No Limit ($0.25/$0.50 USD) - 2016/11/09 18:26:26 ET
Table 'WPN_325998925' 6-max  Seat #4 is the button
Seat 1: brasinsh7 ($32.18 in chips)
Seat 3: IlxxxlI ($20.00 in chips)
Seat 4: Xiniay ($91.01 in chips)
Seat 5: Zaychik033 ($50.00 in chips)
Seat 6: COTHREEO3 ($73.55 in chips)
Zaychik033: posts small blind $0.25
COTHREEO3: posts big blind $0.50
*** HOLE CARDS ***
Dealt to IlxxxlI [9h 3h]
brasinsh7: folds
IlxxxlI: folds
Xiniay: folds
Zaychik033: raises $0.75 to $1.25
COTHREEO3: calls $0.75
*** FLOP *** [8c Ks 2c]
Zaychik033: checks
COTHREEO3: bets $0.50
Zaychik033: calls $0.50
*** TURN *** [8c Ks 2c] [2h]
Zaychik033: checks
COTHREEO3: bets $1.50
Zaychik033: calls $1.50
*** RIVER *** [8c Ks 2c 2h] [Jh]
Zaychik033: checks
COTHREEO3: bets $4.15
Zaychik033: calls $4.15
*** SHOW DOWN ***
Zaychik033: mucks hand
COTHREEO3: shows [Th 2d] (Three Of Kind of 2s)
COTHREEO3 collected $14.06 from pot
*** SUMMARY ***
Total pot $14.80 | Rake $0.74
Board [8c Ks 2c 2h Jh]
Seat 1: brasinsh7 folded before Flop (didn't bet)
Seat 3: IlxxxlI folded before Flop (didn't bet)
Seat 4: Xiniay (button) folded before Flop (didn't bet)
Seat 5: Zaychik033 (small blind) mucked
Seat 6: COTHREEO3 (big blind) showed [Th 2d] and won ($14.06) with Three Of Kind of 2s

PokerStars Hand #771294160: Hold'em No Limit ($0.25/$0.50 USD) - 2016/11/09 18:26:16 ET
Table 'WPN_3981802040' 6-max  Seat #3 is the button
Seat 1: saidafrente ($36.81 in chips)
Seat 3: aleks0v ($87.96 in chips)
Seat 4: IlxxxlI ($20.25 in chips)
Seat 5: IampokerKidd ($64.32 in chips)
Seat 6: Xiniay ($74.94 in chips)
IlxxxlI: posts small blind $0.25
IampokerKidd: posts big blind $0.50
*** HOLE CARDS ***
Dealt to IlxxxlI [Jh 9d]
Xiniay: raises $1 to $1.50
saidafrente: folds
aleks0v: folds
IlxxxlI: folds
IampokerKidd: folds
Uncalled bet ($1.00) returned to Xiniay
Xiniay: doesn't show hand
Xiniay collected $1.25 from pot
*** SUMMARY ***
Total pot $1.25 | Rake $0
Seat 1: saidafrente folded before Flop (didn't bet)
Seat 3: aleks0v (button) folded before Flop (didn't bet)
Seat 4: IlxxxlI (small blind) folded before Flop
Seat 5: IampokerKidd (big blind) folded before Flop
Seat 6: Xiniay collected ($1.25)

PokerStars Hand #771294135: Hold'em No Limit ($0.25/$0.50 USD) - 2016/11/09 18:26:11 ET
Table 'WPN_3219946394' 6-max  Seat #5 is the button
Seat 1: iGash ($81.14 in chips)
Seat 2: IlxxxlI ($20.00 in chips)
Seat 3: saidafrente ($58.18 in chips)
Seat 4: odel_nadel ($159.19 in chips)
Seat 5: Xiniay ($47.50 in chips)
iGash: posts small blind $0.25
IlxxxlI: posts big blind $0.50
*** HOLE CARDS ***
Dealt to IlxxxlI [Qd 9c]
saidafrente: folds
odel_nadel: raises $1 to $1.50
Xiniay: folds
iGash: calls $1.25
IlxxxlI: folds
*** FLOP *** [2h 5c 3h]
iGash: checks
odel_nadel: checks
*** TURN *** [2h 5c 3h] [5d]
iGash: bets $3
odel_nadel: folds
Uncalled bet ($3.00) returned to iGash
iGash: doesn't show hand
iGash collected $3.33 from pot
*** SUMMARY ***
Total pot $3.50 | Rake $0.17
Board [2h 5c 3h 5d]
Seat 1: iGash (small blind) collected ($3.33)
Seat 2: IlxxxlI (big blind) folded before Flop
Seat 3: saidafrente folded before Flop (didn't bet)
Seat 4: odel_nadel folded on the Turn
Seat 5: Xiniay (button) folded before Flop (didn't bet)

PokerStars Hand #771293890: Hold'em No Limit ($0.25/$0.50 USD) - 2016/11/09 18:25:25 ET
Table 'WPN_3421571163' 6-max  Seat #4 is the button
Seat 1: legenda99 ($63.72 in chips)
Seat 2: IlxxxlI ($20.00 in chips)
Seat 3: Xiniay ($64.91 in chips)
Seat 4: Zaychik033 ($80.66 in chips)
legenda99: posts small blind $0.25
IlxxxlI: posts big blind $0.50
*** HOLE CARDS ***
Dealt to IlxxxlI [7d Qs]
Xiniay: folds
Zaychik033: folds
legenda99: raises $1 to $1.50
IlxxxlI: calls $1
*** FLOP *** [7h 6s 6d]
legenda99: checks
IlxxxlI: bets $1.42
legenda99: calls $1.42
*** TURN *** [7h 6s 6d] [Th]
legenda99: checks
IlxxxlI: bets $1.50
legenda99: raises $6 to $7.50
IlxxxlI: folds
Uncalled bet ($6.00) returned to legenda99
legenda99: doesn't show hand
legenda99 collected $8.40 from pot
*** SUMMARY ***
Total pot $8.84 | Rake $0.44
Board [7h 6s 6d Th]
Seat 1: legenda99 (small blind) collected ($8.40)
Seat 2: IlxxxlI (big blind) folded on the Turn
Seat 3: Xiniay folded before Flop (didn't bet)
Seat 4: Zaychik033 (button) folded before Flop (didn't bet)

PokerStars Hand #771293706: Hold'em No Limit ($0.25/$0.50 USD) - 2016/11/09 18:24:51 ET
Table 'WPN_325998925' 6-max  Seat #3 is the button
Seat 1: brasinsh7 ($50.00 in chips)
Seat 3: IlxxxlI ($20.00 in chips)
Seat 4: Xiniay ($74.49 in chips)
Seat 5: Zaychik033 ($50.00 in chips)
Seat 6: COTHREEO3 ($73.55 in chips)
Xiniay: posts small blind $0.25
Zaychik033: posts big blind $0.50
*** HOLE CARDS ***
Dealt to IlxxxlI [Kd 6s]
COTHREEO3: folds
brasinsh7: raises $1 to $1.50
IlxxxlI: folds
Xiniay: raises $3.50 to $5
Zaychik033: folds
brasinsh7: calls $3.50
*** FLOP *** [8s 8h 4d]
Xiniay: bets $3.32
brasinsh7: calls $3.32
*** TURN *** [8s 8h 4d] [7d]
Xiniay: checks
brasinsh7: checks
*** RIVER *** [8s 8h 4d 7d] [5d]
Xiniay: checks
brasinsh7: bets $9.50
Xiniay: raises $56.67 to $66.17 and is all-in
brasinsh7: folds
Uncalled bet ($56.67) returned to Xiniay
Xiniay: doesn't show hand
Xiniay collected $34.34 from pot
*** SUMMARY ***
Total pot $36.14 | Rake $1.80
Board [8s 8h 4d 7d 5d]
Seat 1: brasinsh7 folded on the River
Seat 3: IlxxxlI (button) folded before Flop (didn't bet)
Seat 4: Xiniay (small blind) collected ($34.34)
Seat 5: Zaychik033 (big blind) folded before Flop
Seat 6: COTHREEO3 folded before Flop (didn't bet)

PokerStars Hand #771293548: Hold'em No Limit ($0.25/$0.50 USD) - 2016/11/09 18:24:24 ET
Table 'WPN_3981802040' 6-max  Seat #1 is the button
Seat 1: saidafrente ($36.81 in chips)
Seat 3: aleks0v ($85.13 in chips)
Seat 4: IlxxxlI ($20.75 in chips)
Seat 5: IampokerKidd ($64.32 in chips)
Seat 6: Xiniay ($77.55 in chips)
aleks0v: posts small blind $0.25
IlxxxlI: posts big blind $0.50
*** HOLE CARDS ***
Dealt to IlxxxlI [9c Jh]
IampokerKidd: folds
Xiniay: raises $1 to $1.50
saidafrente: folds
aleks0v: calls $1.25
IlxxxlI: folds
*** FLOP *** [Qc 5s 9d]
aleks0v: checks
Xiniay: bets $1.11
aleks0v: calls $1.11
*** TURN *** [Qc 5s 9d] [Js]
aleks0v: checks
Xiniay: checks
*** RIVER *** [Qc 5s 9d Js] [Tc]
aleks0v: checks
Xiniay: checks
*** SHOW DOWN ***
aleks0v: shows [8c Ac] (Straight to Q)
Xiniay: mucks hand
aleks0v collected $5.44 from pot
*** SUMMARY ***
Total pot $5.72 | Rake $0.28
Board [Qc 5s 9d Js Tc]
Seat 1: saidafrente (button) folded before Flop (didn't bet)
Seat 3: aleks0v (small blind) showed [8c Ac] and won ($5.44) with Straight to Q
Seat 4: IlxxxlI (big blind) folded before Flop
Seat 5: IampokerKidd folded before Flop (didn't bet)
Seat 6: Xiniay mucked

PokerStars Hand #771293527: Hold'em No Limit ($0.25/$0.50 USD) - 2016/11/09 18:24:19 ET
Table 'WPN_3421571163' 6-max  Seat #3 is the button
Seat 1: legenda99 ($64.22 in chips)
Seat 2: IlxxxlI ($20.89 in chips)
Seat 3: Xiniay ($64.91 in chips)
Seat 4: Zaychik033 ($71.18 in chips)
Zaychik033: posts small blind $0.25
legenda99: posts big blind $0.50
*** HOLE CARDS ***
Dealt to IlxxxlI [7d Ad]
IlxxxlI: raises $0.70 to $1.20
Xiniay: folds
Zaychik033: raises $2.80 to $4
legenda99: folds
IlxxxlI: calls $2.80
*** FLOP *** [8c 3d 7c]
Zaychik033: bets $6
IlxxxlI: calls $6
*** TURN *** [8c 3d 7c] [Ts]
Zaychik033: bets $12.98
IlxxxlI: folds
Uncalled bet ($12.98) returned to Zaychik033
Zaychik033: doesn't show hand
Zaychik033 collected $19.48 from pot
*** SUMMARY ***
Total pot $20.50 | Rake $1.02
Board [8c 3d 7c Ts]
Seat 1: legenda99 folded before Flop
Seat 2: IlxxxlI folded on the Turn
Seat 3: Xiniay (button) folded before Flop (didn't bet)
Seat 4: Zaychik033 (small blind) collected ($19.48)

PokerStars Hand #771293503: Hold'em No Limit ($0.25/$0.50 USD) - 2016/11/09 18:24:14 ET
Table 'WPN_3981802040' 6-max  Seat #6 is the button
Seat 1: saidafrente ($37.06 in chips)
Seat 3: aleks0v ($84.88 in chips)
Seat 4: IlxxxlI ($20.75 in chips)
Seat 5: IampokerKidd ($64.32 in chips)
Seat 6: Xiniay ($77.55 in chips)
saidafrente: posts small blind $0.25
aleks0v: posts big blind $0.50
*** HOLE CARDS ***
Dealt to IlxxxlI [2s 7c]
IlxxxlI: folds
IampokerKidd: folds
Xiniay: folds
saidafrente: folds
Uncalled bet ($0.25) returned to aleks0v
aleks0v: doesn't show hand
aleks0v collected $0.50 from pot
*** SUMMARY ***
Total pot $0.50 | Rake $0
Seat 1: saidafrente (small blind) folded before Flop
Seat 3: aleks0v collected ($0.50)
Seat 4: IlxxxlI folded before Flop (didn't bet)
Seat 5: IampokerKidd folded before Flop (didn't bet)
Seat 6: Xiniay (button) folded before Flop (didn't bet)

PokerStars Hand #771293396: Hold'em No Limit ($0.25/$0.50 USD) - 2016/11/09 18:23:53 ET
Table 'WPN_3981802040' 6-max  Seat #5 is the button
Seat 1: saidafrente ($37.56 in chips)
Seat 2: Lopatick ($50.00 in chips)
Seat 3: aleks0v ($84.88 in chips)
Seat 4: IlxxxlI ($20.00 in chips)
Seat 5: IampokerKidd ($64.32 in chips)
Seat 6: Xiniay ($77.80 in chips)
Xiniay: posts small blind $0.25
saidafrente: posts big blind $0.50
*** HOLE CARDS ***
Dealt to IlxxxlI [3s 3h]
Lopatick: folds
aleks0v: folds
IlxxxlI: raises $0.70 to $1.20
IampokerKidd: folds
Xiniay: folds
saidafrente: folds
Uncalled bet ($0.70) returned to IlxxxlI
IlxxxlI: doesn't show hand
IlxxxlI collected $1.25 from pot
*** SUMMARY ***
Total pot $1.25 | Rake $0
Seat 1: saidafrente (big blind) folded before Flop
Seat 2: Lopatick folded before Flop (didn't bet)
Seat 3: aleks0v folded before Flop (didn't bet)
Seat 4: IlxxxlI collected ($1.25)
Seat 5: IampokerKidd (button) folded before Flop (didn't bet)
Seat 6: Xiniay (small blind) folded before Flop

PokerStars Hand #771293244: Hold'em No Limit ($0.25/$0.50 USD) - 2016/11/09 18:23:25 ET
Table 'WPN_3981802040' 6-max  Seat #4 is the button
Seat 1: saidafrente ($36.81 in chips)
Seat 2: Lopatick ($50.00 in chips)
Seat 3: aleks0v ($84.88 in chips)
Seat 4: IlxxxlI ($20.00 in chips)
Seat 5: IampokerKidd ($64.57 in chips)
Seat 6: Xiniay ($78.30 in chips)
IampokerKidd: posts small blind $0.25
Xiniay: posts big blind $0.50
*** HOLE CARDS ***
Dealt to IlxxxlI [Ks Qd]
saidafrente: raises $1 to $1.50
Lopatick: folds
aleks0v: folds
IlxxxlI: folds
IampokerKidd: folds
Xiniay: folds
Uncalled bet ($1.00) returned to saidafrente
saidafrente: doesn't show hand
saidafrente collected $1.25 from pot
*** SUMMARY ***
Total pot $1.25 | Rake $0
Seat 1: saidafrente collected ($1.25)
Seat 2: Lopatick folded before Flop (didn't bet)
Seat 3: aleks0v folded before Flop (didn't bet)
Seat 4: IlxxxlI (button) folded before Flop (didn't bet)
Seat 5: IampokerKidd (small blind) folded before Flop
Seat 6: Xiniay (big blind) folded before Flop

PokerStars Hand #771293203: Hold'em No Limit ($0.25/$0.50 USD) - 2016/11/09 18:23:17 ET
Table 'WPN_325998925' 6-max  Seat #2 is the button
Seat 2: AbstractSun ($51.71 in chips)
Seat 3: IlxxxlI ($20.00 in chips)
Seat 4: Xiniay ($71.50 in chips)
Seat 6: COTHREEO3 ($73.55 in chips)
IlxxxlI: posts small blind $0.25
Xiniay: posts big blind $0.50
*** HOLE CARDS ***
Dealt to IlxxxlI [4d As]
COTHREEO3: folds
AbstractSun: raises $0.75 to $1.25
IlxxxlI: raises $0.75 to $2
Xiniay: calls $1.50
AbstractSun: folds
*** FLOP *** [4c Qd Jh]
IlxxxlI: checks
Xiniay: checks
*** TURN *** [4c Qd Jh] [6d]
IlxxxlI: checks
Xiniay: bets $3.32
IlxxxlI: folds
Uncalled bet ($3.32) returned to Xiniay
Xiniay: doesn't show hand
Xiniay collected $4.99 from pot
*** SUMMARY ***
Total pot $5.25 | Rake $0.26
Board [4c Qd Jh 6d]
Seat 2: AbstractSun (button) folded before Flop
Seat 3: IlxxxlI (small blind) folded on the Turn
Seat 4: Xiniay (big blind) collected ($4.99)
Seat 6: COTHREEO3 folded before Flop (didn't bet)

PokerStars Hand #771293042: Hold'em No Limit ($0.25/$0.50 USD) - 2016/11/09 18:22:44 ET
Table 'WPN_3981802040' 6-max  Seat #3 is the button
Seat 1: saidafrente ($36.81 in chips)
Seat 2: Lopatick ($50.00 in chips)
Seat 3: aleks0v ($83.04 in chips)
Seat 4: IlxxxlI ($20.00 in chips)
Seat 5: IampokerKidd ($65.07 in chips)
Seat 6: Xiniay ($78.30 in chips)
IlxxxlI: posts small blind $0.25
IampokerKidd: posts big blind $0.50
*** HOLE CARDS ***
Dealt to IlxxxlI [Qs 7c]
Xiniay: folds
saidafrente: folds
Lopatick: raises $0.75 to $1.25
aleks0v: calls $1.25
IlxxxlI: folds
IampokerKidd: folds
*** FLOP *** [Jh Qh 6h]
Lopatick: checks
aleks0v: bets $2.25
Lopatick: folds
Uncalled bet ($2.25) returned to aleks0v
aleks0v: doesn't show hand
aleks0v collected $3.09 from pot
*** SUMMARY ***
Total pot $3.25 | Rake $0.16
Board [Jh Qh 6h]
Seat 1: saidafrente folded before Flop (didn't bet)
Seat 2: Lopatick folded on the Flop
Seat 3: aleks0v (button) collected ($3.09)
Seat 4: IlxxxlI (small blind) folded before Flop
Seat 5: IampokerKidd (big blind) folded before Flop
Seat 6: Xiniay folded before Flop (didn't bet)

PokerStars Hand #771292979: Hold'em No Limit ($0.25/$0.50 USD) - 2016/11/09 18:22:34 ET
Table 'WPN_3421571163' 6-max  Seat #2 is the button
Seat 1: legenda99 ($78.18 in chips)
Seat 2: IlxxxlI ($20.89 in chips)
Seat 3: Xiniay ($65.16 in chips)
Seat 4: Zaychik033 ($71.68 in chips)
Seat 5: cardplayerX ($49.25 in chips)
Seat 6: Lopatick ($66.22 in chips)
Xiniay: posts small blind $0.25
Zaychik033: posts big blind $0.50
*** HOLE CARDS ***
Dealt to IlxxxlI [8h As]
cardplayerX: raises $1 to $1.50
Lopatick: folds
legenda99: raises $3.50 to $5
IlxxxlI: folds
Xiniay: folds
Zaychik033: folds
cardplayerX: calls $3.50
*** FLOP *** [5h 9h 7c]
cardplayerX: checks
legenda99: checks
*** TURN *** [5h 9h 7c] [Ts]
cardplayerX: bets $3.40
legenda99: calls $3.40
*** RIVER *** [5h 9h 7c Ts] [9c]
cardplayerX: bets $5.56
legenda99: calls $5.56
*** SHOW DOWN ***
legenda99: mucks hand
cardplayerX: shows [Jc Js] (Two pairs. Js and 9s)
cardplayerX collected $27.24 from pot
*** SUMMARY ***
Total pot $28.67 | Rake $1.43
Board [5h 9h 7c Ts 9c]
Seat 1: legenda99 mucked
Seat 2: IlxxxlI (button) folded before Flop (didn't bet)
Seat 3: Xiniay (small blind) folded before Flop
Seat 4: Zaychik033 (big blind) folded before Flop
Seat 5: cardplayerX showed [Jc Js] and won ($27.24) with Two pairs. Js and 9s
Seat 6: Lopatick folded before Flop (didn't bet)

PokerStars Hand #771292881: Hold'em No Limit ($0.25/$0.50 USD) - 2016/11/09 18:22:12 ET
Table 'WPN_3421571163' 6-max  Seat #1 is the button
Seat 1: legenda99 ($78.18 in chips)
Seat 2: IlxxxlI ($21.14 in chips)
Seat 3: Xiniay ($64.91 in chips)
Seat 4: Zaychik033 ($71.68 in chips)
Seat 5: cardplayerX ($49.25 in chips)
Seat 6: Lopatick ($66.22 in chips)
IlxxxlI: posts small blind $0.25
Xiniay: posts big blind $0.50
*** HOLE CARDS ***
Dealt to IlxxxlI [Kh 5c]
Zaychik033: folds
cardplayerX: folds
Lopatick: folds
legenda99: folds
IlxxxlI: folds
Uncalled bet ($0.25) returned to Xiniay
Xiniay: doesn't show hand
Xiniay collected $0.50 from pot
*** SUMMARY ***
Total pot $0.50 | Rake $0
Seat 1: legenda99 (button) folded before Flop (didn't bet)
Seat 2: IlxxxlI (small blind) folded before Flop
Seat 3: Xiniay (big blind) collected ($0.50)
Seat 4: Zaychik033 folded before Flop (didn't bet)
Seat 5: cardplayerX folded before Flop (didn't bet)
Seat 6: Lopatick folded before Flop (didn't bet)

PokerStars Hand #771292858: Hold'em No Limit ($0.25/$0.50 USD) - 2016/11/09 18:22:09 ET
Table 'WPN_3981802040' 6-max  Seat #2 is the button
Seat 1: saidafrente ($36.81 in chips)
Seat 2: Lopatick ($50.00 in chips)
Seat 3: aleks0v ($81.54 in chips)
Seat 4: IlxxxlI ($20.00 in chips)
Seat 5: IampokerKidd ($65.07 in chips)
Seat 6: Xiniay ($78.30 in chips)
aleks0v: posts small blind $0.25
IlxxxlI: posts big blind $0.50
*** HOLE CARDS ***
Dealt to IlxxxlI [Tc Qs]
IampokerKidd: folds
Xiniay: folds
saidafrente: folds
Lopatick: raises $0.50 to $1
aleks0v: raises $3.25 to $4.25
IlxxxlI: folds
Lopatick: folds
Uncalled bet ($3.25) returned to aleks0v
aleks0v: doesn't show hand
aleks0v collected $2.50 from pot
*** SUMMARY ***
Total pot $2.50 | Rake $0
Seat 1: saidafrente folded before Flop (didn't bet)
Seat 2: Lopatick (button) folded before Flop
Seat 3: aleks0v (small blind) collected ($2.50)
Seat 4: IlxxxlI (big blind) folded before Flop
Seat 5: IampokerKidd folded before Flop (didn't bet)
Seat 6: Xiniay folded before Flop (didn't bet)

PokerStars Hand #771292850: Hold'em No Limit ($0.25/$0.50 USD) - 2016/11/09 18:22:06 ET
Table 'WPN_325998925' 6-max  Seat #1 is the button
Seat 1: brasinsh7 ($16.99 in chips)
Seat 2: AbstractSun ($51.96 in chips)
Seat 3: IlxxxlI ($20.00 in chips)
Seat 4: Xiniay ($71.50 in chips)
Seat 6: COTHREEO3 ($57.54 in chips)
AbstractSun: posts small blind $0.25
IlxxxlI: posts big blind $0.50
*** HOLE CARDS ***
Dealt to IlxxxlI [As 8d]
Xiniay: folds
COTHREEO3: calls $0.50
brasinsh7: raises $2 to $2.50
AbstractSun: folds
IlxxxlI: folds
COTHREEO3: raises $3.50 to $6
brasinsh7: calls $3.50
*** FLOP *** [4d 4c 2s]
COTHREEO3: bets $4
brasinsh7: calls $4
*** TURN *** [4d 4c 2s] [Qh]
COTHREEO3: checks
brasinsh7: bets $6.99 and is all-in
COTHREEO3: calls $6.99
*** RIVER *** [4d 4c 2s Qh] [5h]
*** SHOW DOWN ***
brasinsh7: shows [Jd 9d] (One pair of 4s)
COTHREEO3: shows [Qs Qc] (Full House (Q/4))
COTHREEO3 collected $33 from pot
*** SUMMARY ***
Total pot $34.73 | Rake $1.73
Board [4d 4c 2s Qh 5h]
Seat 1: brasinsh7 (button) showed [Jd 9d] and lost with One pair of 4s
Seat 2: AbstractSun (small blind) folded before Flop
Seat 3: IlxxxlI (big blind) folded before Flop
Seat 4: Xiniay folded before Flop (didn't bet)
Seat 6: COTHREEO3 showed [Qs Qc] and won ($33) with Full House (Q/4)

PokerStars Hand #771292393: Hold'em No Limit ($0.25/$0.50 USD) - 2016/11/09 18:20:38 ET
Table 'WPN_3421571163' 6-max  Seat #6 is the button
Seat 1: legenda99 ($78.43 in chips)
Seat 2: IlxxxlI ($20.00 in chips)
Seat 3: Xiniay ($64.91 in chips)
Seat 4: Zaychik033 ($71.68 in chips)
Seat 5: cardplayerX ($49.25 in chips)
Seat 6: Lopatick ($67.22 in chips)
legenda99: posts small blind $0.25
IlxxxlI: posts big blind $0.50
*** HOLE CARDS ***
Dealt to IlxxxlI [5s 8h]
Xiniay: folds
Zaychik033: folds
cardplayerX: folds
Lopatick: raises $0.50 to $1
legenda99: folds
IlxxxlI: calls $0.50
*** FLOP *** [Ah Ks 7h]
IlxxxlI: checks
Lopatick: checks
*** TURN *** [Ah Ks 7h] [Qh]
IlxxxlI: checks
Lopatick: checks
*** RIVER *** [Ah Ks 7h Qh] [Js]
IlxxxlI: bets $1.07
Lopatick: folds
Uncalled bet ($1.07) returned to IlxxxlI
IlxxxlI: doesn't show hand
IlxxxlI collected $2.14 from pot
*** SUMMARY ***
Total pot $2.25 | Rake $0.11
Board [Ah Ks 7h Qh Js]
Seat 1: legenda99 (small blind) folded before Flop
Seat 2: IlxxxlI (big blind) collected ($2.14)
Seat 3: Xiniay folded before Flop (didn't bet)
Seat 4: Zaychik033 folded before Flop (didn't bet)
Seat 5: cardplayerX folded before Flop (didn't bet)
Seat 6: Lopatick (button) folded on the River

PokerStars Hand #771292015: Hold'em No Limit ($0.25/$0.50 USD) - 2016/11/09 18:19:19 ET
Table 'WPN_325998925' 6-max  Seat #6 is the button
Seat 1: brasinsh7 ($42.21 in chips)
Seat 2: AbstractSun ($52.46 in chips)
Seat 3: IlxxxlI ($20.00 in chips)
Seat 4: Xiniay ($48.32 in chips)
Seat 6: COTHREEO3 ($57.54 in chips)
brasinsh7: posts small blind $0.25
AbstractSun: posts big blind $0.50
*** HOLE CARDS ***
Dealt to IlxxxlI [5c 7d]
IlxxxlI: folds
Xiniay: raises $1 to $1.50
COTHREEO3: folds
brasinsh7: calls $1.25
AbstractSun: folds
*** FLOP *** [Kc 2c 4d]
brasinsh7: bets $2.22
Xiniay: calls $2.22
*** TURN *** [Kc 2c 4d] [8d]
brasinsh7: bets $6
Xiniay: calls $6
*** RIVER *** [Kc 2c 4d 8d] [5d]
brasinsh7: bets $15.50
Xiniay: calls $15.50
*** SHOW DOWN ***
brasinsh7: shows [Jc Qc] (High card K)
Xiniay: shows [9h Ks] (One pair of Ks)
Xiniay collected $48.40 from pot
*** SUMMARY ***
Total pot $50.94 | Rake $2.54
Board [Kc 2c 4d 8d 5d]
Seat 1: brasinsh7 (small blind) showed [Jc Qc] and lost with High card K
Seat 2: AbstractSun (big blind) folded before Flop
Seat 3: IlxxxlI folded before Flop (didn't bet)
Seat 4: Xiniay showed [9h Ks] and won ($48.40) with One pair of Ks
Seat 6: COTHREEO3 (button) folded before Flop (didn't bet)

PokerStars Hand #771291876: Hold'em No Limit ($0.25/$0.50 USD) - 2016/11/09 18:18:52 ET
Table 'WPN_325998925' 6-max  Seat #4 is the button
Seat 1: brasinsh7 ($42.71 in chips)
Seat 2: AbstractSun ($52.46 in chips)
Seat 3: IlxxxlI ($20.00 in chips)
Seat 4: Xiniay ($47.57 in chips)
Seat 6: COTHREEO3 ($57.79 in chips)
COTHREEO3: posts small blind $0.25
brasinsh7: posts big blind $0.50
*** HOLE CARDS ***
Dealt to IlxxxlI [Qs 3s]
AbstractSun: folds
IlxxxlI: folds
Xiniay: raises $1 to $1.50
COTHREEO3: folds
brasinsh7: folds
Uncalled bet ($1.00) returned to Xiniay
Xiniay: doesn't show hand
Xiniay collected $1.25 from pot
*** SUMMARY ***
Total pot $1.25 | Rake $0
Seat 1: brasinsh7 (big blind) folded before Flop
Seat 2: AbstractSun folded before Flop (didn't bet)
Seat 3: IlxxxlI folded before Flop (didn't bet)
Seat 4: Xiniay (button) collected ($1.25)
Seat 6: COTHREEO3 (small blind) folded before Flop

PokerStars Hand #771291707: Hold'em No Limit ($0.25/$0.50 USD) - 2016/11/09 18:18:18 ET
Table 'WPN_325998925' 6-max  Seat #3 is the button
Seat 1: brasinsh7 ($40.88 in chips)
Seat 2: AbstractSun ($52.46 in chips)
Seat 3: IlxxxlI ($20.00 in chips)
Seat 4: Xiniay ($49.07 in chips)
Seat 6: COTHREEO3 ($58.29 in chips)
Xiniay: posts small blind $0.25
COTHREEO3: posts big blind $0.50
*** HOLE CARDS ***
Dealt to IlxxxlI [Qc 5s]
brasinsh7: raises $1 to $1.50
AbstractSun: folds
IlxxxlI: folds
Xiniay: calls $1.25
COTHREEO3: folds
*** FLOP *** [7c Jc Th]
Xiniay: checks
brasinsh7: bets $2.22
Xiniay: folds
Uncalled bet ($2.22) returned to brasinsh7
brasinsh7: doesn't show hand
brasinsh7 collected $3.33 from pot
*** SUMMARY ***
Total pot $3.50 | Rake $0.17
Board [7c Jc Th]
Seat 1: brasinsh7 collected ($3.33)
Seat 2: AbstractSun folded before Flop (didn't bet)
Seat 3: IlxxxlI (button) folded before Flop (didn't bet)
Seat 4: Xiniay (small blind) folded on the Flop
Seat 6: COTHREEO3 folded before Flop

PokerStars Hand #771291376: Hold'em No Limit ($0.25/$0.50 USD) - 2016/11/09 18:17:22 ET
Table 'WPN_325998925' 6-max  Seat #2 is the button
Seat 1: brasinsh7 ($42.88 in chips)
Seat 2: AbstractSun ($52.46 in chips)
Seat 3: IlxxxlI ($20.00 in chips)
Seat 4: Xiniay ($44.82 in chips)
Seat 5: aquamarin ($66.81 in chips)
Seat 6: COTHREEO3 ($58.29 in chips)
IlxxxlI: posts small blind $0.25
Xiniay: posts big blind $0.50
*** HOLE CARDS ***
Dealt to IlxxxlI [9s 3s]
aquamarin: raises $1.50 to $2
COTHREEO3: folds
brasinsh7: calls $2
AbstractSun: folds
IlxxxlI: folds
Xiniay: raises $6.50 to $8.50
aquamarin: folds
brasinsh7: folds
Uncalled bet ($6.50) returned to Xiniay
Xiniay: doesn't show hand
Xiniay collected $6.25 from pot
*** SUMMARY ***
Total pot $6.25 | Rake $0
Seat 1: brasinsh7 folded before Flop
Seat 2: AbstractSun (button) folded before Flop (didn't bet)
Seat 3: IlxxxlI (small blind) folded before Flop
Seat 4: Xiniay (big blind) collected ($6.25)
Seat 5: aquamarin folded before Flop
Seat 6: COTHREEO3 folded before Flop (didn't bet)

PokerStars Hand #771290913: Hold'em No Limit ($0.25/$0.50 USD) - 2016/11/09 18:16:02 ET
Table 'WPN_325998925' 6-max  Seat #1 is the button
Seat 1: brasinsh7 ($59.88 in chips)
Seat 2: AbstractSun ($52.71 in chips)
Seat 3: IlxxxlI ($20.00 in chips)
Seat 4: Xiniay ($44.82 in chips)
Seat 5: aquamarin ($45.09 in chips)
Seat 6: COTHREEO3 ($64.29 in chips)
AbstractSun: posts small blind $0.25
IlxxxlI: posts big blind $0.50
*** HOLE CARDS ***
Dealt to IlxxxlI [4d 7h]
Xiniay: folds
aquamarin: raises $1.50 to $2
COTHREEO3: raises $4 to $6
brasinsh7: calls $6
AbstractSun: folds
IlxxxlI: folds
aquamarin: calls $4
*** FLOP *** [4s 7c 2s]
aquamarin: checks
COTHREEO3: checks
brasinsh7: checks
*** TURN *** [4s 7c 2s] [Kc]
aquamarin: checks
COTHREEO3: checks
brasinsh7: checks
*** RIVER *** [4s 7c 2s Kc] [2c]
aquamarin: bets $11
COTHREEO3: folds
brasinsh7: calls $11
*** SHOW DOWN ***
brasinsh7: mucks hand
aquamarin: shows [Ks Ad] (Two pairs. Ks and 2s)
aquamarin collected $38.72 from pot
*** SUMMARY ***
Total pot $40.75 | Rake $2.03
Board [4s 7c 2s Kc 2c]
Seat 1: brasinsh7 (button) mucked
Seat 2: AbstractSun (small blind) folded before Flop
Seat 3: IlxxxlI (big blind) folded before Flop
Seat 4: Xiniay folded before Flop (didn't bet)
Seat 5: aquamarin showed [Ks Ad] and won ($38.72) with Two pairs. Ks and 2s
Seat 6: COTHREEO3 folded on the River

PokerStars Hand #771290472: Hold'em No Limit ($0.25/$0.50 USD) - 2016/11/09 18:14:39 ET
Table 'WPN_325998925' 6-max  Seat #6 is the button
Seat 1: brasinsh7 ($49.50 in chips)
Seat 2: AbstractSun ($53.21 in chips)
Seat 3: IlxxxlI ($20.00 in chips)
Seat 4: Xiniay ($44.82 in chips)
Seat 5: aquamarin ($56.09 in chips)
Seat 6: COTHREEO3 ($64.29 in chips)
brasinsh7: posts small blind $0.25
AbstractSun: posts big blind $0.50
*** HOLE CARDS ***
Dealt to IlxxxlI [3h 5s]
IlxxxlI: folds
Xiniay: folds
aquamarin: raises $1 to $1.50
COTHREEO3: folds
brasinsh7: raises $3.50 to $5
AbstractSun: folds
aquamarin: calls $3.50
*** FLOP *** [8h 8s 9s]
brasinsh7: bets $6
aquamarin: calls $6
*** TURN *** [8h 8s 9s] [Ad]
brasinsh7: bets $14.50
aquamarin: folds
Uncalled bet ($14.50) returned to brasinsh7
brasinsh7: doesn't show hand
brasinsh7 collected $21.38 from pot
*** SUMMARY ***
Total pot $22.50 | Rake $1.12
Board [8h 8s 9s Ad]
Seat 1: brasinsh7 (small blind) collected ($21.38)
Seat 2: AbstractSun (big blind) folded before Flop
Seat 3: IlxxxlI folded before Flop (didn't bet)
Seat 4: Xiniay folded before Flop (didn't bet)
Seat 5: aquamarin folded on the Turn
Seat 6: COTHREEO3 (button) folded before Flop (didn't bet)

PokerStars Hand #771290373: Hold'em No Limit ($0.25/$0.50 USD) - 2016/11/09 18:14:20 ET
Table 'WPN_325998925' 6-max  Seat #5 is the button
Seat 1: brasinsh7 ($50.00 in chips)
Seat 2: AbstractSun ($52.46 in chips)
Seat 3: IlxxxlI ($20.00 in chips)
Seat 4: Xiniay ($44.82 in chips)
Seat 5: aquamarin ($56.09 in chips)
Seat 6: COTHREEO3 ($64.54 in chips)
COTHREEO3: posts small blind $0.25
brasinsh7: posts big blind $0.50
*** HOLE CARDS ***
Dealt to IlxxxlI [5d 5h]
AbstractSun: raises $1 to $1.50
IlxxxlI: folds
Xiniay: folds
aquamarin: folds
COTHREEO3: folds
brasinsh7: folds
Uncalled bet ($1.00) returned to AbstractSun
AbstractSun: doesn't show hand
AbstractSun collected $1.25 from pot
*** SUMMARY ***
Total pot $1.25 | Rake $0
Seat 1: brasinsh7 (big blind) folded before Flop
Seat 2: AbstractSun collected ($1.25)
Seat 3: IlxxxlI folded before Flop (didn't bet)
Seat 4: Xiniay folded before Flop (didn't bet)
Seat 5: aquamarin (button) folded before Flop (didn't bet)
Seat 6: COTHREEO3 (small blind) folded before Flop

PokerStars Hand #771290118: Hold'em No Limit ($0.25/$0.50 USD) - 2016/11/09 18:13:32 ET
Table 'WPN_325998925' 6-max  Seat #4 is the button
Seat 2: AbstractSun ($52.46 in chips)
Seat 3: IlxxxlI ($20.00 in chips)
Seat 4: Xiniay ($44.82 in chips)
Seat 5: aquamarin ($52.94 in chips)
Seat 6: COTHREEO3 ($68.04 in chips)
aquamarin: posts small blind $0.25
COTHREEO3: posts big blind $0.50
*** HOLE CARDS ***
Dealt to IlxxxlI [Jc 9h]
AbstractSun: folds
IlxxxlI: folds
Xiniay: folds
aquamarin: raises $1 to $1.50
COTHREEO3: calls $1
*** FLOP *** [Jh 6h Ad]
aquamarin: checks
COTHREEO3: checks
*** TURN *** [Jh 6h Ad] [Tc]
aquamarin: bets $2
COTHREEO3: calls $2
*** RIVER *** [Jh 6h Ad Tc] [Ac]
aquamarin: bets $5
COTHREEO3: folds
Uncalled bet ($5.00) returned to aquamarin
aquamarin: doesn't show hand
aquamarin collected $6.65 from pot
*** SUMMARY ***
Total pot $7 | Rake $0.35
Board [Jh 6h Ad Tc Ac]
Seat 2: AbstractSun folded before Flop (didn't bet)
Seat 3: IlxxxlI folded before Flop (didn't bet)
Seat 4: Xiniay (button) folded before Flop (didn't bet)
Seat 5: aquamarin (small blind) collected ($6.65)
Seat 6: COTHREEO3 (big blind) folded on the River

PokerStars Hand #771289785: Hold'em No Limit ($0.25/$0.50 USD) - 2016/11/09 18:12:26 ET
Table 'WPN_325998925' 6-max  Seat #3 is the button
Seat 2: AbstractSun ($52.46 in chips)
Seat 3: IlxxxlI ($20.00 in chips)
Seat 4: Xiniay ($45.07 in chips)
Seat 5: aquamarin ($50.00 in chips)
Seat 6: COTHREEO3 ($71.04 in chips)
Xiniay: posts small blind $0.25
aquamarin: posts big blind $0.50
*** HOLE CARDS ***
Dealt to IlxxxlI [5d 6s]
COTHREEO3: raises $1 to $1.50
AbstractSun: folds
IlxxxlI: folds
Xiniay: folds
aquamarin: calls $1
*** FLOP *** [5s 5h Kc]
aquamarin: checks
COTHREEO3: bets $1.50
aquamarin: calls $1.50
*** TURN *** [5s 5h Kc] [Js]
aquamarin: checks
COTHREEO3: checks
*** RIVER *** [5s 5h Kc Js] [3d]
aquamarin: bets $4
COTHREEO3: folds
Uncalled bet ($4.00) returned to aquamarin
aquamarin: doesn't show hand
aquamarin collected $5.94 from pot
*** SUMMARY ***
Total pot $6.25 | Rake $0.31
Board [5s 5h Kc Js 3d]
Seat 2: AbstractSun folded before Flop (didn't bet)
Seat 3: IlxxxlI (button) folded before Flop (didn't bet)
Seat 4: Xiniay (small blind) folded before Flop
Seat 5: aquamarin (big blind) collected ($5.94)
Seat 6: COTHREEO3 folded on the River

PokerStars Hand #771289583: Hold'em No Limit ($0.25/$0.50 USD) - 2016/11/09 18:11:47 ET
Table 'WPN_325998925' 6-max  Seat #2 is the button
Seat 2: AbstractSun ($52.46 in chips)
Seat 3: IlxxxlI ($20.00 in chips)
Seat 4: Xiniay ($45.57 in chips)
Seat 6: COTHREEO3 ($70.35 in chips)
IlxxxlI: posts small blind $0.25
Xiniay: posts big blind $0.50
*** HOLE CARDS ***
Dealt to IlxxxlI [3h 8c]
COTHREEO3: calls $0.50
AbstractSun: folds
IlxxxlI: folds
Xiniay: checks
*** FLOP *** [3s Js 3c]
Xiniay: checks
COTHREEO3: bets $1
Xiniay: folds
Uncalled bet ($1.00) returned to COTHREEO3
COTHREEO3: doesn't show hand
COTHREEO3 collected $1.19 from pot
*** SUMMARY ***
Total pot $1.25 | Rake $0.06
Board [3s Js 3c]
Seat 2: AbstractSun (button) folded before Flop (didn't bet)
Seat 3: IlxxxlI (small blind) folded before Flop
Seat 4: Xiniay (big blind) folded on the Flop
Seat 6: COTHREEO3 collected ($1.19)

PokerStars Hand #771289220: Hold'em No Limit ($0.25/$0.50 USD) - 2016/11/09 18:10:40 ET
Table 'WPN_325998925' 6-max  Seat #1 is the button
Seat 1: TheUnderTaker ($50.56 in chips)
Seat 2: AbstractSun ($52.71 in chips)
Seat 3: IlxxxlI ($20.00 in chips)
Seat 4: Xiniay ($45.57 in chips)
Seat 6: COTHREEO3 ($50.00 in chips)
AbstractSun: posts small blind $0.25
IlxxxlI: posts big blind $0.50
COTHREEO3: posts big blind $0.50
*** HOLE CARDS ***
Dealt to IlxxxlI [8h 3c]
Xiniay: folds
COTHREEO3: checks
TheUnderTaker: raises $2.06 to $2.56
AbstractSun: folds
IlxxxlI: folds
COTHREEO3: raises $3.44 to $6
TheUnderTaker: calls $3.44
*** FLOP *** [Kd 8s Ts]
COTHREEO3: bets $5
TheUnderTaker: calls $5
*** TURN *** [Kd 8s Ts] [Qs]
COTHREEO3: checks
TheUnderTaker: bets $10.81
COTHREEO3: raises $28.19 to $39 and is all-in
TheUnderTaker: folds
Uncalled bet ($28.19) returned to COTHREEO3
COTHREEO3: doesn't show hand
COTHREEO3 collected $42.16 from pot
*** SUMMARY ***
Total pot $44.37 | Rake $2.21
Board [Kd 8s Ts Qs]
Seat 1: TheUnderTaker (button) folded on the Turn
Seat 2: AbstractSun (small blind) folded before Flop
Seat 3: IlxxxlI (big blind) folded before Flop
Seat 4: Xiniay folded before Flop (didn't bet)
Seat 6: COTHREEO3 collected ($42.16)

